rank,funny,somewhat_funny,unfunny,count,score,precision,contest,caption
1,545,586,600,1731,1.9682264586943963,0.019538871912053852,538,I'm not a big cat person.
2,488,631,566,1685,1.9537091988130564,0.019239959431628224,538,Think it over. I'm still the only one here who can use a can opener.
3,231,378,460,1069,1.7857811038353602,0.02371232015543067,538,"In my defense, the neutering was a requirement of the condo board."
4,223,329,447,999,1.7757757757757757,0.024932658158073925,538,"First of all, I'd like to apologize for the whole laser light thing."
5,233,225,452,910,1.7593406593406593,0.027647600382879948,538,"I may be a little prick, but at least I'm not a giant pussy."
6,164,259,369,792,1.7411616161616161,0.027678451892314347,538,Don't forget I'm still the only one who knows how to operate the can opener.
7,134,213,309,656,1.733231707317073,0.030370223365644017,538,"Kids, stay in the thimble."
8,123,216,323,662,1.6978851963746224,0.029684234763884102,538,"If you are going to rip-up the sofa, you are going to learn how to fix it!"
9,96,169,283,548,1.6587591240875912,0.03242655895740811,538,Kill me and the can opener dies with me.
10,81,180,265,526,1.650190114068441,0.0319352833834641,538,"If you eat me, you won't have anyone around to ignore anymore."
11,86,135,265,486,1.631687242798354,0.03477669367401649,538,"Take it easy, pal. She neutered me, too."
12,71,159,249,479,1.62839248434238,0.03329738921442729,538,"So this is what the label meant by ""and other side effects."""
13,82,121,257,460,1.6195652173913044,0.035920084923568185,538,So! Schrodinger's Cat finally meets String Theory!
14,77,116,248,441,1.6122448979591837,0.03651299370487175,538,He realized then that shrinking himself wasn't his real mistake -- it was getting a cat.
15,75,114,247,436,1.6055045871559632,0.036606182485701105,538,"Honey, run the can opener, quick!"
16,55,124,221,400,1.585,0.0360233494314542,538,"Seriously, you'll just cough me up."
17,56,99,217,372,1.5672043010752688,0.03838234554346958,538,One of us is having a bad dream.
18,57,94,218,369,1.5636856368563685,0.03883098931549853,538,"""Honey...was the cat food made by Monsanto?"
19,55,75,210,340,1.5441176470588236,0.04106197363029499,538,"It was then that Bill realized he had made a terrible mistake wishing for ""a ton of pussy."""
20,43,91,197,331,1.5347432024169185,0.03925872383280859,538,"So that would be a no on the cat sweater, then."
21,57,58,210,325,1.5292307692307692,0.04303009257454,538,I thought I'd sew a pussycat.
22,40,87,191,318,1.5251572327044025,0.03975236598663372,538,"Easy now, kitty. How about we work together until we figure out whose dream this is."
23,42,79,192,313,1.5207667731629393,0.04074385859656678,538,Absolutely the last time I cat-sit for Gulliver.
23,50,63,200,313,1.5207667731629393,0.04270717074179116,538,One of us is in the wrong cartoon.
25,45,65,193,303,1.5115511551155116,0.042554844775421825,538,You knew I was a terrible wizard when you married me.
25,36,83,184,303,1.5115511551155116,0.04017718757326271,538,I know this is how you perceive me but in reality I'm twenty times your size and control your food.
27,31,89,178,298,1.5067114093959733,0.0392697932360868,538,What happened to you just ignoring me all the time?
27,29,93,176,298,1.5067114093959733,0.038690076049781155,538,Looks like my wish for a shrink may have been misinterpreted.
29,31,90,179,300,1.5066666666666666,0.03907895370678183,538,Remember how everyone was saying you should be neutered but I said no?
29,35,82,183,300,1.5066666666666666,0.0402038654728559,538,Don't make me call the dog.
31,35,77,181,293,1.5017064846416381,0.04091860186467761,538,Keep in mind I only get one life.
32,42,61,188,291,1.4982817869415808,0.04309799745561107,538,"“If you stop calling me, “a little man”, I will stop calling you, “a big pussy”."
33,33,77,178,288,1.4965277777777777,0.04085986122128501,538,Small Lives Matter
33,32,79,177,288,1.4965277777777777,0.040562687145756705,538,Calm down. It's the catnip talking.
35,32,69,174,275,1.4836363636363636,0.04196190069541234,538,"Don't come any closer, I'm allergic."
36,28,73,169,270,1.4777777777777779,0.041213632396837896,538,It was then that Archie realized he hadn't paid close enough attention to the non-GMO cat food label.
37,24,79,165,268,1.4738805970149254,0.040057180777407074,538,You seemed much cuter online
38,25,75,165,265,1.471698113207547,0.04072627811521018,538,I'm afraid things got out of proportion here.
38,28,69,168,265,1.471698113207547,0.04176593136071445,538,"I understand your frustration, but your boots won't be ready until Thursday after 3."
40,26,72,166,264,1.4696969696969697,0.04118267859721654,538,One of us has eaten too many mushrooms.
40,29,66,169,264,1.4696969696969697,0.042218816919670624,538,Kind of wishing I'd grabbed the laser pointer instead.
42,35,48,173,256,1.4609375,0.045240603881727015,538,This is the last time we drop acid and catnip together.
43,27,62,164,253,1.458498023715415,0.042804294452551274,538,"Stay back, I'm allergic"
43,20,76,157,253,1.458498023715415,0.04015744572892799,538,Can't you go back to being aloof?
45,26,62,163,251,1.454183266932271,0.04266483993698026,538,"When the sign said 'World's Biggest Cathouse', I guess I misunderstood."
46,24,65,160,249,1.4538152610441768,0.04215170634364849,538,This situation has gotten completely out of proportion.
47,27,58,163,248,1.4516129032258065,0.04340752301211286,538,I guess you're not a person-cat.
48,28,54,163,245,1.4489795918367347,0.04416661572685247,538,You have nine lives and I have ten needles. Any questions?
48,24,62,159,245,1.4489795918367347,0.042624710243608796,538,"If you'd just work with me, I think we have a best selling children's book here."
50,32,45,167,244,1.4467213114754098,0.045787865812054254,538,"Look, neither of us want an alteration"
50,22,65,157,244,1.4467213114754098,0.04194299728686055,538,I have GOT to start reading the list of side effects with my medication.
52,20,68,155,243,1.4444444444444444,0.04123720105695586,538,I hate being part of the shrinking middle class.
53,25,57,159,241,1.4439834024896265,0.04350914752820237,538,"You might be her cat, but I'm her little man, so back off."
54,24,58,158,240,1.4416666666666667,0.04322739437394721,538,"So, am I in your dream, or are you in mine?"
54,31,44,165,240,1.4416666666666667,0.045963900495584735,538,"Either you're a subconscious dream manifestation of my ex-wife, or I'm in really big trouble."
56,23,59,157,239,1.4393305439330544,0.042937703376025774,538,Your OTHER left paw.
56,23,59,157,239,1.4393305439330544,0.042937703376025774,538,"'It'll sleep a lot,' she said. 'You'll barely know it's here,' she said."
58,24,55,157,236,1.4364406779661016,0.04372788404371638,538,Did I say catgut? I meant nylon.
58,31,41,164,236,1.4364406779661016,0.04652485389275289,538,"Don't marry a cat lady, they said, but did I listen?"
58,25,53,158,236,1.4364406779661016,0.04413830388253048,538,You need to cooperate for this to become viral.
58,23,57,156,236,1.4364406779661016,0.043313575426819774,538,"OK, let's say we reschedule the neutering."
62,22,60,157,239,1.4351464435146444,0.04250034278760637,538,"Okay, I'll stop making dumb internet videos of you. Just reverse the spell."
63,25,50,157,232,1.4310344827586208,0.044661351955453774,538,...and what was your second wish?
63,22,56,154,232,1.4310344827586208,0.04338985307626867,538,"Kitty, it's me. I've been downsized."
65,23,53,155,231,1.4285714285714286,0.04393830448915905,538,"When I wake up, you'd better be sleeping at the foot of the bed."
66,23,52,154,229,1.4279475982532752,0.044212495943779274,538,Do you solemnly swear to leave the upholstery alone?
66,23,52,154,229,1.4279475982532752,0.044212495943779274,538,You need a shrink.
66,22,54,153,229,1.4279475982532752,0.04377715645363192,538,"Oh, now you make eye contact."
66,25,48,156,229,1.4279475982532752,0.04507056177156618,538,Wait wait! The Red Dot! I can show you how to catch it!
66,20,58,151,229,1.4279475982532752,0.04289322424742518,538,I'm guessing this is a bad time to bring up that you were adopted.
66,33,32,164,229,1.4279475982532752,0.04835078594715931,538,This will hurt me more than it will hurt you.
66,19,60,150,229,1.4279475982532752,0.04244435552493372,538,You're going to need to sit still if you want these alterations done.
73,30,37,161,228,1.4254385964912282,0.047287595669023214,538,I wouldn't think such a big pussy would be afraid of a little prick
73,27,43,158,228,1.4254385964912282,0.04604550049860708,538,"I said a stitch in time saves nine and yes, all of your lives matter."
73,28,41,159,228,1.4254385964912282,0.04646322178702733,538,Pause the paws and I'll remove the thorn.
76,18,60,149,227,1.422907488986784,0.04220928960348214,538,I'm more valuable to you alive. I can mend the catnip mouse.
77,22,51,152,225,1.4222222222222223,0.04429538495992326,538,Where's the dog when you need him?
78,23,48,153,224,1.4196428571428572,0.044866512148007034,538,How did you get out of the bag?
78,19,56,149,224,1.4196428571428572,0.04304474607579384,538,Oh yeah? Good luck working the can opener.
78,20,54,150,224,1.4196428571428572,0.04350733962941187,538,"Honey, would you mind putting Precious outside for a while?"
81,14,65,144,223,1.4170403587443947,0.040751843822727236,538,This was much more fun when you were a kitten.
82,16,59,145,220,1.4136363636363636,0.042091217956722785,538,"Honey, the cat's outta the bag..."
82,23,45,152,220,1.4136363636363636,0.04541197674607562,538,"Honey, I think we can leave the debate over 'shrank' or 'shrunk' for another day."
82,22,47,151,220,1.4136363636363636,0.04495260428018607,538,It said 'condensed milk.' Who knew?
85,20,50,149,219,1.4109589041095891,0.04413906740019844,538,"""Take shrinking,"" they said. ""It's the best super power,"" they said."
85,25,40,154,219,1.4109589041095891,0.04645122654317945,538,Hand over Thumbelina and nobody gets hurt.
87,18,53,146,217,1.4101382488479262,0.0434519468084191,538,It seems as though I've brought a needle to a catfight.
87,17,55,145,217,1.4101382488479262,0.04295814572270986,538,Would it help if I say I'm a big cat lover?
87,17,55,145,217,1.4101382488479262,0.04295814572270986,538,Stand back! This needle is threaded!
87,23,43,151,217,1.4101382488479262,0.04584123328382667,538,I think I liked you better as a kitten.
87,19,51,147,217,1.4101382488479262,0.04394019889520062,538,Does it really even matter whose dream this is?
92,19,45,139,203,1.4088669950738917,0.046078220926605705,538,Last time I take LSD.
93,26,37,155,218,1.408256880733945,0.04703735696275708,538,I should have known the genie would confuse my wish for a ton of pussy.
93,20,49,149,218,1.408256880733945,0.0442588447563642,538,Alice! Where's the pill that makes you larger?
93,28,33,157,218,1.408256880733945,0.04792774582987527,538,"Well, I didn't try to eat you when I was the bigger one."
96,22,44,150,216,1.4074074074074074,0.04550135778708485,538,"I may be a big pussy, but I'm not afraid of a little prick."
96,16,56,144,216,1.4074074074074074,0.04256730702841993,538,This is the last time I house sit for Stephen King's cat!
96,16,56,144,216,1.4074074074074074,0.04256730702841993,538,I know this is a dream because I don't sew.
99,28,31,156,215,1.4046511627906977,0.048403179952784155,538,You're not what I told the genie I wanted lots of!
99,20,47,148,215,1.4046511627906977,0.044666736398773096,538,"Honey, the cat hasn't forgotten we had him neutered."
99,26,35,154,215,1.4046511627906977,0.0474966336416127,538,This is going to hurt me more than it does you.
102,19,47,146,212,1.400943396226415,0.04458513727380178,538,"Tell me where the ball of yarn is, and nobody gets hurt"
103,22,40,148,210,1.4,0.04637705924825155,538,"THIS was the point of my bringing the sewing kit in, kitten."
103,17,50,143,210,1.4,0.04385190179924177,538,Why do I always have to be Androcles?
105,24,36,151,211,1.3981042654028435,0.047162606804729244,538,Stop being such a big pussy and let me get that splinter.
106,21,41,147,209,1.3971291866028708,0.04601288142957571,538,But you ARE a big pussy!
106,18,47,144,209,1.3971291866028708,0.04448781161835467,538,I seem to have lost perspective
106,23,37,149,209,1.3971291866028708,0.047002111732986844,538,It's the same nightmare - the cat's got my tongue and I'm hanging on by a thread.
106,13,57,139,209,1.3971291866028708,0.04182262853791289,538,Honey! Change the box!
110,20,42,146,208,1.3942307692307692,0.045636696085654405,538,"Hey, Alice -- which one makes you larger?"
110,15,52,141,208,1.3942307692307692,0.04301688462192617,538,You were a lot more fun when you weighed three pounds.
110,17,48,143,208,1.3942307692307692,0.04408349611125935,538,"Now, what have you done with Thumbelina?"
110,19,44,145,208,1.3942307692307692,0.04512490328196536,538,"To be honest, I'm not thrilled with you either at the moment."
110,17,48,143,208,1.3942307692307692,0.04408349611125935,538,Alice warned me this might happen.
115,17,47,142,206,1.3932038834951457,0.04437331285360505,538,Curiosity isn't going to be your problem.
116,19,42,144,205,1.3902439024390243,0.04555321455622534,538,Who's the pussy now?
116,20,40,145,205,1.3902439024390243,0.04607514909424973,538,Should've taken the blue pill.
118,16,47,141,204,1.3872549019607843,0.04406395307305585,538,"I suppose you realize, now, that ""fixed"" is just a euphemism."
119,12,54,136,202,1.386138613861386,0.04207594803043968,538,C'mon. You're blowing this whole thing out of proportion.
119,26,26,150,202,1.386138613861386,0.049598453641079614,538,It's time for the fat cats to answer to the little guys.
121,15,47,139,201,1.3830845771144278,0.04390811515168759,538,"Just remember, I'm the only one who knows where the Friskies are kept!"
121,14,49,138,201,1.3830845771144278,0.043337874110214065,538,Sorry about that whole neutering thing
121,10,57,134,201,1.3830845771144278,0.04097763240193831,538,"Hey, I think I hear the sound of the can opener!"
124,14,48,137,199,1.3819095477386936,0.04362131363676788,538,I'm done playing cat and mouse.
124,14,48,137,199,1.3819095477386936,0.04362131363676788,538,Now do something cute for the Internet.
124,16,44,139,199,1.3819095477386936,0.04476981899510718,538,"Ah but you forget, my fearsome foe, that there's more than one way to skin a cat"
124,14,48,137,199,1.3819095477386936,0.04362131363676788,538,Back off. I have a needle - and it's threaded.
124,13,50,136,199,1.3819095477386936,0.043035568529631134,538,"Relax, I get splinters out of my kids hands all the time."
129,15,45,138,198,1.378787878787879,0.04431215833809902,538,You got the yarn. Now just go.
129,16,43,139,198,1.378787878787879,0.04488698630483059,538,"Or, hear me out, I could teach you how the can opener works"
129,15,45,138,198,1.378787878787879,0.04431215833809902,538,Wait - is this the dream about health insurance or the one about calling the cable company?
129,16,43,139,198,1.378787878787879,0.04488698630483059,538,"I don't know what has happened to me, but it was Helen who had you neutered."
133,17,40,140,197,1.3756345177664975,0.04557579800571621,538,Why don't we settle this with a nice belly rub?
133,12,50,135,197,1.3756345177664975,0.04263996388822925,538,"I'm telling you, it was Louise who insisted on neutering."
133,24,26,147,197,1.3756345177664975,0.04939367312433384,538,Are you sure that was catnip?
133,15,44,138,197,1.3756345177664975,0.04442475240753183,538,"C'mon, cough it up."
137,18,37,140,195,1.3743589743589744,0.04646413744504064,538,Time to find out if I'm a mouse or a man.
137,16,41,138,195,1.3743589743589744,0.04531202798707218,538,That's it! I'm now officially a dog person!
137,15,43,137,195,1.3743589743589744,0.044724845289793966,538,honey..the cat's out of the bag
140,15,43,138,196,1.3724489795918366,0.044537046617949376,538,"Okay, from now on we're switching to non-GMO milk!"
141,17,38,139,194,1.3711340206185567,0.0460148259120266,538,"Honey, I blew up the cat."
141,16,40,138,194,1.3711340206185567,0.04543069726199945,538,I'm going to need a spool sample.
141,19,34,141,194,1.3711340206185567,0.04716138360692418,538,Help me find the antidote and you can have tuna every night.
141,16,40,138,194,1.3711340206185567,0.04543069726199945,538,"OK, Honey, free the children while I have him distracted"
141,15,42,137,194,1.3711340206185567,0.0448389596635423,538,This is because I only put out the dry food isn't it?!
141,14,44,136,194,1.3711340206185567,0.04423930778963548,538,"Honey, you were supposed to shrink the kids!"
147,16,39,137,192,1.3697916666666667,0.04574642472209787,538,"You may have claws, but I have opposable thumbs. En garde!"
147,18,35,139,192,1.3697916666666667,0.046923452755360875,538,"Yes, you're right to be upset. I'm very sorry we named you ""Mr. Snuggles."""
147,16,39,137,192,1.3697916666666667,0.04574642472209787,538,Declawing was just a suggestion...
147,12,47,133,192,1.3697916666666667,0.043296481238023626,538,"Alice, quick, where’s the other pill?"
147,20,31,141,192,1.3697916666666667,0.048071670057473585,538,Okay -- I promise we won't use cat gut any more.
147,15,41,136,192,1.3697916666666667,0.045146404652414554,538,Don't make me use the scissors.
147,16,39,137,192,1.3697916666666667,0.04574642472209787,538,I wouldn't be so curious if I were you.
154,14,42,135,191,1.3664921465968587,0.04464907093501669,538,Usually I wake up about now.......
154,17,36,138,191,1.3664921465968587,0.04646368838497627,538,Well I'll be damned - my wife really IS a witch!
154,11,48,132,191,1.3664921465968587,0.04275751083007669,538,You're taking things out of proportion.
154,16,38,137,191,1.3664921465968587,0.045866793405950776,538,"The name is Thumb, Tom Thumb."
154,15,40,136,191,1.3664921465968587,0.045262027532493074,538,"Yes, honey-- I believe you now. Please change me back."
154,18,34,139,191,1.3664921465968587,0.04705301201122185,538,Stay back! I know cross-stitch.
154,15,40,136,191,1.3664921465968587,0.045262027532493074,538,Be gentle—this is the only life I've got!
154,13,44,134,191,1.3664921465968587,0.044027581518499774,538,Think about it – am I really worth one of your lives ?
162,15,40,137,192,1.3645833333333333,0.04506611352694508,538,"On second thought, I'll just have the vet remove those."
163,15,39,136,190,1.3631578947368421,0.04537725318027215,538,"Okay,the litter box is full. I'll call the backhoe guy."
163,13,43,134,190,1.3631578947368421,0.04413281682730803,538,I'm never petsitting for Gulliver again.
165,15,38,135,188,1.3617021276595744,0.0456941802652533,538,"What am I, a man or a mouse?"
165,13,42,133,188,1.3617021276595744,0.0444317400429413,538,I might be little but I can be a big prick
165,17,34,137,188,1.3617021276595744,0.0469226671980975,538,The cat's out of the bag....and it's bigger than expected.
165,25,18,145,188,1.3617021276595744,0.05154465097818802,538,"Don't worry, this will hurt me more than it will hurt you."
165,13,42,133,188,1.3617021276595744,0.0444317400429413,538,Am I a man or a mouse? Seriously?
170,12,45,134,191,1.361256544502618,0.04331067109412293,538,"So, if I mess up, you'll still have eight more lives."
170,12,45,134,191,1.361256544502618,0.04331067109412293,538,"If you want to get to my curtains, you're going to have to get through me first."
170,15,39,137,191,1.361256544502618,0.0451790773876506,538,"Honey, please put the cat out."
170,17,35,139,191,1.361256544502618,0.04638288731400126,538,"Oh, now you're interested in me."
170,13,43,135,191,1.361256544502618,0.04394230116431437,538,"As soon as I find the ""Drink Me"" bottle, you're going to be one sorry cat"
175,14,41,137,192,1.359375,0.044372173176436276,538,"I don't know if you're in my dream or I'm in your dream, but either way I hope one of us wakes up."
176,17,33,137,187,1.358288770053476,0.04704928262255345,538,"""Catgut"" is just a brand name."
177,22,25,146,193,1.3575129533678756,0.048823487141257865,538,This will hurt me more than it hurts you.
178,14,38,133,185,1.3567567567567567,0.045494428983865486,538,"Mittens, are we stuck in your dream or mine?"
178,12,42,131,185,1.3567567567567567,0.04418409505022133,538,OMG! You're right. It's probably ME who's off my meds.
178,15,36,134,185,1.3567567567567567,0.046135642134346344,538,Are you getting this on video?
181,14,38,134,186,1.3548387096774193,0.04528980758795488,538,Neutering was NOT my idea.
182,17,31,136,184,1.3532608695652173,0.04752050097105896,538,"Okay, things seemed to have changed since last night, but I'm still in charge."
182,12,41,131,184,1.3532608695652173,0.04428561116578994,538,"Personally, I think you are blowing this little sliver in your paw WAY out of proportion."
182,15,35,134,184,1.3532608695652173,0.046253702014598407,538,Okay! I'm sorry about the neutering thing!
182,11,43,130,184,1.3532608695652173,0.04360984779937856,538,"I was against having you fixed, remember?"
182,16,33,135,184,1.3532608695652173,0.046891379605401254,538,"See, this is why I'm a dog person."
182,15,35,134,184,1.3532608695652173,0.046253702014598407,538,How's that cerebral cortex and opposable thumbs working out for you NOW!
182,13,39,132,184,1.3532608695652173,0.044951216752943564,538,You should try it. The dog crochets.
182,18,29,137,184,1.3532608695652173,0.0481414015560722,538,Oh relax. You should be able to take a little needling.
190,13,35,125,173,1.3526011560693643,0.04691423385365369,538,"If you don't kill me, the vet bills will."
191,17,30,136,183,1.349726775956284,0.047648570880306794,538,Taxidermy looked so much easier online.
191,8,48,127,183,1.349726775956284,0.04159258519906689,538,Calm down - you took some bad catnip.
193,16,31,134,181,1.3480662983425415,0.047358662847769094,538,"Behind the scenes, The Cat in the Hat was quite harsh with the wardrobe department."
193,14,35,132,181,1.3480662983425415,0.046044198747709764,538,Sensitive about our name ....are we Mr. Buttons?
193,10,43,128,181,1.3480662983425415,0.043295713661960375,538,What catnip induced hallucinations look like from the inside.
193,15,33,133,181,1.3480662983425415,0.0467060552019075,538,Last chance. Where did you find the steroids.
193,16,31,134,181,1.3480662983425415,0.047358662847769094,538,Sew...what's new pussycat?
193,21,21,139,181,1.3480662983425415,0.050495343525456225,538,This is going to hurt me more than it's going to hurt you.
193,10,43,128,181,1.3480662983425415,0.043295713661960375,538,I got sewing supplies and I'm not afraid to use them.
193,18,27,136,181,1.3480662983425415,0.04863761563994202,538,He quickly realized why the magic beans were in the clearance aisle.
193,14,35,132,181,1.3480662983425415,0.046044198747709764,538,"Don't you recognize me? Before that damned genie showed up, I'm the one that fed you every day and cleaned out your litter box!"
193,13,37,131,181,1.3480662983425415,0.04537268874679529,538,"It's not fair. You're bigger, stronger and you have nine lives."
193,11,41,129,181,1.3480662983425415,0.04399893380189452,538,Please tell me you’re litter trained.
193,9,45,127,181,1.3480662983425415,0.042580881476238,538,Exactly what did you do with Thumbelina?
193,13,37,131,181,1.3480662983425415,0.04537268874679529,538,I'm sorry about all those YouTube videos of you that I posted.
193,12,39,130,181,1.3480662983425415,0.04469109005057417,538,No more GMO cat-nip for you!
193,6,51,124,181,1.3480662983425415,0.04036049311738308,538,"OK, OK...A cat is man's best friend."
193,13,37,131,181,1.3480662983425415,0.04537268874679529,538,"Nevertheless, you see my point."
209,14,36,134,184,1.3478260869565217,0.04550968270434111,538,I think I may need to use your litter box.
209,16,32,136,184,1.3478260869565217,0.04679662682646,538,That's Mister Curiousity to you...
211,17,28,135,180,1.3444444444444446,0.048132229299551924,538,Wow! Jefferson Airplane wasn't kidding about those pills!
211,14,34,132,180,1.3444444444444446,0.046157250330281584,538,"Oh, so now you notice me?"
211,10,42,128,180,1.3444444444444446,0.04338431481917314,538,Touché
211,21,20,139,180,1.3444444444444446,0.05064587330738604,538,This is going to hurt me more than it hurts you.
211,15,32,133,180,1.3444444444444446,0.0468248332029391,538,I knew this would happen when they took away all our guns.
211,17,28,135,180,1.3444444444444446,0.048132229299551924,538,It's definitely out of the bag!
211,14,34,132,180,1.3444444444444446,0.046157250330281584,538,"You have me at a disadvantage, Ms. Galore."
211,15,32,133,180,1.3444444444444446,0.0468248332029391,538,You ruined the couch; I think it's only right that you fix it.
219,10,41,127,178,1.3426966292134832,0.04367414004929214,538,"I'm living in that sewing basket, Buster! Use it as a litter box again and you'll get a lot worse than a jab with a needle!"
219,11,39,128,178,1.3426966292134832,0.044394937561776066,538,"Keep up that attitude, and you'll have eight lives."
219,13,35,130,178,1.3426966292134832,0.045802515490435895,538,"I told you, when you ""give five"" you retract the claws."
219,15,31,132,178,1.3426966292134832,0.047168107545133134,538,Good. Now STAY!!
219,9,43,126,178,1.3426966292134832,0.04294124517263526,538,"Let's keep this in perspective, shall we!"
219,16,29,133,178,1.3426966292134832,0.04783628686946821,538,"Hey, calm down...I'm not the one who decides how vets take your temperature."
219,15,31,132,178,1.3426966292134832,0.047168107545133134,538,"Hey, look over there! A laser dot!"
219,6,49,123,178,1.3426966292134832,0.04066338181669024,538,I think someone put catnip in my LSD.
219,15,31,132,178,1.3426966292134832,0.047168107545133134,538,You're right. I lied. I knew she made the salmon for you and I ate it anyway.
219,18,25,135,178,1.3426966292134832,0.04914539943469461,538,I think this is gonna hurt me more than its gonna hurt you.
219,17,27,134,178,1.3426966292134832,0.04849526073264139,538,"When I said I was making a calico quilt, don’t worry, I didn’t mean you."
219,11,39,128,178,1.3426966292134832,0.044394937561776066,538,"Just remember you're a living organism on this planet, and you're very safe. You've just taken catnip, a heavy drug. Relax, stay inside and listen to some music, Okay? Do you have any Allman Brothers?"
231,11,39,129,179,1.3407821229050279,0.04418771853537373,538,Things could be worse... I could be allergic to you.
231,13,35,131,179,1.3407821229050279,0.04558613678123167,538,Ask yourself: Am I man or am I mouse?
233,13,34,130,177,1.3389830508474576,0.04591037448690106,538,Cat. Lives. Matter.
234,11,37,127,175,1.3371428571428572,0.04479787535593945,538,Just don't lecture me about perspective.
234,13,33,129,175,1.3371428571428572,0.046240810183104136,538,"If dogs are man's best friend, you must be my ex girlfriend."
234,9,41,125,175,1.3371428571428572,0.04330689028806741,538,"Funny cat video, take two."
234,12,35,128,175,1.3371428571428572,0.045525059927451796,538,He looked a lot cuter on the internet.
234,12,35,128,175,1.3371428571428572,0.045525059927451796,538,"Think, Max. Think! I'm the guy who changes your litter box!"
234,14,31,130,175,1.3371428571428572,0.046945649120889325,538,"I'm warning you, I know how to cross stitch!"
234,11,37,127,175,1.3371428571428572,0.04479787535593945,538,"""No more GMO milk for you!'"
234,13,33,129,175,1.3371428571428572,0.046240810183104136,538,You look different from your profile photo.
234,9,41,125,175,1.3371428571428572,0.04330689028806741,538,Just remember that I'm the little guy who cleans your big litter box.
234,8,43,124,175,1.3371428571428572,0.04254180651348645,538,You really want to waste one of your lives like this?
244,10,38,126,174,1.3333333333333333,0.04414667820219519,538,Curiosity killed the man
244,13,32,129,174,1.3333333333333333,0.04634923408702686,538,Do you really think I'm afraid of a little prick?
244,8,42,124,174,1.3333333333333333,0.0426151107023978,538,"Relax, you're already neutered."
244,11,36,127,174,1.3333333333333333,0.044892872088377854,538,I can only imagine how this looks from your perspective...
244,12,34,128,174,1.3333333333333333,0.045626864152588154,538,"For Pete's sake, I'm a man, not a mouse."
244,13,32,129,174,1.3333333333333333,0.04634923408702686,538,Don't make me mix metaphors.
244,14,30,130,174,1.3333333333333333,0.047060517087143136,538,I assure you that I do not taste like chicken.
244,14,30,130,174,1.3333333333333333,0.047060517087143136,538,"No, Honey! Go back to the V.R. program's SIZE drop-down and click on 100%, not 10%. Hurry!"
244,12,34,128,174,1.3333333333333333,0.045626864152588154,538,"Thirty years later, and still these damn flashbacks."
244,9,40,125,174,1.3333333333333333,0.043387652946810774,538,"The thorn is out, but you're going to need stitches."
244,8,42,124,174,1.3333333333333333,0.0426151107023978,538,"Serves me right, for wishing to know what cats dream about."
244,13,32,129,174,1.3333333333333333,0.04634923408702686,538,"Before we begin, I would like to apologize for the whole bath thing."
256,8,41,123,172,1.3313953488372092,0.04289220320786424,538,I think there's a nursery rhyme in here somewhere.
256,11,35,126,172,1.3313953488372092,0.04520773677190416,538,"I know you probably don't want to hear this right now, but a stitch in time does save nine."
256,9,39,124,172,1.3313953488372092,0.043677689408084204,538,"I've got a threaded needle, and I'm not afraid to use it."
256,10,37,125,172,1.3313953488372092,0.04444929704768596,538,I feel like Roald Dahl would know what to do in my situation
256,14,29,129,172,1.3313953488372092,0.0474103135620387,538,You mis-heard me. I said cats are in a basket of ADORABLES.
256,9,39,124,172,1.3313953488372092,0.043677689408084204,538,"Honey, I think I took the wrong pills this morning."
256,7,43,122,172,1.3313953488372092,0.04209206148456461,538,"I have to clean your dirty litter, and you're the one who's pissed?"
256,17,23,132,172,1.3313953488372092,0.049515009846145513,538,This pussy isn't afraid of a little prick!
256,11,35,126,172,1.3313953488372092,0.04520773677190416,538,Calm down. It's not catgut.
256,13,31,128,172,1.3313953488372092,0.046687668350930515,538,I know this is going to sound weird... but can you help me come up with a caption for what we're doing here?
256,8,41,123,172,1.3313953488372092,0.04289220320786424,538,"Okay, I get it. You don't like chasing the laser pointer."
267,15,27,131,173,1.329479768786127,0.047881470378901364,538,It IS catgut and I'm not afraid to use it!
268,14,28,129,171,1.327485380116959,0.04752593075395723,538,They finally have a cat large enough to catch the rats in the streets of New York.
268,12,32,127,171,1.327485380116959,0.04605556638258975,538,"I don't know how you did this but remember, if it wasn't for me you'd be clawless and ball-less."
268,8,40,123,171,1.327485380116959,0.04296414082003175,538,"We've had mice for years, but NOW you're a hunter?"
268,18,20,133,171,1.327485380116959,0.05033797664236764,538,I can't sew your balls back on. They're gone.
272,12,31,127,170,1.3235294117647058,0.04615606418235279,538,Whoa...let's just hiss and make up.
272,13,29,128,170,1.3235294117647058,0.04690411394621742,538,"Size does matter, doesn't it?"
272,10,35,125,170,1.3235294117647058,0.04462235955501362,538,Size matters.
275,15,25,131,171,1.3216374269005848,0.04811905511080174,538,Please remember this will hurt me more then you.
276,9,36,123,168,1.3214285714285714,0.04413202172529347,538,"Fine, get yourself another tailor."
276,7,40,121,168,1.3214285714285714,0.04248603703221037,538,You know what they say about curiosity
276,15,24,129,168,1.3214285714285714,0.048737576244003426,538,"After a change in perspective, Harold had fond memories of a less complicated time with his pet rock."
276,7,40,121,168,1.3214285714285714,0.04248603703221037,538,Can you please spit up my wife?
280,9,35,122,166,1.319277108433735,0.04443401450320272,538,"you DO realize this is just your mental projection OF me, right?"
281,8,37,122,167,1.3173652694610778,0.04338486622170629,538,"So, this is what you've been planning--all those years just laying there, staring at me."
281,13,27,127,167,1.3173652694610778,0.04736001426877904,538,"Mr. Stumpf, CEO of Wells Fargo, meet Senator Elizabeth Warren"
281,9,35,123,167,1.3173652694610778,0.044208500132531886,538,"Stay with me here. A stitch in times saves nine… A cat has nine lives… You’re not following this, are you?"
281,10,33,124,167,1.3173652694610778,0.045017067328523216,538,"Mr. Jingles, please try and understand... Mrs. Thumb was only trying to make you a sweater. Now please cough her back up."
285,14,22,122,158,1.3164556962025316,0.05006535082244022,538,"Good. Let's try it again, but this time from the diaphragm."
286,10,32,123,165,1.3151515151515152,0.04533366533349307,538,The tables are turned. Now you sing that damn Meow Mix Song.
286,12,28,125,165,1.3151515151515152,0.04693570999339344,538,This is just a dream. This is just a dream. This is just....
286,10,32,123,165,1.3151515151515152,0.04533366533349307,538,I promise. No more laser pointer.
286,9,34,122,165,1.3151515151515152,0.044511025404519275,538,"Honey, did I take the wrong dosage of my medication again?"
286,14,24,127,165,1.3151515151515152,0.04848484848484849,538,I should've run for the laser pointer instead.
286,10,32,123,165,1.3151515151515152,0.04533366533349307,538,I hope I wake up soon!
286,16,20,129,165,1.3151515151515152,0.04998599996612548,538,This is your brain on catnip.
286,9,34,122,165,1.3151515151515152,0.044511025404519275,538,"Can you believe it, both of us are named Tom!"
286,8,36,121,165,1.3151515151515152,0.0436728926515564,538,Now I'm beginning to wish I hadn't signed those nanoparticle research consent forms.
286,13,26,126,165,1.3151515151515152,0.047716566332787654,538,Relax. You're just on a bad catnip trip!
286,11,30,124,165,1.3151515151515152,0.046141641091063744,538,"Wait a minute, will you? Having you neutered was the wife's idea."
286,10,32,123,165,1.3151515151515152,0.04533366533349307,538,I'm warning you...don't get curious.
286,12,28,125,165,1.3151515151515152,0.04693570999339344,538,"So what do YOU think, ""Darn that cat"" means?"
286,10,32,123,165,1.3151515151515152,0.04533366533349307,538,NOW you pay attention to me.
286,16,20,129,165,1.3151515151515152,0.04998599996612548,538,What kind of Genie are you? I said I wanted to thread the needle with an F14 Tomcat. Not a 14 year old tomcat!
286,9,34,122,165,1.3151515151515152,0.044511025404519275,538,"Honest, your yarn ball is under the sofa..."
302,11,29,124,164,1.3109756097560976,0.04623334529222424,538,"Calm down, Princess, I said play, not spay."
302,11,29,124,164,1.3109756097560976,0.04623334529222424,538,Just put yourself in my position.
302,8,35,121,164,1.3109756097560976,0.04373867990289973,538,Would you feel better if we switched to wet food?
302,12,27,125,164,1.3109756097560976,0.04703550697076911,538,"I'm a man, not a mouse."
302,7,37,120,164,1.3109756097560976,0.042874880997631794,538,"That's Hollywood, kiddo. Great computer animation. Ridiculous storylines."
302,10,31,123,164,1.3109756097560976,0.04541701793185895,538,Catgut totally unacceptable; got it.
302,13,25,126,164,1.3109756097560976,0.04782421578117623,538,"""I know what you're thinking: have I gone through eight lives, or only seven?"
302,10,31,123,164,1.3109756097560976,0.04541701793185895,538,Just don't forget: I'm a man not a mouse.
302,11,29,124,164,1.3109756097560976,0.04623334529222424,538,"Good news! We held a meeting, and we've decided we won't be neutering you after all."
302,11,29,124,164,1.3109756097560976,0.04623334529222424,538,It's just a sliver. Don't be such a big pussy.
302,8,35,121,164,1.3109756097560976,0.04373867990289973,538,"I may be tiny, but I'm the one with opposable thumbs."
302,8,35,121,164,1.3109756097560976,0.04373867990289973,538,"You got your wish, smarty; so who's going to operate the can opener so you can get fed?"
302,12,27,125,164,1.3109756097560976,0.04703550697076911,538,"You'd think with a kid named Tom Thumb, Mom would think twice before bringing home a new pet."
302,11,29,124,164,1.3109756097560976,0.04623334529222424,538,No; I don't use Cat Gut.
302,11,29,124,164,1.3109756097560976,0.04623334529222424,538,"Honest, that whole spaying thing was your mom's idea."
302,15,21,128,164,1.3109756097560976,0.04936384317756245,538,This'll hurt me more than it will you.
302,11,29,124,164,1.3109756097560976,0.04623334529222424,538,"Laser pointer trick isn’t so funny now little man, is it?"
302,13,25,126,164,1.3109756097560976,0.04782421578117623,538,"Much to the chagrin of his father, Tom Thumb ultimately dropped out of his veterinary medicine program and went on to pursue a career in the arts."
302,6,39,119,164,1.3109756097560976,0.04199331758118013,538,"No, you are not a ""fat cat."" You are ""plus size."""
321,11,29,125,165,1.309090909090909,0.04599092250979998,538,That's all you got? 'MEOW?'
322,10,30,122,162,1.308641975308642,0.045740212713391765,538,Bob Barker's first day in hell.
322,11,28,123,162,1.308641975308642,0.046570895365752325,538,Woof
322,14,22,126,162,1.308641975308642,0.048978485107978066,538,No more needlepoint until you catch those mice.
322,8,34,120,162,1.308641975308642,0.0440318587713859,538,Any chance you’d repay the favor that I didn’t have you declawed?
322,15,20,127,162,1.308641975308642,0.0497551327962649,538,"""I know it's going to hurt, but stop being such a pussy!"
322,10,30,122,162,1.308641975308642,0.045740212713391765,538,Whose nightmare is this?
322,10,30,122,162,1.308641975308642,0.045740212713391765,538,"Remember, I just took this OUT of your paw."
322,13,24,125,162,1.308641975308642,0.04818932213022822,538,Everyone gets out alive. It's a Disney production.
322,5,40,117,162,1.308641975308642,0.041337160988131436,538,Why couldn't you be this good at cornering mice?
331,11,27,123,161,1.3043478260869565,0.04666142609104571,538,Lets see if we can get another year out of this coat.
331,10,29,122,161,1.3043478260869565,0.04582192633769696,538,"I use a silk thread, not catgut."
331,10,29,122,161,1.3043478260869565,0.04582192633769696,538,"Actually, I'm the scaredy cat."
331,8,33,120,161,1.3043478260869565,0.0440950045945313,538,I'm just the taxidermist; it's the vet you should be mad at.
331,8,33,120,161,1.3043478260869565,0.0440950045945313,538,"I may be small, but the Rotweiler just came up behind you."
331,4,41,116,161,1.3043478260869565,0.04042042087832035,538,"Trust me, this video is going viral"
331,8,33,120,161,1.3043478260869565,0.0440950045945313,538,I know you're really the pound of cheese I ate at 3 am...but just in case.
331,4,41,116,161,1.3043478260869565,0.04042042087832035,538,"Uh... woof, woof?"
331,8,33,120,161,1.3043478260869565,0.0440950045945313,538,No more laser pointer. I promise.
331,8,33,120,161,1.3043478260869565,0.0440950045945313,538,"Just so you know, a stitch in time will save all nine of your lives."
331,12,25,124,161,1.3043478260869565,0.04748608676657739,538,"It's NOT a hairball...I KNOW you've got Alice, now cough her up."
331,7,35,119,161,1.3043478260869565,0.04320566720511258,538,You should see my dog.
331,11,27,123,161,1.3043478260869565,0.04666142609104571,538,You're still getting dry food.
331,11,27,123,161,1.3043478260869565,0.04666142609104571,538,I'm tired of playing cat and mouse.
331,13,23,125,161,1.3043478260869565,0.048296668497482424,538,The giant cat dream tormented George every year during New York Fashion Week.
331,10,29,122,161,1.3043478260869565,0.04582192633769696,538,"You look upset. I can help, I'm a shrink."
331,11,27,123,161,1.3043478260869565,0.04666142609104571,538,"Call me a pussy one more time, I dare you."
348,12,24,123,159,1.3018867924528301,0.04784564800532318,538,"I'm sorry, but you need to floss."
348,11,26,122,159,1.3018867924528301,0.04700632443777409,538,Maybe we don't need to spay you after all?
348,10,28,121,159,1.3018867924528301,0.04615173930903655,538,"Ok, I had you neutered. You scratched my teak coffee table. That's even in my book."
348,11,26,122,159,1.3018867924528301,0.04700632443777409,538,I wish we had you de-clawed before the power plant blew up.
348,16,16,127,159,1.3018867924528301,0.0510651742056102,538,This is going to hurt me more than you
348,12,24,123,159,1.3018867924528301,0.04784564800532318,538,"I may be small, but at least I'm not a pussy."
348,11,26,122,159,1.3018867924528301,0.04700632443777409,538,I won't use catgut!
348,10,28,121,159,1.3018867924528301,0.04615173930903655,538,I knew I should have had you declawed.
348,5,38,116,159,1.3018867924528301,0.04161640976525041,538,"Fine, I'll start buying the premium cat food!"
348,12,24,123,159,1.3018867924528301,0.04784564800532318,538,I'll clean the litter box when I damn well please!
348,11,26,122,159,1.3018867924528301,0.04700632443777409,538,Yeah it's Cat Gut!
348,13,22,124,159,1.3018867924528301,0.048670499575711096,538,Remember this going to hurt me a lot more than you.
348,7,34,118,159,1.3018867924528301,0.04348733785309519,538,(Just a typical day for a member of America's shrinking middle class.)
348,7,34,118,159,1.3018867924528301,0.04348733785309519,538,I regret not getting you declawed when I had the chance.
348,11,26,122,159,1.3018867924528301,0.04700632443777409,538,"Honey. Call the pet store, NOW!"
348,8,32,119,159,1.3018867924528301,0.04439324328599178,538,"En garde, fluffy."
348,12,24,123,159,1.3018867924528301,0.04784564800532318,538,"Go ahead, make my day."
348,12,24,123,159,1.3018867924528301,0.04784564800532318,538,"Look, I am not ""The Brave little tailor"", and you are NOT ""Puss in Boots"""
366,8,31,117,156,1.3012820512820513,0.04494263579716196,538,"Look, you're not making this fitting any easier."
367,11,25,122,158,1.2974683544303798,0.04709533892254248,538,Got milk?
367,11,25,122,158,1.2974683544303798,0.04709533892254248,538,"Look, basically we're both giant pussies."
367,9,29,120,158,1.2974683544303798,0.045351070969297406,538,"Relax, this has already been blown way out of proportion."
367,10,27,121,158,1.2974683544303798,0.04623143187427464,538,"Oh, darn it!"
367,8,31,119,158,1.2974683544303798,0.04445327865274734,538,Androcles was a such a liar...
367,9,29,120,158,1.2974683544303798,0.045351070969297406,538,"Knit one, purr two."
367,11,25,122,158,1.2974683544303798,0.04709533892254248,538,"yes doctor, I think my dream is symbolic. But how does a little prick and an over powering puss have anything to do with my relationship with my wife' Oh yeah there was a string attached as well."
367,10,27,121,158,1.2974683544303798,0.04623143187427464,538,Stop playing with your food!
367,11,25,122,158,1.2974683544303798,0.04709533892254248,538,"C'mon, you big pussy!"
376,8,30,118,156,1.294871794871795,0.04475643922134656,538,I think you're blowing this out of proportion.
376,7,32,117,156,1.294871794871795,0.04382266383773693,538,Don't make me call my best friend.
376,9,28,119,156,1.294871794871795,0.04567112695908522,538,"So, that's a 'no' on the pumpkin costume for Halloween this year?"
376,10,26,120,156,1.294871794871795,0.046567851825606826,538,This is exactly why I threw out your catnip stash in the first place.
376,11,24,121,156,1.294871794871795,0.047447632286453094,538,"Steve, be reasonable. Put the needle down. It was always going to end this way."
376,14,18,124,156,1.294871794871795,0.04999416733386849,538,It's just a splinter. Don't be a pussy.
376,9,28,119,156,1.294871794871795,0.04567112695908522,538,Don't make me get the knitting needles.
376,9,28,119,156,1.294871794871795,0.04567112695908522,538,"In this final moment of clarity, Alice's tailor regretted several of his decisions."
376,11,24,121,156,1.294871794871795,0.047447632286453094,538,It'll hurt me more than it'll hurt you
376,13,20,123,156,1.294871794871795,0.04915998150394333,538,I never thought I'd say no to pussy.
376,4,38,114,156,1.294871794871795,0.04089360473251189,538,"Well, you're not ignoring me anymore, so at least there's that."
387,11,23,121,155,1.2903225806451613,0.04753473532987144,538,"We both know you're a pussycat, so stop the posturing and let me see the splinter."
387,9,27,119,155,1.2903225806451613,0.04573813181316198,538,This is the last time I eat Chinese food before I go to bed.
387,14,17,124,155,1.2903225806451613,0.05010900721991057,538,Don't make me go 'Hello Kitty' all over your ass.
387,10,25,120,155,1.2903225806451613,0.046645084224594915,538,I knew I should have paid more attention to that glowing green stuff in your litter box.
387,6,33,116,155,1.2903225806451613,0.04290239107641971,538,"If you'd just stop fighting with me, we could easily turn this into a fable."
387,13,19,123,155,1.2903225806451613,0.04926586469355507,538,The night Dick’s recurrent dream about a big pussy got wilder.
387,5,35,115,155,1.2903225806451613,0.04191453184174533,538,Easy there fella... I still control the food!
387,10,25,120,155,1.2903225806451613,0.046645084224594915,538,You don't look anything like your craigslist photo.
387,5,35,115,155,1.2903225806451613,0.04191453184174533,538,"Listen, would a mouse know how to sew?"
387,12,21,122,155,1.2903225806451613,0.048408039037357235,538,I know the situation has changed a bit between us but you can't be still upset about the laser pointer.
387,14,17,124,155,1.2903225806451613,0.05010900721991057,538,I don't care how curious you were. I was dating that goldfish.
387,8,29,118,155,1.2903225806451613,0.04481282764116549,538,"I know I'm small, but I'm the best darn cat tailor in the county."
387,8,29,118,155,1.2903225806451613,0.04481282764116549,538,"I saw the movie, and I get away."
387,11,23,121,155,1.2903225806451613,0.04753473532987144,538,I know Androclese and you are no Androclese!
387,6,33,116,155,1.2903225806451613,0.04290239107641971,538,This is the last time I let my agent talk me into working below scale.
387,11,23,121,155,1.2903225806451613,0.04753473532987144,538,This is definitely going on YouTube.
387,6,33,116,155,1.2903225806451613,0.04290239107641971,538,This will go viral.
387,11,23,121,155,1.2903225806451613,0.04753473532987144,538,"Am I dreaming, or are you?"
387,13,19,123,155,1.2903225806451613,0.04926586469355507,538,*Not drawn to scale*
406,11,22,120,153,1.2875816993464053,0.04789443677317868,538,"Ok, ok, I promise: no more science experiments and no more talk of neutering."
406,9,26,118,153,1.2875816993464053,0.04606385187768173,538,Bad Mittens!
406,11,22,120,153,1.2875816993464053,0.04789443677317868,538,It wasn't my idea to have you neutered.
406,14,16,123,153,1.2875816993464053,0.0505160866441228,538,"I don't care how sweetly you say pussy, I know a little prick, when I see one!"
406,6,32,115,153,1.2875816993464053,0.04317268249474997,538,"Believe me, I really don't taste like chicken!"
406,6,32,115,153,1.2875816993464053,0.04317268249474997,538,We talked about this before I took the potion; remember?
406,6,32,115,153,1.2875816993464053,0.04317268249474997,538,I'm gonna need a bigger needle!
406,12,20,121,153,1.2875816993464053,0.04878397673238124,538,Me? Ow!
406,9,26,118,153,1.2875816993464053,0.04606385187768173,538,"No hard felines, OK?"
415,8,28,118,154,1.2857142857142858,0.044865648136121705,538,It wasn't my idea to get you neutered.
416,10,23,119,152,1.2828947368421053,0.04706232672255111,538,And here I thought Aunt Nancy was the one who would get eaten by her cats.
416,9,25,118,152,1.2828947368421053,0.046127261145655206,538,I told them this would happen if they took away our guns.
416,10,23,119,152,1.2828947368421053,0.04706232672255111,538,You're still a big pussy.
416,9,25,118,152,1.2828947368421053,0.046127261145655206,538,"When I figure out how to take that 'large' pill, you are so declawed."
416,8,27,117,152,1.2828947368421053,0.04517284411080174,538,HONEY! You forgot to shrink the cat!
416,9,25,118,152,1.2828947368421053,0.046127261145655206,538,Where's a laser pointer when you really need one?
416,10,23,119,152,1.2828947368421053,0.04706232672255111,538,You've been feeding at Russia's Olympic training table?
416,11,21,120,152,1.2828947368421053,0.04797917227590347,538,"Well, you're not a camel, but then again, I'm not a rich man."
416,7,29,116,152,1.2828947368421053,0.04419782199744824,538,"Once you're trained, your going to be an internet sensation. You're gonna be huge!"
416,6,31,115,152,1.2828947368421053,0.04320079968678176,538,"Watch out, this is threaded!"
416,6,31,115,152,1.2828947368421053,0.04320079968678176,538,"On the other hand, have you ever seen a 3 inch talking mouse carrying a threaded needle?"
416,9,25,118,152,1.2828947368421053,0.046127261145655206,538,Darn Kitty
416,8,27,117,152,1.2828947368421053,0.04517284411080174,538,Imagine the trouble you'll be in when I wake up.
416,10,23,119,152,1.2828947368421053,0.04706232672255111,538,"Touché, Pussycat."
416,10,23,119,152,1.2828947368421053,0.04706232672255111,538,"It's a play on words, stupid. ""Darn cat!"""
416,8,27,117,152,1.2828947368421053,0.04517284411080174,538,So you lost your mittens. No need for a hissing fit.
416,9,25,118,152,1.2828947368421053,0.046127261145655206,538,This is what we get for living near power lines!
416,5,33,114,152,1.2828947368421053,0.04218021713833118,538,"Sure I'm domesticated, but don't push your luck."
416,9,25,118,152,1.2828947368421053,0.046127261145655206,538,"Don't worry, I know a guy who got a camel through."
416,10,23,119,152,1.2828947368421053,0.04706232672255111,538,"Just so you know, I wasn't the one who saran wrapped the litter box."
416,9,25,118,152,1.2828947368421053,0.046127261145655206,538,"God, I thought you couldn't get any bossier."
416,5,33,114,152,1.2828947368421053,0.04218021713833118,538,"If you can strike that pose every time, we're gonna be really big in Vegas."
438,10,22,118,150,1.28,0.047411757195425085,538,"Oh, so NOW you'll pay attention to me"
438,9,24,117,150,1.28,0.0464584681381658,538,Trust me - - fur is so last season.
438,7,28,115,150,1.28,0.044490654575079204,538,"I didn't declaw you and I fed you organic cat food, and this is the thanks I get?"
438,4,34,112,150,1.28,0.04136377604474826,538,"Okay, I guess you do have the upper hand."
438,7,28,115,150,1.28,0.044490654575079204,538,Gulliver arrives on the island of viral videos.
438,9,24,117,150,1.28,0.0464584681381658,538,Put the needle down and nobody gets hurt
438,8,26,116,150,1.28,0.04548520422216428,538,"Sweetie, you're going to be a lot less angry when you see what happened to the dog."
438,8,26,116,150,1.28,0.04548520422216428,538,"Janet, you won't believe what happened when I rubbed the thimble."
438,5,32,113,150,1.28,0.042431679524773294,538,"Leave me alone and I promise no more teasing you with the laser pointer, deal?"
438,9,24,117,150,1.28,0.0464584681381658,538,"I'm just spitballing here, but have you considered going vegan?"
438,5,32,113,150,1.28,0.042431679524773294,538,"Honey, the cats out of the box again."
438,8,26,116,150,1.28,0.04548520422216428,538,"I'm here for my tongue, and I'm not leaving without it."
438,8,26,116,150,1.28,0.04548520422216428,538,Stop toying with me!
438,6,30,114,150,1.28,0.04347335834630263,538,Figures. The mice told me you'd say that.
438,10,22,118,150,1.28,0.047411757195425085,538,"So, who's the little prick now?"
438,6,30,114,150,1.28,0.04347335834630263,538,"Kids put down the shrink ray, NOW!"
438,5,32,113,150,1.28,0.042431679524773294,538,"New house rule: You scratch it, you sew it."
438,7,28,115,150,1.28,0.044490654575079204,538,"If you can just settle down for two minutes, we'll both be YouTube celebrities."
438,9,24,117,150,1.28,0.0464584681381658,538,"Man, I wish I had Clifford back!"
438,2,38,110,150,1.28,0.039140657269061525,538,You're less scary than your litter box.
438,8,26,116,150,1.28,0.04548520422216428,538,"Yes I am sure, send the dog in."
438,8,26,116,150,1.28,0.04548520422216428,538,"So we meet again, Mr. Bitsypookums."
438,11,20,119,150,1.28,0.048346252998251245,538,What was in that catnip?
438,8,26,116,150,1.28,0.04548520422216428,538,But I don't want to play cat and mouse.
438,6,30,114,150,1.28,0.04347335834630263,538,"Don't take it personally, I'm just needling you."
438,8,26,116,150,1.28,0.04548520422216428,538,Don't bite the hand that feeds you!
464,10,21,116,147,1.2789115646258504,0.04805635429828093,538,"I'm sorry, but from behind you resemble my pincushion."
464,10,21,116,147,1.2789115646258504,0.04805635429828093,538,Not clothing. I need boots
466,6,30,115,151,1.2781456953642385,0.043224288402862826,538,"Gee, I hope the cat's in my dream and not the other way around."
466,8,26,117,151,1.2781456953642385,0.045221007833030055,538,"You just couldn't be happy with a ball of yarn, could you??"
468,8,26,118,152,1.2763157894736843,0.04495977096993022,538,"Relax, I just meant that you're a large cat."
469,12,17,120,149,1.2751677852348993,0.04935559750198767,538,Darn?!
469,4,33,112,149,1.2751677852348993,0.041357190816598915,538,"Yes, I was wrong to take selfies of you after bath time and post them online. I'm sorry about your street creds..."
469,12,17,120,149,1.2751677852348993,0.04935559750198767,538,I swear - Bob said they were normal mushrooms.
469,7,27,115,149,1.2751677852348993,0.044525289408853794,538,"I'm an on-site button specialist, not a mouse."
469,10,21,118,149,1.2751677852348993,0.0474824763638524,538,"When I wake up from this dream, I'm going to have you declawed!"
469,7,27,115,149,1.2751677852348993,0.044525289408853794,538,"Yes, I will address you as ""The Mighty Mighty Roger, World's Most Powerful Supercat and Ruler of all Carpet and Furniture Dominions."" Now will you calm down for a minute and let me back into the lab?"
469,6,29,114,149,1.2751677852348993,0.04349490401616014,538,"You want the mouse, second floor bedroom on the left."
469,8,25,116,149,1.2751677852348993,0.04553236341888473,538,I said frayed not spayed!
469,7,27,115,149,1.2751677852348993,0.044525289408853794,538,"When I wake up, I think I should talk to my therapist about the symbolic psychosexual meaning of poking at a giant, angry kitty with an oversized needle."
469,10,21,118,149,1.2751677852348993,0.0474824763638524,538,Okay fine I will clean your litter box
469,6,29,114,149,1.2751677852348993,0.04349490401616014,538,Dam GMO's
469,8,25,116,149,1.2751677852348993,0.04553236341888473,538,"When I wake up, either the cat needs to be let out or my wife is still mad at me."
469,6,29,114,149,1.2751677852348993,0.04349490401616014,538,Would it make any difference if you knew that I'm a Leo?
469,8,25,116,149,1.2751677852348993,0.04553236341888473,538,"I may be no Tom Thumb, but you're no Puss in Boots."
469,7,27,115,149,1.2751677852348993,0.044525289408853794,538,You're going to be in big trouble when this shrinking potion wears off.
469,9,23,117,149,1.2751677852348993,0.04651764009573785,538,Who are you calling a pussy?
469,8,25,116,149,1.2751677852348993,0.04553236341888473,538,I'm sorry I made that remark about herding cats.
486,11,18,117,146,1.273972602739726,0.04910204344329833,538,Expelliarmus
486,9,22,115,146,1.273972602739726,0.04713877435539064,538,They were out of yarn.
488,10,21,119,150,1.2733333333333334,0.04720052578733677,538,The catnip was GMO.
489,4,32,111,147,1.272108843537415,0.04158564273400371,538,I thought those mushrooms I foraged looked odd.
489,9,22,116,147,1.272108843537415,0.04685408714485814,538,No wonder I'm a dog person. Cats always blow everything out of proportion.
489,5,30,112,147,1.272108843537415,0.042691376666907206,538,"Don't worry it's nylon thread, not cat's gut."
489,7,26,114,147,1.272108843537415,0.044821083899732446,538,Taxidermy nightmare
489,8,24,115,147,1.272108843537415,0.0458488551881332,538,"After this piece, I'll be known as the world's greatest taxidermist, not just the tiniest."
489,7,26,114,147,1.272108843537415,0.044821083899732446,538,"Of course it's sharp, but that's not the point."
489,7,26,114,147,1.272108843537415,0.044821083899732446,538,"Well, now you know what it feels like."
489,8,24,115,147,1.272108843537415,0.0458488551881332,538,Oh yeah? Well don't forget I've got opposable thumbs
489,9,22,116,147,1.272108843537415,0.04685408714485814,538,Dang! That genie did warn me about wording my three wishes very carefully.
489,5,30,112,147,1.272108843537415,0.042691376666907206,538,"Back off, Mittens. I don't know where your stupid ball of yarn is."
489,9,22,116,147,1.272108843537415,0.04685408714485814,538,"When I previously called you the ""devil cat from hell,"" I simply meant that you were a ""beast of great suffering."""
489,10,20,117,147,1.272108843537415,0.04783820065902891,538,"If you were Lassie, or even just any dog, I'd be getting the help I need by now."
489,7,26,114,147,1.272108843537415,0.044821083899732446,538,I assure you it's silk thread not cat gut.
489,7,26,114,147,1.272108843537415,0.044821083899732446,538,Don't bring a pin to a claw fight.
489,8,24,115,147,1.272108843537415,0.0458488551881332,538,Yes. I expect you to fix the trousers you ripped.
489,8,24,115,147,1.272108843537415,0.0458488551881332,538,"That's it Gizmo, just hold that pose and tomorrow we'll be all over Facebook."
489,6,28,113,147,1.272108843537415,0.04376918552853482,538,Remember that a stitch in time saves nine lives!
489,9,22,116,147,1.272108843537415,0.04685408714485814,538,"OK, I'm ready. But promise me you will never lose your mittens again."
489,7,26,114,147,1.272108843537415,0.044821083899732446,538,Breath mint?
489,10,20,117,147,1.272108843537415,0.04783820065902891,538,Don't hiss at me! I wasn't the one who neutered you!
489,11,18,118,147,1.272108843537415,0.0488024733226613,538,Stop pawing me or I'll needle you.
489,7,26,114,147,1.272108843537415,0.044821083899732446,538,"No, a ""stitch in time saves NINE"" DOES NOT refer to cat lives!"" Get over it!"
489,9,22,116,147,1.272108843537415,0.04685408714485814,538,Will a stitch in time take nine?
489,7,26,114,147,1.272108843537415,0.044821083899732446,538,This will be so cute on youtube.
513,12,14,114,140,1.2714285714285714,0.051536372115806764,538,I was just measuring your inseam.
514,7,26,115,148,1.2702702702702702,0.04455515926155409,538,So this is what the brown acid I got at Woodstock was all about.
514,10,20,118,148,1.2702702702702702,0.04754942909114843,538,You got to ask yourself one question... am I feline lucky?
516,11,17,118,146,1.2671232876712328,0.048880809883930156,538,"Sorry, I'm not a cat person, I'm just a little prick."
516,5,29,112,146,1.2671232876712328,0.04269067470972507,538,No one is going to believe this yarn.
516,8,23,115,146,1.2671232876712328,0.045890234702387844,538,"Stop, or i'll sew!"
516,8,23,115,146,1.2671232876712328,0.045890234702387844,538,"Honey, call the doctor... it's happened again."
516,7,25,114,146,1.2671232876712328,0.044849083934353454,538,No owner - no catnip. Remember that!
516,6,27,113,146,1.2671232876712328,0.04378318191339136,538,I wish now I would have gone the other way on the declawing and neutering decision.
516,7,25,114,146,1.2671232876712328,0.044849083934353454,538,You're not you when your hungry.
516,9,21,116,146,1.2671232876712328,0.046908282342565076,538,I love your videos.
516,8,23,115,146,1.2671232876712328,0.045890234702387844,538,Perhaps you could just *tell* me your boot size.
516,9,21,116,146,1.2671232876712328,0.046908282342565076,538,"Calico is so yesterday, why don't we go with a nice slimming tabby look?"
516,9,21,116,146,1.2671232876712328,0.046908282342565076,538,A stitch in time could save all nine.
516,7,25,114,146,1.2671232876712328,0.044849083934353454,538,I only said that I needed a yard of calico.
516,6,27,113,146,1.2671232876712328,0.04378318191339136,538,"Cool it, Taffy -- it's just me. Took the wrong blue pill again."
516,8,23,115,146,1.2671232876712328,0.045890234702387844,538,What Would Jerry Do?
516,9,21,116,146,1.2671232876712328,0.046908282342565076,538,Don't be such a big pussy...this is not going to hurt.
516,9,21,116,146,1.2671232876712328,0.046908282342565076,538,Man. Not mouse! Man.
516,11,17,118,146,1.2671232876712328,0.048880809883930156,538,"Tiny hands, big prick!"
516,6,27,113,146,1.2671232876712328,0.04378318191339136,538,"Listen Puss, if you want boots, this is how we start."
516,5,29,112,146,1.2671232876712328,0.04269067470972507,538,"Suddenly, this video doesn’t seem so damn cute and funny anymore."
516,5,29,112,146,1.2671232876712328,0.04269067470972507,538,Say it isn't sew.
516,7,25,114,146,1.2671232876712328,0.044849083934353454,538,Silly boy. You should have taken the red pill.
516,10,19,117,146,1.2671232876712328,0.04790469980721477,538,This will probably hurt me more than you.
516,8,23,115,146,1.2671232876712328,0.045890234702387844,538,"You may have the upper paw now, but guess who's not getting his breakfast when I wake up."
539,8,23,116,147,1.2653061224489797,0.04561319813620343,538,"What do you mean, I look like a mouse?"
539,8,23,116,147,1.2653061224489797,0.04561319813620343,538,"You may get nine, but I only get one, so let's play carefully now, Ok?"
539,5,29,113,147,1.2653061224489797,0.04243818992211959,538,But think of all the hits a video of this would get on YouTube!
539,9,21,117,147,1.2653061224489797,0.04662351128270054,538,"OK, forget the pants...just a nice dinner jacket..."
543,9,20,115,144,1.2638888888888888,0.04724963782078061,538,"Honey, you're not you when you're hungry. You should eat a snickers."
543,5,28,111,144,1.2638888888888888,0.04294214579750938,538,"No, seriously, we haven't used cat gut for years now."
543,9,20,115,144,1.2638888888888888,0.04724963782078061,538,I promise to never complain about your butt in my face again.
543,11,16,117,144,1.2638888888888888,0.04926234331053624,538,"You told the genie, ""Diminish my husband, show me nice threads and wrap me in fur."""
543,6,26,112,144,1.2638888888888888,0.04405851771019594,538,"""Last time I date a 'cat lady'""."
543,7,24,113,144,1.2638888888888888,0.0451472931629876,538,"You see, opposable thumbs still beat claws"
543,9,20,115,144,1.2638888888888888,0.04724963782078061,538,Scratch the furniture! Scratch the furniture!
543,5,28,111,144,1.2638888888888888,0.04294214579750938,538,Maybe it will heal without stitches
543,6,26,112,144,1.2638888888888888,0.04405851771019594,538,We're going to need a bigger spool.
543,8,22,114,144,1.2638888888888888,0.046210422818557334,538,I'm in sew much trouble.
543,6,26,112,144,1.2638888888888888,0.04405851771019594,538,Now who's the fuzzy snugglekins?
543,10,18,116,144,1.2638888888888888,0.0482664828977629,538,"""Me ow?"" You ow."
543,8,22,114,144,1.2638888888888888,0.046210422818557334,538,"Feeling frisky, punk?"
543,7,24,113,144,1.2638888888888888,0.0451472931629876,538,I promise you it's not catgut!
543,5,28,111,144,1.2638888888888888,0.04294214579750938,538,"Ibricadibra? No, Urbicadurba? Nuts! What’s my password?"
543,8,22,114,144,1.2638888888888888,0.046210422818557334,538,"I'm sorry I called them ""canine teeth."" They still need cleaning."
543,8,22,114,144,1.2638888888888888,0.046210422818557334,538,It's only fair to tell you that the pin is mightier than the claw.
560,7,25,116,148,1.2635135135135136,0.044314025996588666,538,A stich in time saves 9. You are on your 8th life. Think about it.
561,8,20,109,137,1.2627737226277371,0.04778259701132749,538,"You know this is catgut suture, don't you?"
561,8,20,109,137,1.2627737226277371,0.04778259701132749,538,"FYI, Your litterbox does not clean itself."
563,7,24,115,146,1.2602739726027397,0.044599508482464946,538,Back off or I'll put the Ow in your meow.
564,8,21,114,143,1.2587412587412588,0.046245085894578014,538,I'm warning you. This is a dirty needle.
564,6,25,112,143,1.2587412587412588,0.044063838426966706,538,"The ""naked without my homework"" dream is scarier than this one."
564,5,27,111,143,1.2587412587412588,0.04293167595934606,538,"Now, let's talk about ""you"" cleaning the litter box!"
564,5,27,111,143,1.2587412587412588,0.04293167595934606,538,"Oh, how the tabbies have turned."
564,10,17,116,143,1.2587412587412588,0.04832798445906852,538,I will never lace marijuana with catnip again!
564,8,21,114,143,1.2587412587412588,0.046245085894578014,538,Why sew catty?
564,7,23,113,143,1.2587412587412588,0.0451676312546647,538,"Don't worry, I'm the tailor you sent for, not a vet."
564,9,19,115,143,1.2587412587412588,0.04729800234297885,538,Schrödinger will be happy to know his cat is definitely alive!
564,7,23,113,143,1.2587412587412588,0.0451676312546647,538,You won't be getting out of the bag on my watch again.
564,7,23,113,143,1.2587412587412588,0.0451676312546647,538,"I opened the liquor cabinet and one of the bottles said Drink Me, so back off!"
564,6,25,112,143,1.2587412587412588,0.044063838426966706,538,What was I thinking when I named you Gulliver?
564,8,21,114,143,1.2587412587412588,0.046245085894578014,538,I have to stop eating herring before bed.
564,6,25,112,143,1.2587412587412588,0.044063838426966706,538,"Ok, but what if I told you I could make you two suits for the same price?"
564,5,27,111,143,1.2587412587412588,0.04293167595934606,538,"In retrospect, the laser pointer gag was uncalled for."
564,12,13,118,143,1.2587412587412588,0.050324747335232976,538,"All I said was, 'Cat got your tongue?'."
564,7,23,113,143,1.2587412587412588,0.0451676312546647,538,"So, punk, are you feeling lucky?"
564,10,17,116,143,1.2587412587412588,0.04832798445906852,538,I hate cat cartoons.
564,9,19,115,143,1.2587412587412588,0.04729800234297885,538,Hiss all you want. I'm the incredible shrinking man and the star and you're just an uncredited extra.
564,6,25,112,143,1.2587412587412588,0.044063838426966706,538,"Ever since he took up sewing, Ted felt small."
564,7,23,113,143,1.2587412587412588,0.0451676312546647,538,It's not my worst nightmare-but it's close.
564,7,23,113,143,1.2587412587412588,0.0451676312546647,538,"Something tells me that after I give you your stitches, I'll need a few myself."
585,6,25,113,144,1.2569444444444444,0.04379364598089652,538,"Please raise your right paw and repeat after me, I (state your name) do solemnly swear not to harm the little guy."
585,5,27,112,144,1.2569444444444444,0.042670344868245405,538,'A stitch in time saves nine.' Where do you want it?
585,5,27,112,144,1.2569444444444444,0.042670344868245405,538,Me ow? No--You ow!
588,8,17,104,129,1.255813953488372,0.04956089865327294,538,I certainly hope I wake up soon.
589,9,18,114,141,1.2553191489361701,0.047643831529288014,538,I'm just trying to get the splinter out.
589,8,20,113,141,1.2553191489361701,0.04656841805556057,538,You're missing the point.
589,9,18,114,141,1.2553191489361701,0.047643831529288014,538,"I’ll show YOU a little prick, ya big pussy."
589,4,28,109,141,1.2553191489361701,0.04199225011621295,538,"Whoa...If that's the way you feel, you can neuter yourself."
589,6,24,111,141,1.2553191489361701,0.04433941040440235,538,Back away! I had to go to ridiculous lengths to thread this thing!
589,4,28,109,141,1.2553191489361701,0.04199225011621295,538,"Please hold still. Remember ""A stitch in time will save your nine""!"
589,9,18,114,141,1.2553191489361701,0.047643831529288014,538,"Okay, okay, I'll stop trying to needle you."
589,7,22,112,141,1.2553191489361701,0.04546757567326129,538,You go to war with the weapons you have.
589,4,28,109,141,1.2553191489361701,0.04199225011621295,538,You see? How would you like it if I scratched you?
589,5,26,110,141,1.2553191489361701,0.043181780792555385,538,"Ah, my little human. I see you brought a needle to a claw fight!"
589,3,30,108,141,1.2553191489361701,0.04076802604037714,538,At least this will make for a good yarn!
589,4,28,109,141,1.2553191489361701,0.04199225011621295,538,Your owners said you needed a shrink.
589,3,30,108,141,1.2553191489361701,0.04076802604037714,538,"Honestly, I'm a tailor not a vet."
589,8,20,113,141,1.2553191489361701,0.04656841805556057,538,"C'mon ya big pussy, hold still and I'll get that splinter out."
589,6,24,111,141,1.2553191489361701,0.04433941040440235,538,I've got your tongue and I need to sew it back on.
589,5,26,110,141,1.2553191489361701,0.043181780792555385,538,Perspective. It's all a matter of perspective.
589,6,24,111,141,1.2553191489361701,0.04433941040440235,538,"Seriously, our custom-made boots will make you legendary."
589,6,24,111,141,1.2553191489361701,0.04433941040440235,538,"But a stitch in time could save all nine, big guy."
589,6,24,111,141,1.2553191489361701,0.04433941040440235,538,"All right, calm down! You know how long it takes me to drag out a bag of kibble!"
589,6,24,111,141,1.2553191489361701,0.04433941040440235,538,"I told you, my name is Thumb. I bought this house from the Mouse family in a short sale."
589,7,22,112,141,1.2553191489361701,0.04546757567326129,538,How was I supposed to know it was catgut?
589,8,20,113,141,1.2553191489361701,0.04656841805556057,538,I am *not* looking forward to cleaning your litter box.
589,9,18,114,141,1.2553191489361701,0.047643831529288014,538,"Prick on somebody your own size, Gulliver."
612,7,22,113,142,1.2535211267605635,0.045182036405808805,538,I told you to stop needling me!
613,6,23,110,139,1.2517985611510791,0.04461810422546896,538,"You see, if I jab myself and don't wake up, I'm basically out of options here."
613,7,21,111,139,1.2517985611510791,0.045771602978594964,538,Just so we're clear. Cats are notoriously ungrateful.
613,6,23,110,139,1.2517985611510791,0.04461810422546896,538,"Again?! That's it, I have got to go easy on the Ambien."
613,5,25,109,139,1.2517985611510791,0.043433982204254526,538,I really regret trying to become Ant Man right now.
613,3,29,107,139,1.2517985611510791,0.04096317835579747,538,All they told me was you needed boots repaired.
613,7,21,111,139,1.2517985611510791,0.045771602978594964,538,I need to tag you in case you get lost
613,8,19,112,139,1.2517985611510791,0.04689673819985177,538,"I said tailor, not neuter."
613,6,23,110,139,1.2517985611510791,0.04461810422546896,538,"I'm gonna taste like chicken, ya know, so why not just go eat a chicken?"
613,9,17,113,139,1.2517985611510791,0.04799550466804937,538,Don't be a pussy.
613,5,25,109,139,1.2517985611510791,0.043433982204254526,538,Did I say six? Of course you're a size two.
613,6,23,110,139,1.2517985611510791,0.04461810422546896,538,Spay...I mean STAY!
613,8,19,112,139,1.2517985611510791,0.04689673819985177,538,I should've insisted on declawing
613,7,21,111,139,1.2517985611510791,0.045771602978594964,538,I must have pissed off the cartoonist...
613,8,19,112,139,1.2517985611510791,0.04689673819985177,538,Say hello to my little friend.
613,6,23,110,139,1.2517985611510791,0.04461810422546896,538,"I heard you lost your mittens, I'm just here to help."
613,9,17,113,139,1.2517985611510791,0.04799550466804937,538,Hah... you should have killed me instead of dropping me on the porch.
613,9,17,113,139,1.2517985611510791,0.04799550466804937,538,Sometimes I can be a little prick.
613,7,21,111,139,1.2517985611510791,0.045771602978594964,538,I came for my tongue. . . .
613,4,27,108,139,1.2517985611510791,0.042216660165913016,538,"I fought for your balls, Sparkles."
613,4,27,108,139,1.2517985611510791,0.042216660165913016,538,"Yeah, well I can become feral too!"
613,8,19,112,139,1.2517985611510791,0.04689673819985177,538,"Try as I might, I can think of nothing witty to say about being miniaturized and threatened by a giant house cat and having nothing to defend myself with but a damned needle and thread"
634,5,25,110,140,1.25,0.04316011443339083,538,"No, I said I luuuv cats. I adore cats. I wish I could marry a cat."
635,6,22,110,138,1.2463768115942029,0.04460956331318161,538,Suffering years of domestic cat abuse left Dave feeling small and powerless. Today he takes his power back.
635,7,20,111,138,1.2463768115942029,0.045779904562916626,538,No way am I going to clean your litter box.
635,7,20,111,138,1.2463768115942029,0.045779904562916626,538,Who are you calling a pussy now?
635,7,20,111,138,1.2463768115942029,0.045779904562916626,538,"Remember, a stitch in time saves nine lives."
635,9,16,113,138,1.2463768115942029,0.04803511952086458,538,Don't underestimate me. I can be a real prick.
635,5,24,109,138,1.2463768115942029,0.04340767923070482,538,"I keep telling you, I can't operate a can opener that is bigger than I am - eat the dry stuff!"
635,7,20,111,138,1.2463768115942029,0.045779904562916626,538,I can't believe you've never had your whiskers threaded!
635,4,26,108,138,1.2463768115942029,0.04217155550129456,538,Don't eat me and I'll make sure you're in the sequel.
635,6,22,110,138,1.2463768115942029,0.04460956331318161,538,Quit toying with me.
635,8,18,112,138,1.2463768115942029,0.04692106333606209,538,I'm not dropping the needle until you stop throwing a hissy fit.
635,3,28,107,138,1.2463768115942029,0.040898087615459135,538,You were more fun when you were smaller and played with yarn!
635,4,26,108,138,1.2463768115942029,0.04217155550129456,538,I seem to remember a different attitude when YOU were the small one.
635,6,22,110,138,1.2463768115942029,0.04460956331318161,538,Don't thread on me.
635,8,18,112,138,1.2463768115942029,0.04692106333606209,538,I'm tired of always being the little prick in this relationship.
635,4,26,108,138,1.2463768115942029,0.04217155550129456,538,"Read my lips. I am a man, not a mouse."
635,8,18,112,138,1.2463768115942029,0.04692106333606209,538,"Tell Mr. Gulliver that if he makes water on our village again, you’ll both be deported."
635,11,12,115,138,1.2463768115942029,0.05018909994189712,538,needle and threat
635,8,18,112,138,1.2463768115942029,0.04692106333606209,538,"When I wake up, believe me, you're gonna get it!"
635,7,20,111,138,1.2463768115942029,0.045779904562916626,538,I think you're over reacting.
635,6,22,110,138,1.2463768115942029,0.04460956331318161,538,"A stitch in time saves nine, you know !"
635,9,16,113,138,1.2463768115942029,0.04803511952086458,538,They don't call me the little prick for nothing!
635,9,16,113,138,1.2463768115942029,0.04803511952086458,538,"Now who's talking about ""just a little prick""?"
635,8,18,112,138,1.2463768115942029,0.04692106333606209,538,"No, listening to the ""drink me"" sign was mistake #2, #1 was not having you declawed."
635,5,24,109,138,1.2463768115942029,0.04340767923070482,538,"Sit, human"
635,4,26,108,138,1.2463768115942029,0.04217155550129456,538,"Oh, don't be such a big scaredy cat!"
635,6,22,110,138,1.2463768115942029,0.04460956331318161,538,"It's not catgut, it's cotton."
635,4,26,108,138,1.2463768115942029,0.04217155550129456,538,"Look, YOU may be indifferent to the fact that some life forms only have ONE life, but it's pretty meaningful to me, so there's no way I'm putting down the needle, Max!"
635,3,28,107,138,1.2463768115942029,0.040898087615459135,538,I guess I should have read the fine print before taking that little blue pill.
635,8,18,112,138,1.2463768115942029,0.04692106333606209,538,"Okay. I'll make you a ""Bernie for President"" sweater if it makes you happy."
635,5,24,109,138,1.2463768115942029,0.04340767923070482,538,"If I make this stitch in time, we'll save all your lives."
665,4,26,109,139,1.2446043165467626,0.041904567364428186,538,"As Yogi Berra once said, ""There's more than one way to stitch a cat."
666,9,15,112,136,1.2426470588235294,0.04839057184298448,538,"Some things have changed, Mittens, but some have not. You are still going to wear a Halloween costume this year."
666,5,23,108,136,1.2426470588235294,0.04365681614360453,538,One more step and I bark.
666,4,25,107,136,1.2426470588235294,0.042390861443509856,538,Darn you cat!
666,8,17,111,136,1.2426470588235294,0.0472516135324224,538,Wait! We haven't discussed the clawback clause...
666,7,19,110,136,1.2426470588235294,0.04608451496483136,538,Darn that cat
666,6,21,109,136,1.2426470588235294,0.044887081189025055,538,How could I know the catnip was cut with parsley?
666,6,21,109,136,1.2426470588235294,0.044887081189025055,538,"Okay, it's out. Now just remember the story about a lion, a thorn, and a Roman slave."
666,5,23,108,136,1.2426470588235294,0.04365681614360453,538,"Well, if you think playing 'thorn in the lion's paw' is a good trust building exercise, I guess we'll try it."
666,7,19,110,136,1.2426470588235294,0.04608451496483136,538,"If you just let me take a stitch right now, I can save all your lives."
666,7,19,110,136,1.2426470588235294,0.04608451496483136,538,Remember a stitch in time saves all nine.
666,2,29,105,136,1.2426470588235294,0.03973814553015243,538,I'm willing to admit I've been unreasonable.
666,5,23,108,136,1.2426470588235294,0.04365681614360453,538,Back off or curiosity may just get the best of you!
666,5,23,108,136,1.2426470588235294,0.04365681614360453,538,I hired you to be a mouser! Do not go beyond your job description!
666,6,21,109,136,1.2426470588235294,0.044887081189025055,538,"Touché, Mr. Nibbles -- you've certainly turned the tables with your shrink-ray -- but did you stop to consider who would open your tins of meat from now on?"
666,6,21,109,136,1.2426470588235294,0.044887081189025055,538,"Please understand, after I put in you in the box I had no idea if you were alive or dead."
666,8,17,111,136,1.2426470588235294,0.0472516135324224,538,Do you have a moment to talk about our lord and savior?
666,3,27,106,136,1.2426470588235294,0.041085918172157385,538,Downsizing has its drawbacks.
666,6,21,109,136,1.2426470588235294,0.044887081189025055,538,This is the last time I try lucid dreaming during a catnap.
666,8,17,111,136,1.2426470588235294,0.0472516135324224,538,So this is your fantasy while you're batting my things around?
666,8,17,111,136,1.2426470588235294,0.0472516135324224,538,"After hunting big cats on 4 continents, Felix was finally able to try it at home."
666,6,21,109,136,1.2426470588235294,0.044887081189025055,538,I told you it was sharp. You never listen.
666,7,19,110,136,1.2426470588235294,0.04608451496483136,538,I guess this is as close as I'll get to being a lion tamer.
666,5,23,108,136,1.2426470588235294,0.04365681614360453,538,I finally understand ancient Egypt.
666,7,19,110,136,1.2426470588235294,0.04608451496483136,538,Lets hope the pin is mightier than the claw.
666,5,23,108,136,1.2426470588235294,0.04365681614360453,538,"A stitch in time, saves 9 lives."
666,7,19,110,136,1.2426470588235294,0.04608451496483136,538,"I’m just hanging’ by a thread here, what’s up with you?"
666,2,29,105,136,1.2426470588235294,0.03973814553015243,538,"OK you win,I'll clean your litter box"
666,8,17,111,136,1.2426470588235294,0.0472516135324224,538,"Look my wife is sorely mistaken ""I'm a man not a mouse!"""
666,5,23,108,136,1.2426470588235294,0.04365681614360453,538,"This type of weird dream means nothing, okay?"
666,5,23,108,136,1.2426470588235294,0.04365681614360453,538,"Honey, we're going to need a bigger needle!"
666,7,19,110,136,1.2426470588235294,0.04608451496483136,538,"Look, Fella, this is MY spool! Go find yourself something else to play with."
666,9,15,112,136,1.2426470588235294,0.04839057184298448,538,Mr. Bojangles' catnip withdrawals were legendary.
666,5,23,108,136,1.2426470588235294,0.04365681614360453,538,They're all so cute on the Internet.
666,7,19,110,136,1.2426470588235294,0.04608451496483136,538,"Patches, it's the catnip, it's always the catnip...I'm backing away now, Patches, slowly...very...slowly..."
700,4,25,108,137,1.2408759124087592,0.04211755849911165,538,"Stitch in time saves nine lives, Mr Snuggles."
700,6,21,110,137,1.2408759124087592,0.04459342045456528,538,There! Now do you see my point?
700,5,23,109,137,1.2408759124087592,0.04337315922182596,538,She calls you Fluffy? Nonsense! In my book you're Tiger!
700,5,23,109,137,1.2408759124087592,0.04337315922182596,538,Are you kitten me? This is sew unfair.
700,4,25,108,137,1.2408759124087592,0.04211755849911165,538,"Oh Martha, did you let the cat out of the bag?"
700,6,21,110,137,1.2408759124087592,0.04459342045456528,538,OK you can make the yarn ball.
706,3,24,99,126,1.2380952380952381,0.04280420010332235,538,Who knew taxidermy would ever get this big?
707,4,24,107,135,1.237037037037037,0.04233041136859312,538,I'm just not a cat person.
707,3,26,106,135,1.237037037037037,0.04100372430793054,538,"Please believe me, I'm NOT a dog person!"
707,3,26,106,135,1.237037037037037,0.04100372430793054,538,The synthetic catnip has me feeling odd as well.
707,6,20,109,135,1.237037037037037,0.04486624973921271,538,"I'm the smallest taxidermist in the world, but my work is the greatest!"
707,7,18,110,135,1.237037037037037,0.04608186937587219,538,"You're lucky I""m didn't bring out the laser pointer."
707,4,24,107,135,1.237037037037037,0.04233041136859312,538,"Honey, I told you I'm not a cat person."
707,4,24,107,135,1.237037037037037,0.04233041136859312,538,"C'mon now, show me that famous Cheshire Cat grin!"
707,7,18,110,135,1.237037037037037,0.04608186937587219,538,Don't act so surprised. It's not like I didn't tell you it was sharp.
707,9,14,112,135,1.237037037037037,0.048421641072995805,538,I took care of Rover and I can take of you!
707,6,20,109,135,1.237037037037037,0.04486624973921271,538,The revenge of Schrödinger's cat!
707,4,24,107,135,1.237037037037037,0.04233041136859312,538,I should have never agreed to make a fashion line for the biggest catwalk event of the season.
707,7,18,110,135,1.237037037037037,0.04608186937587219,538,And with that my Trojan cat is complete and come sundown all of Lilliput shall know my name and sweet revenge will be mine at last.
707,9,14,112,135,1.237037037037037,0.048421641072995805,538,"You killed my father, prepare to die."
707,6,20,109,135,1.237037037037037,0.04486624973921271,538,I'm the best pound-per-pound taxidermist in town.
707,7,18,110,135,1.237037037037037,0.04608186937587219,538,"Soft kitty, warm kitty, little ball of fur..."
707,8,16,111,135,1.237037037037037,0.04726623535557376,538,He probably smells my dog on me.
707,4,24,107,135,1.237037037037037,0.04233041136859312,538,Needle me one more time and you're dead meat.
707,7,18,110,135,1.237037037037037,0.04608186937587219,538,Nice kitty.
707,2,28,105,135,1.237037037037037,0.03963265178621323,538,I think I'm in the wrong dream
707,5,22,108,135,1.237037037037037,0.04361676336166934,538,Do you prefer a general anesthetic or a local?
707,6,20,109,135,1.237037037037037,0.04486624973921271,538,Sew vindictive.
707,5,22,108,135,1.237037037037037,0.04361676336166934,538,Stay back or I'll ruche.
707,5,22,108,135,1.237037037037037,0.04361676336166934,538,Who's a ferocious tabby cat? You are ... YOU are... !
707,4,24,107,135,1.237037037037037,0.04233041136859312,538,I’ll put down the needle if you promise not to aim another hairball at me.
707,5,22,108,135,1.237037037037037,0.04361676336166934,538,Ok I get it - the dead bird gifts were under appreciated and no I do not know how hard it is to catch a bird.
707,7,18,110,135,1.237037037037037,0.04608186937587219,538,I'll have your pajamas mended by Friday.
707,4,24,107,135,1.237037037037037,0.04233041136859312,538,"Mr. Whiskers, trust me, you got a hold of some bad cat nip is all. Drink some warm milk it will bring you down."
707,6,20,109,135,1.237037037037037,0.04486624973921271,538,"Okay Merlin, I believe you."
735,7,18,111,136,1.2352941176470589,0.04577497070560295,538,"No, ‘catastrophic’ is what happened to me."
735,7,18,111,136,1.2352941176470589,0.04577497070560295,538,Hiss all you like; you're not getting your cell phone back until you mend those curtains.
735,6,20,110,136,1.2352941176470589,0.04456922123197992,538,"You can treat me like a boy toy, but clean your own d*** litter box!!!"
738,3,25,105,133,1.2330827067669172,0.04118214718083957,538,"Okay, no more sweaters, I promise!"
738,5,21,107,133,1.2330827067669172,0.043861276537850824,538,I hate when you hallucinate on your catnip
738,7,17,109,133,1.2330827067669172,0.04638592364753896,538,"why yes, I do feel threatened."
738,7,17,109,133,1.2330827067669172,0.04638592364753896,538,"Okay, I forgot the milk. So sew me!"
738,9,13,111,133,1.2330827067669172,0.04878008041958116,538,And I've got eight more where this comes from.
738,7,17,109,133,1.2330827067669172,0.04638592364753896,538,You’re not the only one who’s domesticated.
738,4,23,106,133,1.2330827067669172,0.04254280683002801,538,"Fortunately, the dog is still on my side."
738,7,17,109,133,1.2330827067669172,0.04638592364753896,538,Spare me and I'll teach you to embroider.
738,9,13,111,133,1.2330827067669172,0.04878008041958116,538,But I can still open cans.
738,6,19,108,133,1.2330827067669172,0.045141253262205396,538,"Don't take it so serious, I'm just needling you a bit."
738,4,23,106,133,1.2330827067669172,0.04254280683002801,538,Who's the pet now?
738,6,19,108,133,1.2330827067669172,0.045141253262205396,538,Honest-I've changed my mind about your operation!
738,5,21,107,133,1.2330827067669172,0.043861276537850824,538,"For the last time, stop needling me!"
738,7,17,109,133,1.2330827067669172,0.04638592364753896,538,"Yes, I am a little prick!"
738,7,17,109,133,1.2330827067669172,0.04638592364753896,538,You looked more harmless in the YouTube videos.
738,5,21,107,133,1.2330827067669172,0.043861276537850824,538,Wait 'til the neighbor's dog sees you!
738,5,21,107,133,1.2330827067669172,0.043861276537850824,538,I said scoop your own litter!
738,4,23,106,133,1.2330827067669172,0.04254280683002801,538,Actually I had nothing to do with the decision to neuter you!
738,3,25,105,133,1.2330827067669172,0.04118214718083957,538,Have you had a tetanus shot?
738,5,21,107,133,1.2330827067669172,0.043861276537850824,538,I can save you all nine.
738,2,27,104,133,1.2330827067669172,0.03977496800591531,538,Well I must be going... tell Alice the cake was delicious!
738,6,19,108,133,1.2330827067669172,0.045141253262205396,538,You need a few alterations before your Cats audition.
738,6,19,108,133,1.2330827067669172,0.045141253262205396,538,"It's either me or the vet, and her needle is way bigger."
738,6,19,108,133,1.2330827067669172,0.045141253262205396,538,"But they made a whole series out of a big, red dog."
738,4,23,106,133,1.2330827067669172,0.04254280683002801,538,"ok! I will buy canned food next time!"""
738,3,25,105,133,1.2330827067669172,0.04118214718083957,538,"Let's call it ""Cutest Cat Videos: The Payback."""
738,7,17,109,133,1.2330827067669172,0.04638592364753896,538,I know you switched my enhancement pills.
738,6,19,108,133,1.2330827067669172,0.045141253262205396,538,It was just a little catnip. You're getting this all out of proportion.
738,8,15,110,133,1.2330827067669172,0.047598057514861465,538,"Cool it, it's either this, or you go down to eight lives!"
738,5,21,107,133,1.2330827067669172,0.043861276537850824,538,"Okay, remember, the safe word is, 'cross-stitch'."
738,6,19,108,133,1.2330827067669172,0.045141253262205396,538,Now listen you have 9 lives and I have a stitch in time saves 9 so let's just call it quits PLEASE.
738,6,19,108,133,1.2330827067669172,0.045141253262205396,538,Perhaps I should have been more specific when I told that genie I wanted to lose weight.
738,5,21,107,133,1.2330827067669172,0.043861276537850824,538,"If you want a costume to wear to Cat Con, you'll have to sit still for the fitting."
738,6,19,108,133,1.2330827067669172,0.045141253262205396,538,"Honey, how do you say, 'I'm sorry I didn't change your Litter Box' in Cat?"
738,6,19,108,133,1.2330827067669172,0.045141253262205396,538,Taxidermy in Lilliputia
738,7,17,109,133,1.2330827067669172,0.04638592364753896,538,"Now that the needles out of your paw, will you use the thimble?"
738,5,21,107,133,1.2330827067669172,0.043861276537850824,538,"Yo, Ralph , I've finished the taxidermy on Fluffy!"
738,6,19,108,133,1.2330827067669172,0.045141253262205396,538,Remind me to lock you up before I shrink myself next time.
738,7,17,109,133,1.2330827067669172,0.04638592364753896,538,Don't be such a fraidy cat. I'm just going to harpoon your hair ball and then yank it out.
738,3,25,105,133,1.2330827067669172,0.04118214718083957,538,"I'm not food, I'm entertainment!"
738,5,21,107,133,1.2330827067669172,0.043861276537850824,538,If I ever get out of this you'll never get another bite of premium cat food!
738,3,25,105,133,1.2330827067669172,0.04118214718083957,538,I'm never going to finish these kitten mittens if you don't cooperate.
738,7,17,109,133,1.2330827067669172,0.04638592364753896,538,You're nothing but a giant pussy.
738,6,19,108,133,1.2330827067669172,0.045141253262205396,538,I wish I'd had you declawed.
738,6,19,108,133,1.2330827067669172,0.045141253262205396,538,Patience my feline friend--Christmas sweaters take time.
783,8,14,107,129,1.2325581395348837,0.048614061994616015,538,Day 7 in the land of the giants. Tim's deliberate attempt to create a 'lion and the thorn' friendship went horribly wrong.
783,3,24,102,129,1.2325581395348837,0.04192501483097662,538,"Well, this is a catastrophe."
785,4,21,101,126,1.2301587301587302,0.04387963104516852,538,"Patches, we'll harpoon the yarn ball and have it out from under the fridge in no time."
785,6,17,103,126,1.2301587301587302,0.04668394022175475,538,...and where's Thumbelina!?
785,3,23,100,126,1.2301587301587302,0.042407993275749206,538,"I've got your nine lives right here, pal."
788,4,22,106,132,1.2272727272727273,0.042464704276476285,538,"Eventually, I’m going to have to use your litter box."
788,5,20,107,132,1.2272727272727273,0.04380538243518159,538,"It's not the size of the Bob in the fight, it's the size of the fight in the Bob."
788,6,18,108,132,1.2272727272727273,0.045106229628472036,538,The crack about you being the runt of the litter still burns doesn't it?
788,5,20,107,132,1.2272727272727273,0.04380538243518159,538,I never should have fed you human-shaped treats!
788,6,18,108,132,1.2272727272727273,0.045106229628472036,538,Wow! What did you take last night?
788,5,20,107,132,1.2272727272727273,0.04380538243518159,538,I thought you liked posing for those photos!
788,6,18,108,132,1.2272727272727273,0.045106229628472036,538,"Don't give me that ""nice kitty"" crap!"
788,7,16,109,132,1.2272727272727273,0.0463705981447337,538,"Trust me, a stitch in time saves nine lives."
788,6,18,108,132,1.2272727272727273,0.045106229628472036,538,Maybe I should've worn the thimble.
788,7,16,109,132,1.2272727272727273,0.0463705981447337,538,Honey! I shrunk myself again!
788,6,18,108,132,1.2272727272727273,0.045106229628472036,538,"No, no, no. I'm not a dog person."
788,6,18,108,132,1.2272727272727273,0.045106229628472036,538,Dream Caused by the Meow of a Cat a Second Before Awakening.
788,5,20,107,132,1.2272727272727273,0.04380538243518159,538,"Wait, Puss, I'll have your boots ready tomorrow."
788,5,20,107,132,1.2272727272727273,0.04380538243518159,538,Scott was dismayed to learn that he underestimated the amount of anesthetic required to finish Whisker’s neutering.
788,4,22,106,132,1.2272727272727273,0.042464704276476285,538,"Look, I've been shrinking for weeks, and you're not helping at all."
788,4,22,106,132,1.2272727272727273,0.042464704276476285,538,What we have here is a failure to communicate
788,5,20,107,132,1.2272727272727273,0.04380538243518159,538,"You need a few stitches, stop being such a big pussy."
788,7,16,109,132,1.2272727272727273,0.0463705981447337,538,A stitch in time saves nine and you are on eight!
788,6,18,108,132,1.2272727272727273,0.045106229628472036,538,I'm telling you I have it on record that a stitch in time saves nine lives.
788,5,20,107,132,1.2272727272727273,0.04380538243518159,538,Back off! It's just the catnip talking.
788,2,26,104,132,1.2272727272727273,0.039647575805851216,538,"We could change the game to, Pin the Tail on the Donkey."
788,8,14,110,132,1.2272727272727273,0.04760139486721281,538,Don't be such a pussy
788,3,24,105,132,1.2272727272727273,0.04108029562070666,538,This is the last time I swipe one of Alice's pills!
788,4,22,106,132,1.2272727272727273,0.042464704276476285,538,Marge? I have a little problem here.
788,3,24,105,132,1.2272727272727273,0.04108029562070666,538,"It's the same dream, Dr. Brown, but this time when I pop the ballon it turns into my ex wife's cat."
813,3,23,102,128,1.2265625,0.04181953482362248,538,OK! OK! I'll get you a ball of yarn.
813,6,17,105,128,1.2265625,0.046021386127029565,538,I'm Tom: Are you Jerry?
815,9,12,112,133,1.2255639097744362,0.048462980111218516,538,"But remember, a stitch in time saves nine lives."
815,2,26,105,133,1.2255639097744362,0.03938543227376263,538,I see you followed the thread.
815,5,20,108,133,1.2255639097744362,0.043508341442180715,538,How many lives do you have left?
815,8,14,111,133,1.2255639097744362,0.047273029040961784,538,No---You can't have any more Human Growth Hormone!
815,7,16,110,133,1.2255639097744362,0.04605234096280959,538,Pause!
815,4,22,107,133,1.2255639097744362,0.04217884076757722,538,"Schrödinger said ""dead or alive"", so take your pick."
815,8,14,111,133,1.2255639097744362,0.047273029040961784,538,I said new litter not neuter!
815,8,14,111,133,1.2255639097744362,0.047273029040961784,538,The label said the mushroom would make me tall!
815,6,18,109,133,1.2255639097744362,0.044798403337642796,538,This had better be a nightmare!
815,4,22,107,133,1.2255639097744362,0.04217884076757722,538,I should probably stop drinking before bed.
825,3,23,104,130,1.2230769230769232,0.04124679509478872,538,"I see the point, but I think you need to go back and look at the entire thread."
825,6,17,107,130,1.2230769230769232,0.04537708517216677,538,The camel wasn't nearly as fussy!
825,4,21,105,130,1.2230769230769232,0.04266800546039562,538,Since when is 'Pussy' not a term of endearment?
825,7,15,108,130,1.2230769230769232,0.04667269483433478,538,Can we just call it a draw?
825,2,25,103,130,1.2230769230769232,0.039774835275769825,538,It's the only way I can get the splinter out...
825,5,19,106,130,1.2230769230769232,0.0440433794609952,538,I think I can get that hairball out for you
825,5,19,106,130,1.2230769230769232,0.0440433794609952,538,"Now, what size do you want those mittens?"
825,7,15,108,130,1.2230769230769232,0.04667269483433478,538,Relax ! It wasn't me who named you Ivanka.
825,3,23,104,130,1.2230769230769232,0.04124679509478872,538,You simply aren't getting my point!
825,5,19,106,130,1.2230769230769232,0.0440433794609952,538,Cinderella said this would go differently.
825,5,19,106,130,1.2230769230769232,0.0440433794609952,538,I come in peace.
825,5,19,106,130,1.2230769230769232,0.0440433794609952,538,I can't make you a new yarn-ball if you insist on micro-managing everything.
825,7,15,108,130,1.2230769230769232,0.04667269483433478,538,There's no way I'm changing your litter box right now.
825,5,19,106,130,1.2230769230769232,0.0440433794609952,538,"C'mon, big guy; one more stitch and you're ""fixed."""
825,3,23,104,130,1.2230769230769232,0.04124679509478872,538,"Alright, Patches, just listen. Everything is going to be fine. You're very high right now. You will probably be that way for about five more hours. Try taking some hairball medicine. If you have some milk, go ahead and drink it."
825,5,19,106,130,1.2230769230769232,0.0440433794609952,538,"No, you're gonna have to change your own litter now."
825,8,13,109,130,1.2230769230769232,0.04793329769039268,538,"HONEY---on second thought, you actually look thin in that dress. NOW PLEASE UNSHRINK ME!"
825,5,19,106,130,1.2230769230769232,0.0440433794609952,538,Stand down! Gulliver will be right back.
825,8,13,109,130,1.2230769230769232,0.04793329769039268,538,We're going to have to do something for that hairball!
825,7,15,108,130,1.2230769230769232,0.04667269483433478,538,"I'm not needling you! If you don't back off, I'll sew you who's boss!"
825,3,23,104,130,1.2230769230769232,0.04124679509478872,538,"Can you please clarify what you mean by ""domesticated""?"
825,6,17,107,130,1.2230769230769232,0.04537708517216677,538,Relax. This is just a dry run before you're neutered.
825,5,19,106,130,1.2230769230769232,0.0440433794609952,538,"Believe me, threading the needle is the hardest part."
825,5,19,106,130,1.2230769230769232,0.0440433794609952,538,It is my duty to ensure you do not get out of the bag again.
825,5,19,106,130,1.2230769230769232,0.0440433794609952,538,When I wake up there will be a reckoning!
825,6,17,107,130,1.2230769230769232,0.04537708517216677,538,Paging Dr. Freud.
825,5,19,106,130,1.2230769230769232,0.0440433794609952,538,Another visual metaphor for my marriage.
825,4,21,105,130,1.2230769230769232,0.04266800546039562,538,It's not catgut!
825,6,17,107,130,1.2230769230769232,0.04537708517216677,538,This is exactly why I should have had you de-clawed.
825,7,15,108,130,1.2230769230769232,0.04667269483433478,538,"I don't care how big you are, Bob Barker says I've got to spay you."
825,4,21,105,130,1.2230769230769232,0.04266800546039562,538,"You've had your fun, Merlin. Now switch me back!"
825,6,17,107,130,1.2230769230769232,0.04537708517216677,538,I hope those cat obedience lessons were worth it.
825,5,19,106,130,1.2230769230769232,0.0440433794609952,538,"I told you, you can have the spool when I'm done with it!"
825,3,23,104,130,1.2230769230769232,0.04124679509478872,538,"Now the truth comes out, Snowball. It was never loving, it was always transactional for you."
825,5,19,106,130,1.2230769230769232,0.0440433794609952,538,"I'm not just a play thing, you know....."
825,3,23,104,130,1.2230769230769232,0.04124679509478872,538,OK! I promise - no more baths.
825,7,15,108,130,1.2230769230769232,0.04667269483433478,538,What do you mean you're not afraid of a little prick?
825,2,25,103,130,1.2230769230769232,0.039774835275769825,538,Size isn't everything!
825,7,15,108,130,1.2230769230769232,0.04667269483433478,538,I'll sew you!
825,5,19,106,130,1.2230769230769232,0.0440433794609952,538,"Fine. But next Halloween, you're going as ""The Incredible Shrinking Cat."""
825,7,15,108,130,1.2230769230769232,0.04667269483433478,538,"It's not how big it is, it's what I do with it."
825,8,13,109,130,1.2230769230769232,0.04793329769039268,538,"Stop being a pussycat, this won't hurt."
825,4,21,105,130,1.2230769230769232,0.04266800546039562,538,"Since you're opposed to the idea, I'm willing to drop it."
825,4,21,105,130,1.2230769230769232,0.04266800546039562,538,"Not so amusing when the table's turned, is it?"
825,3,23,104,130,1.2230769230769232,0.04124679509478872,538,"I know I said I would stop needling you, but we've exhausted all other options."
825,5,19,106,130,1.2230769230769232,0.0440433794609952,538,I'm really more of a 'dog person'
825,6,17,107,130,1.2230769230769232,0.04537708517216677,538,"And here, students, the photographer achieved the illusion of a small man talking to a giant cat by having him hold a fishing pole and stand far away"
825,2,25,103,130,1.2230769230769232,0.039774835275769825,538,One of us left rehab a tad too soon.
825,3,23,104,130,1.2230769230769232,0.04124679509478872,538,I knew we shouldn't have named you Abracadabra!
825,8,13,109,130,1.2230769230769232,0.04793329769039268,538,"Etui, Brute?"
825,4,21,105,130,1.2230769230769232,0.04266800546039562,538,I take you have read Gulliver's Travels.
825,2,25,103,130,1.2230769230769232,0.039774835275769825,538,I'm a tailor. I know how to use this thing.
825,3,23,104,130,1.2230769230769232,0.04124679509478872,538,"Be calm, I'm just needling you."
825,1,27,102,130,1.2230769230769232,0.03824626696604206,538,Alright...alright... Next time thread your own damned needle!
825,6,17,107,130,1.2230769230769232,0.04537708517216677,538,"Awright, I'll quit needling you, ya big pussy."
825,5,19,106,130,1.2230769230769232,0.0440433794609952,538,"I thought you were different, but you're like all the other fat cats. Just trying to intimidate the little guy."
881,3,23,105,131,1.2213740458015268,0.04096613088549232,538,"Aaand, action!"
881,4,21,106,131,1.2213740458015268,0.042375272174035514,538,En garde!
881,7,15,109,131,1.2213740458015268,0.046346338885746845,538,Don't you want the splinter out?
884,5,18,105,128,1.21875,0.04428108477108411,538,Where's the moderator?
884,3,22,103,128,1.21875,0.04140955779017633,538,But I can't reach your treats jar any more.
884,4,20,104,128,1.21875,0.042869371029220206,538,"Don't worry, I am not going to neuter you"
884,6,16,106,128,1.21875,0.04564916170716533,538,It was my ball of yarn first
884,5,18,105,128,1.21875,0.04428108477108411,538,that's some thorn you had stuck in your paw
884,9,10,109,128,1.21875,0.04952716883444788,538,Uhm ... Arf? ... Woof Woof? ... Grrrrr? ...
884,6,16,106,128,1.21875,0.04564916170716533,538,"I know you are angry, but surely you can appreciate the irony of me having got YOUR tongue."
884,4,20,104,128,1.21875,0.042869371029220206,538,I might need a bigger bag of catnip.
884,6,16,106,128,1.21875,0.04564916170716533,538,I'm a man not a mouse! I refuse to play dead.
884,4,20,104,128,1.21875,0.042869371029220206,538,If I thread your claws now you can repair the sofa as you go.
884,7,14,107,128,1.21875,0.04697741436722461,538,Is that all you got?
884,3,22,103,128,1.21875,0.04140955779017633,538,A stitch can save nine lives.
884,4,20,104,128,1.21875,0.042869371029220206,538,Aren't you happy that we micro surgeons don't use catgut any more?
884,6,16,106,128,1.21875,0.04564916170716533,538,Good kitty!
884,5,18,105,128,1.21875,0.04428108477108411,538,"You know this is going to go viral, don't you?"
884,6,16,106,128,1.21875,0.04564916170716533,538,Be careful what you wish for!
884,7,14,107,128,1.21875,0.04697741436722461,538,Wow! Things are really different in Canada.
884,4,20,104,128,1.21875,0.042869371029220206,538,I think you can see my point.
884,5,18,105,128,1.21875,0.04428108477108411,538,You should see what I did with the Gingham Dog.
884,6,16,106,128,1.21875,0.04564916170716533,538,You are going to reap what you sew
884,4,20,104,128,1.21875,0.042869371029220206,538,I told you cat gut is not made from cat guts!
884,4,20,104,128,1.21875,0.042869371029220206,538,You're big enough to fix your own pajamas
884,4,20,104,128,1.21875,0.042869371029220206,538,Suddenly Tom realized ITT Tech really didn't teach him the skills necessary for this job.
884,4,20,104,128,1.21875,0.042869371029220206,538,Remember where your catnip comes from.
884,3,22,103,128,1.21875,0.04140955779017633,538,I'll get it. Looks like a piece of tuna.
884,6,16,106,128,1.21875,0.04564916170716533,538,Trump-size hands don't fail me now.
884,2,24,102,128,1.21875,0.0398963655025738,538,If you don't hold still I'll never finish
884,7,14,107,128,1.21875,0.04697741436722461,538,A stitch in time saves nine :: A stitch in thine saves mine
884,3,22,103,128,1.21875,0.04140955779017633,538,Claritin has had unexpected side effects for me.
884,8,12,108,128,1.21875,0.04826913047376049,538,"Louise, come out now. You're taking this Halloween thing too far."
884,6,16,106,128,1.21875,0.04564916170716533,538,Just wait until the spell wears off.
884,5,18,105,128,1.21875,0.04428108477108411,538,Really? You're sitting during the national anthem?
884,3,22,103,128,1.21875,0.04140955779017633,538,But I don't have a ball of yarn!
884,4,20,104,128,1.21875,0.042869371029220206,538,Do you think I'm a man or a mouse?
884,5,18,105,128,1.21875,0.04428108477108411,538,"MAN ! Not a mouse, not a mouse..... good kitty, goooood kitty."
884,4,20,104,128,1.21875,0.042869371029220206,538,"If I'm dreaming, I'd like to wake up now!"
884,2,24,102,128,1.21875,0.0398963655025738,538,Are you angry about the castration?
884,4,20,104,128,1.21875,0.042869371029220206,538,"I see your claw, and raise you a needle."
884,5,18,105,128,1.21875,0.04428108477108411,538,I knew I should have gotten a dog.
884,2,24,102,128,1.21875,0.0398963655025738,538,How about truce now and I'll pull a thorn out of your paw at some later date?
884,6,16,106,128,1.21875,0.04564916170716533,538,Um...meow?
884,5,18,105,128,1.21875,0.04428108477108411,538,This twine ain't big enough for the both of us.
884,5,18,105,128,1.21875,0.04428108477108411,538,"I'm looking for a great, white cat."
884,5,18,105,128,1.21875,0.04428108477108411,538,Never underestimate the commitment of a Lilliputian taxidermist!
884,6,16,106,128,1.21875,0.04564916170716533,538,where are my internet royalties little man!
884,3,22,103,128,1.21875,0.04140955779017633,538,You need to look cute this time if you want to get views on YouTube.
884,3,22,103,128,1.21875,0.04140955779017633,538,Remember! I saved you from the pound.
931,1,25,98,124,1.217741935483871,0.038934948590401156,538,I'll save nine my way.
932,6,16,107,129,1.2170542635658914,0.04532564171909496,538,"what's that, a needle and threat?"
932,3,22,104,129,1.2170542635658914,0.04112227746884291,538,You usually like it when I play with the thread.
932,4,20,105,129,1.2170542635658914,0.042569539993195335,538,"And you believed Washington, when they told you, 'You'll be able to keep your present vet.""?"
935,3,21,101,125,1.216,0.04186614615113729,538,"Come on,make my day"
936,5,17,104,126,1.2142857142857142,0.04451807959055331,538,"Trust me, we only use man made fur."
936,5,17,104,126,1.2142857142857142,0.04451807959055331,538,"Well, meow to you too."
938,5,17,105,127,1.2125984251968505,0.04419837067680215,538,What's with the attitude?
938,4,19,104,127,1.2125984251968505,0.04276109906832521,538,When did I get a cat?
938,5,17,105,127,1.2125984251968505,0.04419837067680215,538,"Sew, we meet again!"
938,8,11,108,127,1.2125984251968505,0.04825400606522372,538,Have you seen the DARN cat?
938,5,17,105,127,1.2125984251968505,0.04419837067680215,538,"Touch that cardigan again, I dare you."
938,6,15,106,127,1.2125984251968505,0.04559035366650368,538,'' IT'S NOT CAT GUT '' !
938,6,15,106,127,1.2125984251968505,0.04559035366650368,538,Talk to the paw; I don't want to be neutered!
938,3,21,103,127,1.2125984251968505,0.041273807875918625,538,"Darn, cat."
938,3,21,103,127,1.2125984251968505,0.041273807875918625,538,Look who's the scaredy - cat now
938,4,19,104,127,1.2125984251968505,0.04276109906832521,538,You should've seen the hay.
938,3,21,103,127,1.2125984251968505,0.041273807875918625,538,Don't make me get the crinkle ball.
938,8,11,108,127,1.2125984251968505,0.04825400606522372,538,"There's no good caption for this cartoon, Felix!"
938,4,19,104,127,1.2125984251968505,0.04276109906832521,538,"And they said, I was too small to be a taxidermist !"
938,7,13,107,127,1.2125984251968505,0.04694107715412767,538,"I'm not afraid of you, ya big pussy."
938,6,15,106,127,1.2125984251968505,0.04559035366650368,538,My shrink warned me about you.
938,4,19,104,127,1.2125984251968505,0.04276109906832521,538,Stop being sew sensitive.
938,5,17,105,127,1.2125984251968505,0.04419837067680215,538,"Don't worry, it's cotton thread, not cat gut."
938,6,15,106,127,1.2125984251968505,0.04559035366650368,538,You obviously don't agree with my point.
938,5,17,105,127,1.2125984251968505,0.04419837067680215,538,"I am telling you the truth, I don't have any shoelaces!"
938,5,17,105,127,1.2125984251968505,0.04419837067680215,538,What size sweater?
958,3,20,102,125,1.208,0.04141995778879799,538,Put down your weapon and nobody gets hurt.
958,2,22,101,125,1.208,0.039831904864835316,538,"Suddenly, I realize naming you 'Fluffy' may have been a misnomer."
958,5,16,104,125,1.208,0.04442608939975293,538,"You picked up a splinter. Now we're not going to hurt each other, are we?"
958,6,14,105,125,1.208,0.045855312423091786,538,"Hold on a minute, I'm thinking of a caption!"
958,8,10,107,125,1.208,0.04858779881357446,538,oh fuck
958,5,16,104,125,1.208,0.04442608939975293,538,"Oh wait. Maybe it's anesthetic first, then cut, then snip and then stitch!"
958,3,20,102,125,1.208,0.04141995778879799,538,"I'm sure you harbor a few complaints, but just think about my fine can opener skills."
958,5,16,104,125,1.208,0.04442608939975293,538,"It was her idea to call you ""Snickers."""
958,5,16,104,125,1.208,0.04442608939975293,538,The witch says I can either put your tail back where I found it or stay this size forever.
958,7,12,106,125,1.208,0.0472413159795943,538,Samantha! Call your mother.
958,7,12,106,125,1.208,0.0472413159795943,538,Put down the needle and crawl slowly back into your thimble.
958,2,22,101,125,1.208,0.039831904864835316,538,Sharpen your claws on something I don't have to mend.
958,5,16,104,125,1.208,0.04442608939975293,538,Come near me and I promise you I’ll sew.
958,2,22,101,125,1.208,0.039831904864835316,538,"Look, I don't like this forced perspective any more than you do."
958,2,22,101,125,1.208,0.039831904864835316,538,And so you're assuming it was me that smoked your catnip
958,5,16,104,125,1.208,0.04442608939975293,538,You might feel a little prick?
958,3,20,102,125,1.208,0.04141995778879799,538,"Watch it,this thing is loaded."
958,5,16,104,125,1.208,0.04442608939975293,538,"Trust me, whiskers. A stitch in time saves nine lives."
958,10,6,109,125,1.208,0.051174590469073813,538,Jim's taxidermied Mother-in-Law was now complete.
958,4,18,103,125,1.208,0.04294933248946162,538,Pause please?
958,5,16,104,125,1.208,0.04442608939975293,538,I hope you got a giant discount on this home neutering kit.
958,4,18,103,125,1.208,0.04294933248946162,538,"You win -- based on our new relationship dynamics, no more dry cat food."
958,4,18,103,125,1.208,0.04294933248946162,538,If you think you are bad take a look at what I did to the dog.
958,5,16,104,125,1.208,0.04442608939975293,538,Just trust me -- kittens are overrated.
958,5,16,104,125,1.208,0.04442608939975293,538,Just because I've shrunk doesn't mean the sweater I'm making for you will.
958,4,18,103,125,1.208,0.04294933248946162,538,The mice from Cinderella made this look so much easier
958,4,18,103,125,1.208,0.04294933248946162,538,"They told me that the revival of ""Cats"" on Broadway was going to be big, but I didn't believe them."
958,5,16,104,125,1.208,0.04442608939975293,538,"Trust me, it won't hurt a bit..."
958,5,16,104,125,1.208,0.04442608939975293,538,"Yes, Honey, I know Siegfreid .... or was it Roy .... got bitten trying this."
958,7,12,106,125,1.208,0.0472413159795943,538,"Seriously, we must revisit those tartar control treats."
958,5,16,104,125,1.208,0.04442608939975293,538,Hold still now and let me take out the splinter.
958,4,18,103,125,1.208,0.04294933248946162,538,Reason #37 to Neuter your pets.
958,3,20,102,125,1.208,0.04141995778879799,538,"I know I promised you a ball of yarn, but this is close and there's no need to take that tone with me!"
958,6,14,105,125,1.208,0.045855312423091786,538,what would martha stewart do?
958,5,16,104,125,1.208,0.04442608939975293,538,"I don't need your ""stitch in time to save nine!"""
958,3,20,102,125,1.208,0.04141995778879799,538,"Hmm, I dont recall how Gulliver handled this one..."
958,3,20,102,125,1.208,0.04141995778879799,538,My stitch in time trumps your nine.
958,4,18,103,125,1.208,0.04294933248946162,538,"Stop dawdling! If you're to visit the queen, I have to finish your boots then get back to the beanstalk before I'm missed!"
958,4,18,103,125,1.208,0.04294933248946162,538,My subconscious really needs to stop taking my catnaps so literally.
958,5,16,104,125,1.208,0.04442608939975293,538,"I threaded the needle for you, but it's only going to get harder from here."
958,5,16,104,125,1.208,0.04442608939975293,538,Think of all the wet food I've given you
958,5,16,104,125,1.208,0.04442608939975293,538,"Easy now, the job description read: 'Fixing Big Buttons'. Honest mistake."
958,4,18,103,125,1.208,0.04294933248946162,538,Fine! Less work reconfiguring the shrink ray; more tummy rubs.
958,4,18,103,125,1.208,0.04294933248946162,538,"Well, Muffy, I never liked you much, either."
958,5,16,104,125,1.208,0.04442608939975293,538,Don't you know me? I used to be big.
958,4,18,103,125,1.208,0.04294933248946162,538,"I know the last alterations were painful, but I promise, this won't hurt too much."
958,8,10,107,125,1.208,0.04858779881357446,538,Don't give me any of that Stitch in time saves nine crap!
958,3,20,102,125,1.208,0.04141995778879799,538,Wait till I tell my analyst – Dr. Katz – about this dream!
958,6,14,105,125,1.208,0.045855312423091786,538,Do you want to be in this musical or not?
958,5,16,104,125,1.208,0.04442608939975293,538,This is definitely going viral.
958,4,18,103,125,1.208,0.04294933248946162,538,"Nothing's changed around here, Timmy--stay off the kitchen counters!"
958,3,20,102,125,1.208,0.04141995778879799,538,Back down fur ball! You're not messing with some whack-job cat hoarder here.
1010,6,14,106,126,1.2063492063492063,0.04551986877189821,538,It is I Don Quixote.
1011,3,19,101,123,1.2032520325203253,0.04155986513665221,538,"The cat's out of the bag, Mister."
1011,5,15,103,123,1.2032520325203253,0.04465179092518381,538,Hope I remembered to set the alarm. I can't wake-up soon enough from this one.
1011,6,13,104,123,1.2032520325203253,0.04612008731725397,538,"Now, you're just going to feel a little poke."
1011,9,7,107,123,1.2032520325203253,0.05026830530389442,538,Haystack my ass!
1011,4,17,102,123,1.2032520325203253,0.04313354160628968,538,"Maybe we should play scissors , rock and paper and forget the needle and thread option"
1011,5,15,103,123,1.2032520325203253,0.04465179092518381,538,Remember my couch?
1011,4,17,102,123,1.2032520325203253,0.04313354160628968,538,"If you don't calm down, I can't clean under your nails"
1011,3,19,101,123,1.2032520325203253,0.04155986513665221,538,"Now, now fluffy. Let's try to keep things in perspective."
1011,5,15,103,123,1.2032520325203253,0.04465179092518381,538,I always suspected you would try to eat me if I were smaller than you.
1011,5,15,103,123,1.2032520325203253,0.04465179092518381,538,My stitch in time won't save your nine!
1011,3,19,101,123,1.2032520325203253,0.04155986513665221,538,Don't look at me like that - I don't know what to do with it either!
1011,4,17,102,123,1.2032520325203253,0.04313354160628968,538,Androcles! It's me! Lionel...from Troy! Remember?
1011,4,17,102,123,1.2032520325203253,0.04313354160628968,538,"Use your words, Big Guy."
1011,2,21,100,123,1.2032520325203253,0.03992420780493856,538,"Look, I'm sure we can work out the timing for the litter box."
1011,5,15,103,123,1.2032520325203253,0.04465179092518381,538,"No I said, ""stay"" not ""spay""."
1011,4,17,102,123,1.2032520325203253,0.04313354160628968,538,"""Did I hear you say so what, or sew WHAT""!"
1011,7,11,105,123,1.2032520325203253,0.047543059172458955,538,"Go ahead, call me a pussy again..."
1011,2,21,100,123,1.2032520325203253,0.03992420780493856,538,Stay back or I'll knit you a sweater you'll really hate!
1011,7,11,105,123,1.2032520325203253,0.047543059172458955,538,"It's cat gut, but it didn't come from any cat you knew."
1011,6,13,104,123,1.2032520325203253,0.04612008731725397,538,"It saves nine, I say!"
1011,1,23,99,123,1.2032520325203253,0.03821861257982965,538,Were you only pretending to love me?
1011,6,13,104,123,1.2032520325203253,0.04612008731725397,538,I'm sorry. I thought a stitch in time saved nine.
1011,6,13,104,123,1.2032520325203253,0.04612008731725397,538,"My name is Human Montoya. You eat my father, prepare to die."
1011,5,15,103,123,1.2032520325203253,0.04465179092518381,538,Am I dreaming this? or are you dreaming me?
1011,4,17,102,123,1.2032520325203253,0.04313354160628968,538,Stop needling me Tom!
1011,3,19,101,123,1.2032520325203253,0.04155986513665221,538,I told you already - I didn't touch your milk.
1011,2,21,100,123,1.2032520325203253,0.03992420780493856,538,"Somebody wake me up, please..."
1011,5,15,103,123,1.2032520325203253,0.04465179092518381,538,A stitch in time saves nine.
1011,4,17,102,123,1.2032520325203253,0.04313354160628968,538,"C'mon, don't over-react. I was just needling you."
1011,6,13,104,123,1.2032520325203253,0.04612008731725397,538,Don't be so cranky...I'll fix your mittens. I promise.
1011,5,15,103,123,1.2032520325203253,0.04465179092518381,538,"""This is just a dream, right?"
1011,6,13,104,123,1.2032520325203253,0.04612008731725397,538,The eye of the tiger. I thought there might be a common thread.
1011,3,19,101,123,1.2032520325203253,0.04155986513665221,538,"It's just a sewing needle, you big pussy."
1011,2,21,100,123,1.2032520325203253,0.03992420780493856,538,"If you can't respect me when I'm three inches tall, well, it makes me question everything I believed about our us."
1011,5,15,103,123,1.2032520325203253,0.04465179092518381,538,Igor! Stop celebrating. REVERSE THE BEAM!!
1011,4,17,102,123,1.2032520325203253,0.04313354160628968,538,"My guess is that ""here, kitty kitty"" won't cut it. Am I right?"
1011,4,17,102,123,1.2032520325203253,0.04313354160628968,538,Your explanation of String Theory doesn't even come close!
1011,3,19,101,123,1.2032520325203253,0.04155986513665221,538,"No worries, I'm hiding it in a haystack. Not your litter box."
1011,4,17,102,123,1.2032520325203253,0.04313354160628968,538,No more sleeping on our bed!
1011,8,9,106,123,1.2032520325203253,0.04892466143777325,538,I'm not going back into the litter box.
1011,1,23,99,123,1.2032520325203253,0.03821861257982965,538,You will be in big trouble when my wife gets home.
1011,6,13,104,123,1.2032520325203253,0.04612008731725397,538,"Before I begin, are you familiar with ""Androcles and the Lion""?"
1011,3,19,101,123,1.2032520325203253,0.04155986513665221,538,What Would Rick Moranis Do?
1011,4,17,102,123,1.2032520325203253,0.04313354160628968,538,"Good God, Buttons. I SHRANK. Cleaning your litter box is out of the question."
1011,5,15,103,123,1.2032520325203253,0.04465179092518381,538,"You'r nothing but a big pussy cat, aren't you, aren't you?"
1011,7,11,105,123,1.2032520325203253,0.047543059172458955,538,"Scissors, thread, thimble. Your turn."
1011,4,17,102,123,1.2032520325203253,0.04313354160628968,538,Now Mr. Jones regretted not giving the cat that extra treat.
1011,2,21,100,123,1.2032520325203253,0.03992420780493856,538,"I promise to clean your litter box tomorrow, but it is is a big box!"
1011,3,19,101,123,1.2032520325203253,0.04155986513665221,538,Consider it payback for what happened in your litter box.
1011,6,13,104,123,1.2032520325203253,0.04612008731725397,538,"Hold still, Patches."
1011,3,19,101,123,1.2032520325203253,0.04155986513665221,538,Don't forget--- a stitch in time saves nine lives.
1011,2,21,100,123,1.2032520325203253,0.03992420780493856,538,"Do you want to hear the whole story of how I got here, or not?"
1011,8,9,106,123,1.2032520325203253,0.04892466143777325,538,"When this wears off, I am going to kick you so hard across the floor."
1011,5,15,103,123,1.2032520325203253,0.04465179092518381,538,"No, I'm a shoemaker's elf. The kitty treat elf called in sick."
1011,4,17,102,123,1.2032520325203253,0.04313354160628968,538,This is one cat toy that's fighting back.
1011,4,17,102,123,1.2032520325203253,0.04313354160628968,538,"No, you misunderstood me. I said, 'SO you're back'."
1011,3,19,101,123,1.2032520325203253,0.04155986513665221,538,"Ok I get it, you wanted a red ball of yarn."
1011,4,17,102,123,1.2032520325203253,0.04313354160628968,538,"Look, if I was a mouse, would I be offering to sew up that tear you made in the curtains?"
1069,4,17,103,124,1.2016129032258065,0.042815663640008654,538,When you realize wearing mouse scented cologne was a bad idea...
1069,3,19,102,124,1.2016129032258065,0.04125591726495557,538,Good thing I saved the taxidermy kit I used on Clifford.
1069,4,17,103,124,1.2016129032258065,0.042815663640008654,538,Are you sure that a stitch in time saves nine lives?
1069,3,19,102,124,1.2016129032258065,0.04125591726495557,538,"If I don't get the ""...and the Brobdingnag's Taxidermy Association Award goes to Lemuel Gulliver!"" this time, I'll be very disappointed."
1069,4,17,103,124,1.2016129032258065,0.042815663640008654,538,Did you ever hear the story of Androcles and the Lion?
1074,5,14,103,122,1.1967213114754098,0.04453517972424422,538,"""Okay. Okay! You'll sing 'Memory' and I'll play the air guitar!"
1074,6,12,104,122,1.1967213114754098,0.046031133268198215,538,Magic Beans he told me...Silver and Gold he told me...Oy...
1074,4,16,102,122,1.1967213114754098,0.04298719851521895,538,Just point me in the direction of the goose that lays the golden eggs and no one will get hurt.
1074,5,14,103,122,1.1967213114754098,0.04453517972424422,538,"Okay, Okay, no more Cat Hats!"
1074,4,16,102,122,1.1967213114754098,0.04298719851521895,538,"If this wasn't a forced perspective shot, I'd be royally screwed."
1074,3,18,101,122,1.1967213114754098,0.04138135134698903,538,"Just hold still, Felix. I've done this a thousand times."
1074,5,14,103,122,1.1967213114754098,0.04453517972424422,538,I simply cannot make you a mouse skin coat with less than forty skins
1074,5,14,103,122,1.1967213114754098,0.04453517972424422,538,"Again I tell you, it is easier for me to go through the eye of this needle than for a fat cat like you to enter the kingdom of God."
1074,3,18,101,122,1.1967213114754098,0.04138135134698903,538,I have a needle and I'm not afraid to use it!!
1074,6,12,104,122,1.1967213114754098,0.046031133268198215,538,"O.K., here it is, but I still don't think you can fix that rip before they return."
1074,4,16,102,122,1.1967213114754098,0.04298719851521895,538,Just as I suspected -- Cats don't really love us; they just use us.
1074,4,16,102,122,1.1967213114754098,0.04298719851521895,538,I'm Dr. Daniel. Didn't your service let you know I'd be doing your thornectomy today?
1074,4,16,102,122,1.1967213114754098,0.04298719851521895,538,It's MY ball of yarn!
1074,2,20,100,122,1.1967213114754098,0.03971061876147311,538,"Okay! I agree! The incredible expanding kitty, is a much better title."
1074,2,20,100,122,1.1967213114754098,0.03971061876147311,538,OK...not sure how this acupuncture thing really work...
1074,6,12,104,122,1.1967213114754098,0.046031133268198215,538,Honey! It might be Muffin's nappy time.
1074,4,16,102,122,1.1967213114754098,0.04298719851521895,538,Please tell the witch I am sorry I called her an ugly broom riding genie.
1074,7,10,105,122,1.1967213114754098,0.04747997711497464,538,Sew be it.
1074,1,22,99,122,1.1967213114754098,0.03796643577602682,538,There's more than one way to fence a cat.
1074,4,16,102,122,1.1967213114754098,0.04298719851521895,538,Meowch!!!!
1074,7,10,105,122,1.1967213114754098,0.04747997711497464,538,"It's a free-will universe, cat. Decide to eat me and I'll stab you. You'll just have to suture self."
1074,4,16,102,122,1.1967213114754098,0.04298719851521895,538,This is gonna make a helluva yarn.
1074,4,16,102,122,1.1967213114754098,0.04298719851521895,538,This is how you repay me for adopting you?
1074,5,14,103,122,1.1967213114754098,0.04453517972424422,538,I'll get din-din as soon as I wake up.
1074,2,20,100,122,1.1967213114754098,0.03971061876147311,538,We don't use cat gut anymore.
1074,6,12,104,122,1.1967213114754098,0.046031133268198215,538,"Finally some truth in advertising, Mittens. That high-protein, free range chicken, all natural, spring medley, super veggie robust octane Kitty Chow really helped you grow!"
1074,3,18,101,122,1.1967213114754098,0.04138135134698903,538,"It's fashion week, Mittens, why not make this easy?"
1074,5,14,103,122,1.1967213114754098,0.04453517972424422,538,"The next time some guy tells you sewing makes you a pussy, have him talk to me."
1074,5,14,103,122,1.1967213114754098,0.04453517972424422,538,"Just say, ""Thank you, Androcles"""
1074,6,12,104,122,1.1967213114754098,0.046031133268198215,538,"Umm, yeah - it is the size of the cat in the fight."
1074,5,14,103,122,1.1967213114754098,0.04453517972424422,538,You'll feel better after your cat nap.
1074,4,16,102,122,1.1967213114754098,0.04298719851521895,538,Which cake did you eat?
1074,1,22,99,122,1.1967213114754098,0.03796643577602682,538,"Hold on, I can prove we are 99% genetically identical"
1074,4,16,102,122,1.1967213114754098,0.04298719851521895,538,"Deal . . . you get three mice, a hoop of cheese, and I keep the notions."
1074,3,18,101,122,1.1967213114754098,0.04138135134698903,538,Just because I'm small doesn't mean I can't needle you.
1074,5,14,103,122,1.1967213114754098,0.04453517972424422,538,Glad I didn't go with the blind stitch.
1074,2,20,100,122,1.1967213114754098,0.03971061876147311,538,"It's kind of a funny story, actually...."
1074,3,18,101,122,1.1967213114754098,0.04138135134698903,538,"Shoot the designers, not the tailor"
1074,7,10,105,122,1.1967213114754098,0.04747997711497464,538,Trust me. In a few minutes you'll be having a ball.
1074,4,16,102,122,1.1967213114754098,0.04298719851521895,538,"You're mistaking me for a talking mouse, while I'm actually a small tailor."
1074,5,14,103,122,1.1967213114754098,0.04453517972424422,538,Did you roll the blue thread under the couch again?
1074,4,16,102,122,1.1967213114754098,0.04298719851521895,538,"Chill, Tabby! You've brought small claws to a big needle fight."
1074,4,16,102,122,1.1967213114754098,0.04298719851521895,538,Bob Barker sent me.
1074,0,24,98,122,1.1967213114754098,0.036138168861347665,538,"Now Roger, let's not be melodramatic."
1074,4,16,102,122,1.1967213114754098,0.04298719851521895,538,"I told you, I can no longer operate the can opener!"
1074,4,16,102,122,1.1967213114754098,0.04298719851521895,538,I can't open a can either!
1074,5,14,103,122,1.1967213114754098,0.04453517972424422,538,Now roll over and play dead...
1074,5,14,103,122,1.1967213114754098,0.04453517972424422,538,"Between my cat and quilting, I'm staring to feel less of a man."
1074,3,18,101,122,1.1967213114754098,0.04138135134698903,538,The cat lobby is more powerful than we thought.
1074,4,16,102,122,1.1967213114754098,0.04298719851521895,538,"And there stood Larry, out of his comfort sewn."
1074,3,18,101,122,1.1967213114754098,0.04138135134698903,538,Let's just say I drew the short straw.
1074,7,10,105,122,1.1967213114754098,0.04747997711497464,538,It is all a matter of perspective
1074,6,12,104,122,1.1967213114754098,0.046031133268198215,538,"Seriously, the vet said you would live a happier life without them. No more fighting with other males . . ."
1074,4,16,102,122,1.1967213114754098,0.04298719851521895,538,I would never knowingly put PED's in your milk!
1074,5,14,103,122,1.1967213114754098,0.04453517972424422,538,"No. You listen. Individually we're nothing, but together... we just might become an adage!"
1074,7,10,105,122,1.1967213114754098,0.04747997711497464,538,"Start small. If you can handle this, then you can work up to yarn."
1074,4,16,102,122,1.1967213114754098,0.04298719851521895,538,"Alright already, I lied about the milk in the thimble!"
1074,4,16,102,122,1.1967213114754098,0.04298719851521895,538,"So, you finished sewing your costume?"
1074,6,12,104,122,1.1967213114754098,0.046031133268198215,538,You ripped sofa so you have to fix it
1074,3,18,101,122,1.1967213114754098,0.04138135134698903,538,"Oh calm down. I'm just going to get the splinter out of your paw, and we'll become best of friends."
1074,7,10,105,122,1.1967213114754098,0.04747997711497464,538,Prick!
1074,5,14,103,122,1.1967213114754098,0.04453517972424422,538,How many times do I have to tell you that sewing requires opposable thumbs?
1074,6,12,104,122,1.1967213114754098,0.046031133268198215,538,And they said I could never be a taxidermist.
1074,2,20,100,122,1.1967213114754098,0.03971061876147311,538,"Some day, Fluffy, I'm going to be big, and THEN you'll be sorry."
1074,5,14,103,122,1.1967213114754098,0.04453517972424422,538,You know what I am and I am sure not scared of a little prick.
1074,3,18,101,122,1.1967213114754098,0.04138135134698903,538,"Yes, that's right, a stitch in time saves nine lives."
1074,6,12,104,122,1.1967213114754098,0.046031133268198215,538,About that discount cat food...
1074,2,20,100,122,1.1967213114754098,0.03971061876147311,538,I know how to use to the can opener.
1074,4,16,102,122,1.1967213114754098,0.04298719851521895,538,Hold on -- I'm here to shoot the Gulliver's Travels cat video.
1074,4,16,102,122,1.1967213114754098,0.04298719851521895,538,"If you didn't want stitches, then you shouldn't have been fighting in the alley."
1144,4,16,103,123,1.1951219512195121,0.042666263573966356,538,Can you at least wait till I finish the shirt?
1144,6,12,105,123,1.1951219512195121,0.04568336776128458,538,Scat! Gulliver's calling you.
1146,4,15,101,120,1.1916666666666667,0.04315276968259602,538,After all that catnip?
1146,3,17,100,120,1.1916666666666667,0.041498259106500054,538,I'm going to make you a new mitten.
1146,3,17,100,120,1.1916666666666667,0.041498259106500054,538,My psychiatrist thinks my nightmarish fear of cats and love of sewing represent my internal gender identification issues.
1146,3,17,100,120,1.1916666666666667,0.041498259106500054,538,Play nice and I’ll find some yarn.
1146,4,15,101,120,1.1916666666666667,0.04315276968259602,538,"Sure, I seem small, but I'm actually an industrial giant."
1146,3,17,100,120,1.1916666666666667,0.041498259106500054,538,That's the last time I try catnip.
1146,4,15,101,120,1.1916666666666667,0.04315276968259602,538,"Watch, it's easy. You can be domesticated, too."
1146,5,13,102,120,1.1916666666666667,0.04474614568527821,538,I should have gotten a dog.
1146,4,15,101,120,1.1916666666666667,0.04315276968259602,538,"A little tight in the armpit, you say?"
1146,5,13,102,120,1.1916666666666667,0.04474614568527821,538,"'It won""t hurt and rehab will get you back on your paws in a jiffy.'"
1146,3,17,100,120,1.1916666666666667,0.041498259106500054,538,Did you ever read Alice in Wonderland?
1146,3,17,100,120,1.1916666666666667,0.041498259106500054,538,A mouse terrified them. Wait 'til I leave you on their doorstep.
1146,3,17,100,120,1.1916666666666667,0.041498259106500054,538,"Okay okay, I won't knit you a sweater for Christmas."
1146,4,15,101,120,1.1916666666666667,0.04315276968259602,538,"Hey, Hon? You gotta come do catnip with the cat."
1146,4,15,101,120,1.1916666666666667,0.04315276968259602,538,Splinters again?
1146,5,13,102,120,1.1916666666666667,0.04474614568527821,538,"Sorry, I should have been kinder to you on my way up."
1146,2,19,99,120,1.1916666666666667,0.03977498568775671,538,Back off or you won't get pajamas.
1146,4,15,101,120,1.1916666666666667,0.04315276968259602,538,"Frank, we have had this conversation already. Just because you invented a shrink ray and a cat translator does not mean I will overlook your frankly vacuous views on the Trans-Pacific Partnership."
1146,6,11,103,120,1.1916666666666667,0.046284701318006854,538,Sew what?
1146,6,11,103,120,1.1916666666666667,0.046284701318006854,538,"Say ""aaah"""
1146,1,21,98,120,1.1916666666666667,0.03797358903306728,538,"Ok, I guess I'll play with you."
1146,4,15,101,120,1.1916666666666667,0.04315276968259602,538,Schrödinger's cat is very much alive!
1146,3,17,100,120,1.1916666666666667,0.041498259106500054,538,"Well, then, don’t wear the collar if you don’t want to."
1146,6,11,103,120,1.1916666666666667,0.046284701318006854,538,"Here knitty, knitty, knitty!"
1146,3,17,100,120,1.1916666666666667,0.041498259106500054,538,The sweater wasn't my idea. Is this about something else?
1146,5,13,102,120,1.1916666666666667,0.04474614568527821,538,Stop being such a big pussy!
1146,2,19,99,120,1.1916666666666667,0.03977498568775671,538,I'll try to mend your ways.
1146,5,13,102,120,1.1916666666666667,0.04474614568527821,538,Hold on! We tried flossing.
1146,5,13,102,120,1.1916666666666667,0.04474614568527821,538,Don't you ever call me pussy again.
1146,4,15,101,120,1.1916666666666667,0.04315276968259602,538,"I'll leave you in stitches, ya big pussy!"
1146,3,17,100,120,1.1916666666666667,0.041498259106500054,538,I will have you in stitches in no time!
1146,2,19,99,120,1.1916666666666667,0.03977498568775671,538,"Ok, that was eight. Do you really want to try again?"
1146,2,19,99,120,1.1916666666666667,0.03977498568775671,538,Knock it off. I'm hanging on by a thread here.
1146,4,15,101,120,1.1916666666666667,0.04315276968259602,538,Drop the attitude or your sweater will never get done.
1146,4,15,101,120,1.1916666666666667,0.04315276968259602,538,You wouldn't be so mad if you knew the number of YouTube views you're getting with the giant ball of yarn.
1146,4,15,101,120,1.1916666666666667,0.04315276968259602,538,Let me show you what I can do with just one hair ball.
1146,4,15,101,120,1.1916666666666667,0.04315276968259602,538,Ninth time's the charm.
1146,3,17,100,120,1.1916666666666667,0.041498259106500054,538,As long as I'm holding this needle you'll just have to find your own spool of thread.
1146,3,17,100,120,1.1916666666666667,0.041498259106500054,538,You are fantastic. The props are great. We are ready for Vegas.
1146,2,19,99,120,1.1916666666666667,0.03977498568775671,538,"Ok, calm down. My mistake. I thought you said ""cat knit toys."""
1146,5,13,102,120,1.1916666666666667,0.04474614568527821,538,I promise your Cat's Pajamas will be ready by Tuesday.
1146,5,13,102,120,1.1916666666666667,0.04474614568527821,538,Thank God for perspective!
1146,5,13,102,120,1.1916666666666667,0.04474614568527821,538,I don't know if it's you or if it's me...............I just hope it's a very bad dream.
1146,3,17,100,120,1.1916666666666667,0.041498259106500054,538,Turns out the real estate agent wasn't pulling my leg. Rick Moranis really did live here!
1146,3,17,100,120,1.1916666666666667,0.041498259106500054,538,A stitch in time will save one of your nine!
1146,4,15,101,120,1.1916666666666667,0.04315276968259602,538,You should really relax and take up needle point.
1146,4,15,101,120,1.1916666666666667,0.04315276968259602,538,Really stupid pet tricks
1146,3,17,100,120,1.1916666666666667,0.041498259106500054,538,I was just trying to take out your splinter.
1146,5,13,102,120,1.1916666666666667,0.04474614568527821,538,"I said, ""Ball of yarn,"" not ""Small and armed."""
1146,4,15,101,120,1.1916666666666667,0.04315276968259602,538,I hate when metaphors become reality.
1146,5,13,102,120,1.1916666666666667,0.04474614568527821,538,Tom began to regret not reading the small print about the film producers not using CGI
1146,4,15,101,120,1.1916666666666667,0.04315276968259602,538,It's a simple basting stitch and you can use it for nearly anything.
1146,3,17,100,120,1.1916666666666667,0.041498259106500054,538,I'm afraid you'll have to go to a bigger veterinary practice for your stitches.
1146,4,15,101,120,1.1916666666666667,0.04315276968259602,538,I told Andrew Lloyd Webber and Rick Moranis that this was a bad idea!
1146,4,15,101,120,1.1916666666666667,0.04315276968259602,538,If you're patient I'll take you to the world's largest ball of yarn.
1146,2,19,99,120,1.1916666666666667,0.03977498568775671,538,Come now. You made it hard enough to take measurements.
1146,4,15,101,120,1.1916666666666667,0.04315276968259602,538,"Look, I'm sorry I called you 'flea-bitten furball factory'. Now will you back off?"
1146,5,13,102,120,1.1916666666666667,0.04474614568527821,538,"When I said a little prick, I wasn't talking about your size."
1146,6,11,103,120,1.1916666666666667,0.046284701318006854,538,Finding a haystack would have been better.
1146,2,19,99,120,1.1916666666666667,0.03977498568775671,538,Do I look like a mouse to you? Really?
1146,5,13,102,120,1.1916666666666667,0.04474614568527821,538,"First, you're not a rabbit. But I'm more worried that I took the wrong pill."
1146,6,11,103,120,1.1916666666666667,0.046284701318006854,538,"Beam me up now, damn it, make it sew!"
1146,6,11,103,120,1.1916666666666667,0.046284701318006854,538,"Ok,ok, I did cut the cheese."
1209,4,15,102,121,1.1900826446280992,0.04282395506787311,538,Looks like we stitched the sack around your agates too tight.
1209,3,17,101,121,1.1900826446280992,0.041184342665912,538,"""Careful pussy, my name's Thumb, Tom Thumb."
1209,4,15,102,121,1.1900826446280992,0.04282395506787311,538,"I said 'cataracts,' not 'cat attacks!'"
1209,3,17,101,121,1.1900826446280992,0.041184342665912,538,"""Alright, I'll find the can opener""."
1209,3,17,101,121,1.1900826446280992,0.041184342665912,538,Be careful. My influence hasn't shrunk yet.
1209,3,17,101,121,1.1900826446280992,0.041184342665912,538,"I know I stepped on your tail last night, but there's no hard feelings right?"
1209,2,19,100,121,1.1900826446280992,0.03947668975473125,538,It is I Don Quixote the Man of La Mancha .
1209,5,13,103,121,1.1900826446280992,0.04440306492222323,538,"Sew what? I'm a fat cat, you're a little man."
1209,3,17,101,121,1.1900826446280992,0.041184342665912,538,No catnip.
1209,5,13,103,121,1.1900826446280992,0.04440306492222323,538,Catgut got your tongue?
1219,5,12,102,119,1.184873949579832,0.044600789096914985,538,"Get used to it, I'm NOT cleaning your box, OK?"
1219,5,12,102,119,1.184873949579832,0.044600789096914985,538,Here's proof I'm not a mouse. I sew.
1219,3,16,100,119,1.184873949579832,0.04128402453096098,538,Niiiice kitty! Niiice kitty!
1219,3,16,100,119,1.184873949579832,0.04128402453096098,538,I don't like milk either.
1219,3,16,100,119,1.184873949579832,0.04128402453096098,538,Look at it this way... a stitch in time saves nine.
1219,2,18,99,119,1.184873949579832,0.039521397092913316,538,"For the last time, Stuart Little moved out the apartment years ago."
1219,5,12,102,119,1.184873949579832,0.044600789096914985,538,"If I knew it would've come to this, I would have de-clawed you!"
1219,4,14,101,119,1.184873949579832,0.04297441721268875,538,"Suddenly, it occurred to the poor old Shoemaker that productivity declined significantly the nights when Frisky was not locked in the basement."
1219,4,14,101,119,1.184873949579832,0.04297441721268875,538,"Either the old gypsy woman's curse actually came true, or else maybe I shouldn't have eaten a pastrami and goat cheese sandwich right before bed..."
1219,2,18,99,119,1.184873949579832,0.039521397092913316,538,I think this is a way to mend our relationship.
1219,2,18,99,119,1.184873949579832,0.039521397092913316,538,"Look, I know when I was bigger, I kicked you a few times...but I did let the kid keep you, didn't I?"
1219,4,14,101,119,1.184873949579832,0.04297441721268875,538,Why don't we just press paws?
1219,4,14,101,119,1.184873949579832,0.04297441721268875,538,Fine. I'll change your name to Godzilla.
1219,2,18,99,119,1.184873949579832,0.039521397092913316,538,Apology accepted. Can we put the cat back in the bag now?
1219,5,12,102,119,1.184873949579832,0.044600789096914985,538,"Honey, I shrunk our human"
1219,5,12,102,119,1.184873949579832,0.044600789096914985,538,There's more than one way to stich a cat.
1219,5,12,102,119,1.184873949579832,0.044600789096914985,538,Take me to your leader
1219,3,16,100,119,1.184873949579832,0.04128402453096098,538,"If you put your tail on my nose, I'll sneeze and wake up."
1219,3,16,100,119,1.184873949579832,0.04128402453096098,538,Relax! I'll have you in stitches in no time.
1219,3,16,100,119,1.184873949579832,0.04128402453096098,538,See how lousy that feels?
1219,2,18,99,119,1.184873949579832,0.039521397092913316,538,"""You might wish to reconsider the possibility of assured mutual destruction."
1219,3,16,100,119,1.184873949579832,0.04128402453096098,538,Do we have to go through this every time you need a flea bath?
1219,3,16,100,119,1.184873949579832,0.04128402453096098,538,The worst part of all this is I have trouble pronouncing 'Brobdingnagian'.
1219,5,12,102,119,1.184873949579832,0.044600789096914985,538,"It saves nine stitches, not cat lives."
1219,2,18,99,119,1.184873949579832,0.039521397092913316,538,"Look, it'll only take one stitch to save all nine lives if you sit still and let me do it in time."
1219,3,16,100,119,1.184873949579832,0.04128402453096098,538,"You remember all the chew toys I got you for Christmas, don't you, Mr. Wiggles?"
1219,2,18,99,119,1.184873949579832,0.039521397092913316,538,Well one of us has to domesticate.
1219,3,16,100,119,1.184873949579832,0.04128402453096098,538,I will not wear a sweater like the dog!
1219,3,16,100,119,1.184873949579832,0.04128402453096098,538,"The problem is not as small as you think, Mr. Whiskers"
1219,3,16,100,119,1.184873949579832,0.04128402453096098,538,Maybe it is time to cancel my PETA membership.
1219,4,14,101,119,1.184873949579832,0.04297441721268875,538,Sew........catgut your tongue?
1219,4,14,101,119,1.184873949579832,0.04297441721268875,538,Careful...or you'll need stitches
1219,1,20,98,119,1.184873949579832,0.037676398114449394,538,"Not so happy about kidney with giblets, are you!"
1219,4,14,101,119,1.184873949579832,0.04297441721268875,538,I'll allow three attempts to solve the riddle. You may also phone a friend.
1219,3,16,100,119,1.184873949579832,0.04128402453096098,538,Your anger gives one paws.
1219,4,14,101,119,1.184873949579832,0.04297441721268875,538,An ailurophobe's perception of living with a cat.
1219,4,14,101,119,1.184873949579832,0.04297441721268875,538,Now you know how the couch feels
1219,5,12,102,119,1.184873949579832,0.044600789096914985,538,I SEW HATE THIS DREAM!
1219,5,12,102,119,1.184873949579832,0.044600789096914985,538,Of course it's going to hurt! I will be literally piercing your ears!
1219,4,14,101,119,1.184873949579832,0.04297441721268875,538,I had a notion that something like this would happen.
1259,3,16,101,120,1.1833333333333333,0.04096752374585769,538,"Oh yeah. I've seen the movie, I'm more worried about the spider."
1259,4,14,102,120,1.1833333333333333,0.04264263153554641,538,I said I wanted yarn
1259,2,18,100,120,1.1833333333333333,0.03922093802369406,538,There may be some lingering resentment.
1259,4,14,102,120,1.1833333333333333,0.04264263153554641,538,"But, I'm a cat person."
1259,2,18,100,120,1.1833333333333333,0.03922093802369406,538,I was told I'd be adopting a domestic cat.
1259,4,14,102,120,1.1833333333333333,0.04264263153554641,538,Eye of the Tiger versus Eye of the Needle
1259,4,14,102,120,1.1833333333333333,0.04264263153554641,538,"I thought we were equal partners, but fine…you keep 60% and I’ll keep 40% of all the revenue from your YouTube channel."
1259,6,10,104,120,1.1833333333333333,0.04580945392704768,538,"I said I need that sewing kit, little man!"
1259,6,10,104,120,1.1833333333333333,0.04580945392704768,538,"On second thought, honeybun, that's a great idea, hosting your coven's Annual Wiccan Quilting Bee at our house on Super Bowl Sunday. I'm all for it."
1259,5,12,103,120,1.1833333333333333,0.04425437884193316,538,Oh yeah? Well you grew up to be a big bully.
1259,6,10,104,120,1.1833333333333333,0.04580945392704768,538,I think you may be misinterpreting my usage of the word 'pause'
1259,5,12,103,120,1.1833333333333333,0.04425437884193316,538,"Easy, I'm not trying to needle you."
1271,4,13,100,117,1.1794871794871795,0.04311648219358659,538,"i'm small, not mousey."
1271,5,11,101,117,1.1794871794871795,0.04479278126079695,538,"You won't feel a thing, I promise."
1271,3,15,99,117,1.1794871794871795,0.041372319495311546,538,The vet suggested we take in the waist.
1271,3,15,99,117,1.1794871794871795,0.041372319495311546,538,"Make my day, Pussy!"
1271,3,15,99,117,1.1794871794871795,0.041372319495311546,538,What don't you understand when I say I don't want mittens ?
1271,7,7,103,117,1.1794871794871795,0.04796996649710181,538,"Who you calling needle dick, you big PUSSY!"
1271,4,13,100,117,1.1794871794871795,0.04311648219358659,538,Wait! I have to warn you -- I'm not gluten free!
1271,3,15,99,117,1.1794871794871795,0.041372319495311546,538,You ever hear the one about the lion and the mouse?
1271,3,15,99,117,1.1794871794871795,0.041372319495311546,538,You realize that wasn't catnip?
1271,6,9,102,117,1.1794871794871795,0.04640857107696095,538,I represent a compact and tightly-knit defense team.
1271,2,17,98,117,1.1794871794871795,0.039551316085490784,538,"Sir, you opted for a health insurance plan that only covers the mini program of splinter removal."
1271,1,19,97,117,1.1794871794871795,0.03764232176376304,538,"STOP, little man - i'd rather impale my paw on your shiny stick than hear another story about 'your world'"
1271,2,17,98,117,1.1794871794871795,0.039551316085490784,538,"So the boss say: ""We're downsizing you, but you'll be okay""..."
1271,0,21,96,117,1.1794871794871795,0.035631196604084675,538,"Not now, Gloria!"
1271,4,13,100,117,1.1794871794871795,0.04311648219358659,538,Bark bark?
1271,2,17,98,117,1.1794871794871795,0.039551316085490784,538,You're not so indifferent now.
1271,4,13,100,117,1.1794871794871795,0.04311648219358659,538,"Okay, so the lady pays me to fix the curtain, then I bring you some catnip the next time you rip it up. Deal?"
1271,5,11,101,117,1.1794871794871795,0.04479278126079695,538,This could end as quite a yarn.
1271,2,17,98,117,1.1794871794871795,0.039551316085490784,538,"Look, I'm not excited about this either. You swallowed the rubber band ball."
1271,3,15,99,117,1.1794871794871795,0.041372319495311546,538,"If I'm going to pretend to be the mouse, you need a realistic thorn."
1271,3,15,99,117,1.1794871794871795,0.041372319495311546,538,Master the cross stitch and I'll renegotiate your YouTube deal.
1271,2,17,98,117,1.1794871794871795,0.039551316085490784,538,"Again, sir, the plus-size fee cannot be waived for bespoke pajamas."
1271,3,15,99,117,1.1794871794871795,0.041372319495311546,538,Do you want to be on Facebook or not?
1271,3,15,99,117,1.1794871794871795,0.041372319495311546,538,The spray-bottle was never my idea!
1271,2,17,98,117,1.1794871794871795,0.039551316085490784,538,Let me tell you about a guy named Aesop.
1271,5,11,101,117,1.1794871794871795,0.04479278126079695,538,"Hold still, I'm just a little prick"
1271,4,13,100,117,1.1794871794871795,0.04311648219358659,538,The bath is ready!
1271,1,19,97,117,1.1794871794871795,0.03764232176376304,538,The dog will still listen to me
1271,3,15,99,117,1.1794871794871795,0.041372319495311546,538,My point precisely.
1271,4,13,100,117,1.1794871794871795,0.04311648219358659,538,"Don't be so nasty, you should know that ""a stitch in time saves nine""."
1271,4,13,100,117,1.1794871794871795,0.04311648219358659,538,Keep your paws off of my thread and needle!
1271,4,13,100,117,1.1794871794871795,0.04311648219358659,538,"I'm telling you, it wasn't me! I don't even own a laser."
1271,1,19,97,117,1.1794871794871795,0.03764232176376304,538,"I studied thorn removal, under Androcles"
1271,3,15,99,117,1.1794871794871795,0.041372319495311546,538,Scaredy-cat!
1271,4,13,100,117,1.1794871794871795,0.04311648219358659,538,"Ok tough guy, no catnip for you after I wake up."
1271,2,17,98,117,1.1794871794871795,0.039551316085490784,538,Big cat taxidermy.
1271,5,11,101,117,1.1794871794871795,0.04479278126079695,538,"Sorry, but I just spent an entire week cleaning your litter box."
1271,3,15,99,117,1.1794871794871795,0.041372319495311546,538,This is just a dream. Go play with the thread.
1271,4,13,100,117,1.1794871794871795,0.04311648219358659,538,"If you are going to act this way, Fluffy, then you can thread your own neefdle!"
1271,1,19,97,117,1.1794871794871795,0.03764232176376304,538,"Yeh, it was either shrink or get reading glasses."
1271,4,13,100,117,1.1794871794871795,0.04311648219358659,538,I don't want to play a game of cat and mouse with you.
1271,2,17,98,117,1.1794871794871795,0.039551316085490784,538,Relax! It's just a little microsurgery.
1271,1,19,97,117,1.1794871794871795,0.03764232176376304,538,Enough with the short people jokes.
1271,3,15,99,117,1.1794871794871795,0.041372319495311546,538,"I won't tell you where the mice are, I'm not a rat!"
1271,2,17,98,117,1.1794871794871795,0.039551316085490784,538,Trust me!
1271,5,11,101,117,1.1794871794871795,0.04479278126079695,538,You think just because you house and feed me I'm going to be a cute and cuddly human that will love you? Please....You're lucky I stick around here.
1271,2,17,98,117,1.1794871794871795,0.039551316085490784,538,A stitch in time saves nine lives.
1271,2,17,98,117,1.1794871794871795,0.039551316085490784,538,I told the genie that all I've ever wanted was to play a small role in That Darn Cat.....
1271,2,17,98,117,1.1794871794871795,0.039551316085490784,538,"You know the actor in the ""IN THE INCREDIBLE SHRINKING MAN"" actually lived to tell about it?"
1271,4,13,100,117,1.1794871794871795,0.04311648219358659,538,"if done in time, it saves your lives !"
1271,3,15,99,117,1.1794871794871795,0.041372319495311546,538,I suppose I should have paid more attention when that ancient gypsy was telling me the spell on how to bring Socks back from the dead but she must have talked for a good ten minutes straight! There were Pokémon to catch!
1271,2,17,98,117,1.1794871794871795,0.039551316085490784,538,C'mon...A stitch in time saves nine...nine lives...there's a joke in here somewhere. Work with me.
1271,3,15,99,117,1.1794871794871795,0.041372319495311546,538,"If you want this thing to go viral, don't eat your webmaster."
1271,3,15,99,117,1.1794871794871795,0.041372319495311546,538,Don't you get it kitty?!! A stitch in time saves Nine
1271,3,15,99,117,1.1794871794871795,0.041372319495311546,538,"Mr. Mittens. I would say 'Touché,' but that's already a caption for a Thurber cartoon."
1326,3,15,100,118,1.1779661016949152,0.04104840023841243,538,"But, Bob Barker wants you spayed girl."
1327,2,16,97,115,1.173913043478261,0.03956450490133908,538,Don't make me hurt you!
1327,2,16,97,115,1.173913043478261,0.03956450490133908,538,If you kill me you’ll blow your last chance to be on YouTube.
1327,4,12,99,115,1.173913043478261,0.04324882253520348,538,Remember who is master here.
1327,0,20,95,115,1.173913043478261,0.03549985134468374,538,You're itching for a stitching.
1327,3,14,98,115,1.173913043478261,0.04144762175788623,538,I told you...don't use the Giant Redwood as a scratching post.
1327,6,8,101,115,1.173913043478261,0.04664301934132228,538,"Give me back my tongue, Cat!"
1327,4,12,99,115,1.173913043478261,0.04324882253520348,538,"Yeah, yeah, yeah, everybody's got a yarn to share"
1327,2,16,97,115,1.173913043478261,0.03956450490133908,538,It was my wife who bought you all that cheap cat food.
1327,4,12,99,115,1.173913043478261,0.04324882253520348,538,"Fluffy, you're not getting the point."
1327,3,14,98,115,1.173913043478261,0.04144762175788623,538,I've got five reasons you should roll that thread into a ball for me to play with.
1327,4,12,99,115,1.173913043478261,0.04324882253520348,538,Sorry. Can't knit you a cheezburger.
1327,3,14,98,115,1.173913043478261,0.04144762175788623,538,"I assure you, I am highly qualified to perform this procedure."
1327,5,10,100,115,1.173913043478261,0.044977949619544065,538,"Boss, the team is wondering if you would consider retracting the clause"
1327,4,12,99,115,1.173913043478261,0.04324882253520348,538,"Honey, I shrunk Adam Sandler"
1327,3,14,98,115,1.173913043478261,0.04144762175788623,538,"I'm trying to work with you, but you need to be the bigger cat."
1327,2,16,97,115,1.173913043478261,0.03956450490133908,538,Here's a thought: put away the claws and rub my neck 'til I purr.
1327,2,16,97,115,1.173913043478261,0.03956450490133908,538,You know they say a stitch in time saves nine lives!
1327,4,12,99,115,1.173913043478261,0.04324882253520348,538,A tired man's wish to switch places with his cat goes horribly wrong.
1327,4,12,99,115,1.173913043478261,0.04324882253520348,538,"I keep telling you, a stitch in time will save you nine"
1327,5,10,100,115,1.173913043478261,0.044977949619544065,538,"Think you can make it through the eye of the needle ... Go ahead, make my day!"
1327,3,14,98,115,1.173913043478261,0.04144762175788623,538,"Don't you dare threaten me, without your thimble!!"
1327,5,10,100,115,1.173913043478261,0.044977949619544065,538,"You'd better close that potty pussy mouth, before I sew it shut!"
1327,1,18,96,115,1.173913043478261,0.037587161994374674,538,There will be just a little prick
1327,2,16,97,115,1.173913043478261,0.03956450490133908,538,"Yell all you want, I still think a simple cross stitch is the way to go."
1327,7,6,102,115,1.173913043478261,0.048250663773379165,538,And there's eight more where that came from.
1327,4,12,99,115,1.173913043478261,0.04324882253520348,538,I realize this may seem like a transfer of power but it won't be long before you succumb to your own litter box.
1327,3,14,98,115,1.173913043478261,0.04144762175788623,538,"One stitch, nine lives."
1327,4,12,99,115,1.173913043478261,0.04324882253520348,538,"Relax Cuddles, its only a cartoon"
1327,3,14,98,115,1.173913043478261,0.04144762175788623,538,Tom Thumb's adventures in taxidermy didn't elicit the same excitement as his earlier stories.
1327,3,14,98,115,1.173913043478261,0.04144762175788623,538,You want cuffs? Really? Just listen to yourself.
1327,3,14,98,115,1.173913043478261,0.04144762175788623,538,Don't blame me for you outgrowing your litter box
1327,3,14,98,115,1.173913043478261,0.04144762175788623,538,One way to skin a cat.
1327,2,16,97,115,1.173913043478261,0.03956450490133908,538,Who's a pretty little pussycat? And where's a 100-pound ball of catnip-covered yarn when you need it?
1327,4,12,99,115,1.173913043478261,0.04324882253520348,538,It wasn't my idea. Blame the stupid cartoonist.
1327,3,14,98,115,1.173913043478261,0.04144762175788623,538,I'll whistle for Rex if I have to.
1327,4,12,99,115,1.173913043478261,0.04324882253520348,538,"Wow, the Make-A-Death-Wish Foundation really does have it all!"
1327,4,12,99,115,1.173913043478261,0.04324882253520348,538,"Go get the popcorn, and we'll get ahead on holiday decorating this year."
1327,2,16,97,115,1.173913043478261,0.03956450490133908,538,"Let's do it again. Scissors, thimble, needle."
1327,1,18,96,115,1.173913043478261,0.037587161994374674,538,"Well, your question was answered whether I'm a man or a mouse."
1327,2,16,97,115,1.173913043478261,0.03956450490133908,538,Retract your claws. Step back nice and slow--or it'll be the last time you tangle the thread.
1327,2,16,97,115,1.173913043478261,0.03956450490133908,538,"Now sing after me... Sew, a needle pulling thread."
1327,3,14,98,115,1.173913043478261,0.04144762175788623,538,"Be reasonable, the ball of yarn is lost."
1327,4,12,99,115,1.173913043478261,0.04324882253520348,538,"I don't know why she licked the spoon in KLUTE, she just did it, okay?"
1327,2,16,97,115,1.173913043478261,0.03956450490133908,538,Say hello kitty to my little friend
1327,5,10,100,115,1.173913043478261,0.044977949619544065,538,E.B. White: get out of my dreams!
1327,4,12,99,115,1.173913043478261,0.04324882253520348,538,Time to get back into the bag.
1327,1,18,96,115,1.173913043478261,0.037587161994374674,538,I'm pretty sure my girlfriends cat really hates me.
1327,0,20,95,115,1.173913043478261,0.03549985134468374,538,"Please, I gave to the SPCA!"
1327,4,12,99,115,1.173913043478261,0.04324882253520348,538,"Unlike you, I'm small, feral and armed."
1327,6,8,101,115,1.173913043478261,0.04664301934132228,538,I know this is a dream and you are Trump and this is my magic wand.
1327,3,14,98,115,1.173913043478261,0.04144762175788623,538,Sometimes you're not very nice to your staff... I'm just sayin'.
1327,2,16,97,115,1.173913043478261,0.03956450490133908,538,Where's Siegfried when you need him?
1327,4,12,99,115,1.173913043478261,0.04324882253520348,538,Oh like you have anything to be upset over.
1327,3,14,98,115,1.173913043478261,0.04144762175788623,538,I didn't think it would come down to this.
1327,2,16,97,115,1.173913043478261,0.03956450490133908,538,So much for the marriage counseling.
1327,2,16,97,115,1.173913043478261,0.03956450490133908,538,Remember who brought catnip home...
1327,3,14,98,115,1.173913043478261,0.04144762175788623,538,Come on. I just want enough for a winter coat.
1327,3,14,98,115,1.173913043478261,0.04144762175788623,538,"Um, Genie, do you even know what a Mouseketeer is?"
1327,3,14,98,115,1.173913043478261,0.04144762175788623,538,"OK OK I was wrong to say ""a stitch in time saves nine."""
1327,6,8,101,115,1.173913043478261,0.04664301934132228,538,"IT'S NINE LIVES YOU IDIOT, NOT A STICH IN NINE..."
1327,3,14,98,115,1.173913043478261,0.04144762175788623,538,Why is there never a stress-dream dog?
1327,2,16,97,115,1.173913043478261,0.03956450490133908,538,"Remember, a stitch in time could save nine."
1327,2,16,97,115,1.173913043478261,0.03956450490133908,538,Easy! I was just going to make you some new mittens.
1327,5,10,100,115,1.173913043478261,0.044977949619544065,538,I'm not trying to needle you.
1327,2,16,97,115,1.173913043478261,0.03956450490133908,538,It may help you to know that in college I was a champion at the javelin throw.
1327,1,18,96,115,1.173913043478261,0.037587161994374674,538,I think I've picked up the wrong pills.
1327,2,16,97,115,1.173913043478261,0.03956450490133908,538,"Suddenly Bill realized that maybe inventing the ""People Shrinking Machine"" wasn't such a great idea after all."
1327,3,14,98,115,1.173913043478261,0.04144762175788623,538,Is it really necessary for every movie to have a sequel?
1327,3,14,98,115,1.173913043478261,0.04144762175788623,538,"It's just a little thorn. Here, let's have a look."
1327,3,14,98,115,1.173913043478261,0.04144762175788623,538,You'd better thread carefully.
1327,4,12,99,115,1.173913043478261,0.04324882253520348,538,Don't you dare needle me with your clawstrophobia.
1327,3,14,98,115,1.173913043478261,0.04144762175788623,538,It's not my fault I can't use the can opener.
1327,3,14,98,115,1.173913043478261,0.04144762175788623,538,"Eight down, only one to go."
1327,3,14,98,115,1.173913043478261,0.04144762175788623,538,"For the umpteenth time, I'm telling you I'm a tailor, not a veterinarian!"
1327,4,12,99,115,1.173913043478261,0.04324882253520348,538,This won't hurt a bit. Just put down the giant needle.
1327,3,14,98,115,1.173913043478261,0.04144762175788623,538,"My, that is a big splinter!"
1327,5,10,100,115,1.173913043478261,0.044977949619544065,538,"You darn cat, I darn socks."
1327,1,18,96,115,1.173913043478261,0.037587161994374674,538,Have I ever told you the story about the Lion and the Mouse?
1327,1,18,96,115,1.173913043478261,0.037587161994374674,538,And to think that all of those feedings and pettings have come to this.
1327,1,18,96,115,1.173913043478261,0.037587161994374674,538,"I know, pedicure time is challenging."
1327,5,10,100,115,1.173913043478261,0.044977949619544065,538,"Well, Mr. Trump, I'm afraid that if you want to be president, you're going to have to learn how to thread the needle yourself."
1327,2,16,97,115,1.173913043478261,0.03956450490133908,538,"No, I don't remember squirting you with a squirt gun."
1327,5,10,100,115,1.173913043478261,0.044977949619544065,538,"Well, you needle me all the time too."
1327,2,16,97,115,1.173913043478261,0.03956450490133908,538,"Yeah, I get it that it's sorta embarrassing to be in the remake of ""The Incredible Shrinking Man"". Still, just watch the claws."
1327,2,16,97,115,1.173913043478261,0.03956450490133908,538,I don't care what it costs. We're switching to organic cat food.
1327,0,20,95,115,1.173913043478261,0.03549985134468374,538,"I understand, it's not exactly lion taming, but suddenly I have very few options."
1327,4,12,99,115,1.173913043478261,0.04324882253520348,538,You better listen - I am not one of your playthings!
1327,6,8,101,115,1.173913043478261,0.04664301934132228,538,A stitch in time saves nine lives. It is the way it goes!
1327,2,16,97,115,1.173913043478261,0.03956450490133908,538,What do you have against tailors?
1327,3,14,98,115,1.173913043478261,0.04144762175788623,538,Are you sure you want to do this yourself?
1417,5,10,101,116,1.1724137931034482,0.04461372118850528,538,"'''It will be okay. They say string-theory is the latest cat craze."""
1417,2,16,98,116,1.1724137931034482,0.03925059242663616,538,You can't use cat scratch fever as an excuse for everything.
1417,2,16,98,116,1.1724137931034482,0.03925059242663616,538,"No Gulliver, I said a ball of yarn."
1417,2,16,98,116,1.1724137931034482,0.03925059242663616,538,I thought cat scratch fever was just a song.
1417,3,14,99,116,1.1724137931034482,0.04111610442786581,538,"Wanna play ""Pin the tail on the doggie?"
1417,1,18,97,116,1.1724137931034482,0.037291875366635134,538,Don't be a scaredy-cat. It'll only take a few little stitches.
1417,2,16,98,116,1.1724137931034482,0.03925059242663616,538,Let's see how many of your nine lives it takes to convince you I'm not on the menu.
1417,2,16,98,116,1.1724137931034482,0.03925059242663616,538,I'm only going to tell you one more time: get back in the bag.
1417,2,16,98,116,1.1724137931034482,0.03925059242663616,538,I promise I won't make you wear a Halloween costume this year.
1417,5,10,101,116,1.1724137931034482,0.04461372118850528,538,You're the one that's gonna be hanging by a thread.
1417,6,8,102,116,1.1724137931034482,0.046263475396547384,538,...and l would rather stick this needle in my eye than take you to see 'Cats'...again!
1417,5,10,101,116,1.1724137931034482,0.04461372118850528,538,That's the last can of Puss 'n Boots for you!
1417,4,12,100,116,1.1724137931034482,0.04290057203353385,538,Pushy cat.
1417,3,14,99,116,1.1724137931034482,0.04111610442786581,538,I didn't realize this is what he meant by 'It's gonna be huge.'
1431,2,16,99,117,1.170940170940171,0.038941563546433924,538,"Hey, this is not a toy"
1432,1,17,95,113,1.168141592920354,0.037508226799359806,538,"Needle, thimble, scissors,...shoot."
1432,1,17,95,113,1.168141592920354,0.037508226799359806,538,Oh how I wish I were safely back home in Lilliput.
1432,4,11,98,113,1.168141592920354,0.04336992640433485,538,A stitch in feline takes all nine.
1432,3,13,97,113,1.168141592920354,0.0415081040692339,538,"If you prick us, do we not bleed?"
1432,3,13,97,113,1.168141592920354,0.0415081040692339,538,You're a smart cat. Let's talk non-aggression pact.
1432,1,17,95,113,1.168141592920354,0.037508226799359806,538,My grandfather was a tailor. Don't even think about it.
1432,3,13,97,113,1.168141592920354,0.0415081040692339,538,Don't touch me! I have the right to bear arms!
1432,1,17,95,113,1.168141592920354,0.037508226799359806,538,"I don't know, you're giving me a moment of paws."
1432,1,17,95,113,1.168141592920354,0.037508226799359806,538,Looks like I chose the wrong week to give up knitting .
1432,3,13,97,113,1.168141592920354,0.0415081040692339,538,Why must everything begin and end with the litter box?
1432,1,17,95,113,1.168141592920354,0.037508226799359806,538,"Well, it worked with the spider."
1432,4,11,98,113,1.168141592920354,0.04336992640433485,538,Playtime's over.
1432,5,9,99,113,1.168141592920354,0.04515504766039441,538,"Relax Donald, We just want to wire your mouth shut."
1432,3,13,97,113,1.168141592920354,0.0415081040692339,538,"Who let the cats out?"" ""WHO WHO?"
1432,3,13,97,113,1.168141592920354,0.0415081040692339,538,Warning: this is a long thread.
1432,3,13,97,113,1.168141592920354,0.0415081040692339,538,"In your dreams, kitty."
1432,3,13,97,113,1.168141592920354,0.0415081040692339,538,Siegfried and Roy where are you now that I need you ?
1432,3,13,97,113,1.168141592920354,0.0415081040692339,538,Fluffy always thinks I am playing with her whenever I sew.
1432,5,9,99,113,1.168141592920354,0.04515504766039441,538,You baaad ol' putty tat!
1432,4,11,98,113,1.168141592920354,0.04336992640433485,538,"*Sigh*, Androcles made it look so easy."
1432,2,15,96,113,1.168141592920354,0.03955875238840682,538,"""So what?"" you say! Come any closer and I'll show you sew what!"
1432,2,15,96,113,1.168141592920354,0.03955875238840682,538,"Be nice, or I'll call the Lilliputians."
1432,3,13,97,113,1.168141592920354,0.0415081040692339,538,Wouldn't you rather go out for dinner?
1432,3,13,97,113,1.168141592920354,0.0415081040692339,538,This will hurt you more than it will hurt me.
1432,3,13,97,113,1.168141592920354,0.0415081040692339,538,"Okay, okay, I get it. I need to empathize more. Now back off and bring me the other half of the mushroom, dammit."
1432,3,13,97,113,1.168141592920354,0.0415081040692339,538,I'm asking you one last time. What did you do with my pet mouse?
1432,5,9,99,113,1.168141592920354,0.04515504766039441,538,"Wake up, kitty. I'm not this small. You just wish I was."
1432,3,13,97,113,1.168141592920354,0.0415081040692339,538,"Try it, and I'll be bobbin and weavin' all over the place."
1432,2,15,96,113,1.168141592920354,0.03955875238840682,538,"Not for the first time, Edgar found himself relating to Rick Moranis."
1432,7,5,101,113,1.168141592920354,0.04852869208007393,538,sometimes it feels like trump is this giant pussy were poking at
1432,3,13,97,113,1.168141592920354,0.0415081040692339,538,I'm telling you a stitch in time saves nine!
1432,2,15,96,113,1.168141592920354,0.03955875238840682,538,"Just hold still, Androcles."
1432,3,13,97,113,1.168141592920354,0.0415081040692339,538,The thread is mightier than the claw
1432,5,9,99,113,1.168141592920354,0.04515504766039441,538,Get the point?
1432,2,15,96,113,1.168141592920354,0.03955875238840682,538,Houndstooth? Really?
1432,4,11,98,113,1.168141592920354,0.04336992640433485,538,"Goliath, stop that!"
1432,0,19,94,113,1.168141592920354,0.03533891997128864,538,Just how many lives have you got left?
1432,3,13,97,113,1.168141592920354,0.0415081040692339,538,Does this smell weird to you?
1432,4,11,98,113,1.168141592920354,0.04336992640433485,538,I knitted a monster!
1432,3,13,97,113,1.168141592920354,0.0415081040692339,538,Take me outside; I need to pee.
1432,3,13,97,113,1.168141592920354,0.0415081040692339,538,I just wanted to cuddle...
1432,5,9,99,113,1.168141592920354,0.04515504766039441,538,"Hey, if you don't eat me while I'm under this spell, I'll arrange for you to mate with that cute tabby who lives around the corner plus I'll throw in a five-year supply of catnip."
1432,2,15,96,113,1.168141592920354,0.03955875238840682,538,Let's call a truce and play cat's cradle.
1432,4,11,98,113,1.168141592920354,0.04336992640433485,538,"I might be small, but I have a big prick for you."
1432,4,11,98,113,1.168141592920354,0.04336992640433485,538,"Sew, we'll needle be thready with thimble explanation for this when my kids get home from spool."
1432,3,13,97,113,1.168141592920354,0.0415081040692339,538,"I'm so sorry that you hurt your paw. Remember, a stitch in time saves nine lives!"
1432,5,9,99,113,1.168141592920354,0.04515504766039441,538,"When we named you ""Patches"" you should have known sewing would be involved."
1432,3,13,97,113,1.168141592920354,0.0415081040692339,538,"It's lucky for you, I don't have a tiny spray bottle!"
1432,4,11,98,113,1.168141592920354,0.04336992640433485,538,You asked for a small business owner. What's the problem?
1481,2,15,97,114,1.1666666666666667,0.03923794084373004,538,You don't like dry food?
1481,2,15,97,114,1.1666666666666667,0.03923794084373004,538,Sew there!
1481,2,15,97,114,1.1666666666666667,0.03923794084373004,538,"Okay, I'll sew whatever you want."
1484,4,11,100,115,1.1652173913043478,0.04266205659437598,538,"Cat: I thought you'd be bigger. Guy: And, I suppose cows fly now too? Cat: And, there are pink unicorns. Guy: Who's president? Cat: Trump. Guy: Eat me."
1484,3,13,99,115,1.1652173913043478,0.040834982203559474,538,Not what I meant when I said we needed a big cat to help with jobs around here.
1484,5,9,101,115,1.1652173913043478,0.04441403352723618,538,We forgot your tetanus shot.
1484,2,15,98,115,1.1652173913043478,0.038922236193059345,538,"Now, don't get catty. . ."
1484,1,17,97,115,1.1652173913043478,0.036910502150087024,538,I can use this to get that thorn out of your paw.
1489,4,11,101,116,1.1637931034482758,0.0423166572149465,538,Feeling sharp enough to keep this thread going?
1490,4,10,98,112,1.1607142857142858,0.043112442081771375,538,Hold on! I'm reloading!
1490,0,18,94,112,1.1607142857142858,0.034859460964757435,538,There's more than one way to thread a needle.
1490,2,14,96,112,1.1607142857142858,0.03920372865562368,538,Any chance you need some custom tailoring?
1490,5,8,99,112,1.1607142857142858,0.04493949068613542,538,"You understand this is just a steroidal delusion, right?"
1490,4,10,98,112,1.1607142857142858,0.043112442081771375,538,Baaaaad kitty! (Gulp)
1490,2,14,96,112,1.1607142857142858,0.03920372865562368,538,"OK, we'll sew up the deal. You deal with anger issues, I accept a smaller role in your life."
1490,2,14,96,112,1.1607142857142858,0.03920372865562368,538,"If you can think of another way to become Siamese, I’m all ears…"
1490,3,12,97,112,1.1607142857142858,0.04120445972681756,538,Hold on. I have to recalculate the dose of growth hormone I took.
1490,1,16,95,112,1.1607142857142858,0.03709524470371652,538,Relax... I just asked if you do trouser alterations.
1490,2,14,96,112,1.1607142857142858,0.03920372865562368,538,"If you don't want me to make you those winter bootees, I won't"
1490,3,12,97,112,1.1607142857142858,0.04120445972681756,538,"One, does not bring a needle and thread to a cat fight !"
1490,3,12,97,112,1.1607142857142858,0.04120445972681756,538,Where's my yarn ball gone?
1490,2,14,96,112,1.1607142857142858,0.03920372865562368,538,wrong cartoon
1490,2,14,96,112,1.1607142857142858,0.03920372865562368,538,"Three sets of mittens, you got it."
1490,3,12,97,112,1.1607142857142858,0.04120445972681756,538,"OK, Skipper, cool it! The ""Drink Me"" bottle worked, right? I'll feed you once I've had the ""Eat Me"" cake!"
1490,2,14,96,112,1.1607142857142858,0.03920372865562368,538,"This will wear off, so don't burn any bridges."
1490,2,14,96,112,1.1607142857142858,0.03920372865562368,538,"What is small, furry, and brilliant at sword fights? A mouseketeer! Wait, I got another one..."
1490,4,10,98,112,1.1607142857142858,0.043112442081771375,538,I'm sorry it's come to this.
1490,3,12,97,112,1.1607142857142858,0.04120445972681756,538,But a stitch in time saves nine lives!
1490,1,16,95,112,1.1607142857142858,0.03709524470371652,538,"O.K. then, I won't knit you mittens!"""
1490,3,12,97,112,1.1607142857142858,0.04120445972681756,538,Quit being such a BIG pu**y! You'll just feel a little prick.
1490,3,12,97,112,1.1607142857142858,0.04120445972681756,538,You've got to ask yourself one question: do you feel lucky; well do you punk?
1490,0,18,94,112,1.1607142857142858,0.034859460964757435,538,I'll fix your giant toy mouse as quickly as I can.
1490,2,14,96,112,1.1607142857142858,0.03920372865562368,538,I can assure you I am completely Anti-Fur!
1490,4,10,98,112,1.1607142857142858,0.043112442081771375,538,"One more time, Donald, how do you react when Hillary says you're unqualified."
1490,1,16,95,112,1.1607142857142858,0.03709524470371652,538,Here's the bigger point.
1490,3,12,97,112,1.1607142857142858,0.04120445972681756,538,Just imagine if you were in my position!
1490,3,12,97,112,1.1607142857142858,0.04120445972681756,538,"Don't, I taste like salmon pate."
1490,4,10,98,112,1.1607142857142858,0.043112442081771375,538,The irony is that the bullies called me needle-dick in high school.
1490,1,16,95,112,1.1607142857142858,0.03709524470371652,538,"Come now, a stitch in time saves nine lives."
1490,3,12,97,112,1.1607142857142858,0.04120445972681756,538,I wasn't the one who brought home Clifford.
1490,2,14,96,112,1.1607142857142858,0.03920372865562368,538,"PLEASE tell me this is a ""cute"" cat cartoon!"
1490,4,10,98,112,1.1607142857142858,0.043112442081771375,538,Don't make me get Odie.
1490,4,10,98,112,1.1607142857142858,0.043112442081771375,538,Catnip has you trippin' yo!
1490,3,12,97,112,1.1607142857142858,0.04120445972681756,538,"I can see that you have lots more than I do, but mine is bigger."
1490,5,8,99,112,1.1607142857142858,0.04493949068613542,538,Give me my tongue back.
1490,2,14,96,112,1.1607142857142858,0.03920372865562368,538,Relax. This year's Christmas sweater will have no dogs.
1490,0,18,94,112,1.1607142857142858,0.034859460964757435,538,"I don't care WHAT Sheila says. When I wake up, your claws are history."
1490,2,14,96,112,1.1607142857142858,0.03920372865562368,538,I've seen enough cat videos to know you really mean to be friendly.
1490,5,8,99,112,1.1607142857142858,0.04493949068613542,538,It's time to put away kittenish things.
1490,1,16,95,112,1.1607142857142858,0.03709524470371652,538,I bet Jon never has to deal with this shit.
1490,3,12,97,112,1.1607142857142858,0.04120445972681756,538,Cat's got your tongue isn't supposed to be literal.
1490,4,10,98,112,1.1607142857142858,0.043112442081771375,538,This must be why they recommend feeding only five or less Temptation(c) treats per day!
1490,2,14,96,112,1.1607142857142858,0.03920372865562368,538,Who you gonna call? Catbusters!
1490,4,10,98,112,1.1607142857142858,0.043112442081771375,538,"Okay, I will let you star in the” Cat In The Hat” sequel"
1490,5,8,99,112,1.1607142857142858,0.04493949068613542,538,Thread your own needle Shorty.
1490,1,16,95,112,1.1607142857142858,0.03709524470371652,538,"No one messes with the brave little tailor, cat! One more move and you're number eight."
1490,5,8,99,112,1.1607142857142858,0.04493949068613542,538,"Better not eat me, Mr. Pickles. I know when you're getting neutered."
1490,4,10,98,112,1.1607142857142858,0.043112442081771375,538,You don't threaten me man! Your skills are sew-sew..
1490,4,10,98,112,1.1607142857142858,0.043112442081771375,538,YOU SHALL NOT HISS!!!
1490,3,12,97,112,1.1607142857142858,0.04120445972681756,538,"Well Whiskers, I think we can both agree that this time, the New Yorker has gone too far."
1490,2,14,96,112,1.1607142857142858,0.03920372865562368,538,"Quick, somebody! Give kitty the red pill!"
1490,2,14,96,112,1.1607142857142858,0.03920372865562368,538,"I'm not the spinster you're looking for, kitty."
1490,5,8,99,112,1.1607142857142858,0.04493949068613542,538,I promise I won't use your ball of string.
1490,2,14,96,112,1.1607142857142858,0.03920372865562368,538,The shrink machine mishap has certainly shown your true colors Mr. Whiskers.
1490,3,12,97,112,1.1607142857142858,0.04120445972681756,538,This is no cat and mouse game
1490,2,14,96,112,1.1607142857142858,0.03920372865562368,538,You're the one who said size doesn't matter.
1490,3,12,97,112,1.1607142857142858,0.04120445972681756,538,"Look, I've seen the movie. You're wasting your time."
1490,3,12,97,112,1.1607142857142858,0.04120445972681756,538,Now wasn't a good time to try out my catnip cologne.
1490,4,10,98,112,1.1607142857142858,0.043112442081771375,538,let me point out and puncture the fallacy that a cat has nine lives.
1490,0,18,94,112,1.1607142857142858,0.034859460964757435,538,"So, that's a ""NO"" on taxidermy practice?"
1490,1,16,95,112,1.1607142857142858,0.03709524470371652,538,Kitty sit ... bad girl
1490,4,10,98,112,1.1607142857142858,0.043112442081771375,538,No winter sweater then how about some cute bootees?
1490,4,10,98,112,1.1607142857142858,0.043112442081771375,538,Where the hell is the NRA when you need them?
1490,2,14,96,112,1.1607142857142858,0.03920372865562368,538,Hey! I sure wish you had a fiddle instead!
1490,1,16,95,112,1.1607142857142858,0.03709524470371652,538,Your socks will be ready tomorrow.
1490,2,14,96,112,1.1607142857142858,0.03920372865562368,538,"So, if I get you the sewing machine, you promise to behave, right?"
1490,4,10,98,112,1.1607142857142858,0.043112442081771375,538,"I'm having the 'giant pussy' dream, again; I really need to get laid!"
1490,1,16,95,112,1.1607142857142858,0.03709524470371652,538,"Pals for life, right?"
1490,3,12,97,112,1.1607142857142858,0.04120445972681756,538,"I saw a shrink today because I have ""felines"" of anxiety!"
1490,2,14,96,112,1.1607142857142858,0.03920372865562368,538,"First of all, I would like to point something out to you."
1490,3,12,97,112,1.1607142857142858,0.04120445972681756,538,OK....let's negotiate. I'm a really good negotiator...believe me.
1490,3,12,97,112,1.1607142857142858,0.04120445972681756,538,Call me Androcles.
1490,1,16,95,112,1.1607142857142858,0.03709524470371652,538,"Okay, you shouldn't say that to a witch. How do you think I feel?"
1490,2,14,96,112,1.1607142857142858,0.03920372865562368,538,Puffing yourself up to look big isn't fooling anybody.
1490,3,12,97,112,1.1607142857142858,0.04120445972681756,538,"I'm man, not a mouse, and here's a big prick to prove it."
1490,1,16,95,112,1.1607142857142858,0.03709524470371652,538,You can ask all you want but I simply can't open the tuna can anymore.
1490,5,8,99,112,1.1607142857142858,0.04493949068613542,538,now can you turn me back to my normal size ?
1490,2,14,96,112,1.1607142857142858,0.03920372865562368,538,And I thought getting the thorn out of your paw would be hard.
1490,3,12,97,112,1.1607142857142858,0.04120445972681756,538,"In retrospect, I should not have hidden the shrink ray in the Purina Friskies™ Party Mix Crunch."
1490,4,10,98,112,1.1607142857142858,0.043112442081771375,538,This has to be my finest Build-A-Bear work to date.
1490,3,12,97,112,1.1607142857142858,0.04120445972681756,538,It worked for Despereaux.
1490,2,14,96,112,1.1607142857142858,0.03920372865562368,538,Easy there Tom.......I have no idea where Jerry is?
1490,3,12,97,112,1.1607142857142858,0.04120445972681756,538,So you're the one who made me chase the laser pointer.
1490,2,14,96,112,1.1607142857142858,0.03920372865562368,538,"Oh, yeah? Then, how does feline, fo, fum, sound?"
1490,1,16,95,112,1.1607142857142858,0.03709524470371652,538,I still can't see a sliver.
1490,3,12,97,112,1.1607142857142858,0.04120445972681756,538,"I told you, we are out of wet cat food!"
1490,0,18,94,112,1.1607142857142858,0.034859460964757435,538,This is what comes of watching too many craft shows on Saturday morning .. fer chrissakes wake up!
1490,3,12,97,112,1.1607142857142858,0.04120445972681756,538,We're gonna need a bigger needle
1490,2,14,96,112,1.1607142857142858,0.03920372865562368,538,You're just going to have to wait for the 30 foot ball of string.
1490,5,8,99,112,1.1607142857142858,0.04493949068613542,538,Meow yourself!
1490,3,12,97,112,1.1607142857142858,0.04120445972681756,538,I thought I told you to play outside.
1490,3,12,97,112,1.1607142857142858,0.04120445972681756,538,Now which tooth is hurting you?
1490,0,18,94,112,1.1607142857142858,0.034859460964757435,538,Could we discuss this civilly over a nice bowl of catnip?
1490,4,10,98,112,1.1607142857142858,0.043112442081771375,538,"Unfortunately the tailor's efforts to downsize had some catastrophic effects..."""
1585,3,12,98,113,1.1592920353982301,0.04086294907432108,538,I know I promised but they were out of the wet food.
1586,3,11,96,110,1.1545454545454545,0.04122066502878282,538,I hope this is as awkward for you as it is for me...
1586,4,9,97,110,1.1545454545454545,0.04319663061869463,538,Hold still and I'll get the thorn. One false move and you'll get spayed.
1586,5,7,98,110,1.1545454545454545,0.045086079539041465,538,Tom and Jerry re-enact 'The creation of Adam'
1586,4,9,97,110,1.1545454545454545,0.04319663061869463,538,Why don't you quit trying to needle me
1586,1,15,94,110,1.1545454545454545,0.03695310382944123,538,"You don't scare me, you big pussy!"
1586,1,15,94,110,1.1545454545454545,0.03695310382944123,538,Does this mean that you don't like the Halloween costume that I made for you?
1586,3,11,96,110,1.1545454545454545,0.04122066502878282,538,Just let me thread one more whisker
1586,2,13,95,110,1.1545454545454545,0.03914508339526551,538,"Thumbelina is on sabbatical, so there are going to be a few changes around here."
1586,0,17,93,110,1.1545454545454545,0.034622625712626656,538,"I don't know who's been walking through your cat food, but it wasn't me."
1586,2,13,95,110,1.1545454545454545,0.03914508339526551,538,You may be bigger than me but you are still a pussy cat
1586,2,13,95,110,1.1545454545454545,0.03914508339526551,538,"Well, obviously, you've never seen ""The Incredible Shrinking Man""."
1586,0,17,93,110,1.1545454545454545,0.034622625712626656,538,Ill let you play with this after I wake up
1586,3,11,96,110,1.1545454545454545,0.04122066502878282,538,I'm so disappointed. I asked the witch specifically for a cat that would love me regardless of whether or not I drank the potion that shrinks me.
1586,2,13,95,110,1.1545454545454545,0.03914508339526551,538,Just one more fur ball that's all I ask.
1586,4,9,97,110,1.1545454545454545,0.04319663061869463,538,"Stand up on two legs. Stand up, Simba."
1586,3,11,96,110,1.1545454545454545,0.04122066502878282,538,"Alright, alright, we won't call it a man's cradle."
1586,4,9,97,110,1.1545454545454545,0.04319663061869463,538,Take your stinking paws off me you damn dirty cat.
1586,2,13,95,110,1.1545454545454545,0.03914508339526551,538,"Tiny human, ""accio cheezburger"" is not going to work"
1586,1,15,94,110,1.1545454545454545,0.03695310382944123,538,I think I have enough of this reverse roleplaying game.
1586,2,13,95,110,1.1545454545454545,0.03914508339526551,538,"Hey, Furball, give me a break! If it wasn't for me, you wouldn't even have those claws!"
1586,2,13,95,110,1.1545454545454545,0.03914508339526551,538,"'Sew', you ask, What's your point?"
1586,3,11,96,110,1.1545454545454545,0.04122066502878282,538,"Yes, yes. I will finish it in time for the Tony's."
1586,5,7,98,110,1.1545454545454545,0.045086079539041465,538,I should warn you. I'm not GMO-free.
1586,3,11,96,110,1.1545454545454545,0.04122066502878282,538,"Hold the dramatics Kitty. I can see the sliver. One little flick, no pain, honest."
1586,3,11,96,110,1.1545454545454545,0.04122066502878282,538,"Hey, back off! This is MY Napoleon complex."
1586,1,15,94,110,1.1545454545454545,0.03695310382944123,538,"Yarn, not thread, yarn! Last time I take in a shelter human."
1586,2,13,95,110,1.1545454545454545,0.03914508339526551,538,"Seriously, I'm a magic elf and for my freedom I can grant you that 10th live you've been chasing."
1586,1,15,94,110,1.1545454545454545,0.03695310382944123,538,These cat-and-mouse games aren't as fun as they used to be.
1586,1,15,94,110,1.1545454545454545,0.03695310382944123,538,"I'm sorry, I should have never called you that."
1586,2,13,95,110,1.1545454545454545,0.03914508339526551,538,"Wait, weren't you a spider in the movie?"
1586,1,15,94,110,1.1545454545454545,0.03695310382944123,538,"For the last time, stay off my sewing table."
1586,1,15,94,110,1.1545454545454545,0.03695310382944123,538,Stop losing ping pong balls under the couch...or else.
1586,6,5,99,110,1.1545454545454545,0.046899469502261974,538,"OK, now you roll-over and beg!"
1586,4,9,97,110,1.1545454545454545,0.04319663061869463,538,This isn't what I meant when I asked for a big pussy.
1586,2,13,95,110,1.1545454545454545,0.03914508339526551,538,"My point is, with just using this paw the odds are five to one in my favor!"
1586,2,13,95,110,1.1545454545454545,0.03914508339526551,538,"Sew what now, you big bully"
1586,0,17,93,110,1.1545454545454545,0.034622625712626656,538,I hope you realize that if I put this in your paw you'll be asking me later to take it out.
1586,2,13,95,110,1.1545454545454545,0.03914508339526551,538,Honey uninstall the kids new iphone7 photo app. This is getting dangerous.
1586,3,11,96,110,1.1545454545454545,0.04122066502878282,538,"Well, I guess I'll be ready if you tear me a new one."
1586,4,9,97,110,1.1545454545454545,0.04319663061869463,538,Spare my life and I'll give you a neutering reversal.
1586,2,13,95,110,1.1545454545454545,0.03914508339526551,538,"Guys, how about we have one more look at that CGI budget?"
1586,5,7,98,110,1.1545454545454545,0.045086079539041465,538,Really? You cats have YouTube too?
1586,1,15,94,110,1.1545454545454545,0.03695310382944123,538,"You know, I point this needle at you as though I think I'll be able to defend myself, but honestly, I'm pretty sure this is the end of the line."
1586,3,11,96,110,1.1545454545454545,0.04122066502878282,538,"Hillary!"" Trump's cat got loose again!"
1586,3,11,96,110,1.1545454545454545,0.04122066502878282,538,A stitch in time can save your nine lives.
1586,2,13,95,110,1.1545454545454545,0.03914508339526551,538,I guess this is what happens when we try a new brand of litter.
1586,4,9,97,110,1.1545454545454545,0.04319663061869463,538,"Yes, yes, our roles are reversed, but a stich in time still saves nine."
1586,1,15,94,110,1.1545454545454545,0.03695310382944123,538,In my world the only certainty is death by taxidermy.
1586,4,9,97,110,1.1545454545454545,0.04319663061869463,538,"It'll just be a pinch to remove the splinter; if anything, you'll still have 8 lives"
1586,3,11,96,110,1.1545454545454545,0.04122066502878282,538,"Great acting Daisy, the theater director will love our Androcles and the Lion."
1586,0,17,93,110,1.1545454545454545,0.034622625712626656,538,"Once again, I am compelled to remind you -- I am not a mouse."
1586,3,11,96,110,1.1545454545454545,0.04122066502878282,538,It's true what they say - taxidermy really does add 500 pounds.
1586,4,9,97,110,1.1545454545454545,0.04319663061869463,538,"Very impressive, now lay down and show me the splinter."
1586,2,13,95,110,1.1545454545454545,0.03914508339526551,538,"Hate to tell you but you didn't shrink, everything else got bigger."
1586,4,9,97,110,1.1545454545454545,0.04319663061869463,538,"Paws up, don't shoot."
1586,2,13,95,110,1.1545454545454545,0.03914508339526551,538,What? You think it's only you who gets to play with the sewing kit?
1586,0,17,93,110,1.1545454545454545,0.034622625712626656,538,I promise - this is not catgut suture.
1586,4,9,97,110,1.1545454545454545,0.04319663061869463,538,Are you a man or a mouse?
1586,4,9,97,110,1.1545454545454545,0.04319663061869463,538,I keep telling you I have no thumbs
1586,2,13,95,110,1.1545454545454545,0.03914508339526551,538,Your Haloween costume is very realistic. You'll scare the bejesus out of everyone??
1586,3,11,96,110,1.1545454545454545,0.04122066502878282,538,"OK Coco, your wish came true!"""
1586,1,15,94,110,1.1545454545454545,0.03695310382944123,538,We can repair the curtains and the sofa. Unfortunately the mouse is a goner.
1586,4,9,97,110,1.1545454545454545,0.04319663061869463,538,"This is definitely the last time I read T. S. Eliot after taking Ambien. Okay, second to last. I gotta see how fucked up Four Quartets gets me."
1586,3,11,96,110,1.1545454545454545,0.04122066502878282,538,Open wide. It's just a small cavity.
1586,1,15,94,110,1.1545454545454545,0.03695310382944123,538,I'm feeling threadened.
1586,1,15,94,110,1.1545454545454545,0.03695310382944123,538,"This might not be the best time to tell you this, but it's your turn to be the mouse."
1586,3,11,96,110,1.1545454545454545,0.04122066502878282,538,You're supposed to be smiling!!!! I gotta quit reading Lewis Carroll before going to bed.
1586,0,17,93,110,1.1545454545454545,0.034622625712626656,538,I've crocheted a monster!
1586,4,9,97,110,1.1545454545454545,0.04319663061869463,538,A stitch in time will save nine of your lives.
1586,0,17,93,110,1.1545454545454545,0.034622625712626656,538,You've just gotten way too big for your stitches.
1586,3,11,96,110,1.1545454545454545,0.04122066502878282,538,I'm never getting a Maine Coon Cat again.
1586,2,13,95,110,1.1545454545454545,0.03914508339526551,538,Maybe it's time to invest in a sewing machine
1586,1,15,94,110,1.1545454545454545,0.03695310382944123,538,How would you like to save all nine of your lives with one timely stitch?
1586,3,11,96,110,1.1545454545454545,0.04122066502878282,538,I found the needle in the haystack. But right now I still don't feel very lucky.
1586,3,11,96,110,1.1545454545454545,0.04122066502878282,538,"Back off, punk – I'm the Tom in these here parts."
1586,2,13,95,110,1.1545454545454545,0.03914508339526551,538,You've got me in stitches!
1586,2,13,95,110,1.1545454545454545,0.03914508339526551,538,"I will say this once again, I am very sorry for not cleaning out your litter box"
1586,2,13,95,110,1.1545454545454545,0.03914508339526551,538,This will go with your boots.
1586,0,17,93,110,1.1545454545454545,0.034622625712626656,538,I knew I shouldn't have gotten a cat...
1586,3,11,96,110,1.1545454545454545,0.04122066502878282,538,"Nice kitty, soft kitty, go eat Sheldon."
1586,2,13,95,110,1.1545454545454545,0.03914508339526551,538,How was your day honey?
1586,4,9,97,110,1.1545454545454545,0.04319663061869463,538,"Tut-tut, Whiskers. Gratitude is the sign of noble souls. I remove the thorn; you procure the HGH."
1586,1,15,94,110,1.1545454545454545,0.03695310382944123,538,"Sorry, but I think Alice gave me the wrong medicine this morning."
1586,3,11,96,110,1.1545454545454545,0.04122066502878282,538,"You don’t think very highly of me, do you?"
1586,2,13,95,110,1.1545454545454545,0.03914508339526551,538,"Meow, hell! I'm going for a ROAR!"
1586,4,9,97,110,1.1545454545454545,0.04319663061869463,538,"He calls it his ""magnum opus."" I call it ""that mess in the dining room."""
1586,2,13,95,110,1.1545454545454545,0.03914508339526551,538,I've never liked you and you've never liked me. This ends here.
1586,2,13,95,110,1.1545454545454545,0.03914508339526551,538,"Mittens, we've been over this. Balls of yarn take time. I'd hoped you'd appreciate the creative process."
1586,2,13,95,110,1.1545454545454545,0.03914508339526551,538,"Mr. Cat, please, our worries are Lilliputian when compared with those of nations at war."
1586,3,11,96,110,1.1545454545454545,0.04122066502878282,538,I can't fix you unless you cooperate.
1586,3,11,96,110,1.1545454545454545,0.04122066502878282,538,Schroedinger: please do not sit on the boson beam reducer. I knew I should have had you de-clawed.
1586,3,11,96,110,1.1545454545454545,0.04122066502878282,538,"You can spool me once, you can spool me twice. The ball's in my court now."
1586,2,13,95,110,1.1545454545454545,0.03914508339526551,538,"Beware, feline fiend, for a pin is mightier than a sword! Oh, dang it, this is a needle! My bad."
1586,3,11,96,110,1.1545454545454545,0.04122066502878282,538,Get your stitches in time and your lives will be nine.
1586,2,13,95,110,1.1545454545454545,0.03914508339526551,538,Try it! I've got ten thousand rounds in this spool.
1586,4,9,97,110,1.1545454545454545,0.04319663061869463,538,"...He had a thorn, and you have a splinter -- THAT'S why I need to use needle"
1586,3,11,96,110,1.1545454545454545,0.04122066502878282,538,All your hissing didn't make it any easier to thread the needle.
1586,3,11,96,110,1.1545454545454545,0.04122066502878282,538,Trust me with this. I've traced my genealogy all the way back to Androcles.
1586,3,11,96,110,1.1545454545454545,0.04122066502878282,538,Alright...I get it! Mittens for the other two and opera gloves for you
1586,3,11,96,110,1.1545454545454545,0.04122066502878282,538,"Honey, we're gonna need the crewel for this one."
1586,3,11,96,110,1.1545454545454545,0.04122066502878282,538,Go fetch me your sock toy please.
1586,4,9,97,110,1.1545454545454545,0.04319663061869463,538,My name is not Tim and you are not Garfield.
1586,3,11,96,110,1.1545454545454545,0.04122066502878282,538,Good boy. Now do that when the dog comes.
1586,2,13,95,110,1.1545454545454545,0.03914508339526551,538,You're not following the social contract.
1586,1,15,94,110,1.1545454545454545,0.03695310382944123,538,S'cuse me. When did yarn become your enemy?
1586,2,13,95,110,1.1545454545454545,0.03914508339526551,538,It's called a Brobdingnagian Standoff.
1586,3,11,96,110,1.1545454545454545,0.04122066502878282,538,Kevin's growth-stunting coffee habit put him at a clear disadvantage during his vacation to Texas.
1586,4,9,97,110,1.1545454545454545,0.04319663061869463,538,"Hey, scream all you want. A ball of twine takes time."
1586,2,13,95,110,1.1545454545454545,0.03914508339526551,538,You're aggravating my allergies.
1586,3,11,96,110,1.1545454545454545,0.04122066502878282,538,You're trying too hard. The ferociousness should come naturally to be believable.
1586,2,13,95,110,1.1545454545454545,0.03914508339526551,538,I'm learning how to do it from scratch!
1697,3,11,97,111,1.1531531531531531,0.04087134124703275,538,The year is 2100. Cats have evolved to harness the power of their online presence.
1697,3,11,97,111,1.1531531531531531,0.04087134124703275,538,"Listen, I'm doing the best I can! Stop calling me Stuart and do it yourself!"
1699,0,16,92,108,1.1481481481481481,0.03434300243631002,538,what will I do when you go into heat?
1699,1,14,93,108,1.1481481481481481,0.03677651537147867,538,"George RR Martin's adaption of Honey, We Shrunk Ourselves is perhaps a little grittier than the original."
1699,0,16,92,108,1.1481481481481481,0.03434300243631002,538,"The name is Little, Stuart Little."
1699,3,10,95,108,1.1481481481481481,0.041214713585381466,538,"Curiosity kills the cat, right?"
1699,1,14,93,108,1.1481481481481481,0.03677651537147867,538,"I'll hem , you continue to haw."
1699,4,8,96,108,1.1481481481481481,0.04326341274625983,538,"""Honey, the kids shrunk me!'"
1699,1,14,93,108,1.1481481481481481,0.03677651537147867,538,Do you feel lucky? Well do ya punk?
1699,2,12,94,108,1.1481481481481481,0.03905870388782527,538,Sewing and embroidery really helped me with my anger management issues.
1699,3,10,95,108,1.1481481481481481,0.041214713585381466,538,Hey! Ever hear of David and Goliath?
1699,1,14,93,108,1.1481481481481481,0.03677651537147867,538,Don't worry… you'll just feel a little pinch…
1699,2,12,94,108,1.1481481481481481,0.03905870388782527,538,"If I prick your paw, will you go to sleep too?"
1699,2,12,94,108,1.1481481481481481,0.03905870388782527,538,Practice being a lion.
1699,2,12,94,108,1.1481481481481481,0.03905870388782527,538,It's only fair to warn you; I know kung fu.
1699,3,10,95,108,1.1481481481481481,0.041214713585381466,538,"Crap, not again."
1699,1,14,93,108,1.1481481481481481,0.03677651537147867,538,"Sir, I just didn't think the tails would suit you."
1699,4,8,96,108,1.1481481481481481,0.04326341274625983,538,I don't suppose I could interest you in a cradle?
1699,1,14,93,108,1.1481481481481481,0.03677651537147867,538,Would you be happier if I pulled out a thorn?
1699,1,14,93,108,1.1481481481481481,0.03677651537147867,538,"Let's get to the point, you are my pet."
1699,2,12,94,108,1.1481481481481481,0.03905870388782527,538,"Don't be a scaredy cat, It's not a Cat scan."
1699,1,14,93,108,1.1481481481481481,0.03677651537147867,538,This experience would really come in handy at a Google interview.
1699,2,12,94,108,1.1481481481481481,0.03905870388782527,538,You can dish it out but can't take it.
1699,0,16,92,108,1.1481481481481481,0.03434300243631002,538,My name's Tom. Who are you?
1699,2,12,94,108,1.1481481481481481,0.03905870388782527,538,"Calm down, it's just a small pinprick you big pussy cat."
1699,4,8,96,108,1.1481481481481481,0.04326341274625983,538,Stop trying to needle mee
1699,3,10,95,108,1.1481481481481481,0.041214713585381466,538,"Blowing it out or proportion? Who, me?"
1699,3,10,95,108,1.1481481481481481,0.041214713585381466,538,I get the feeling this debate will be very one-sided.
1699,3,10,95,108,1.1481481481481481,0.041214713585381466,538,"For the last time, I've never even been to Gloucester!"
1699,1,14,93,108,1.1481481481481481,0.03677651537147867,538,You'll realize I'm trying to help you once you stop thinking with your amygdala.
1699,2,12,94,108,1.1481481481481481,0.03905870388782527,538,It's a quick and mostly painless procedure.
1699,1,14,93,108,1.1481481481481481,0.03677651537147867,538,Sigfried and Roy would have sold you for cat food.
1699,3,10,95,108,1.1481481481481481,0.041214713585381466,538,"Release one mouse as a show of good faith, and we'll see about getting you that catnip and twine."
1699,2,12,94,108,1.1481481481481481,0.03905870388782527,538,How can losing a button lead to this?
1699,3,10,95,108,1.1481481481481481,0.041214713585381466,538,"No,you can't change your mind - just turn around ,a few stitches and it's done"
1699,2,12,94,108,1.1481481481481481,0.03905870388782527,538,Do I need to inform you of the provisions of the Second Amendment?
1699,3,10,95,108,1.1481481481481481,0.041214713585381466,538,I need more raw material for the fur ball sweater
1699,3,10,95,108,1.1481481481481481,0.041214713585381466,538,"Look, it's this or hair plugs."
1699,2,12,94,108,1.1481481481481481,0.03905870388782527,538,a stitch is not going to help you this time fella
1699,2,12,94,108,1.1481481481481481,0.03905870388782527,538,Just remember... I'm the one that hid the Catnip...
1699,3,10,95,108,1.1481481481481481,0.041214713585381466,538,Gosh...I shouldn't have adopted a stray human
1699,2,12,94,108,1.1481481481481481,0.03905870388782527,538,"Back to your corner, kitty!"
1699,1,14,93,108,1.1481481481481481,0.03677651537147867,538,Wait! Let me tell you a little story...
1699,1,14,93,108,1.1481481481481481,0.03677651537147867,538,Yet again debunking the proverbial 'stitch in time' theory.
1699,5,6,97,108,1.1481481481481481,0.04521938908235546,538,"Oh No!"" whined Pitty Patrick in deflated dismay. "" Honey, we were supposed to shrink the Kitty!"
1699,1,14,93,108,1.1481481481481481,0.03677651537147867,538,Maybe it's time to stop washing my clothes in catnip.
1699,1,14,93,108,1.1481481481481481,0.03677651537147867,538,I am NOT some piece of yarn.
1699,1,14,93,108,1.1481481481481481,0.03677651537147867,538,Eye of the needle--and wise man--be damned. I want my Kibble NOW!
1699,2,12,94,108,1.1481481481481481,0.03905870388782527,538,"It might have been a cat's cradle, but it unspooled a creature feature."
1699,1,14,93,108,1.1481481481481481,0.03677651537147867,538,"I don't know about you, but the size of this needle gives me paws."
1699,2,12,94,108,1.1481481481481481,0.03905870388782527,538,No I won't do it. I'm not changing your litter box.
1699,2,12,94,108,1.1481481481481481,0.03905870388782527,538,Why the negative attitude? You ran the house when I was bigger than you! It appears you are still in charge.
1699,2,12,94,108,1.1481481481481481,0.03905870388782527,538,We've been over this! I'm first chair!
1699,3,10,95,108,1.1481481481481481,0.041214713585381466,538,"""I'm just itchin' to be stichin'."
1699,3,10,95,108,1.1481481481481481,0.041214713585381466,538,I am not Androclese and you are _not_ a lion.
1699,3,10,95,108,1.1481481481481481,0.041214713585381466,538,Don't make me sew you.
1699,2,12,94,108,1.1481481481481481,0.03905870388782527,538,"Relax, Mongo. You're sweater'll be ready in one week."
1699,1,14,93,108,1.1481481481481481,0.03677651537147867,538,Don't worry - a stitch in time saves nine lives.
1699,2,12,94,108,1.1481481481481481,0.03905870388782527,538,I suppose it is a little strange to have such a large sewing kit.
1699,1,14,93,108,1.1481481481481481,0.03677651537147867,538,I want you to be polite and domestic
1699,2,12,94,108,1.1481481481481481,0.03905870388782527,538,Just stay calm and we'll get that splinter in no time.
1699,5,6,97,108,1.1481481481481481,0.04521938908235546,538,Aaaaaasssh!!! This catnip is crazy!!!!!
1699,1,14,93,108,1.1481481481481481,0.03677651537147867,538,"Stand back!! All I asked was ""how are your anger management classes going?"""
1699,1,14,93,108,1.1481481481481481,0.03677651537147867,538,"I'm sorry I haven't gotten around to changing the kitty litter, but I've had a lot on my mind lately."
1699,3,10,95,108,1.1481481481481481,0.041214713585381466,538,I now regret this decision.
1699,2,12,94,108,1.1481481481481481,0.03905870388782527,538,I'll put the needle down if you quit feeding me kale.
1699,0,16,92,108,1.1481481481481481,0.03434300243631002,538,It's not catnip. It's my aftershave.
1699,3,10,95,108,1.1481481481481481,0.041214713585381466,538,Got it - you don't need the mittens after all. Maybe a new pair of pajamas then?
1699,3,10,95,108,1.1481481481481481,0.041214713585381466,538,"A stitch in time doesn't save nine lives, so back off."
1699,5,6,97,108,1.1481481481481481,0.04521938908235546,538,The deplorables stole the basket
1699,0,16,92,108,1.1481481481481481,0.03434300243631002,538,When your cat thinks they run the world
1699,4,8,96,108,1.1481481481481481,0.04326341274625983,538,"One more step, and I'll introduce you to the whale we brought home in the back seat - and that snake from the office!"
1699,2,12,94,108,1.1481481481481481,0.03905870388782527,538,"OK, OK, I'll raise the hem a little."
1699,0,16,92,108,1.1481481481481481,0.03434300243631002,538,I'm thinking the kitty litter is gargantuan.
1699,2,12,94,108,1.1481481481481481,0.03905870388782527,538,"If you don't help me find the Expandomatic™, I'm going to sew you, Buttons!"
1699,3,10,95,108,1.1481481481481481,0.041214713585381466,538,"I've already warned you, Larry. Don't thread on me."
1773,3,10,96,109,1.146788990825688,0.04085745937580242,538,You call that a needle?
1773,2,12,95,109,1.146788990825688,0.03872256863042321,538,Down girl!
1773,2,12,95,109,1.146788990825688,0.03872256863042321,538,Poetic justice for declawing.
1773,2,12,95,109,1.146788990825688,0.03872256863042321,538,"You don't scare me, you're just a big pussy cat"
1773,2,12,95,109,1.146788990825688,0.03872256863042321,538,". . . and by the way, don't call me Ishmael."
1773,2,12,95,109,1.146788990825688,0.03872256863042321,538,"""Seriously..I'm not half the mouse you think I am""!"
1773,2,12,95,109,1.146788990825688,0.03872256863042321,538,I say you're no Puss in Boots and I'm not Stuart Little.
1773,2,12,95,109,1.146788990825688,0.03872256863042321,538,"Needless to say, you cannot infringe upon my 2nd amendment right to bear arms."
1773,5,6,98,109,1.146788990825688,0.04482322296823783,538,You can't fool me! That's not a laser pointer!
1782,1,14,95,110,1.1454545454545455,0.036154528037881724,538,I swear I'm not a mouse - I'm just a beta male.
1783,1,13,93,107,1.1401869158878504,0.036241607133388115,538,OK - now let's go get that mouse!
1783,1,13,93,107,1.1401869158878504,0.036241607133388115,538,So where did you get the Magic Sand?
1783,0,15,92,107,1.1401869158878504,0.033721185393691164,538,"No, it's NOT unbelievable that my pants still fit---I'm a damn good tailor."
1783,3,9,95,107,1.1401869158878504,0.04081820150522514,538,"Now that the cat's out of the bag, let's stitch it up!"
1783,2,11,94,107,1.1401869158878504,0.038597795673665176,538,"If you've got a better toothpick, I'm all for it."
1783,1,13,93,107,1.1401869158878504,0.036241607133388115,538,That wasn't a real mouse--it was my pin cushion.
1783,2,11,94,107,1.1401869158878504,0.038597795673665176,538,why should I get things at Costco?
1783,3,9,95,107,1.1401869158878504,0.04081820150522514,538,Fine. YOU try making tiny clothes.
1783,3,9,95,107,1.1401869158878504,0.04081820150522514,538,"""Yes Luna...I can see that they're as sharp as needles, but I still can't sew with them can I?"
1783,1,13,93,107,1.1401869158878504,0.036241607133388115,538,"Okay, OKAY! Just the tongue though..."
1783,3,9,95,107,1.1401869158878504,0.04081820150522514,538,"Back off, kitty--this Brave Little Tailor is a man, not a mouse."
1783,1,13,93,107,1.1401869158878504,0.036241607133388115,538,"You see, I'm the Incredible Shrinking Man. By the time I hit your stomach I'll be less than a biteful!"
1783,3,9,95,107,1.1401869158878504,0.04081820150522514,538,"Calm down, it's a sewing needle not a hypodermic needle."
1783,3,9,95,107,1.1401869158878504,0.04081820150522514,538,You're no problem but the spider is up next and I'll even be smaller.
1783,1,13,93,107,1.1401869158878504,0.036241607133388115,538,"In a few minutes, I'll be a footman, but first I have a ball dress to sew."
1783,3,9,95,107,1.1401869158878504,0.04081820150522514,538,"Now, now, don't be a pussy..."
1783,3,9,95,107,1.1401869158878504,0.04081820150522514,538,I just fed you ten minutes ago
1783,1,13,93,107,1.1401869158878504,0.036241607133388115,538,The point of this training was ... obedience .
1783,3,9,95,107,1.1401869158878504,0.04081820150522514,538,"Now that I've been mysteriously shrunk, I find taxidermy much more thrilling."
1783,2,11,94,107,1.1401869158878504,0.038597795673665176,538,I bet this was on the terms and conditions on your adoption form wasn't it?
1783,5,5,97,107,1.1401869158878504,0.04493102559069267,538,There's got to be an easier way to thread a needle.
1783,2,11,94,107,1.1401869158878504,0.038597795673665176,538,"If you don't eat me, then I promise not to sew another sweater for you."
1783,3,9,95,107,1.1401869158878504,0.04081820150522514,538,"Trust me, it's not gonna be as much fun if the cartoonist draws me larger."
1783,3,9,95,107,1.1401869158878504,0.04081820150522514,538,See? I was telling the truth when I said I had a weapon of mass destruction.
1783,3,9,95,107,1.1401869158878504,0.04081820150522514,538,I should have gone into microsurgery.
1783,1,13,93,107,1.1401869158878504,0.036241607133388115,538,I am just saying it COULD be just as hard to find a needle in the kitty litter as in a haystack!
1783,3,9,95,107,1.1401869158878504,0.04081820150522514,538,"What a prick, eh!"
1783,2,11,94,107,1.1401869158878504,0.038597795673665176,538,Cat gut your tongue?
1783,4,7,96,107,1.1401869158878504,0.042923901469651166,538,Are you sure you're a vet?
1783,2,11,94,107,1.1401869158878504,0.038597795673665176,538,"Yet another discarded sketch by Michaelangelo before he settled on the final version of the ""Creation of Adam."""
1783,2,11,94,107,1.1401869158878504,0.038597795673665176,538,And in this dramatic photo we witness Tom Thumbs struggle with fluffy his cat.
1783,4,7,96,107,1.1401869158878504,0.042923901469651166,538,There is nothing more satisfying than taming a pussy.
1783,3,9,95,107,1.1401869158878504,0.04081820150522514,538,Your coat will look brand new when I finish. Now put down that paw and stop acting like a pussy !
1783,1,13,93,107,1.1401869158878504,0.036241607133388115,538,"If I had nine lives, I'd take that stitch-in-time thing pretty seriously."
1783,2,11,94,107,1.1401869158878504,0.038597795673665176,538,Can't we talk about this?
1783,2,11,94,107,1.1401869158878504,0.038597795673665176,538,This is why other cats wear tennis shoes.
1783,3,9,95,107,1.1401869158878504,0.04081820150522514,538,I still have a bigger brain than yours.
1783,2,11,94,107,1.1401869158878504,0.038597795673665176,538,"Remember that old saying, ""A stitch in time and you are a dead cat."""
1783,3,9,95,107,1.1401869158878504,0.04081820150522514,538,"OK, I'll stop singing, ""Sew, a needle pulling thread,"" if you stop spewing out those oversized fur balls."
1783,2,11,94,107,1.1401869158878504,0.038597795673665176,538,"Patience Mittens, I'm making your ball of yarn right now! Now go find that really big mouse in the meantime."
1783,4,7,96,107,1.1401869158878504,0.042923901469651166,538,"Precious, I know you think I'm a little prick."
1783,1,13,93,107,1.1401869158878504,0.036241607133388115,538,"But you were my favorite character on the ""Sopranos."""
1783,2,11,94,107,1.1401869158878504,0.038597795673665176,538,You should be aware that my therapist has yet to cure my 'disproportionate' reaction to stress.
1783,3,9,95,107,1.1401869158878504,0.04081820150522514,538,"What's the matter, a cat got your tongue?"
1783,2,11,94,107,1.1401869158878504,0.038597795673665176,538,"Relax, will you? A 30-foot-tall ball of yarn isn't going to knit itself."
1783,0,15,92,107,1.1401869158878504,0.033721185393691164,538,"Oh, so NOW you complain I don't play fair!"
1783,2,11,94,107,1.1401869158878504,0.038597795673665176,538,"Laugh again, little man, at ""the stupid kitty who goes crazy chasing the fake mouse."""
1783,2,11,94,107,1.1401869158878504,0.038597795673665176,538,I don't suppose you've ever stopped to wonder how we got into this ridiculous situation in the first place?
1783,2,11,94,107,1.1401869158878504,0.038597795673665176,538,"You're no Alice? Well, I'm no Cheshire cat."
1783,2,11,94,107,1.1401869158878504,0.038597795673665176,538,"No, no! Cats are supposed to LOVE playing with strings!!"
1783,1,13,93,107,1.1401869158878504,0.036241607133388115,538,"Pansy, this is the last time you are going to scratch that couch!"
1783,3,9,95,107,1.1401869158878504,0.04081820150522514,538,If you keep acting up I will not sew your tail on.
1835,2,11,95,108,1.1388888888888888,0.03826076324884863,538,"I know it's hard to believe but Androcles is my real name, now sit still please."
1835,1,13,94,108,1.1388888888888888,0.035927924207449495,538,Don't even think about it!
1835,2,11,95,108,1.1388888888888888,0.03826076324884863,538,"Get back Butch! I may be shrinking, but I am incredible."
1838,2,10,93,105,1.1333333333333333,0.03843711067980366,538,A stitch in time saves nine lives? No?
1838,2,10,93,105,1.1333333333333333,0.03843711067980366,538,I thought we had an agreement: I thread the needle and you knit yourself a new owner.
1838,4,6,95,105,1.1333333333333333,0.04293846578199835,538,"You are in big trouble, human, if you screw with my spool."
1838,2,10,93,105,1.1333333333333333,0.03843711067980366,538,Have you seen anyone around my size?
1838,3,8,94,105,1.1333333333333333,0.040749989700141764,538,"You play on the life size Noah's Ark in Kentucky, you're gonna get a splinter. Now deal with it!"
1838,3,8,94,105,1.1333333333333333,0.040749989700141764,538,"Splinter? You're on your own, big boy."
1838,4,6,95,105,1.1333333333333333,0.04293846578199835,538,"This is what I call a ""heightened situation""!"
1838,1,12,92,105,1.1333333333333333,0.03597584320431272,538,Maybe a little breath freshener would bring you more friends.
1838,2,10,93,105,1.1333333333333333,0.03843711067980366,538,Spare me.
1838,1,12,92,105,1.1333333333333333,0.03597584320431272,538,"I just have this feeling that if I help you get this splinter out, I'll be glad later on."
1838,2,10,93,105,1.1333333333333333,0.03843711067980366,538,Now Now Now... Be nice... After all I'm the human who feeds you & changes your litter box...
1838,1,12,92,105,1.1333333333333333,0.03597584320431272,538,It's three small sutures ... such a pussy.
1838,2,10,93,105,1.1333333333333333,0.03843711067980366,538,Nine lives minus two eyes--I like my chances.
1838,2,10,93,105,1.1333333333333333,0.03843711067980366,538,"Darn it, stop arguing about the election-- no one has sewed it up yet."
1838,1,12,92,105,1.1333333333333333,0.03597584320431272,538,You can't eat me. I'm a special effect.
1838,1,12,92,105,1.1333333333333333,0.03597584320431272,538,I can get that thorn out of your paw.
1838,2,10,93,105,1.1333333333333333,0.03843711067980366,538,"C'mon, Pandora, get back in your box."
1838,0,14,91,105,1.1333333333333333,0.033333333333333326,538,Moments like this are a test whether I need a gun license or not.
1838,2,10,93,105,1.1333333333333333,0.03843711067980366,538,"Yes, Republicans for Clinton, you may feel a slight sting."
1838,2,10,93,105,1.1333333333333333,0.03843711067980366,538,The Tailor of Pawnama
1838,1,12,92,105,1.1333333333333333,0.03597584320431272,538,The hardest part is over; I already threaded the needle. Now all I have to do is sew the mittens and put them on her paws.
1838,1,12,92,105,1.1333333333333333,0.03597584320431272,538,You have the advantage here!
1838,2,10,93,105,1.1333333333333333,0.03843711067980366,538,"Listen... I know I'm small, but I can still take a few of those nine lives before all is said and done."
1838,3,8,94,105,1.1333333333333333,0.040749989700141764,538,I was simply going to sew a button on my shirt but you make everything about you. Reverse this spell immediately!
1838,3,8,94,105,1.1333333333333333,0.040749989700141764,538,You are confusing Tom Thumb with Stuart Little.
1838,2,10,93,105,1.1333333333333333,0.03843711067980366,538,Stop knit-picking.
1838,5,4,96,105,1.1333333333333333,0.04502068443351374,538,I need to be thimble.
1838,2,10,93,105,1.1333333333333333,0.03843711067980366,538,"fine, I. willing to accept that the diy home spaying project is off the table"
1838,3,8,94,105,1.1333333333333333,0.040749989700141764,538,I've had it with your attitude - it's time you took my point seriously!
1838,1,12,92,105,1.1333333333333333,0.03597584320431272,538,Snitches get stitches.
1838,4,6,95,105,1.1333333333333333,0.04293846578199835,538,I told you I wanted cuffs on the rear paws only
1838,5,4,96,105,1.1333333333333333,0.04502068443351374,538,Enough of String Theory! I need to bring you down to earthy dimensions.
1838,1,12,92,105,1.1333333333333333,0.03597584320431272,538,I'm going in to rescue the other skeins.
1838,2,10,93,105,1.1333333333333333,0.03843711067980366,538,"Hold still, I'm doing my best to get that thorn out."
1838,1,12,92,105,1.1333333333333333,0.03597584320431272,538,I was thinking it would be more Sprinkles and less Goliath
1838,3,8,94,105,1.1333333333333333,0.040749989700141764,538,"You're the one who crossed your heart, and hoped to die..."
1838,2,10,93,105,1.1333333333333333,0.03843711067980366,538,"OK, ok, I will get you back in the cradle with your silver spoon."
1838,1,12,92,105,1.1333333333333333,0.03597584320431272,538,I needle little help here!
1838,1,12,92,105,1.1333333333333333,0.03597584320431272,538,No. It just doesn't make sense for you to play the Gulliver part.
1838,2,10,93,105,1.1333333333333333,0.03843711067980366,538,"Now listen here, you've pussy-footed around this for long enough."
1838,1,12,92,105,1.1333333333333333,0.03597584320431272,538,Sometimes you just make me feel so little.
1838,1,12,92,105,1.1333333333333333,0.03597584320431272,538,Back off - you know how you hate injections.
1838,2,10,93,105,1.1333333333333333,0.03843711067980366,538,"... and Jonah says, ""Hey, the script says leviathan, not grimalkin."""
1838,2,10,93,105,1.1333333333333333,0.03843711067980366,538,Have you seen my little chair?
1838,3,8,94,105,1.1333333333333333,0.040749989700141764,538,Put down the needle! You're not a licensed acupuncturist!
1838,2,10,93,105,1.1333333333333333,0.03843711067980366,538,I settled for thread. Yarn was too expensive.
1838,0,14,91,105,1.1333333333333333,0.033333333333333326,538,"Less eye of the tiger, more eye of the needle, please."
1838,2,10,93,105,1.1333333333333333,0.03843711067980366,538,"Listen, Bub-find my catnip mouse PRONTO or you're gonna wish that needle was a wand!"
1838,3,8,94,105,1.1333333333333333,0.040749989700141764,538,Our fortunes seem to have reversed since I drop-kicked you that time...
1838,2,10,93,105,1.1333333333333333,0.03843711067980366,538,"Hy, chill! I was just needling ya'."
1838,2,10,93,105,1.1333333333333333,0.03843711067980366,538,I'm just trying to save your lives.
1838,2,10,93,105,1.1333333333333333,0.03843711067980366,538,"I was joking when I said I could fix that threadbare coat of yours, OK?"
1838,3,8,94,105,1.1333333333333333,0.040749989700141764,538,"Mr. Cat, the media insists you're missing the point. Your thoughts?"
1838,2,10,93,105,1.1333333333333333,0.03843711067980366,538,"Don't worry, kitty, it's not a catgut suture."
1838,2,10,93,105,1.1333333333333333,0.03843711067980366,538,I should have been nice to Bella while I was alive!
1838,1,12,92,105,1.1333333333333333,0.03597584320431272,538,This should keep you in stitches!
1838,2,10,93,105,1.1333333333333333,0.03843711067980366,538,It's my right claw. I think one of the pads is falling off.
1838,2,10,93,105,1.1333333333333333,0.03843711067980366,538,I suddenly feel short sighted.
1838,1,12,92,105,1.1333333333333333,0.03597584320431272,538,Being a taxidermist is not all it's sewn up to be....
1838,3,8,94,105,1.1333333333333333,0.040749989700141764,538,"You're not a camel, so don't even think about it."
1838,1,12,92,105,1.1333333333333333,0.03597584320431272,538,You'll be happier once I close the wound.
1838,2,10,93,105,1.1333333333333333,0.03843711067980366,538,"You understand, I have no medical degree."
1838,5,4,96,105,1.1333333333333333,0.04502068443351374,538,I can haz smalls mann
1838,2,10,93,105,1.1333333333333333,0.03843711067980366,538,I'll only drop it for a treat!
1838,2,10,93,105,1.1333333333333333,0.03843711067980366,538,"Yarn, dammit! I said yarn!"
1838,0,14,91,105,1.1333333333333333,0.033333333333333326,538,"I know we've been on pins and needles lately, but let's work this out."
1838,3,8,94,105,1.1333333333333333,0.040749989700141764,538,"Really, pin the needle? Do I look like a donkey to you?"
1838,2,10,93,105,1.1333333333333333,0.03843711067980366,538,Don't forget I am still the one paying for your food.
1838,2,10,93,105,1.1333333333333333,0.03843711067980366,538,Again. Where's the goose?
1838,2,10,93,105,1.1333333333333333,0.03843711067980366,538,"Whose claws aren't so big now, huh?"
1838,2,10,93,105,1.1333333333333333,0.03843711067980366,538,How about we try mending fences?
1838,2,10,93,105,1.1333333333333333,0.03843711067980366,538,maybe I can remove that piece of broccoli in your teeth with this.
1838,2,10,93,105,1.1333333333333333,0.03843711067980366,538,Keep these toes extended when you swipe!
1838,2,10,93,105,1.1333333333333333,0.03843711067980366,538,"I regret everything. Please, I'll let you inside and outside as much as you want."
1838,2,10,93,105,1.1333333333333333,0.03843711067980366,538,"I said OK, I'll recite ""Hey deedle deedle, the cat and the needle"" again!"
1838,1,12,92,105,1.1333333333333333,0.03597584320431272,538,But you love a good nip.
1838,0,14,91,105,1.1333333333333333,0.033333333333333326,538,"With his life hanging by a thread, he said: - Hey, let's paws and avoid this needless violence."
1838,3,8,94,105,1.1333333333333333,0.040749989700141764,538,"You may be a tom cat, but I'm Tom Thumb!"
1838,2,10,93,105,1.1333333333333333,0.03843711067980366,538,I'm your new costume designer for your off Broadway production.
1838,3,8,94,105,1.1333333333333333,0.040749989700141764,538,"A stitch in time saves 9, now you have 18 or is it still 9?"
1838,2,10,93,105,1.1333333333333333,0.03843711067980366,538,You're not what I wished for. Did the genie string you along too?
1838,5,4,96,105,1.1333333333333333,0.04502068443351374,538,Alteration Kit
1838,2,10,93,105,1.1333333333333333,0.03843711067980366,538,This has been quite the taxidermic undertaking. Perhaps a mouse would've made more sense.
1838,0,14,91,105,1.1333333333333333,0.033333333333333326,538,"Oh, that's so cute...so #%&*ing cute."
1838,2,10,93,105,1.1333333333333333,0.03843711067980366,538,"...The flea circus can't even get us a chair, or uniform, or a proper pedestal, let alone a gilded cage -- but fine, I promise I'll ask again about the diamond-studded collar."
1838,2,10,93,105,1.1333333333333333,0.03843711067980366,538,"Easy, easy kitty, a stitch in time gives you 9"
1838,1,12,92,105,1.1333333333333333,0.03597584320431272,538,But a stitch in time saves nine.
1838,3,8,94,105,1.1333333333333333,0.040749989700141764,538,Haven't you ever read 'Androcles and the Lion'?
1838,2,10,93,105,1.1333333333333333,0.03843711067980366,538,"When I was big and you were small, I had a better sense of perspective about it."
1838,2,10,93,105,1.1333333333333333,0.03843711067980366,538,"No, I'm sewing them back ON, now."
1838,4,6,95,105,1.1333333333333333,0.04293846578199835,538,"From hell's heart, I stab at thee..."
1838,2,10,93,105,1.1333333333333333,0.03843711067980366,538,"I'm a man, not a mouse, so don't needle me."
1838,1,12,92,105,1.1333333333333333,0.03597584320431272,538,Nice pussy.
1838,1,12,92,105,1.1333333333333333,0.03597584320431272,538,"Now, now. We agreed today was my day for the thread."
1838,2,10,93,105,1.1333333333333333,0.03843711067980366,538,I'm looking for a really big sweater.
1838,1,12,92,105,1.1333333333333333,0.03597584320431272,538,A stitch in time will save your nine lives
1838,3,8,94,105,1.1333333333333333,0.040749989700141764,538,""" Damn , I mean darn you cat "" ."
1838,2,10,93,105,1.1333333333333333,0.03843711067980366,538,You. Shall Not. Pass....Mr. Timmy
1838,2,10,93,105,1.1333333333333333,0.03843711067980366,538,Neutered? Me? Ow!
1838,2,10,93,105,1.1333333333333333,0.03843711067980366,538,Calm down. You know what they say a stitch in time saves 9 lives.
1838,1,12,92,105,1.1333333333333333,0.03597584320431272,538,"Relax, Buddy. It's just a short trip to the vet."
1838,3,8,94,105,1.1333333333333333,0.040749989700141764,538,"Ok, ok... no more ""mittens for kittens"" references. Now will you hold still?"
1838,0,14,91,105,1.1333333333333333,0.033333333333333326,538,Did you say 'meow' or 'stop needling me'?
1838,2,10,93,105,1.1333333333333333,0.03843711067980366,538,So taxidermy is out of the question.
1838,3,8,94,105,1.1333333333333333,0.040749989700141764,538,"Don't needle me, little man, or I'll put the thimble over your puny body."
1838,1,12,92,105,1.1333333333333333,0.03597584320431272,538,Whose Master's Voice?
1838,2,10,93,105,1.1333333333333333,0.03843711067980366,538,Sew?
1838,5,4,96,105,1.1333333333333333,0.04502068443351374,538,"This caption won't ever get seen so, FART FART FART FART!"
1838,1,12,92,105,1.1333333333333333,0.03597584320431272,538,Why do you always take what I say so litter-ally?
1838,3,8,94,105,1.1333333333333333,0.040749989700141764,538,"Hold still, Kitty. It's the only way I can get the splinter out."
1838,0,14,91,105,1.1333333333333333,0.033333333333333326,538,My friends call me 'Little Androcles.'
1838,3,8,94,105,1.1333333333333333,0.040749989700141764,538,Oh Oh. It worked in Aesop's Fable with the Lion.
1838,3,8,94,105,1.1333333333333333,0.040749989700141764,538,Maybe he said to only take 3 pills and not 13
1838,3,8,94,105,1.1333333333333333,0.040749989700141764,538,"Yikes! I just said, 'Down, boy,' didn't I?"
1838,1,12,92,105,1.1333333333333333,0.03597584320431272,538,Don't needle me man!
1838,3,8,94,105,1.1333333333333333,0.040749989700141764,538,"Calm down, it's just a needle and thread."
1838,0,14,91,105,1.1333333333333333,0.033333333333333326,538,Not so eager to begin taxidermy?
1838,2,10,93,105,1.1333333333333333,0.03843711067980366,538,I am stuffed!
1838,3,8,94,105,1.1333333333333333,0.040749989700141764,538,"I'm Thumbelina's furrier, and we were wondering if you wouldn't mind...."
1838,2,10,93,105,1.1333333333333333,0.03843711067980366,538,They laughed when the Thumbs supported open carry.
1838,1,12,92,105,1.1333333333333333,0.03597584320431272,538,"""Put that down."" It's Mrs. Bunyan's."
1838,0,14,91,105,1.1333333333333333,0.033333333333333326,538,"Yeah, well I'm still a lot smarter than you."
1838,0,14,91,105,1.1333333333333333,0.033333333333333326,538,It worked for sleeping beauty didn't it?
1838,1,12,92,105,1.1333333333333333,0.03597584320431272,538,Wait! How could you forget you and I watched 'Ant Man' together?
1838,0,14,91,105,1.1333333333333333,0.033333333333333326,538,"Easy, Junior. We're both going to have to try to adapt."
1963,2,10,94,106,1.1320754716981132,0.03809354282620335,538,"Sewwww, Project Catwalk is not what I expected."
1964,2,10,95,107,1.1308411214953271,0.03775603163000453,538,You've made a few good points there.
1965,2,9,92,103,1.1262135922330097,0.03823542562589994,538,Don't needle the cat Frank; he'll take you in a single swipe!
1965,2,9,92,103,1.1262135922330097,0.03823542562589994,538,I think we are at an impasse.
1965,1,11,91,103,1.1262135922330097,0.03565922550608978,538,I think they're outsourcing CAT scans again.
1965,2,9,92,103,1.1262135922330097,0.03823542562589994,538,Really dude!
1965,1,11,91,103,1.1262135922330097,0.03565922550608978,538,I'm in a good position to need stitches anyways.
1965,3,7,93,103,1.1262135922330097,0.04064867995265391,538,I should never have fed you Trump's new ego-boosting cat formula!
1965,3,7,93,103,1.1262135922330097,0.04064867995265391,538,I hope I have nine lives.
1965,4,5,94,103,1.1262135922330097,0.04292647890280368,538,But I can't reach the toilet. I promise I'll change the litter next time.
1965,0,13,90,103,1.1262135922330097,0.03288180278808632,538,"If you were a dog, we'd still be cool with each other."
1965,2,9,92,103,1.1262135922330097,0.03823542562589994,538,I always suspected you were a domestic........terrorist
1965,2,9,92,103,1.1262135922330097,0.03823542562589994,538,"So, you REALLY want to NEEDLE ME!!"
1965,2,9,92,103,1.1262135922330097,0.03823542562589994,538,"I was going to knit you a scarf, I swear!"
1965,2,9,92,103,1.1262135922330097,0.03823542562589994,538,"I'll need a 30 mm inseam on those pants, and don't forget the cuffs."
1965,3,7,93,103,1.1262135922330097,0.04064867995265391,538,Here Spot! Here Boy!
1965,4,5,94,103,1.1262135922330097,0.04292647890280368,538,Calm down Donald. All that I am trying to do is to sew your taxes together with the stuff in your litter box.
1965,2,9,92,103,1.1262135922330097,0.03823542562589994,538,"I know, I know, but we're talking ANOTHER nine."
1965,1,11,91,103,1.1262135922330097,0.03565922550608978,538,"Bring it on, Catnip. I think your bark is worse than your bite...."
1965,1,11,91,103,1.1262135922330097,0.03565922550608978,538,It's just so hard to teach an old cat new tricks.
1965,4,5,94,103,1.1262135922330097,0.04292647890280368,538,And I have eight more that are just as lethal!
1965,5,3,95,103,1.1262135922330097,0.04508935572940039,538,"Finding himself hanging by a thread Brad yells, ""Help meow-t!!"""
1965,2,9,92,103,1.1262135922330097,0.03823542562589994,538,I must have cataracts.
1965,0,13,90,103,1.1262135922330097,0.03288180278808632,538,Was it 'a stitch in time saves nine?' or 'a cat has nine lives?' Either way - oh hell.
1965,3,7,93,103,1.1262135922330097,0.04064867995265391,538,I asked my liberal friend to politicize this. Even he struggled...
1965,3,7,93,103,1.1262135922330097,0.04064867995265391,538,Say cheese yourself
1965,2,9,92,103,1.1262135922330097,0.03823542562589994,538,"Well a stitch in time saves nine, so bring it big guy."
1965,2,9,92,103,1.1262135922330097,0.03823542562589994,538,What if I said it was for Itzhak Perlman's violin?
1965,1,11,91,103,1.1262135922330097,0.03565922550608978,538,When I became the incredible shrinking man this was not how I intended to feed you
1965,3,7,93,103,1.1262135922330097,0.04064867995265391,538,We illiputians love cats
1965,4,5,94,103,1.1262135922330097,0.04292647890280368,538,I understand your point purrfectly.
1965,1,11,91,103,1.1262135922330097,0.03565922550608978,538,"In Soviet Russia you don't own the cat, the cat owns you."
1965,1,11,91,103,1.1262135922330097,0.03565922550608978,538,I wish I had my laser guided needle.
1965,3,7,93,103,1.1262135922330097,0.04064867995265391,538,"Ever see the movie Honey, I Shrunk the Kids…well this one goes: Honey, this is the last time you forget our anniversary."
1965,1,11,91,103,1.1262135922330097,0.03565922550608978,538,Let's see how You like being neutered
1965,2,9,92,103,1.1262135922330097,0.03823542562589994,538,Okay! All right! We'll get a divorce!
1965,2,9,92,103,1.1262135922330097,0.03823542562589994,538,"That's right, it's gonna be you-ow when I'm back to size!"
1965,2,9,92,103,1.1262135922330097,0.03823542562589994,538,I don't work with yarn.
1965,5,3,95,103,1.1262135922330097,0.04508935572940039,538,I said Borrower not borrow fur.
1965,2,9,92,103,1.1262135922330097,0.03823542562589994,538,"And when you awake, you’ll be nice and calm."
1965,3,7,93,103,1.1262135922330097,0.04064867995265391,538,I'm a pussy when it comes to needles.
1965,3,7,93,103,1.1262135922330097,0.04064867995265391,538,"Come on, just swat it. It's not sharp; trust me."
1965,3,7,93,103,1.1262135922330097,0.04064867995265391,538,"Oh, so you don't like it either."
1965,1,11,91,103,1.1262135922330097,0.03565922550608978,538,Go chase a mouse and leave me alone... scat!
1965,2,9,92,103,1.1262135922330097,0.03823542562589994,538,I am sure you said mittens.
1965,3,7,93,103,1.1262135922330097,0.04064867995265391,538,I still don't understand Twitter.
1965,4,5,94,103,1.1262135922330097,0.04292647890280368,538,It's your cuticles.
1965,0,13,90,103,1.1262135922330097,0.03288180278808632,538,These Pinterest projects are getting to be unbelievable.
1965,0,13,90,103,1.1262135922330097,0.03288180278808632,538,Okay. I will sew you a mouse before I hem these pants.
1965,1,11,91,103,1.1262135922330097,0.03565922550608978,538,"I shrunk the KIDS, not the kittens, I swear!"
1965,2,9,92,103,1.1262135922330097,0.03823542562589994,538,"Down, Tabby! I said I didn't like FAT cats."
1965,2,9,92,103,1.1262135922330097,0.03823542562589994,538,"No, no, I said I have to put a few extra stitches in my big hat."
1965,2,9,92,103,1.1262135922330097,0.03823542562589994,538,"Given that I've got gout, thrush, hemorrhoids, and a nasty, itchy rash, would you like to rethink this?"
1965,2,9,92,103,1.1262135922330097,0.03823542562589994,538,I've got to finish my sewing. You go and play.
1965,1,11,91,103,1.1262135922330097,0.03565922550608978,538,We'll see which one of us needs stitches!
1965,2,9,92,103,1.1262135922330097,0.03823542562589994,538,"Scardy Cat, Scardy Cat!"
1965,4,5,94,103,1.1262135922330097,0.04292647890280368,538,Now take your silver spoon and go back to your cradle!
1965,3,7,93,103,1.1262135922330097,0.04064867995265391,538,My old man shrank me but I'm gonna show you who's boss around here.
1965,3,7,93,103,1.1262135922330097,0.04064867995265391,538,I should never have adopted you.
1965,1,11,91,103,1.1262135922330097,0.03565922550608978,538,"Okay, I won't hurt you, but first, promise me you will stop trying to eat me."
1965,1,11,91,103,1.1262135922330097,0.03565922550608978,538,I'm not sure why I thought my being smaller would make you listen to me.
1965,2,9,92,103,1.1262135922330097,0.03823542562589994,538,My wife's pussy is bigger & badder than you and I've whipped it with my little needle.
1965,1,11,91,103,1.1262135922330097,0.03565922550608978,538,Wait a minute! Who's supposed to be the endangered species?
1965,1,11,91,103,1.1262135922330097,0.03565922550608978,538,Who’s a kitty? Who’s a kitty with a big big scratch-a-belly? Who’s a?
1965,0,13,90,103,1.1262135922330097,0.03288180278808632,538,"Anywhere but here, kitty kitty kitty!"
1965,2,9,92,103,1.1262135922330097,0.03823542562589994,538,Stop needling me
1965,2,9,92,103,1.1262135922330097,0.03823542562589994,538,Ok. You don't have to wear the sweater I knitted.
1965,2,9,92,103,1.1262135922330097,0.03823542562589994,538,"Oh, stop being a big pussy!"
1965,1,11,91,103,1.1262135922330097,0.03565922550608978,538,But I am the only one who can unfix you.
1965,2,9,92,103,1.1262135922330097,0.03823542562589994,538,"Just my luck that when I finally thread the needle, the cat's out of the bag."
1965,0,13,90,103,1.1262135922330097,0.03288180278808632,538,Glad you like the pajamas. High-fives aren't necessary.
1965,1,11,91,103,1.1262135922330097,0.03565922550608978,538,I must point out to you that there's not much meat on my body.
1965,1,11,91,103,1.1262135922330097,0.03565922550608978,538,"Now that's enough Gulliver, you can spin some more yarn in the morning!"
1965,2,9,92,103,1.1262135922330097,0.03823542562589994,538,I should have never gone to that Zoltar magical wishing machine.
1965,1,11,91,103,1.1262135922330097,0.03565922550608978,538,That disquieting moment when an American cat realizes it should've bought a gun.
1965,1,11,91,103,1.1262135922330097,0.03565922550608978,538,Don't bother. There's nothing left to 'mend.'
1965,3,7,93,103,1.1262135922330097,0.04064867995265391,538,"""Can't you see, I am not a mouse. I'm a little guy with a big heart."
1965,1,11,91,103,1.1262135922330097,0.03565922550608978,538,The video made this seem like a good idea when I saw it on the web.
1965,2,9,92,103,1.1262135922330097,0.03823542562589994,538,Feed me.
1965,2,9,92,103,1.1262135922330097,0.03823542562589994,538,I feel belittled and needle little help
1965,0,13,90,103,1.1262135922330097,0.03288180278808632,538,"If you continue to refuse to work with me, I'm going back to full size and tie you down!"
1965,3,7,93,103,1.1262135922330097,0.04064867995265391,538,Size doesn't matter; I've always been the boss!
1965,3,7,93,103,1.1262135922330097,0.04064867995265391,538,"Let's call a truce. After the spell, my heart's not really in taxidermy anymore."
1965,3,7,93,103,1.1262135922330097,0.04064867995265391,538,"Slower, Pussycat! Chill! Chill!"
1965,1,11,91,103,1.1262135922330097,0.03565922550608978,538,"Look, I know you're pissed-off because I cut your balls off, but I have to sew you up, now. It's for the best. You'll thank me, maybe not today, maybe not tomorrow, but... Aw, come on---don't be a pussy."
1965,1,11,91,103,1.1262135922330097,0.03565922550608978,538,Stop needling me. Can't you see I'm sew sensitive
1965,1,11,91,103,1.1262135922330097,0.03565922550608978,538,I knew I couldn't hide in that thimble forever.
1965,3,7,93,103,1.1262135922330097,0.04064867995265391,538,The best I can do right now is a ball of thread.
1965,0,13,90,103,1.1262135922330097,0.03288180278808632,538,"Oh, yeah? That darn cat again?"
1965,1,11,91,103,1.1262135922330097,0.03565922550608978,538,I had this dream that they took away my guns AND my sewing machines.
1965,3,7,93,103,1.1262135922330097,0.04064867995265391,538,"On guard, you big pussycat"
1965,1,11,91,103,1.1262135922330097,0.03565922550608978,538,"Because, I don't feel like sewing a leather cat suit for you!"
1965,3,7,93,103,1.1262135922330097,0.04064867995265391,538,"Be warned pussycat, my wife has got claws."
1965,2,9,92,103,1.1262135922330097,0.03823542562589994,538,Alice said you're supposed to have a big smile.
1965,1,11,91,103,1.1262135922330097,0.03565922550608978,538,Harpoon in post-whaling world
1965,4,5,94,103,1.1262135922330097,0.04292647890280368,538,"When the moons in the sky like a big pizza pie, that's curare."
1965,1,11,91,103,1.1262135922330097,0.03565922550608978,538,"C'mon. Just give me three days to try and reverse this thing. Then it'll be fresh liver and pilchards for life, I promise."
1965,1,11,91,103,1.1262135922330097,0.03565922550608978,538,"Of course size matters. But trust me, sewing will get you at least another million views."
1965,2,9,92,103,1.1262135922330097,0.03823542562589994,538,Call me Ishmael.
1965,2,9,92,103,1.1262135922330097,0.03823542562589994,538,I think I went a size too small.
1965,3,7,93,103,1.1262135922330097,0.04064867995265391,538,Ok I'm sorry! We will definitely go to the other vet even though he doesn't take our insurance.
1965,3,7,93,103,1.1262135922330097,0.04064867995265391,538,"Bad time to ask, I know, but could you check to make sure the DVR is still recording Game of Thrones?"
1965,1,11,91,103,1.1262135922330097,0.03565922550608978,538,There kitty kitty kitty.
1965,1,11,91,103,1.1262135922330097,0.03565922550608978,538,"Come'on, just a yard. It will grow back."
1965,1,11,91,103,1.1262135922330097,0.03565922550608978,538,All of my vet school debt was for nothing!
1965,2,9,92,103,1.1262135922330097,0.03823542562589994,538,"If you leap, I will sew!"
1965,2,9,92,103,1.1262135922330097,0.03823542562589994,538,"So ""Gulliver's Cats"" doesn't quite get a green light?"
1965,2,9,92,103,1.1262135922330097,0.03823542562589994,538,See? How does it feel to have our roles reversed?
1965,2,9,92,103,1.1262135922330097,0.03823542562589994,538,You called about a tooth taht needs to be pulled?
1965,1,11,91,103,1.1262135922330097,0.03565922550608978,538,"That's it, I'm laying off the spicy fish tacos."
1965,3,7,93,103,1.1262135922330097,0.04064867995265391,538,"Your kidding, Right?"
1965,3,7,93,103,1.1262135922330097,0.04064867995265391,538,"Smelly cat, smelly cat, what are they feeding you?"
2075,3,7,94,104,1.125,0.040274218751477006,538,"This isn't quite what I meant when I said ""I dream of being a lion tamer""....."
2075,1,11,92,104,1.125,0.03533553029557649,538,"Kitty, before you swipe, let me prey."
2075,4,5,95,104,1.125,0.042529039413416465,538,"Oh no, you've had your nine lives"
2075,2,9,93,104,1.125,0.03788543517838634,538,A stitch in time saves nine lives so don't eat me.
2075,2,9,93,104,1.125,0.03788543517838634,538,"You can huff and you can puff,but I'll stick you with my piny pin pin!"
2075,0,13,91,104,1.125,0.032586702869168815,538,Why does Gulliver's cat need a sweater?
2081,1,10,90,101,1.118811881188119,0.03528421719050586,538,The last great act of defiance.
2081,1,10,90,101,1.118811881188119,0.03528421719050586,538,"Enough with the needling already! We agreed: I do the hunting, you do the hemming."
2081,2,8,91,101,1.118811881188119,0.037986784343071046,538,"Storage Box #1 Bar Code #1 Microfilm #1 Interim Billing? 87-16 ""Tom Thumb's final moments."""
2081,2,8,91,101,1.118811881188119,0.037986784343071046,538,"Sorry, Kitty, we are totally out of steroids."
2081,0,12,89,101,1.118811881188119,0.03235670225419444,538,"Darn, I knew I should have taken up knitting!"
2081,4,4,93,101,1.118811881188119,0.04288397589645092,538,Gullipurr's Travels
2081,2,8,91,101,1.118811881188119,0.037986784343071046,538,"Fluffy, I'm going to stop you with my generic Epi Pen."
2081,2,8,91,101,1.118811881188119,0.037986784343071046,538,Put down your weapon and or I will stuff you in the thimble.
2081,2,8,91,101,1.118811881188119,0.037986784343071046,538,"Ever seen ""That Darn Cat?"""
2081,2,8,91,101,1.118811881188119,0.037986784343071046,538,"Just relax, I've never had a problem I couldn't sew myself out of"
2081,2,8,91,101,1.118811881188119,0.037986784343071046,538,Your coat needs a little tailoring.
2081,2,8,91,101,1.118811881188119,0.037986784343071046,538,"Yes, I had you spayed, but handling that medication had side effects -obviously!!"
2081,0,12,89,101,1.118811881188119,0.03235670225419444,538,"I am trying to help, don't be such a fraidy cat!"
2081,1,10,90,101,1.118811881188119,0.03528421719050586,538,"The headline read, ""A Catnap Turned Deadly."""
2081,0,12,89,101,1.118811881188119,0.03235670225419444,538,Don't blame me just because the store was out of kitty litter.
2081,2,8,91,101,1.118811881188119,0.037986784343071046,538,"In my heart I was always Bob, never Tinkerbell"
2081,0,12,89,101,1.118811881188119,0.03235670225419444,538,And this little piggy ran all the way where?
2081,1,10,90,101,1.118811881188119,0.03528421719050586,538,Now you'll know how I feel when you scratch me you big stupid cat!
2081,3,6,92,101,1.118811881188119,0.0405094505851065,538,I dreamed your mother is coming for a visit.
2081,1,10,90,101,1.118811881188119,0.03528421719050586,538,Voodoo Shmoodoo. The only reason I haven't eaten you yet is because you said you could sew me up a Carolina jersey.
2081,3,6,92,101,1.118811881188119,0.0405094505851065,538,"Whoa, whoa, whoa, whoa, whoa. Slow down. I'm going to fucking vote for Hillary, OK? Relax. And don't act like I have some obligation to pretend to be excited about her. 'Cause I'm not. I'm just not. Like, not at all."
2081,4,4,93,101,1.118811881188119,0.04288397589645092,538,Honest. I was just going to devise a fishing pole to catch us some fish.
2081,2,8,91,101,1.118811881188119,0.037986784343071046,538,I clawed a rip in the drapes for a REASON! It was blocking my view of the birds.
2081,1,10,90,101,1.118811881188119,0.03528421719050586,538,"I'll use this, I thread you not."
2081,0,12,89,101,1.118811881188119,0.03235670225419444,538,"No big deal, it's just your manhood."
2081,0,12,89,101,1.118811881188119,0.03235670225419444,538,"Trust me, kitty, I'm no Androcles. I WILL hurt you!"
2081,2,8,91,101,1.118811881188119,0.037986784343071046,538,I thought Lewis Carroll magic died with him!
2081,3,6,92,101,1.118811881188119,0.0405094505851065,538,"Think twice, big mama has just stepped away for a moment and she really likes me."
2081,3,6,92,101,1.118811881188119,0.0405094505851065,538,how does this keep happing?
2081,1,10,90,101,1.118811881188119,0.03528421719050586,538,"They greenlighted ‘Honey, I shrunk the Haberdasher’ but passed on ‘That Darned Cat’."
2081,2,8,91,101,1.118811881188119,0.037986784343071046,538,Ip Sew Cat Sew
2081,3,6,92,101,1.118811881188119,0.0405094505851065,538,So what happened to the camel?
2081,3,6,92,101,1.118811881188119,0.0405094505851065,538,"Sew, can we hit the paws button."
2081,2,8,91,101,1.118811881188119,0.037986784343071046,538,"Far, a long long way to run. I forgot the next line. Give me a hint"
2081,0,12,89,101,1.118811881188119,0.03235670225419444,538,Tell me again. Your degree in surgery from was where?
2081,2,8,91,101,1.118811881188119,0.037986784343071046,538,Be a good boy or I’ll get Siegfried
2081,5,2,94,101,1.118811881188119,0.04513374780214448,538,"So you don't like me calling you , thimble, spooly or snippers. How about Toast?"
2081,0,12,89,101,1.118811881188119,0.03235670225419444,538,Back off or she will make YOU a Halloween costume.
2081,2,8,91,101,1.118811881188119,0.037986784343071046,538,"Sorry, but you have to stay perfectly still if you want your fursuit to fit just right."
2081,2,8,91,101,1.118811881188119,0.037986784343071046,538,Limit the 2nd amendment and our society will go to the dogs.
2081,2,8,91,101,1.118811881188119,0.037986784343071046,538,"Trust me. I may look small, but I can sew up your curiosity."
2081,2,8,91,101,1.118811881188119,0.037986784343071046,538,"Tomorrow, you're Costco's problem!"
2081,1,10,90,101,1.118811881188119,0.03528421719050586,538,"Do not fold, spindle or mutilate, my ass!"
2081,1,10,90,101,1.118811881188119,0.03528421719050586,538,We can do this the hard way or the easy way. Quit peeing in my sandbox!
2081,1,10,90,101,1.118811881188119,0.03528421719050586,538,"Alice... I thought you said ""White R-A-B-B-I-T !!!"
2081,3,6,92,101,1.118811881188119,0.0405094505851065,538,You want me to stitch what?
2081,2,8,91,101,1.118811881188119,0.037986784343071046,538,'Did you ever read Moby Dick?'
2081,3,6,92,101,1.118811881188119,0.0405094505851065,538,"Honey, can you call the Crazy Cat Lady in the Shoe again?!"
2081,3,6,92,101,1.118811881188119,0.0405094505851065,538,Do I look like a mouse?
2081,2,8,91,101,1.118811881188119,0.037986784343071046,538,"""So, you're not buying 'a stitch in time saves one'?"
2081,2,8,91,101,1.118811881188119,0.037986784343071046,538,"So, this is how you really see me, huh?!"
2081,1,10,90,101,1.118811881188119,0.03528421719050586,538,"Believe me, I know how to thread the needle."
2081,2,8,91,101,1.118811881188119,0.037986784343071046,538,Don't be such a ... coward.
2081,3,6,92,101,1.118811881188119,0.0405094505851065,538,"Make it count Tom, this is his last life."
2081,1,10,90,101,1.118811881188119,0.03528421719050586,538,"You've played with a lot of string in your time, haven't you."
2081,1,10,90,101,1.118811881188119,0.03528421719050586,538,A stitch in time saves nine? Next you'll be telling me how the early bird gets the worm.
2081,2,8,91,101,1.118811881188119,0.037986784343071046,538,I can stop the limp!
2081,3,6,92,101,1.118811881188119,0.0405094505851065,538,Life just ain't as thimble as it used to be
2081,1,10,90,101,1.118811881188119,0.03528421719050586,538,Expecto Patronum!
2081,2,8,91,101,1.118811881188119,0.037986784343071046,538,"Nice kitty-very, very, very nice kitty."
2081,0,12,89,101,1.118811881188119,0.03235670225419444,538,"Relax. It was a camel, not a cat, that couldn't go through the eye of a needle."
2081,2,8,91,101,1.118811881188119,0.037986784343071046,538,I called him a pussy but he's really just a prick.
2081,1,10,90,101,1.118811881188119,0.03528421719050586,538,No need to be a fraidy cat.
2081,0,12,89,101,1.118811881188119,0.03235670225419444,538,I told you I'm not buying that fancy cat food
2081,2,8,91,101,1.118811881188119,0.037986784343071046,538,Now hold on. You told me to wish for anything. Do you understand now that size matters?
2081,2,8,91,101,1.118811881188119,0.037986784343071046,538,I'm a protected species. I've reverse evolved.
2081,1,10,90,101,1.118811881188119,0.03528421719050586,538,A domesticated cat would wear a thimble!
2081,3,6,92,101,1.118811881188119,0.0405094505851065,538,I knew I should not have used the thimble for Monopoly
2081,2,8,91,101,1.118811881188119,0.037986784343071046,538,i keep trying to tell you - i'm making the mittens.
2081,2,8,91,101,1.118811881188119,0.037986784343071046,538,"Back off, or your next stitch in time will lose you nine."
2081,1,10,90,101,1.118811881188119,0.03528421719050586,538,How am I supposed to get any mending done when you are staring at me like that.
2081,0,12,89,101,1.118811881188119,0.03235670225419444,538,I promise you it won't hurt!
2081,3,6,92,101,1.118811881188119,0.0405094505851065,538,New York Fashion Week critics were enormously catty this year.
2081,0,12,89,101,1.118811881188119,0.03235670225419444,538,You say that your mitten is not lost but it needs a stitch?
2081,2,8,91,101,1.118811881188119,0.037986784343071046,538,Well THIS is an unflattering metaphor for my penis!
2081,1,10,90,101,1.118811881188119,0.03528421719050586,538,"Watch out, I have frightened-person-holding-a-needle-like reflexes."
2081,1,10,90,101,1.118811881188119,0.03528421719050586,538,"I'm sorry. But I'm not Androcles. And you're not the lion. So if I ever survive this encounter, YOU'LL have ME in stitches!"
2081,2,8,91,101,1.118811881188119,0.037986784343071046,538,"Sewing lesson #1, don!t stick yourself ."
2081,2,8,91,101,1.118811881188119,0.037986784343071046,538,"Hey, you can't blame the mini for the actions of a few."
2081,3,6,92,101,1.118811881188119,0.0405094505851065,538,"So you know, I'm more into the S than the M."
2081,2,8,91,101,1.118811881188119,0.037986784343071046,538,Do re meow fa so la...
2081,1,10,90,101,1.118811881188119,0.03528421719050586,538,It's a stitch in time and you already have nine; I'm asking for just one.
2081,0,12,89,101,1.118811881188119,0.03235670225419444,538,"Hey, I may be the Incredible Shrinking Man, but that doesn't give you the right to go all 'puma' on me!"
2081,2,8,91,101,1.118811881188119,0.037986784343071046,538,Jack be nimble and Jack be quick!!!
2081,1,10,90,101,1.118811881188119,0.03528421719050586,538,The Cat and the Incredible Shrinking Man finally came to an agreement. Two mice per day.
2081,1,10,90,101,1.118811881188119,0.03528421719050586,538,Shouldn't your people talk to my people before this gets out of hand?
2081,2,8,91,101,1.118811881188119,0.037986784343071046,538,"Yes, but Me Ow is just what you asked for, right?"
2081,1,10,90,101,1.118811881188119,0.03528421719050586,538,Sure was a bad day to put catnip in my pants.
2081,3,6,92,101,1.118811881188119,0.0405094505851065,538,Have you seen a ball of yellow yarn?
2081,1,10,90,101,1.118811881188119,0.03528421719050586,538,No more just playing with balls of yarn: It's high time you started doing  a little sewing for me!
2081,1,10,90,101,1.118811881188119,0.03528421719050586,538,"Look, I know this is your favorite game, but it's way too dangerous - you could get hurt..."
2081,1,10,90,101,1.118811881188119,0.03528421719050586,538,Its payback time for eating all my sweaters
2081,2,8,91,101,1.118811881188119,0.037986784343071046,538,A stitch in time may save nine; a needle in the paw compensates my being small
2081,1,10,90,101,1.118811881188119,0.03528421719050586,538,"I know. I saw that movie, too. And the cat doesn't get the incredible shrinking man."
2081,2,8,91,101,1.118811881188119,0.037986784343071046,538,Now try it with the thimble.
2081,0,12,89,101,1.118811881188119,0.03235670225419444,538,"Really, try to have a positive outlook? I can't even turn things around in my dreams."
2081,1,10,90,101,1.118811881188119,0.03528421719050586,538,This is NOT Alice's Wonderland!
2081,3,6,92,101,1.118811881188119,0.0405094505851065,538,I'm sorry you're upset - I asked for your help because T.S. Eliot told me you were the practical kind.
2081,2,8,91,101,1.118811881188119,0.037986784343071046,538,"Feel Steinbeck's point in ""Of Mice and Men."""
2081,2,8,91,101,1.118811881188119,0.037986784343071046,538,"Cat: ""Don't try to needle your way out of this"""
2081,2,8,91,101,1.118811881188119,0.037986784343071046,538,"So, you want a Donald Trump costume for Halloween."
2081,3,6,92,101,1.118811881188119,0.0405094505851065,538,I CAN HEAR MY ANALYST NOW...
2081,2,8,91,101,1.118811881188119,0.037986784343071046,538,Me and the rest of the Lilliputians joined Garment Maker's Union Local 31. You feelin' me?
2081,2,8,91,101,1.118811881188119,0.037986784343071046,538,Go ahead - make my crochet.
2081,0,12,89,101,1.118811881188119,0.03235670225419444,538,"Hey, relax kitty. This stitch in time will save you nine later!"
2081,2,8,91,101,1.118811881188119,0.037986784343071046,538,Sorry. I've always been a doggie fan.
2081,1,10,90,101,1.118811881188119,0.03528421719050586,538,Wait! Can I get some catnip before you try this?
2081,1,10,90,101,1.118811881188119,0.03528421719050586,538,I just flossed my Great Dane.
2081,1,10,90,101,1.118811881188119,0.03528421719050586,538,I am NOT going to wear that silly bell around my neck.
2081,1,10,90,101,1.118811881188119,0.03528421719050586,538,I said I'm sorry.
2081,3,6,92,101,1.118811881188119,0.0405094505851065,538,Who's the bad kitty who got into my HGH?
2081,1,10,90,101,1.118811881188119,0.03528421719050586,538,Misinterpretation of the Modern Rags-To-Riches Mentality: Sew The Company's Big Cat
2193,3,6,93,102,1.1176470588235294,0.04012724288607789,538,Needling the kitty gets you a swat!
2193,1,10,91,102,1.1176470588235294,0.03495599376513975,538,"If I sew you a ball of yarn, will you leave me alone?"
2193,2,8,92,102,1.1176470588235294,0.03763055355523473,538,Don't play with food!
2193,1,10,91,102,1.1176470588235294,0.03495599376513975,538,"OK, 60/40 split on the sweaters, but I need that fur NOW."
2193,2,8,92,102,1.1176470588235294,0.03763055355523473,538,Hold still while I weave on your winter coat.
2193,2,8,92,102,1.1176470588235294,0.03763055355523473,538,My name is Catawampus and you are a human from the planet earth.
2193,1,10,91,102,1.1176470588235294,0.03495599376513975,538,It's amazing how playtime with my knitting can turn us both into psychopathic lunatics.
2193,0,12,90,102,1.1176470588235294,0.03205907733144528,538,"How many times must I remind you, your princess kitty halloween costume WILL be done on time!"
2193,2,8,92,102,1.1176470588235294,0.03763055355523473,538,"Okay, I see your point. Can I stop playing with the yarn now?"
2193,2,8,92,102,1.1176470588235294,0.03763055355523473,538,I warn you! I have a great cat lawyer. Raymond Purr!
2203,1,10,92,103,1.116504854368932,0.034633791303501894,538,"I'll have you know that my nickname is ""hairball."""
2204,1,9,90,100,1.11,0.03450955072018602,538,I guess I've spun one yarn too many.
2204,1,9,90,100,1.11,0.03450955072018602,538,"Billy, I'm in no mood to be pussy footing around what's at stake today."
2204,2,7,91,100,1.11,0.037321967966993566,538,All stuffed and sewn up for perpetuity.
2204,2,7,91,100,1.11,0.037321967966993566,538,I'm morally opposed to altering your coat.
2204,2,7,91,100,1.11,0.037321967966993566,538,No way! I haven't recovered from the last time I cleaned the letterbox!
2204,1,9,90,100,1.11,0.03450955072018602,538,We're trying a mash-up of domestic comedy and giant monster movie.
2204,0,11,89,100,1.11,0.03144660377352203,538,"Hey,don't blame me if I'm trying to capitalize on your gigantic fur balls."
2204,2,7,91,100,1.11,0.037321967966993566,538,Enough with the phony purring.
2204,2,7,91,100,1.11,0.037321967966993566,538,"En garde! Only one foil, s'il vous plait."
2204,0,11,89,100,1.11,0.03144660377352203,538,"Honey, your new sculpture is really menacing, to say the least!"
2204,2,7,91,100,1.11,0.037321967966993566,538,Must not make lizard noises...
2204,2,7,91,100,1.11,0.037321967966993566,538,I thought you liked it.
2204,1,9,90,100,1.11,0.03450955072018602,538,Be a good kitten; I'll make you mittens!
2204,1,9,90,100,1.11,0.03450955072018602,538,"You know, I am glad you made me give up knitting."
2204,1,9,90,100,1.11,0.03450955072018602,538,"No more kitty, kitty- get the point!!"
2204,1,9,90,100,1.11,0.03450955072018602,538,We've been over this.
2204,2,7,91,100,1.11,0.037321967966993566,538,IF YOU WERE IN MY SHOES WHAT WOULD YOU DO?
2204,1,9,90,100,1.11,0.03450955072018602,538,"If you'd only use the thimble, you'd stop poking your paw and might even enjoy sewing!"
2204,0,11,89,100,1.11,0.03144660377352203,538,What's wrong with your fur coat?
2204,2,7,91,100,1.11,0.037321967966993566,538,"Believe me, if I don't stitch your cut, you'll have a nasty scar."
2204,1,9,90,100,1.11,0.03450955072018602,538,So many cats. So few recipes.
2204,1,9,90,100,1.11,0.03450955072018602,538,"Honey, it's official: Mr. Tibbs' ninth life is his last."
2204,1,9,90,100,1.11,0.03450955072018602,538,Can I use your litter box?
2204,3,5,92,100,1.11,0.03993681878855019,538,Let me sew up our differences.
2204,3,5,92,100,1.11,0.03993681878855019,538,"I don't care if my language reminds you of your first wife- to me, your mousy."
2204,2,7,91,100,1.11,0.037321967966993566,538,GOTTCHA
2204,1,9,90,100,1.11,0.03450955072018602,538,Think of it as a little harpoon.
2204,2,7,91,100,1.11,0.037321967966993566,538,Who's pussy now?
2204,2,7,91,100,1.11,0.037321967966993566,538,It's either this or you never go outside again.
2204,0,11,89,100,1.11,0.03144660377352203,538,"Sharp, isn't it?"
2204,2,7,91,100,1.11,0.037321967966993566,538,I see the cat doesn't have your tongue.
2204,0,11,89,100,1.11,0.03144660377352203,538,I already tried lion taming.
2204,0,11,89,100,1.11,0.03144660377352203,538,What other cat owner would play Androcles and the Lion with their cat?
2204,1,9,90,100,1.11,0.03450955072018602,538,Look - I don't have my phone - I swear I'm not going to post this.
2204,0,11,89,100,1.11,0.03144660377352203,538,A stitch in time will not save nine this time.
2204,0,11,89,100,1.11,0.03144660377352203,538,"Hey relax, I'm just borrowing it."
2204,2,7,91,100,1.11,0.037321967966993566,538,My common sense seems to have shrunk as well.
2204,0,11,89,100,1.11,0.03144660377352203,538,Stay still or I won't be able to get that sliver out.
2204,1,9,90,100,1.11,0.03450955072018602,538,"Well, how was I supposed to know that you wanted the stole trimmed in ermine?"
2204,3,5,92,100,1.11,0.03993681878855019,538,Rehearsing at the Metropolitan Opera
2204,1,9,90,100,1.11,0.03450955072018602,538,You're Moby Dick and I'm Ahab.
2204,1,9,90,100,1.11,0.03450955072018602,538,"I know you hated the vet, Coco, but please have mercy!"
2204,1,9,90,100,1.11,0.03450955072018602,538,Find your own toy. I'm exercising my right to spear yarns.
2204,0,11,89,100,1.11,0.03144660377352203,538,My name is Androcles-what's yours?
2204,0,11,89,100,1.11,0.03144660377352203,538,That happens every time you sit on the pin cushion.
2204,2,7,91,100,1.11,0.037321967966993566,538,"Laugh it up, Fuzz Ball."
2204,2,7,91,100,1.11,0.037321967966993566,538,I'm not anybody's food...get the point?
2204,2,7,91,100,1.11,0.037321967966993566,538,Don't be such a baby. It's just a little sliver. You shouldn't have been scratching the teak table leg.
2204,1,9,90,100,1.11,0.03450955072018602,538,just tell me where the gold is!
2204,1,9,90,100,1.11,0.03450955072018602,538,Cinderella's dress making mice slapped this needle and thread in my hands and then ran like hell.
2204,3,5,92,100,1.11,0.03993681878855019,538,This moment really could hurt me more than it hurts you.
2204,0,11,89,100,1.11,0.03144660377352203,538,This dream has gone a little to far.
2204,0,11,89,100,1.11,0.03144660377352203,538,I’ll pick your snacks up tomorrow.
2204,1,9,90,100,1.11,0.03450955072018602,538,"If I take the stitches out, will the cat disappear?"
2204,1,9,90,100,1.11,0.03450955072018602,538,You get in the cup if you're so brave!
2204,1,9,90,100,1.11,0.03450955072018602,538,All pussy cats hate a small prick.
2204,2,7,91,100,1.11,0.037321967966993566,538,"Uh Barbie, we've got a problem... the cat wants to play 'dolls!'"
2204,1,9,90,100,1.11,0.03450955072018602,538,"Hey, if you prick me I bleed"
2204,2,7,91,100,1.11,0.037321967966993566,538,Why do you automatically assume I meant your fur?
2204,2,7,91,100,1.11,0.037321967966993566,538,"Great, I found the needle and now THIS."
2204,1,9,90,100,1.11,0.03450955072018602,538,"So we agree. No claws, no teeth, just needles allowed."
2204,1,9,90,100,1.11,0.03450955072018602,538,Don't let the size of my hands fool ya!
2204,3,5,92,100,1.11,0.03993681878855019,538,"""I think you've had too much catnip,Harry Chapin Jr.""."
2204,2,7,91,100,1.11,0.037321967966993566,538,Stop! No! Or that's my last yarning!
2204,1,9,90,100,1.11,0.03450955072018602,538,"Relax, it's Causal Friday."
2204,2,7,91,100,1.11,0.037321967966993566,538,"Now Kitty, remember all those extra treats I gave you?!"
2204,2,7,91,100,1.11,0.037321967966993566,538,"C'mon, Pussy!"
2204,2,7,91,100,1.11,0.037321967966993566,538,"Hold on while I find my glasses, Tiger."
2204,2,7,91,100,1.11,0.037321967966993566,538,How did you do that?
2204,0,11,89,100,1.11,0.03144660377352203,538,But you said you needed a small alteration.
2204,2,7,91,100,1.11,0.037321967966993566,538,I assure you that I has nothing to do with that ridiculous Christmas sweater
2204,1,9,90,100,1.11,0.03450955072018602,538,Don't blame me for what Donald trump called Ted Cruz.
2204,2,7,91,100,1.11,0.037321967966993566,538,"Now, say "" I love dogs""."
2204,1,9,90,100,1.11,0.03450955072018602,538,I shouldn't have to defend my point with you.
2204,2,7,91,100,1.11,0.037321967966993566,538,I'm afraid not - the ball of yarn stays. Might I interest you in something shiny?
2204,0,11,89,100,1.11,0.03144660377352203,538,"If you think of all of this rationally, you'll see it as a no-win situation."
2204,0,11,89,100,1.11,0.03144660377352203,538,"Settle down, I don't think you're getting the point"
2281,1,9,91,101,1.108910891089109,0.034183517825014005,538,Sometimes only catnip will work.
2281,2,7,92,101,1.108910891089109,0.036966642975434595,538,Being your tailor keeps me on pins and needles.
2281,1,9,91,101,1.108910891089109,0.034183517825014005,538,I thought you said you wanted a new sweater?
2281,3,5,93,101,1.108910891089109,0.03955442446621422,538,I'm not here to be a thorn on your side . in just here to get the thorn in your paw
2281,2,7,92,101,1.108910891089109,0.036966642975434595,538,"You'll have to do better than ""I swear."""
2281,0,11,90,101,1.108910891089109,0.031152738064459954,538,Wake up! Its late.
2287,1,9,92,102,1.107843137254902,0.0338635640722447,538,No more fooling around with my ball of yarn!
2287,1,9,92,102,1.107843137254902,0.0338635640722447,538,"I may have used that term. Actually, I'm looking for my damned dog."
2287,1,9,92,102,1.107843137254902,0.0338635640722447,538,"I only need a hem, no cuffs."
2287,0,11,91,102,1.107843137254902,0.030864282122060153,538,I always knew I didn't like you.
2287,2,7,93,102,1.107843137254902,0.03661800148069146,538,"Do you believe in karma, by any chance?"
2287,2,7,93,102,1.107843137254902,0.03661800148069146,538,"Look PAL, I think between the two of us it's YOU who should know what cat tailors DO."
2293,1,9,93,103,1.1067961165048543,0.03354952174237468,538,Your money or your nine lives
2294,1,8,89,98,1.1020408163265305,0.033985541406505795,538,Time to press the pause button.
2294,1,8,89,98,1.1020408163265305,0.033985541406505795,538,"For some people, the cat is easy to see. Others don't see it at all. Some people say the cat is tame. Others say it's vicious and dangerous. Since no one can really be sure who's right, isn't it smart to be as strong as the cat? If there is a cat."""
2294,1,8,89,98,1.1020408163265305,0.033985541406505795,538,"OK, we've got about nine weeks to get ready for Macy's."
2294,0,10,88,98,1.1020408163265305,0.030734729362213595,538,I thought you liked needling?
2294,1,8,89,98,1.1020408163265305,0.033985541406505795,538,Tiny tailor or titan tabby is besde the point; who's the pet here?
2294,1,8,89,98,1.1020408163265305,0.033985541406505795,538,I don't believe a stitch in time saves nine!
2294,1,8,89,98,1.1020408163265305,0.033985541406505795,538,"Frankly, what I said is, 'I need a skein of yarn,' not 'I have a vein to darn.'"
2294,0,10,88,98,1.1020408163265305,0.030734729362213595,538,"Seriously, they say a stitch in time..."
2294,0,10,88,98,1.1020408163265305,0.030734729362213595,538,"OK, I won't try your cat-weed again"
2294,2,6,90,98,1.1020408163265305,0.036951460869878,538,Don't holler. I'm working on your cushion.
2294,2,6,90,98,1.1020408163265305,0.036951460869878,538,Hi I'm little Marco and I'm giving you the needle
2294,0,10,88,98,1.1020408163265305,0.030734729362213595,538,"So not only sows, but apparently you can't make a silk purse out of a cat's ear."
2294,0,10,88,98,1.1020408163265305,0.030734729362213595,538,I thought you always liked the sweaters I sew you
2294,1,8,89,98,1.1020408163265305,0.033985541406505795,538,You're going to hate yourself when you wake up.
2294,3,4,91,98,1.1020408163265305,0.0396963965133226,538,This guy's a real prick.
2294,0,10,88,98,1.1020408163265305,0.030734729362213595,538,"Hey, don't blame me. The CDC says not to pet you."
2294,1,8,89,98,1.1020408163265305,0.033985541406505795,538,Of course you get free shipping on returns.
2294,2,6,90,98,1.1020408163265305,0.036951460869878,538,"Sir, I'm afraid I won't be able to mend your coat if you don't stop moving right meow."
2294,3,4,91,98,1.1020408163265305,0.0396963965133226,538,You can either kill me or forgive me. The choice is yours.
2294,1,8,89,98,1.1020408163265305,0.033985541406505795,538,"I knew this ""Night at the Museum"" movie is a documentary!"
2294,3,4,91,98,1.1020408163265305,0.0396963965133226,538,What?
2294,0,10,88,98,1.1020408163265305,0.030734729362213595,538,"Sure, the thorn is in your right paw."
2294,1,8,89,98,1.1020408163265305,0.033985541406505795,538,catgut indeed!
2294,3,4,91,98,1.1020408163265305,0.0396963965133226,538,"""Grrrrrrrrr! My Yarn! You can't have it! Mine! Mine! Mine! Mine!"
2294,1,8,89,98,1.1020408163265305,0.033985541406505795,538,I just think now you're going to have to start taking a little more responsibility for your own needs.
2294,0,10,88,98,1.1020408163265305,0.030734729362213595,538,Take it easy! I had no choice..They only had thread.
2294,0,10,88,98,1.1020408163265305,0.030734729362213595,538,I thought you’d be pleased. I had these toys tailor-made for you.
2294,2,6,90,98,1.1020408163265305,0.036951460869878,538,"Meow, you need to stop that right meow."
2294,0,10,88,98,1.1020408163265305,0.030734729362213595,538,Can we agree that there's no such thing as a Free Lunch?
2294,1,8,89,98,1.1020408163265305,0.033985541406505795,538,Trust me. It won't hurt.
2294,2,6,90,98,1.1020408163265305,0.036951460869878,538,"You're missing the point, I don't wish to needle you."
2294,2,6,90,98,1.1020408163265305,0.036951460869878,538,Thread your own claws!
2294,1,8,89,98,1.1020408163265305,0.033985541406505795,538,You're blaming me because your pajamas are not so great?
2294,0,10,88,98,1.1020408163265305,0.030734729362213595,538,A stitch in thine keeps you with nine.
2294,0,10,88,98,1.1020408163265305,0.030734729362213595,538,"LISTEN!!! If we just keep talking over each other, I'll never be able to explain why I've been miniaturized next to this sewing kit."
2294,0,10,88,98,1.1020408163265305,0.030734729362213595,538,"I'm only dreaming; I'm only dreaming, and if I just stick something I'll wake up."
2294,0,10,88,98,1.1020408163265305,0.030734729362213595,538,"Princess, I'm not going to allow this."
2294,1,8,89,98,1.1020408163265305,0.033985541406505795,538,"Stop Jerry, think! If I were a rat my tail would thicker."
2294,1,8,89,98,1.1020408163265305,0.033985541406505795,538,"Easy Fancy Feast...hey, is that a spool of yarn behind you?"
2294,2,6,90,98,1.1020408163265305,0.036951460869878,538,I thought the alien was joking when he said it was a shrink-away ray gun. Nice kitty!
2294,2,6,90,98,1.1020408163265305,0.036951460869878,538,Sew...who's man of the house now?
2294,1,8,89,98,1.1020408163265305,0.033985541406505795,538,Get lost. Somebody wished for a ten inch prick.
2294,2,6,90,98,1.1020408163265305,0.036951460869878,538,You can has anything you want!
2294,0,10,88,98,1.1020408163265305,0.030734729362213595,538,Sorry. What I meant was you have an athletic build.
2294,1,8,89,98,1.1020408163265305,0.033985541406505795,538,"OK, you belong to the witch next door, now scat!"
2294,1,8,89,98,1.1020408163265305,0.033985541406505795,538,"Listen, I've told you a 1,000 times...you can keep sewing back together his toys, but that dang dog is hell bent on a life long mission to find The Squeaker."
2294,1,8,89,98,1.1020408163265305,0.033985541406505795,538,I'm only trying to stop you from doing something you'll regret later.
2294,0,10,88,98,1.1020408163265305,0.030734729362213595,538,Chill out. Your tux will be ready tomorrow.
2294,2,6,90,98,1.1020408163265305,0.036951460869878,538,"No, a stich in time DOES NOT save nine!!"
2294,0,10,88,98,1.1020408163265305,0.030734729362213595,538,Honey!? Do you mind? I was playing with the shrink ray again..
2294,0,10,88,98,1.1020408163265305,0.030734729362213595,538,"Okay, I'll give you some more pickled herring."
2294,1,8,89,98,1.1020408163265305,0.033985541406505795,538,No more steroids - no more catnip!
2294,1,8,89,98,1.1020408163265305,0.033985541406505795,538,"Sew long, it's been good to know ya..."
2294,2,6,90,98,1.1020408163265305,0.036951460869878,538,See if my shirt's ready. I'm late for work.
2294,1,8,89,98,1.1020408163265305,0.033985541406505795,538,"You're in the wrong scene, incredible giant kitty. Send in the incredible giant spider so I can slay it, then escape though the window screen into the incredible star-lit night."
2294,0,10,88,98,1.1020408163265305,0.030734729362213595,538,Let’s see if a stitch in time will save nine lives.
2294,2,6,90,98,1.1020408163265305,0.036951460869878,538,"Easy there, Big fella !!"
2294,0,10,88,98,1.1020408163265305,0.030734729362213595,538,You think you're in heaven? Ha ha ha ha ha!
2294,1,8,89,98,1.1020408163265305,0.033985541406505795,538,I'll sew you who's boss around here.
2294,0,10,88,98,1.1020408163265305,0.030734729362213595,538,I know this is gotta be a dream.
2294,1,8,89,98,1.1020408163265305,0.033985541406505795,538,If you don't leave me alone I'm not going to have your alterations done before the Kauffman boy's Bar Mitzvah.
2294,2,6,90,98,1.1020408163265305,0.036951460869878,538,"OK, pussy cat, so I'm just a beginner at needlepoint but I still have to finish your whiskers."
2294,1,8,89,98,1.1020408163265305,0.033985541406505795,538,Didn't you used to be a spider?
2294,1,8,89,98,1.1020408163265305,0.033985541406505795,538,Next time I'm sowing the bag first
2294,1,8,89,98,1.1020408163265305,0.033985541406505795,538,Please let me find somebody who CAN work the can opener.
2294,2,6,90,98,1.1020408163265305,0.036951460869878,538,This is one I just did for the mad props.
2294,1,8,89,98,1.1020408163265305,0.033985541406505795,538,I was just wondering if you were missing a thimble .
2294,2,6,90,98,1.1020408163265305,0.036951460869878,538,"The Thimble is rent free for year, with monthly nail cleaning. What a sweet deal."
2294,0,10,88,98,1.1020408163265305,0.030734729362213595,538,"Take it easy, Felix, it's me!"
2294,1,8,89,98,1.1020408163265305,0.033985541406505795,538,"You know, my wife said ""don't let the cat shrink you, he's just going to try to kill you."". But would I listen to her?"
2294,0,10,88,98,1.1020408163265305,0.030734729362213595,538,I am Androcles and you are the Lion.
2294,1,8,89,98,1.1020408163265305,0.033985541406505795,538,Are you the Cheshire Cat that Alice warned me about?
2294,1,8,89,98,1.1020408163265305,0.033985541406505795,538,It's a thread of deep regret.
2294,0,10,88,98,1.1020408163265305,0.030734729362213595,538,"What is the creature that walks on four legs in the morning, two legs at noon and three in the evening?"
2294,0,10,88,98,1.1020408163265305,0.030734729362213595,538,If you aren't good I'll hide in the thimble.
2294,2,6,90,98,1.1020408163265305,0.036951460869878,538,"honey, she's not playing with the thread like we saw in the Buzzfeed picture"
2294,2,6,90,98,1.1020408163265305,0.036951460869878,538,"So,what was it again?""A stitch in time..saves nine lives""..right?"
2294,1,8,89,98,1.1020408163265305,0.033985541406505795,538,"Okay, in this fable, you're the lion, and I'm the mouse."
2294,1,8,89,98,1.1020408163265305,0.033985541406505795,538,"Stop arguing! If we work quickly, you may be spared her wrath and my fate. And to think all I did was leave the seat up!"
2294,1,8,89,98,1.1020408163265305,0.033985541406505795,538,You knew I wasn't polydactyl when you adopted me.
2294,1,8,89,98,1.1020408163265305,0.033985541406505795,538,"Yes, but I'm your little prick."
2294,2,6,90,98,1.1020408163265305,0.036951460869878,538,"Well, I was hoping you're like balloons and virginity."
2294,0,10,88,98,1.1020408163265305,0.030734729362213595,538,"Don't get huffy now. If you want to be Puss in boots, you'll just have to accept the fact that your boots will be big as buckets."
2294,1,8,89,98,1.1020408163265305,0.033985541406505795,538,Don't get sew close or I will have you in stitches.
2294,2,6,90,98,1.1020408163265305,0.036951460869878,538,Looks like we've discovered one more tendency you forgot to mention in your personal ad.
2294,0,10,88,98,1.1020408163265305,0.030734729362213595,538,Do you want to help me make a large cat quilt?
2294,1,8,89,98,1.1020408163265305,0.033985541406505795,538,On guard pussy cat!
2294,2,6,90,98,1.1020408163265305,0.036951460869878,538,Be patient Jack. Jumping over the candlestick comes next!
2294,0,10,88,98,1.1020408163265305,0.030734729362213595,538,I'll knit you a kitty cat hat. I promise.
2294,1,8,89,98,1.1020408163265305,0.033985541406505795,538,"Poke, poke! LOL Poke, poke, LOL!!"
2294,0,10,88,98,1.1020408163265305,0.030734729362213595,538,One of us will get the point
2294,2,6,90,98,1.1020408163265305,0.036951460869878,538,I told you - I'm voting for Hillary. Let's just agree to disagree.
2294,2,6,90,98,1.1020408163265305,0.036951460869878,538,Appears you're going to have to finish the hem.
2294,2,6,90,98,1.1020408163265305,0.036951460869878,538,No offense Luther-- I was just spooling around.
2294,0,10,88,98,1.1020408163265305,0.030734729362213595,538,Remember the mouse and the lion?
2294,0,10,88,98,1.1020408163265305,0.030734729362213595,538,"Either someone bought a large sewing kit and I developed a thyroid problem or you've shrunk, LITTLE MAN."
2294,1,8,89,98,1.1020408163265305,0.033985541406505795,538,Fooled you again Tom. See? The power of forced perspective!
2294,2,6,90,98,1.1020408163265305,0.036951460869878,538,We talked about this. Shrink ray first. Mouse suit second.
2294,3,4,91,98,1.1020408163265305,0.0396963965133226,538,"Cut me some slack, I'm on the needle."
2294,1,8,89,98,1.1020408163265305,0.033985541406505795,538,"... so, a needle pulling threeeaaad,"
2294,0,10,88,98,1.1020408163265305,0.030734729362213595,538,Just a few stitches but the thorn is gone.
2294,1,8,89,98,1.1020408163265305,0.033985541406505795,538,"Will there be anything else, sir?"
2294,1,8,89,98,1.1020408163265305,0.033985541406505795,538,"Calm down, Mr. Snuggles. Of course u can has cheezburger."
2294,0,10,88,98,1.1020408163265305,0.030734729362213595,538,"If you don’t want to keep losing buttons, Fluffy, you gotta trim those nails."
2294,1,8,89,98,1.1020408163265305,0.033985541406505795,538,This reoccurring nightmare is my teenage angst for a girl named Tabitha and my middle-aged fear of ED
2294,1,8,89,98,1.1020408163265305,0.033985541406505795,538,"If you don,t floss ,then l have to do if for you,calm down."
2294,1,8,89,98,1.1020408163265305,0.033985541406505795,538,"You poke me with that thing, and I'll tie you up in knots, sucker!"
2294,0,10,88,98,1.1020408163265305,0.030734729362213595,538,"Hail Mary full of grace, Our...Oh, screw it: I am prepared to lance you, you giant pussy!"
2294,1,8,89,98,1.1020408163265305,0.033985541406505795,538,"I'm sorry Bruno, but you can't claw your way out of this one."""
2294,1,8,89,98,1.1020408163265305,0.033985541406505795,538,So I forgot to feed you. Let's not make a memorable action sequence out of it.
2294,0,10,88,98,1.1020408163265305,0.030734729362213595,538,My first Taxidermy ... to scale.
2294,1,8,89,98,1.1020408163265305,0.033985541406505795,538,"Let go, Luke."
2294,1,8,89,98,1.1020408163265305,0.033985541406505795,538,CATastrophic!!!
2294,2,6,90,98,1.1020408163265305,0.036951460869878,538,I'm going to need a bigger spool.
2294,2,6,90,98,1.1020408163265305,0.036951460869878,538,HONEY I SHRANK MY SELF
2294,1,8,89,98,1.1020408163265305,0.033985541406505795,538,"""Don't touch me, I'm the guy who feeds you,"" said the educated mouse, skilled in the field of hypnosis."
2294,2,6,90,98,1.1020408163265305,0.036951460869878,538,"You're right, we haven't discussed the steroid diet in a long while."
2294,1,8,89,98,1.1020408163265305,0.033985541406505795,538,The answer is NO!!
2294,0,10,88,98,1.1020408163265305,0.030734729362213595,538,"OK, I will make it in gender-neutral pink."
2294,1,8,89,98,1.1020408163265305,0.033985541406505795,538,These stitches shouldn't hurt a bit
2294,2,6,90,98,1.1020408163265305,0.036951460869878,538,"The last time I had this dream, Circe, I was riding a hamster toward you with a knitting needle."
2294,1,8,89,98,1.1020408163265305,0.033985541406505795,538,I told you that I'd sew your mouth shut if you didn't stop meowing.
2294,2,6,90,98,1.1020408163265305,0.036951460869878,538,You're only making this harder on yourself.
2294,2,6,90,98,1.1020408163265305,0.036951460869878,538,"Now, meow like a dog!"
2294,1,8,89,98,1.1020408163265305,0.033985541406505795,538,Stick me again and I will eat you
2294,1,8,89,98,1.1020408163265305,0.033985541406505795,538,"Honey, I'm done; now you can have giant rabid Mrs. Whiskers forever."
2294,3,4,91,98,1.1020408163265305,0.0396963965133226,538,"Stop needling, don't thread on me!"
2294,2,6,90,98,1.1020408163265305,0.036951460869878,538,"Hold that pose, while I stitch you nose to your paw.... It should scare the bejeezus out of Lois when she returns from the market."
2422,0,10,89,99,1.101010101010101,0.030440148787487714,538,The shrinking man takes a page from Aesop.
2422,0,10,89,99,1.101010101010101,0.030440148787487714,538,"OK, no more circus side-shows."
2424,1,7,88,96,1.09375,0.033371003933186844,538,Beware! Remember I am a good rug maker.
2424,1,7,88,96,1.09375,0.033371003933186844,538,Catmando
2424,2,5,89,96,1.09375,0.03650920636117426,538,EITHER WE LEARN TO GET ALONG OR I DROP YOU IN A RIVER WHEN THE SHRINK RAY WEARS OFF
2424,1,7,88,96,1.09375,0.033371003933186844,538,Cat Sweater Catastrophe
2424,1,7,88,96,1.09375,0.033371003933186844,538,"Sew I feel like you're getting kind of catty, because you're really missing the point of the conversation."
2424,3,3,90,96,1.09375,0.03939822831977147,538,Why thank you! Our therapist thought we needed to create a circle of trust.
2424,1,7,88,96,1.09375,0.033371003933186844,538,You belittle me once too often!
2424,1,7,88,96,1.09375,0.033371003933186844,538,What happened to the last catnip sweater I sewed for you?
2424,1,7,88,96,1.09375,0.033371003933186844,538,"""Sorry if i'm about to needle you""."
2424,1,7,88,96,1.09375,0.033371003933186844,538,Sorry! If it feels worse like this I'll put it back in.
2424,1,7,88,96,1.09375,0.033371003933186844,538,"No, I said I'd do a PAW job with a needle and thread…"
2424,2,5,89,96,1.09375,0.03650920636117426,538,"Down, Fluffy, down!"
2424,0,9,87,96,1.09375,0.02990527809425515,538,“I don’t want to wear a costume for Halloween” said the cat.
2424,2,5,89,96,1.09375,0.03650920636117426,538,"Remember, I want ruffles and wide lapels. It's Seventies week on Dancing with the Siamese Stars."" ""In powder orange or powder blue?"
2424,2,5,89,96,1.09375,0.03650920636117426,538,Alright I wont neuter you. How about a nice declawing?
2424,1,7,88,96,1.09375,0.033371003933186844,538,"No, cat's cradle is not my interest at this time."
2424,1,7,88,96,1.09375,0.033371003933186844,538,"Clearly you don't understand, I am smaller to suggest depth."
2424,0,9,87,96,1.09375,0.02990527809425515,538,"Don't worry, I can handle this."
2424,2,5,89,96,1.09375,0.03650920636117426,538,"Nine lives? No, just stitches."
2424,0,9,87,96,1.09375,0.02990527809425515,538,Get back Future. I am not ready to deal with you let.
2424,2,5,89,96,1.09375,0.03650920636117426,538,I swear it's not a thorn
2424,0,9,87,96,1.09375,0.02990527809425515,538,Wanna show me how this works?
2424,0,9,87,96,1.09375,0.02990527809425515,538,"Stay back, kitty, or I'll needle you into submission!"
2424,2,5,89,96,1.09375,0.03650920636117426,538,This is the last time I swipe right when someone says they love living large.
2424,1,7,88,96,1.09375,0.033371003933186844,538,It was at this moment Steven realized Pumpkin's darning knowledge far exceeded his own.
2424,0,9,87,96,1.09375,0.02990527809425515,538,My shrink warned me you'd be catty.
2424,1,7,88,96,1.09375,0.033371003933186844,538,"Yes, I saw Bride of Frankenstein ... and that's why I'm not making you one."
2424,2,5,89,96,1.09375,0.03650920636117426,538,"Watch it Kitty, I received a B+ in High School Home Ec"
2424,0,9,87,96,1.09375,0.02990527809425515,538,Can this wait until after I've repaired my mouseman costume?
2424,1,7,88,96,1.09375,0.033371003933186844,538,You could go for a nice price on Etsy.
2424,0,9,87,96,1.09375,0.02990527809425515,538,Mom and Dad didn't think this one through.
2424,0,9,87,96,1.09375,0.02990527809425515,538,"Remember kitty what I said? When you make it big, don't cut me short."
2424,0,9,87,96,1.09375,0.02990527809425515,538,"Look, I hear you make great pajamas, but I'm not paying for double stitching."
2424,0,9,87,96,1.09375,0.02990527809425515,538,Let me warn you - I was Saint George in a previous lifetime.
2424,1,7,88,96,1.09375,0.033371003933186844,538,Back off Trump!
2424,2,5,89,96,1.09375,0.03650920636117426,538,This is why I'm voting for Trump.
2424,0,9,87,96,1.09375,0.02990527809425515,538,"I don't care how big you are, if you keep on snarling at me I'm going to stick you."
2424,3,3,90,96,1.09375,0.03939822831977147,538,This is not the cat's meow
2424,1,7,88,96,1.09375,0.033371003933186844,538,"Okay, so it was me who destroyed your dumb ball of yarn. Why not care about what really matters, like planet earth? Hello! Who’s screwing that up for us all?"
2424,1,7,88,96,1.09375,0.033371003933186844,538,Note: Restring with spaghetti.
2424,1,7,88,96,1.09375,0.033371003933186844,538,Sew the cat obviously doesn't like needles.
2424,1,7,88,96,1.09375,0.033371003933186844,538,I'm darning you.
2424,1,7,88,96,1.09375,0.033371003933186844,538,Won't be the first time I've sewn up a huge pussy.
2424,1,7,88,96,1.09375,0.033371003933186844,538,Interesting. I followed the thread of anger and discovered this snarling hairy creature.
2424,0,9,87,96,1.09375,0.02990527809425515,538,Every mistake can come back and haunt you
2424,0,9,87,96,1.09375,0.02990527809425515,538,Make yourself a pair of mittens!
2424,2,5,89,96,1.09375,0.03650920636117426,538,Not your average kitty cat.
2424,1,7,88,96,1.09375,0.033371003933186844,538,This is NOT a nightmare!
2424,0,9,87,96,1.09375,0.02990527809425515,538,"For the last time, how was I to know you'd fall for the old, ""Help yourself to tbe rest of that Almond Roca in the box in the kitchen!"" Now get outta my way, you're not sewing nothin' shut!"
2424,1,7,88,96,1.09375,0.033371003933186844,538,You really are the cat's meow
2424,2,5,89,96,1.09375,0.03650920636117426,538,'WTF is going on in this picture?' - caption contest participants.
2424,0,9,87,96,1.09375,0.02990527809425515,538,If Barneys stocked anything decent in my size we wouldn't even be having this conversation.
2424,2,5,89,96,1.09375,0.03650920636117426,538,He took my request last night too literal.
2424,1,7,88,96,1.09375,0.033371003933186844,538,A penny for your thoughts.
2424,1,7,88,96,1.09375,0.033371003933186844,538,"I don't care what happened in Rome all those years ago, I'm still going to eat you."
2424,2,5,89,96,1.09375,0.03650920636117426,538,Nice try Desperaux; your costume ain't cuttin' it.
2424,1,7,88,96,1.09375,0.033371003933186844,538,"Out, damned Spot! I mean Fluffy!"
2424,1,7,88,96,1.09375,0.033371003933186844,538,"With the exception of hands, you've got everything here that you need to get the sewing done."
2424,0,9,87,96,1.09375,0.02990527809425515,538,"I know you prefer knitting needles and yarn, but will this do?"
2424,1,7,88,96,1.09375,0.033371003933186844,538,ooooooo....you poor thing.....let me take that thorn out of you paw. You'll feel better.
2424,0,9,87,96,1.09375,0.02990527809425515,538,"It's an even match - your lives, my stitch."
2424,1,7,88,96,1.09375,0.033371003933186844,538,"This better not hurt,Mister, or you're a fur ball!"
2424,1,7,88,96,1.09375,0.033371003933186844,538,Giant cats take too much work espectially making huge mittens for their paws.
2424,1,7,88,96,1.09375,0.033371003933186844,538,just a little fix
2424,0,9,87,96,1.09375,0.02990527809425515,538,"I know about the water in Flint. Look at me, But I'm not going all postal over it."
2424,2,5,89,96,1.09375,0.03650920636117426,538,"Dream (nightmare): ""OK, OK, we don't have to go to the Kitty Dress Up party."""
2424,0,9,87,96,1.09375,0.02990527809425515,538,You need me!
2424,0,9,87,96,1.09375,0.02990527809425515,538,Don't tense up. You will just feel a little prick.
2424,0,9,87,96,1.09375,0.02990527809425515,538,"No, you pass a needle point side down."
2424,0,9,87,96,1.09375,0.02990527809425515,538,"Still, the easiest way to thread a needle."
2424,1,7,88,96,1.09375,0.033371003933186844,538,"'Sew, a needle pulling thread, La... ' Tiger, get with the program. You're not too big for sing-alongs."
2424,1,7,88,96,1.09375,0.033371003933186844,538,"So, I take it you are not in favor of building a wall?"
2424,1,7,88,96,1.09375,0.033371003933186844,538,"Well your not a lion, and I'm not a mouse,but maybe they'll write a fable about us!"
2424,0,9,87,96,1.09375,0.02990527809425515,538,This is just a dream and you're a nice kitty.
2424,2,5,89,96,1.09375,0.03650920636117426,538,"Perhaps a stage production, such as 'Androcles and the Giant Feral Cat'?"
2424,2,5,89,96,1.09375,0.03650920636117426,538,Castration is a relatively simple procedure that removes the testicles.
2424,1,7,88,96,1.09375,0.033371003933186844,538,I’d rather be sewing.
2424,2,5,89,96,1.09375,0.03650920636117426,538,Look who's in charge meow.
2424,0,9,87,96,1.09375,0.02990527809425515,538,I don't think the thimble is gonna help either of us.
2424,2,5,89,96,1.09375,0.03650920636117426,538,I knew I should have picked up knitting.
2424,0,9,87,96,1.09375,0.02990527809425515,538,"If you like what you see, subscribe to my YouTube channel: Teeny Tiny Tony. Subscribe now."
2424,1,7,88,96,1.09375,0.033371003933186844,538,"I won't let them post any more photos of you at the Tube station, I promise."
2424,0,9,87,96,1.09375,0.02990527809425515,538,I promise I won't de-claw you!
2424,2,5,89,96,1.09375,0.03650920636117426,538,"If this is not a bad dream..., then Darwin's theory of evolution has some definite gaps...which one did you crawl out from?!?"
2424,0,9,87,96,1.09375,0.02990527809425515,538,Sorry...Androcles isn't on your HMO provider list.
2424,0,9,87,96,1.09375,0.02990527809425515,538,Back off unless you want an Edwardian collar.
2424,2,5,89,96,1.09375,0.03650920636117426,538,"I knew you'd be mad, but my litter box is full."
2424,1,7,88,96,1.09375,0.033371003933186844,538,Sit still! I need to take a blood sample.
2424,1,7,88,96,1.09375,0.033371003933186844,538,Sorry I lost the directions to making your cradle.
2424,1,7,88,96,1.09375,0.033371003933186844,538,That darn cat is at it again!
2424,1,7,88,96,1.09375,0.033371003933186844,538,I need some catgut
2424,2,5,89,96,1.09375,0.03650920636117426,538,"Look, cobbler, it's Puss in Boots, not Puss in Bedroom Slippers"
2424,1,7,88,96,1.09375,0.033371003933186844,538,"It's not 4 claws, but it will do some damage!"
2424,0,9,87,96,1.09375,0.02990527809425515,538,You don't seem to be respecting my ownership rights.
2424,1,7,88,96,1.09375,0.033371003933186844,538,Gulliver not gullible.
2424,0,9,87,96,1.09375,0.02990527809425515,538,Maybe we can talk this over
2424,0,9,87,96,1.09375,0.02990527809425515,538,"I might not be a mouse, but I believe you owe me a favor."
2424,0,9,87,96,1.09375,0.02990527809425515,538,"Look I'm sorry, I didn't mean anything by it when I called you a big pussy."
2424,1,7,88,96,1.09375,0.033371003933186844,538,This day just keeps getting weirder and weirder and weirder.
2424,2,5,89,96,1.09375,0.03650920636117426,538,"Show some respect ... I spend $4,500 a month for you to stay here full time. I get a few hours here before I fall asleep ..."
2424,2,5,89,96,1.09375,0.03650920636117426,538,Just my luck! I'm allergic to cats.
2424,2,5,89,96,1.09375,0.03650920636117426,538,Do not needle me or this could turn out CATastrophic for you
2424,1,7,88,96,1.09375,0.033371003933186844,538,I said fix your PAW.
2424,2,5,89,96,1.09375,0.03650920636117426,538,Do not be such a Pussy Cat it is not going to hurt!
2424,1,7,88,96,1.09375,0.033371003933186844,538,Perhaps we can call a truce?
2424,0,9,87,96,1.09375,0.02990527809425515,538,"Go away, Kitty. This is supposed to be a Game of Thrones dream."
2424,1,7,88,96,1.09375,0.033371003933186844,538,I'm thinking it wasn't catnip I'm thinking i I'm thinking it wasn't catnip.
2424,2,5,89,96,1.09375,0.03650920636117426,538,"Honey, I'm finished. Kitty was always bigger than life."
2424,0,9,87,96,1.09375,0.02990527809425515,538,"I know I said no more dry food, but the stores were closed today."
2424,2,5,89,96,1.09375,0.03650920636117426,538,Where is the fantastic shrinking girl?
2424,0,9,87,96,1.09375,0.02990527809425515,538,"Quick, before the dog gets back, make me a mane."
2424,2,5,89,96,1.09375,0.03650920636117426,538,"Not owwie...just ow, as in me-ow."
2424,1,7,88,96,1.09375,0.033371003933186844,538,Aaah c'mon! It's just a pinch!
2424,1,7,88,96,1.09375,0.033371003933186844,538,this won't hurt a bit
2424,0,9,87,96,1.09375,0.02990527809425515,538,what would tom thumb do in a situation like this?
2539,1,7,89,97,1.092783505154639,0.03303932048630483,538,"Cease, desist, and withdraw your claws!"
2539,0,9,88,97,1.092783505154639,0.029611147662567158,538,"The Pet store said You were friendly, but not this friendly!"
2539,1,7,89,97,1.092783505154639,0.03303932048630483,538,"Do, a deer, a female deer. Re, a drop of golden sun. Mi, a name I call myself. Fa, a long long way to run. Sol, a needle pulling thread . . ."
2539,0,9,88,97,1.092783505154639,0.029611147662567158,538,"You may remember when you were smaller and scratched me I denied you tuna fish for a week, so cool it."
2539,1,7,89,97,1.092783505154639,0.03303932048630483,538,"""Haven't you heard, 'A well placed stitch negates nine!""?"
2539,0,9,88,97,1.092783505154639,0.029611147662567158,538,No. You're not fierce enough for the circus yet.
2539,1,7,89,97,1.092783505154639,0.03303932048630483,538,Unshrink me right MEOW!
2539,1,7,89,97,1.092783505154639,0.03303932048630483,538,This is the last blind date I'm going on.
2539,0,9,88,97,1.092783505154639,0.029611147662567158,538,"OK, no more yarn balls."
2539,0,9,88,97,1.092783505154639,0.029611147662567158,538,You can play with the cotton after I sew my button back on.
2549,1,6,87,94,1.0851063829787233,0.0326499653871415,538,"Don't bully me! - I'm sticking to my knitting."" ""Don't bully me! - I'm sticking to my knitting."""
2549,2,4,88,94,1.0851063829787233,0.03598334113429031,538,"Hey there big guy, no needle to get upset."
2549,0,8,86,94,1.0851063829787233,0.028935093578151216,538,"Go ahead and mix the metaphor, ""a stitch in time saves nine lives!"""
2549,0,8,86,94,1.0851063829787233,0.028935093578151216,538,I just want to sew up your wound.
2549,2,4,88,94,1.0851063829787233,0.03598334113429031,538,Did you ever hear the one about the cat and the needle?
2549,0,8,86,94,1.0851063829787233,0.028935093578151216,538,"Goliath, we'll have to let out that Harley Quinn costume a tad."
2549,0,8,86,94,1.0851063829787233,0.028935093578151216,538,Watch-it! This is very sharp.
2549,2,4,88,94,1.0851063829787233,0.03598334113429031,538,"Believe me, it's done wonders for other tomcats I know ... a little stitch'll do ya!"
2549,1,6,87,94,1.0851063829787233,0.0326499653871415,538,Fur is murder!
2549,1,6,87,94,1.0851063829787233,0.0326499653871415,538,Funny thing is I am usually the one that's 'all thumbs'.
2549,2,4,88,94,1.0851063829787233,0.03598334113429031,538,We also have a pre-train fixed menu if you prefer
2549,1,6,87,94,1.0851063829787233,0.0326499653871415,538,"Shoot, I thought this was going to be a bad idea."
2549,2,4,88,94,1.0851063829787233,0.03598334113429031,538,You were told our budget was small.
2549,3,2,89,94,1.0851063829787233,0.03903308133611641,538,"""When I asked him to try to give me a big ""O' this wasn't what I had in mind"" This is for last week's entry! I am so sorry I missed my boss's deadline!!!!"
2549,1,6,87,94,1.0851063829787233,0.0326499653871415,538,Consider this a thread misuse intervention.
2549,1,6,87,94,1.0851063829787233,0.0326499653871415,538,"Honestly, it was only an innocent text thread."
2549,0,8,86,94,1.0851063829787233,0.028935093578151216,538,Settle down. I specialize in reclawing.
2549,1,6,87,94,1.0851063829787233,0.0326499653871415,538,"Honey, you're right. I'm just a small man in a big man's world."
2549,1,6,87,94,1.0851063829787233,0.0326499653871415,538,""" Listen it's not my idea to be standing here without a shirt and pointing a needle at you, so cool it and go drink your milk""."
2549,0,8,86,94,1.0851063829787233,0.028935093578151216,538,I don't eat dairy or fish.
2549,0,8,86,94,1.0851063829787233,0.028935093578151216,538,Careful now. I may be copyrighted material.
2549,0,8,86,94,1.0851063829787233,0.028935093578151216,538,"You know Betty, he only half-listens, What I said was ""Wouldn't it be fun to see the Rolling Stones again?"
2549,2,4,88,94,1.0851063829787233,0.03598334113429031,538,"I'm sorry Donald, I was only trying to sew up your mouth"
2549,0,8,86,94,1.0851063829787233,0.028935093578151216,538,Just a threading assistant. The creativity is yours.
2549,0,8,86,94,1.0851063829787233,0.028935093578151216,538,Don't needle me. It was sewn up ages ago.
2549,0,8,86,94,1.0851063829787233,0.028935093578151216,538,"You know, wonders come out of the mouths of babes."
2549,0,8,86,94,1.0851063829787233,0.028935093578151216,538,"Sweetheart, grab my suit I think its working"
2549,1,6,87,94,1.0851063829787233,0.0326499653871415,538,Keeping the comment thread on point was like herding cats.
2549,1,6,87,94,1.0851063829787233,0.0326499653871415,538,"Don't worry, kitty, this needle is only to make sure that you have nine lives"
2549,2,4,88,94,1.0851063829787233,0.03598334113429031,538,"New series on SyFy this fall, ""Purrfect."""
2549,2,4,88,94,1.0851063829787233,0.03598334113429031,538,"Let me sew your mouth shut, and you'll never lose your tongue again."
2549,0,8,86,94,1.0851063829787233,0.028935093578151216,538,"So, what's the point of this conversation?"
2549,3,2,89,94,1.0851063829787233,0.03903308133611641,538,I have a 1/22nd Amendment right!
2549,0,8,86,94,1.0851063829787233,0.028935093578151216,538,"I will engage you, as prodigious a creature as you are."
2549,0,8,86,94,1.0851063829787233,0.028935093578151216,538,If I can only remember how Grant Williams got out of this mess...
2549,0,8,86,94,1.0851063829787233,0.028935093578151216,538,Needle! I use an app from my i-phone!
2549,1,6,87,94,1.0851063829787233,0.0326499653871415,538,"""It's not natural to declaw the cat,"" she says. ""Why is this old lamp so dirty?"" she says..."
2549,0,8,86,94,1.0851063829787233,0.028935093578151216,538,"Down, Simba down."
2549,0,8,86,94,1.0851063829787233,0.028935093578151216,538,High fives
2549,0,8,86,94,1.0851063829787233,0.028935093578151216,538,Classic game of cat and mouse
2549,1,6,87,94,1.0851063829787233,0.0326499653871415,538,"So then he said 'Maybe I am reinventing it, but so what?'"
2549,0,8,86,94,1.0851063829787233,0.028935093578151216,538,"Sorry, didn't know your name was Haystack."
2549,1,6,87,94,1.0851063829787233,0.0326499653871415,538,"Trust me!"" "" No freakin way! Get that thing away from me or I'll eat you, too."
2549,1,6,87,94,1.0851063829787233,0.0326499653871415,538,"Now that I've taken this ""thorn"" out of your paw, do you promise not to eat me?"
2549,0,8,86,94,1.0851063829787233,0.028935093578151216,538,Stop growling at me just because I tell you your vibrato is a little off.
2549,0,8,86,94,1.0851063829787233,0.028935093578151216,538,You’re filled with gratitude…right?
2549,0,8,86,94,1.0851063829787233,0.028935093578151216,538,Gary's Rick Moranis obsession had gone a little too far.
2549,1,6,87,94,1.0851063829787233,0.0326499653871415,538,I could of sworn I ordered smalls.
2549,1,6,87,94,1.0851063829787233,0.0326499653871415,538,"Thanks for your help, I don't know if I should lick you or rub my head on you!"
2549,0,8,86,94,1.0851063829787233,0.028935093578151216,538,"Remember, Fluffy, this is only a movie!"
2549,0,8,86,94,1.0851063829787233,0.028935093578151216,538,"Good news, it's not a Cat atrophy."
2549,0,8,86,94,1.0851063829787233,0.028935093578151216,538,"Now come on, Gulliver, don’t get yourself all in a spat – you’re running out of lives."
2549,0,8,86,94,1.0851063829787233,0.028935093578151216,538,You're my version of Kitty Frankenstein.
2549,1,6,87,94,1.0851063829787233,0.0326499653871415,538,"If you want a mend, get a dog."
2549,1,6,87,94,1.0851063829787233,0.0326499653871415,538,Don’t you recognize me?
2549,1,6,87,94,1.0851063829787233,0.0326499653871415,538,"... and my favorite, the video of me trying to get the tape off my paw. HiLARious!"
2549,0,8,86,94,1.0851063829787233,0.028935093578151216,538,"No, I didn't call you a large coward."
2549,1,6,87,94,1.0851063829787233,0.0326499653871415,538,"Actually, I think this is a job for the Brave Little Knitter..."
2549,0,8,86,94,1.0851063829787233,0.028935093578151216,538,"You forget, I'm one of your staff."
2549,2,4,88,94,1.0851063829787233,0.03598334113429031,538,Waar's mah 'ong?
2549,2,4,88,94,1.0851063829787233,0.03598334113429031,538,So you're the evil cat.
2549,1,6,87,94,1.0851063829787233,0.0326499653871415,538,The death of Peter Dinklage.
2549,3,2,89,94,1.0851063829787233,0.03903308133611641,538,"Man: I completely support Colin Kaepernick's decision to protest the national anthem. Cat: Ah, you know, I agree intellectually, but not emotionally."
2549,1,6,87,94,1.0851063829787233,0.0326499653871415,538,This tiny house isn't big enough for the two of us.
2549,1,6,87,94,1.0851063829787233,0.0326499653871415,538,"No, I get that it's a premium haunted house, but I can't help thinking that it's oddly specific."
2549,1,6,87,94,1.0851063829787233,0.0326499653871415,538,Stop that or I'll shoot
2549,1,6,87,94,1.0851063829787233,0.0326499653871415,538,I'm Needleman.don't mess with me!
2549,0,8,86,94,1.0851063829787233,0.028935093578151216,538,Size does matter - I'm really good at threading these things.
2549,1,6,87,94,1.0851063829787233,0.0326499653871415,538,The wife really loves it when I interrupt her sewing...
2549,0,8,86,94,1.0851063829787233,0.028935093578151216,538,What happened after the Lilliputians lost their 2nd Amendement rights
2549,1,6,87,94,1.0851063829787233,0.0326499653871415,538,"Do I look like a Dalmatian, fool?"
2549,0,8,86,94,1.0851063829787233,0.028935093578151216,538,My cat only wears designer clothes.
2549,1,6,87,94,1.0851063829787233,0.0326499653871415,538,I'm about to have a little more fun!
2549,0,8,86,94,1.0851063829787233,0.028935093578151216,538,"Work it, you're a tiger, work it for the needle!"
2549,0,8,86,94,1.0851063829787233,0.028935093578151216,538,I couldn't help noticing that you're carrying.
2549,1,6,87,94,1.0851063829787233,0.0326499653871415,538,You're pins. I'm needles. Let's play!
2549,3,2,89,94,1.0851063829787233,0.03903308133611641,538,"Awww, Tabby! I have to drink SOME blood if I’m to grow up to be a real boy."
2549,1,6,87,94,1.0851063829787233,0.0326499653871415,538,I have to go fix that bag.
2549,1,6,87,94,1.0851063829787233,0.0326499653871415,538,"no , honest , not that kind of catsuit"
2549,1,6,87,94,1.0851063829787233,0.0326499653871415,538,"I'm just not getting ""great white whale,"" Mittens. Did you even read the script?"
2549,0,8,86,94,1.0851063829787233,0.028935093578151216,538,"I can see that you are angry, but before we do anything rash, might I suggest you start that cat sweater we discussed on Friday?"
2549,2,4,88,94,1.0851063829787233,0.03598334113429031,538,"No, please, my ears are not torn, they just don't have fur on the inside."
2549,0,8,86,94,1.0851063829787233,0.028935093578151216,538,"Remember, you're the needle...I'm the haystack."
2549,1,6,87,94,1.0851063829787233,0.0326499653871415,538,Everything changed the day the giant cats attacked...
2549,1,6,87,94,1.0851063829787233,0.0326499653871415,538,You scratch my back and I'll needle you with stitches!
2549,1,6,87,94,1.0851063829787233,0.0326499653871415,538,"Well, this is quite a bind."
2549,3,2,89,94,1.0851063829787233,0.03903308133611641,538,My last dream was way worse than this...Hillary becoming President.
2549,2,4,88,94,1.0851063829787233,0.03598334113429031,538,This is how you show a cat to not pay with yarn.
2549,0,8,86,94,1.0851063829787233,0.028935093578151216,538,You mess with the MAN... you get the NEEDLE!!
2549,0,8,86,94,1.0851063829787233,0.028935093578151216,538,"Norma, he’s literally going viral!"
2549,1,6,87,94,1.0851063829787233,0.0326499653871415,538,You plan to saw what to my WHAT?
2549,2,4,88,94,1.0851063829787233,0.03598334113429031,538,I've pinpointed your soft spot.
2549,0,8,86,94,1.0851063829787233,0.028935093578151216,538,"Relax, its fall and I want to sew you a sweater."
2642,0,8,87,95,1.0842105263157895,0.02864290665845136,538,"Either take your nap now or in 1/2 hour, I know it's a tough decision."
2642,0,8,87,95,1.0842105263157895,0.02864290665845136,538,We will make a killing with this show! !
2642,3,2,90,95,1.0842105263157895,0.03863041028833638,538,"Okay, so for your pants, you dress to the right."
2642,0,8,87,95,1.0842105263157895,0.02864290665845136,538,"So, you're telling me that the spider was eaten by his wife last night, and the directer is giving you a second chance."
2646,0,8,89,97,1.0824742268041236,0.028075832711972844,538,A little warning about the gargantuan cat in the escape room would've been nice.
2647,1,5,86,92,1.076086956521739,0.03180242267428119,538,It puts the lotion in the thimble.
2647,0,7,85,92,1.076086956521739,0.02779392999764994,538,We have to sew your mouth shut Mr. Trump.
2647,2,3,87,92,1.076086956521739,0.035359378263665836,538,You called about an overstretched scruff?
2647,1,5,86,92,1.076086956521739,0.03180242267428119,538,Fluffy! I thought we had a deal - I sew you a new sweater and you don't eat me.
2647,2,3,87,92,1.076086956521739,0.035359378263665836,538,"I'm sorry I didn't feed you more, but there is no time to fight about it now"
2647,1,5,86,92,1.076086956521739,0.03180242267428119,538,Hurry before the kittens come home and I'll give you a slice of pie!
2647,2,3,87,92,1.076086956521739,0.035359378263665836,538,"In that case, I'll see you in court."
2647,0,7,85,92,1.076086956521739,0.02779392999764994,538,"I told you the shipment of hand-sewn mice wouldn't be ready to go out, until Thursday."
2647,0,7,85,92,1.076086956521739,0.02779392999764994,538,Your mind is mine.
2647,1,5,86,92,1.076086956521739,0.03180242267428119,538,The last cat that smashed my needle is still airborne.
2647,1,5,86,92,1.076086956521739,0.03180242267428119,538,Shame on you for tearing up the pillow! I never know what you might shred next!
2647,0,7,85,92,1.076086956521739,0.02779392999764994,538,Meow. I can't reach for any higher sky. Now put that god forsaken needle down. Cats lives have meaning too.
2647,0,7,85,92,1.076086956521739,0.02779392999764994,538,Nine lives for a stitch?
2647,0,7,85,92,1.076086956521739,0.02779392999764994,538,"I guess it will easier for me to get to heaven, if I thread this needle with a camel rather than you kitty."
2647,1,5,86,92,1.076086956521739,0.03180242267428119,538,"No, that's not the catnip I asked for."
2647,2,3,87,92,1.076086956521739,0.035359378263665836,538,I still say the NFL players have a right not stand for the anthem.
2647,0,7,85,92,1.076086956521739,0.02779392999764994,538,""" Touché Pussy Cat be dammed. This isn't Saturday morning TV""."
2647,0,7,85,92,1.076086956521739,0.02779392999764994,538,"Cruella, I just need to get the splinter out of your paw, baby girl."
2647,0,7,85,92,1.076086956521739,0.02779392999764994,538,Calm down--What's with the rush to tie the knot?
2647,0,7,85,92,1.076086956521739,0.02779392999764994,538,"This is for Sept. 19 issue - I know it's too late, this is for my own benefit - ""The irony is that he thought he'd have nothing to do in retirement."""
2647,0,7,85,92,1.076086956521739,0.02779392999764994,538,"Oh yeah! Well, I'll knit one and purl two you!"
2647,0,7,85,92,1.076086956521739,0.02779392999764994,538,The seamstress shrunk the kids.
2647,0,7,85,92,1.076086956521739,0.02779392999764994,538,I guess I really don't know how to sew......
2647,1,5,86,92,1.076086956521739,0.03180242267428119,538,"I heard, 'blouse.' 'I want a blouse.'"
2647,1,5,86,92,1.076086956521739,0.03180242267428119,538,"Yes! I bought -three- pairs of your RFID tagged, pie-resistant mittens; and none of them worked!"
2647,0,7,85,92,1.076086956521739,0.02779392999764994,538,"Knock off with the hypnosis, your paw needs stitches!"
2647,1,5,86,92,1.076086956521739,0.03180242267428119,538,Hey. Paws down. Catgut is really from sheep!
2647,0,7,85,92,1.076086956521739,0.02779392999764994,538,"From hell's heart I stab at thee...thou damned whale! Thus, I give up the spear!"
2647,1,5,86,92,1.076086956521739,0.03180242267428119,538,i can haz sewed 9 pairs of leviez alrdy...let me napzz
2647,0,7,85,92,1.076086956521739,0.02779392999764994,538,"""A stitch in time saves nine, Tinky""."
2647,0,7,85,92,1.076086956521739,0.02779392999764994,538,"Sure I used the word 'miniature,' but that doesn't mean I'm a dog person."
2647,0,7,85,92,1.076086956521739,0.02779392999764994,538,WONDERFUL ! In my dream the cat has CATNIP WITHDRAWAL !
2647,1,5,86,92,1.076086956521739,0.03180242267428119,538,I need it for emergency surgery. I need it for emergency surgery.
2647,1,5,86,92,1.076086956521739,0.03180242267428119,538,That's the last trip to the Catskills for you
2647,0,7,85,92,1.076086956521739,0.02779392999764994,538,I'm armed. Stop singing that song or you'll be a memory too.
2647,1,5,86,92,1.076086956521739,0.03180242267428119,538,z
2647,0,7,85,92,1.076086956521739,0.02779392999764994,538,all outta yarn today sir! please calm down
2647,1,5,86,92,1.076086956521739,0.03180242267428119,538,"Yes, it is a good idea for an act, but I don't think the'll ll buy the whole 'Simba' thing."
2647,0,7,85,92,1.076086956521739,0.02779392999764994,538,"Tom called you a scaredy cat, it was Tom!! please don't eat me."
2647,1,5,86,92,1.076086956521739,0.03180242267428119,538,"Now hold still, this won't hurt a bit"
2647,1,5,86,92,1.076086956521739,0.03180242267428119,538,"Listen to Thumbelina--and think! You got nine lives, right? And a stitch in time saves nine, right? Get on line, Big Guy, NOW!"
2647,0,7,85,92,1.076086956521739,0.02779392999764994,538,If cats' dreams came true.
2647,0,7,85,92,1.076086956521739,0.02779392999764994,538,"No, Please stop! I don't want to play Circus anymore."
2647,1,5,86,92,1.076086956521739,0.03180242267428119,538,Paws Up ... Don't Stitch
2647,0,7,85,92,1.076086956521739,0.02779392999764994,538,"In the event of my death, my operatives would avenge me. Some of them are pit bulls."
2647,0,7,85,92,1.076086956521739,0.02779392999764994,538,Androcles was the wrong name for you.
2647,0,7,85,92,1.076086956521739,0.02779392999764994,538,Now close your left eye and follow the needle.
2647,1,5,86,92,1.076086956521739,0.03180242267428119,538,"Could this be the end of ""Sewing Man""?"
2647,1,5,86,92,1.076086956521739,0.03180242267428119,538,"His gallery calls it ""neo-Neolithic."""
2647,1,5,86,92,1.076086956521739,0.03180242267428119,538,Damn autocorrect. I asked the genie to make me cool.
2647,0,7,85,92,1.076086956521739,0.02779392999764994,538,"Down Ophelia! For the last time, I'm NOT the one eating the blueberries out of your gourmet cat food!"
2647,2,3,87,92,1.076086956521739,0.035359378263665836,538,"When you find yourself beseeching a behemoth feline with a yarn needle, you’re at risk of looking a knitwit."
2647,0,7,85,92,1.076086956521739,0.02779392999764994,538,"Alright, already! I'm getting my levels checked today, thank you very much!"
2647,1,5,86,92,1.076086956521739,0.03180242267428119,538,Because it wasn't worth saving the dog's life. For you a stitch in time saves nine.
2647,0,7,85,92,1.076086956521739,0.02779392999764994,538,Fluffy... Did you find that mitten that needed darning?
2647,2,3,87,92,1.076086956521739,0.035359378263665836,538,A hiss-tory lesson to remember.
2647,0,7,85,92,1.076086956521739,0.02779392999764994,538,You're meowing up the wrong tree.
2647,3,1,88,92,1.076086956521739,0.038589858440170176,538,"Back off, Fluffy. I may not have Grant Williams' looks, but I have his pluck and this here needle."
2647,1,5,86,92,1.076086956521739,0.03180242267428119,538,Meatloaf?
2647,0,7,85,92,1.076086956521739,0.02779392999764994,538,Don't try to stitch those who don't want to be stitched
2647,1,5,86,92,1.076086956521739,0.03180242267428119,538,"I liked you better when you were nothing but a fading grin, before you got back up to your old tricks with ""Drink Me"""
2647,0,7,85,92,1.076086956521739,0.02779392999764994,538,"Calm down, Kitty, or no more gourmet cat food!"
2647,0,7,85,92,1.076086956521739,0.02779392999764994,538,Don't bother; you will be all sewed up soon!
2647,0,7,85,92,1.076086956521739,0.02779392999764994,538,'Incredible Shrinking Man' 60th Anniversary Blu-ray? Tell me more!
2647,1,5,86,92,1.076086956521739,0.03180242267428119,538,"I swear, I am not the mouse that roared!"
2647,0,7,85,92,1.076086956521739,0.02779392999764994,538,that penis enlarger app used to work before it was hacked
2647,0,7,85,92,1.076086956521739,0.02779392999764994,538,"Relax, it's just the name of the material -- your suit won't be made of real sharkskin."
2647,0,7,85,92,1.076086956521739,0.02779392999764994,538,This is not the seamstress dream I had in mind.
2647,1,5,86,92,1.076086956521739,0.03180242267428119,538,"Perspective makes things in the front look larger, and smaller in the back."
2647,2,3,87,92,1.076086956521739,0.035359378263665836,538,"But, I was just knitting you a sweater!"
2647,1,5,86,92,1.076086956521739,0.03180242267428119,538,Sew what? I'm a big pussy!
2647,0,7,85,92,1.076086956521739,0.02779392999764994,538,"You know, in the original episode of ""The Land of the Giants."" I win!"
2647,0,7,85,92,1.076086956521739,0.02779392999764994,538,A feline nail stylist is the only job I can do in Brobdingnag.
2647,1,5,86,92,1.076086956521739,0.03180242267428119,538,Stop complaining. It was an accident. I said I'd sew your claw back on.
2647,0,7,85,92,1.076086956521739,0.02779392999764994,538,Just please don't go for my tongue.
2647,1,5,86,92,1.076086956521739,0.03180242267428119,538,"Now, now, I helped you catch the mouse. Take me to Times Square."
2647,1,5,86,92,1.076086956521739,0.03180242267428119,538,Back To The Future meets The Incredible Shrinking Man.
2647,0,7,85,92,1.076086956521739,0.02779392999764994,538,"I was only kidding about trading places, I meant my dumb, lazy dog!"
2647,1,5,86,92,1.076086956521739,0.03180242267428119,538,The David of Goliaths versus the mouse of men.
2647,1,5,86,92,1.076086956521739,0.03180242267428119,538,If you swat me I'll stab you with this needle.
2647,1,5,86,92,1.076086956521739,0.03180242267428119,538,"See all the heartpounding action in Michael Bay's latest sequel, ""Honey, I Shrank the Yid"
2647,0,7,85,92,1.076086956521739,0.02779392999764994,538,I was only listening to Bob Barker on that neutering thing.
2647,1,5,86,92,1.076086956521739,0.03180242267428119,538,Larry: Wanna hear a joke? What do you call a cat having a heart attack? A cat attack. Trixie the cat: Ya ima just gonna kill you now.
2647,1,5,86,92,1.076086956521739,0.03180242267428119,538,So. . .help me out. Does this count as a CATCH-22?
2647,1,5,86,92,1.076086956521739,0.03180242267428119,538,"We're gonna have so much fun, you said."
2647,1,5,86,92,1.076086956521739,0.03180242267428119,538,"Cat food is expensive, true. But,still. No reason to want to tie my stomach."
2647,0,7,85,92,1.076086956521739,0.02779392999764994,538,"No reason to get testy, we can certainly discuss your applique design."
2647,1,5,86,92,1.076086956521739,0.03180242267428119,538,Relax! I'm only doing this to meet Lily Tomlin.
2647,0,7,85,92,1.076086956521739,0.02779392999764994,538,"If this were an AK-47 instead of this stupid needle, you wouldn't be so fierce now, would you?"
2647,0,7,85,92,1.076086956521739,0.02779392999764994,538,"If I knew you were going to get so snarky, I never would've shown you how to use the UpSizer 9000."
2647,1,5,86,92,1.076086956521739,0.03180242267428119,538,Just don't think about all the times I've fed you.
2647,0,7,85,92,1.076086956521739,0.02779392999764994,538,Nightmares also plague 7foot tall basketball stars...
2647,1,5,86,92,1.076086956521739,0.03180242267428119,538,May I refer you to a friend of mine who isn't as scrawny?
2647,1,5,86,92,1.076086956521739,0.03180242267428119,538,"Curiosity's my middle name, you son of a queen."
2647,0,7,85,92,1.076086956521739,0.02779392999764994,538,"I'm sorry I couldn't find a ball of yarn master, but this is the best I could do. Now, will you turn me back please?"
2647,1,5,86,92,1.076086956521739,0.03180242267428119,538,Alice? I didn't realize that the 'she' that would be ten feet tall was Mrs. Whiskers.
2647,1,5,86,92,1.076086956521739,0.03180242267428119,538,Martha Steward never said knitting booties for your cat would be dangerous!
2647,1,5,86,92,1.076086956521739,0.03180242267428119,538,"Whoops, sorry, I came prepared for a giant aline."
2647,0,7,85,92,1.076086956521739,0.02779392999764994,538,"I was only mending the bag you came out of. For your benefit, don't be so curious. Remember this is your ninth life."
2647,1,5,86,92,1.076086956521739,0.03180242267428119,538,"I told you, Mr Dentist Wannabe: No root canal."
2647,1,5,86,92,1.076086956521739,0.03180242267428119,538,"Trust me, ceiling concussions are a one way ticket to a catatonic state."
2647,0,7,85,92,1.076086956521739,0.02779392999764994,538,I told you it was sharp. We'll play after I'm done with my darning.
2647,0,7,85,92,1.076086956521739,0.02779392999764994,538,I knew the contestants on Project Runway had a tendency to be catty but this is taking it to a whole new level.
2647,1,5,86,92,1.076086956521739,0.03180242267428119,538,"Oh, come on, let's give it a try. I just know you will rock this pants suit."
2647,1,5,86,92,1.076086956521739,0.03180242267428119,538,"You said, Stay away from the yarn."
2647,1,5,86,92,1.076086956521739,0.03180242267428119,538,Who's shrinking now?
2647,0,7,85,92,1.076086956521739,0.02779392999764994,538,I'd have the upper hand if I were vermin.
2647,1,5,86,92,1.076086956521739,0.03180242267428119,538,I really wish OBAMA didn't take away our guns
2647,1,5,86,92,1.076086956521739,0.03180242267428119,538,"“Back off, I have been genetically humanized!”."
2756,1,5,87,93,1.075268817204301,0.031469239415701566,538,"Well, it seems the mice in our lab experiment did go up a few intelligence points."
2756,2,3,88,93,1.075268817204301,0.03498667060609415,538,Some detergence can be underwhelming.
2756,0,7,86,93,1.075268817204301,0.02750561649383918,538,"honey, I expanded the kitty. er and your sewing basket too....."
2756,2,3,88,93,1.075268817204301,0.03498667060609415,538,"Don't be scared, I'm good"
2756,1,5,87,93,1.075268817204301,0.031469239415701566,538,And I thought working at the New Yorker was tough.
2756,0,7,86,93,1.075268817204301,0.02750561649383918,538,"I know; I know splinter hurts...needle...needle hurts...calm ...kitty...I will spear splinter,catch thread if you jump...smooth...I know....baby...there, there..all better."
2762,1,5,88,94,1.074468085106383,0.031142956046401403,538,I said I wanted blue thread!
2763,1,4,84,89,1.0674157303370786,0.031141677669920615,538,No way!! First clean your litter box.
2764,0,6,84,90,1.0666666666666667,0.026440992651270086,538,"Why the big deal, it's just a few stitches."
2764,0,6,84,90,1.0666666666666667,0.026440992651270086,538,The nice around here would be much more worth your time.
2764,0,6,84,90,1.0666666666666667,0.026440992651270086,538,It still astonishes me that you guys repealed the 2nd amendment.
2764,0,6,84,90,1.0666666666666667,0.026440992651270086,538,When I wake up you're going in the washing machine Diabla
2764,0,6,84,90,1.0666666666666667,0.026440992651270086,538,"Nice kitty, I'm sure we can talk this out."
2764,0,6,84,90,1.0666666666666667,0.026440992651270086,538,"Easy now, Knitty Kitty..."
2764,1,4,85,90,1.0666666666666667,0.030802824262100497,538,Just one more take in your SuperCat outfit!
2764,1,4,85,90,1.0666666666666667,0.030802824262100497,538,Just a few strands for my Pussy G.alore pillow
2764,0,6,84,90,1.0666666666666667,0.026440992651270086,538,I feel like the pussy.
2764,0,6,84,90,1.0666666666666667,0.026440992651270086,538,"This is gonna hurt me a lot more than it is you, kitty, kitty."
2764,2,2,86,90,1.0666666666666667,0.034619385792633225,538,"Yes, but I'm your are your little prick."
2764,1,4,85,90,1.0666666666666667,0.030802824262100497,538,"Last night you made me promise to keep you off all string like items. It's not just yarn, thread counts too."
2764,0,6,84,90,1.0666666666666667,0.026440992651270086,538,And I thought my biggest problem was Mr. Mouse.
2764,2,2,86,90,1.0666666666666667,0.034619385792633225,538,YOU! make a Move - I Swallow You!
2764,1,4,85,90,1.0666666666666667,0.030802824262100497,538,"Sorry buddy, it's cashmere wool, not cats-mere."
2764,0,6,84,90,1.0666666666666667,0.026440992651270086,538,"'DON'T BE AFRAID. I WON'T HURT YOU!"""
2764,1,4,85,90,1.0666666666666667,0.030802824262100497,538,A stitch in the feline sent Stein to the devine.
2764,0,6,84,90,1.0666666666666667,0.026440992651270086,538,"Fascinating discussion on aphorisms, but I don't think that one refers to reincarnation."
2764,1,4,85,90,1.0666666666666667,0.030802824262100497,538,"To finish your coat, I will need your help. My fingers are too small for the thimble."
2764,1,4,85,90,1.0666666666666667,0.030802824262100497,538,Kitty's paw is not that dangerous. I've done this a hundred times before!
2764,1,4,85,90,1.0666666666666667,0.030802824262100497,538,That doesn't look like a voting lever.
2764,0,6,84,90,1.0666666666666667,0.026440992651270086,538,Have you thought of what Morris would say?
2764,1,4,85,90,1.0666666666666667,0.030802824262100497,538,"No warp, no woof and, certainly, no nap!"
2764,0,6,84,90,1.0666666666666667,0.026440992651270086,538,'I don't think you could handle our sewing kit....'
2764,2,2,86,90,1.0666666666666667,0.034619385792633225,538,It's only a little prick.
2764,0,6,84,90,1.0666666666666667,0.026440992651270086,538,Size will matter unless you have a weapon.
2764,1,4,85,90,1.0666666666666667,0.030802824262100497,538,Do you have any idea what a sewing basket means to someone who is homeless?
2764,1,4,85,90,1.0666666666666667,0.030802824262100497,538,"Ok, what will it take for you to join me on that show,""We Got Talent""?"
2764,1,4,85,90,1.0666666666666667,0.030802824262100497,538,I must stop teaching so much Jonathan Swift!
2764,0,6,84,90,1.0666666666666667,0.026440992651270086,538,"You are a lion, aren’t you?"
2764,0,6,84,90,1.0666666666666667,0.026440992651270086,538,"Alright-already, I'll finish your cat hat today!"
2764,0,6,84,90,1.0666666666666667,0.026440992651270086,538,Should try this now before Trump got rid of Obamacare.
2764,0,6,84,90,1.0666666666666667,0.026440992651270086,538,This needle is infected with feline immunodeficiency virus!
2764,0,6,84,90,1.0666666666666667,0.026440992651270086,538,"Honey, I know you don't like sewing but can you help fix my shirt?"
2764,1,4,85,90,1.0666666666666667,0.030802824262100497,538,Oh what cold little hands you have!
2764,0,6,84,90,1.0666666666666667,0.026440992651270086,538,We call this thread the needle pose.
2764,0,6,84,90,1.0666666666666667,0.026440992651270086,538,Calm down. They were ordered from your catalog.
2764,1,4,85,90,1.0666666666666667,0.030802824262100497,538,i'm only a tiny lil dude but i WILL bloody well stab you
2764,0,6,84,90,1.0666666666666667,0.026440992651270086,538,I need your help. I work for Catvin Klein.
2764,0,6,84,90,1.0666666666666667,0.026440992651270086,538,I can't promise to knit you famous on Instagram.
2764,0,6,84,90,1.0666666666666667,0.026440992651270086,538,You're supposed to use another cat's paw.
2764,0,6,84,90,1.0666666666666667,0.026440992651270086,538,I sure make taxidermy look nimble and quick!
2764,0,6,84,90,1.0666666666666667,0.026440992651270086,538,"The thread's already passing through it..........Besides, you're not a camel."
2764,2,2,86,90,1.0666666666666667,0.034619385792633225,538,Damn gastric bypass surgery....
2764,0,6,84,90,1.0666666666666667,0.026440992651270086,538,It's just a dream!
2764,1,4,85,90,1.0666666666666667,0.030802824262100497,538,Your have sharp teeth and claws. I am little and have a needle. What is fair about this?
2764,1,4,85,90,1.0666666666666667,0.030802824262100497,538,"Dude, what's more fucking retarded than New Yorker cartoons? Being forced onto a stupid-ass New Yorker ""cartoon lounge"" email list. Mittens, will you stab me through the heart with this needle and put me out of my misery?"
2764,1,4,85,90,1.0666666666666667,0.030802824262100497,538,"Cassandra, you're a very nice kitty, but I'm growing a little tired of all the cat and mouse"
2764,1,4,85,90,1.0666666666666667,0.030802824262100497,538,"I'm not lion, I promise."
2764,0,6,84,90,1.0666666666666667,0.026440992651270086,538,"No, Fluffy, I'm not renaming you Gulliver, despite any circumstances you wish to bring up."
2764,1,4,85,90,1.0666666666666667,0.030802824262100497,538,"A stich in time saves nine, so it's cold turkey off the catnip."
2764,1,4,85,90,1.0666666666666667,0.030802824262100497,538,Spool it!
2764,1,4,85,90,1.0666666666666667,0.030802824262100497,538,Darn! Another paws in my work.
2764,0,6,84,90,1.0666666666666667,0.026440992651270086,538,"I am not making those sounds again, I just asked if you wanted a scarf."
2764,1,4,85,90,1.0666666666666667,0.030802824262100497,538,I'm sending back that case of Trump Steaks.
2764,1,4,85,90,1.0666666666666667,0.030802824262100497,538,"Sew, you like to needle me, but not needled be!"
2764,1,4,85,90,1.0666666666666667,0.030802824262100497,538,Thread may yield unpredictable results.
2764,0,6,84,90,1.0666666666666667,0.026440992651270086,538,"Yep, you're dying."
2764,1,4,85,90,1.0666666666666667,0.030802824262100497,538,Remember. I'm Androcles.
2764,0,6,84,90,1.0666666666666667,0.026440992651270086,538,Is point blank close enough?
2764,0,6,84,90,1.0666666666666667,0.026440992651270086,538,The camel worked too well. We need a capital investment plan which reflects the markets of today.
2764,1,4,85,90,1.0666666666666667,0.030802824262100497,538,"Yeah, go ahead and take your best swipe with your oh so scary claws! I'm just dreaming so no matter what, after I stick it to you I just wake up."
2764,0,6,84,90,1.0666666666666667,0.026440992651270086,538,"Relax Muffins, I've scaled it down... and if it doesn't work, I've got 8 more tries."
2764,0,6,84,90,1.0666666666666667,0.026440992651270086,538,This sequel is supposed to be about an incredible shrinking woman.
2764,0,6,84,90,1.0666666666666667,0.026440992651270086,538,Sorry the crochet took so long.
2764,1,4,85,90,1.0666666666666667,0.030802824262100497,538,"If you want your sweater fixed, it's your turn to sew!"
2764,0,6,84,90,1.0666666666666667,0.026440992651270086,538,I thought that Alice girl was joking when she said you were related to the Treasure Cat.
2764,2,2,86,90,1.0666666666666667,0.034619385792633225,538,MEOW! Meow.
2764,1,4,85,90,1.0666666666666667,0.030802824262100497,538,And now I will thrust my oversized needle into this pussy.
2764,1,4,85,90,1.0666666666666667,0.030802824262100497,538,How come 'Mouse Man' never got his own movie?
2764,0,6,84,90,1.0666666666666667,0.026440992651270086,538,Wait! I know the whereabouts of Ratman's secret lair!
2764,1,4,85,90,1.0666666666666667,0.030802824262100497,538,Good kitty. Just back off so that I can find the witch. I don't want to hurt you.
2764,0,6,84,90,1.0666666666666667,0.026440992651270086,538,This was a paw decision!
2764,0,6,84,90,1.0666666666666667,0.026440992651270086,538,"Back off, Haberdashery!"
2764,1,4,85,90,1.0666666666666667,0.030802824262100497,538,The literal dying art of sewing in the modern household.
2764,0,6,84,90,1.0666666666666667,0.026440992651270086,538,"Got a hit film for shrinking the kids, but this isn't working so well....."
2764,1,4,85,90,1.0666666666666667,0.030802824262100497,538,it will be ok. We just need some fur for little kitty britches.
2764,2,2,86,90,1.0666666666666667,0.034619385792633225,538,Big cats like to play.
2764,0,6,84,90,1.0666666666666667,0.026440992651270086,538,How 'bout we trade this yarn for your ninth life?
2764,0,6,84,90,1.0666666666666667,0.026440992651270086,538,"Look, my Shrink-O-Matic malfunctioned but I can still use a can opener."
2764,0,6,84,90,1.0666666666666667,0.026440992651270086,538,where's that famous cheesier cat grin?
2845,1,4,86,91,1.065934065934066,0.030471259110747873,538,Sewing your wild oats again?
2845,1,4,86,91,1.065934065934066,0.030471259110747873,538,"Hey, what's with playing avoid the needle?"
2845,0,6,85,91,1.065934065934066,0.026159078492830955,538,"Look at this needle, is it a small needle? And, the dog referred to my needle: ‘If it's small, something else must be small.’ I guarantee you there’s no problem. I guarantee."
2845,0,6,85,91,1.065934065934066,0.026159078492830955,538,One more hiss and we'll wrap it up
2845,0,6,85,91,1.065934065934066,0.026159078492830955,538,"All I said was ""my third wish already...darn"" and you appear."
2845,0,6,85,91,1.065934065934066,0.026159078492830955,538,Well I'm sorry it was YOU who swallowed it. See if I help you next time.
2851,0,6,86,92,1.065217391304348,0.025883102208852066,538,David and Goliath battle in the 21st Century.
2852,0,6,89,95,1.063157894736842,0.025088985264210828,538,Thumbelina! Tell your mother she has got to pick a different familiar.
2853,1,3,84,88,1.0568181818181819,0.02961770764999516,538,"No sir, I promise VR is no longer one of my 'pet peeves'."
2853,1,3,84,88,1.0568181818181819,0.02961770764999516,538,This is nothing like The Spiderwick Chronicles.
2853,0,5,83,88,1.0568181818181819,0.024818855464885405,538,I'm busy sewing our superhero costumes!
2853,0,5,83,88,1.0568181818181819,0.024818855464885405,538,"Yes, perhaps necessity is the mother of invention. I will argue that marriage is the mother of reinvention."
2853,0,5,83,88,1.0568181818181819,0.024818855464885405,538,A challenge Lily Tomlin never faced in the remake.
2853,0,5,83,88,1.0568181818181819,0.024818855464885405,538,"Lentando decrescendo, Grizabella: Look a new day has begun..."
2859,1,3,85,89,1.0561797752808988,0.029289991744514136,538,The tables have turned -- no more catgut!
2859,0,5,84,89,1.0561797752808988,0.024546710604081548,538,"I'll just sew myself out, if that's o-cat with you. I wouldn't want to be a paw-ther..."
2859,0,5,84,89,1.0561797752808988,0.024546710604081548,538,"Well, you're right. It is easier this way."
2859,0,5,84,89,1.0561797752808988,0.024546710604081548,538,"'Who the hell thought this one up ?"""
2859,1,3,85,89,1.0561797752808988,0.029289991744514136,538,"Whoa, this thread is made from cotton, not fir-balls."
2859,1,3,85,89,1.0561797752808988,0.029289991744514136,538,I'm pretty paw-sitive that this needle hurts more than nail clippings.
2859,0,5,84,89,1.0561797752808988,0.024546710604081548,538,"Wait, I could spin a little thing you can conquer, unlike those years of that ball of yarn."
2859,1,3,85,89,1.0561797752808988,0.029289991744514136,538,My patience ran out back at 'M.' Now he's on the couch.
2859,0,5,84,89,1.0561797752808988,0.024546710604081548,538,"OK, I Just Have A Needle!"
2859,0,5,84,89,1.0561797752808988,0.024546710604081548,538,"Hi, I'm Ahab. Who are you!?"
2859,1,3,85,89,1.0561797752808988,0.029289991744514136,538,"Just remember: Revenge is mine, saith the pawed."
2859,1,3,85,89,1.0561797752808988,0.029289991744514136,538,Looks like you've got this deal all sewed up.
2859,0,5,84,89,1.0561797752808988,0.024546710604081548,538,hey nerdle
2859,1,3,85,89,1.0561797752808988,0.029289991744514136,538,"Now, now calm down. How will you ever learn to sew if you don't cooperate? N"
2859,0,5,84,89,1.0561797752808988,0.024546710604081548,538,"Well, that's hardly fair."
2859,0,5,84,89,1.0561797752808988,0.024546710604081548,538,"I told you before Ahab, keep your distance!"
2859,0,5,84,89,1.0561797752808988,0.024546710604081548,538,I was a winner on 'Project Runway.' Big sewing kits don't intimidate me.
2859,0,5,84,89,1.0561797752808988,0.024546710604081548,538,"Now listen, I never said knitting was going to be easy."
2859,0,5,84,89,1.0561797752808988,0.024546710604081548,538,"6/10. ""I found the Little Prince reboot premature, but Adam Driver was finally cast as an appropriate villain"""
2859,2,1,86,89,1.0561797752808988,0.03336564447612069,538,"Don't scratch, don't bite, an' I'll lend you my toothpick."
2859,1,3,85,89,1.0561797752808988,0.029289991744514136,538,"No, no! I asked you for yarn!"
2859,0,5,84,89,1.0561797752808988,0.024546710604081548,538,Thanks to my incredible shrink I no longer shrink in beastly situations nor do I shrink from my shrinking mastery.
2859,1,3,85,89,1.0561797752808988,0.029289991744514136,538,"So is this where I say, ""Up next on Viral Kitty, it's teeny weeny tiny taxidermy?"""
2859,0,5,84,89,1.0561797752808988,0.024546710604081548,538,Scratch me gently with a cat claw!
2859,0,5,84,89,1.0561797752808988,0.024546710604081548,538,You can either star purring or I'll shove this pretty pin up your nose.
2859,1,3,85,89,1.0561797752808988,0.029289991744514136,538,I wonder if I can make this the next BIG thing!
2859,1,3,85,89,1.0561797752808988,0.029289991744514136,538,"On second thought, the roses could use pruning."
2859,1,3,85,89,1.0561797752808988,0.029289991744514136,538,"No, Tabby, don't use the triple overhand stitch!"
2859,0,5,84,89,1.0561797752808988,0.024546710604081548,538,"Ouch, I don't want to reap what you sow"
2859,0,5,84,89,1.0561797752808988,0.024546710604081548,538,Dave took up sculpting when he retired from the Force
2859,0,5,84,89,1.0561797752808988,0.024546710604081548,538,No more kittens for Miss Snicklepuss.
2859,0,5,84,89,1.0561797752808988,0.024546710604081548,538,"All right, I'll let you join my quilting club."
2859,0,5,84,89,1.0561797752808988,0.024546710604081548,538,The other three are downstairs.
2859,1,3,85,89,1.0561797752808988,0.029289991744514136,538,"Now, say 'Sew' not 'Mew.'"
2859,0,5,84,89,1.0561797752808988,0.024546710604081548,538,"Tom Thumb, I've told you before, no more air needle!"
2859,0,5,84,89,1.0561797752808988,0.024546710604081548,538,"Towards thee I roll, thou all-destroying but unconquering ... kitten."
2859,0,5,84,89,1.0561797752808988,0.024546710604081548,538,They call me the Incredible Shrinking Manicurist.
2859,0,5,84,89,1.0561797752808988,0.024546710604081548,538,"I said, sew up the drapes you ripped, and my name is NOT Thumbelino. OR Thanks, my eyesight is not like it used to be."
2859,1,3,85,89,1.0561797752808988,0.029289991744514136,538,Why do you have to be such a huge p... uuugh! That genie must've gone to law school.
2898,0,5,85,90,1.0555555555555556,0.024280462345539,538,Don't you neddle a 'cat'atonic schizophrenic!
2898,0,5,85,90,1.0555555555555556,0.024280462345539,538,"This may seem beside the point, but have you seen any poisonous spiders?"
2898,0,5,85,90,1.0555555555555556,0.024280462345539,538,"You're meant to purr, not growl ."
2898,1,3,86,90,1.0555555555555556,0.02896944496966529,538,pretty much
2898,0,5,85,90,1.0555555555555556,0.024280462345539,538,"I know you are part Siamese, but this is getting weird."
2898,1,3,86,90,1.0555555555555556,0.02896944496966529,538,Don't bother asking for explanations He'll just tell you that he tried To reinvigorate textile manufacturing In the year of the cat
2898,0,5,85,90,1.0555555555555556,0.024280462345539,538,He's got into a bit of a tangle!
2898,0,5,85,90,1.0555555555555556,0.024280462345539,538,"Well, nobody’s purr-fect…"
2898,2,1,87,90,1.0555555555555556,0.03299873682412395,538,Get away from my new bar stool!
2898,0,5,85,90,1.0555555555555556,0.024280462345539,538,"Harriet, I'm done, but is 'Mr. Tibbs the Rabid Years' the best idea?"
2898,1,3,86,90,1.0555555555555556,0.02896944496966529,538,I'm pretty sure this is the wrong scenario... you can't be sleeping beauty... for multiple reasons.
2898,0,5,85,90,1.0555555555555556,0.024280462345539,538,"Costantino Fortunato, I can't help you every time."
2898,1,3,86,90,1.0555555555555556,0.02896944496966529,538,"Winslow was thinking, ""Sheesh! How was I to know the little girls at the door selling cookies were witches?"""
2898,0,5,85,90,1.0555555555555556,0.024280462345539,538,You know that I can kill you right? Better watch yourself.
2898,0,5,85,90,1.0555555555555556,0.024280462345539,538,"Step aside, Cat-on-the-Rhumba! You wanna see viral?! I'll show you viral!"
2898,0,5,85,90,1.0555555555555556,0.024280462345539,538,"Think that attitude will get you into Heaven, either?"
2898,0,5,85,90,1.0555555555555556,0.024280462345539,538,"Here Kitty,kitty."
2898,2,1,87,90,1.0555555555555556,0.03299873682412395,538,"Sew, if I stop needling you, will you no longer see me as a thread and a thimble of destruction? Then we can be spool with each other...no kitten."
2916,1,3,87,91,1.054945054945055,0.02865583474814352,538,I admit it -- catting around is so belittling!
2916,0,5,86,91,1.054945054945055,0.024019921334439576,538,"O.K., you can have a smaller thimble."
2916,0,5,86,91,1.054945054945055,0.024019921334439576,538,"Me-ow? You're gonna ow. Hold still, you big galoot."
2916,0,5,86,91,1.054945054945055,0.024019921334439576,538,"""Something tells me you're not allergic to needles""."
2916,1,3,87,91,1.054945054945055,0.02865583474814352,538,Stand still! I'm trying to save you.
2916,0,5,86,91,1.054945054945055,0.024019921334439576,538,"Just stay away from the tongue,Fluffy!"
2922,0,5,87,92,1.0543478260869565,0.02376490622713203,538,"Listen kitty, No fooling around. The wife can never find out I've been in this room."
2922,0,5,87,92,1.0543478260869565,0.02376490622713203,538,"This dream is getting scary,,,I'm going to wake up."
2922,0,5,87,92,1.0543478260869565,0.02376490622713203,538,Seven in one blow my ass!
2925,0,5,88,93,1.053763440860215,0.02351524327248115,538,How Do You Like when The Cat Messes with You!!
2926,1,3,91,95,1.0526315789473684,0.02746644518119758,538,"One more move and I saw you to the wall ,uh just kitting lol"
2927,0,4,83,87,1.0459770114942528,0.02258398432011167,538,"2D is harmless, right? Right?"
2927,0,4,83,87,1.0459770114942528,0.02258398432011167,538,I thought I ordered the standard powered laser
2927,0,4,83,87,1.0459770114942528,0.02258398432011167,538,"Release Claes, or I'll use this."
2927,0,4,83,87,1.0459770114942528,0.02258398432011167,538,"Don't mess with ""Sewer Man "" he's small yet Crafty!"
2927,0,4,83,87,1.0459770114942528,0.02258398432011167,538,"After watching the debates, Bob has gone paleo."
2927,0,4,83,87,1.0459770114942528,0.02258398432011167,538,If you want to save them....
2927,0,4,83,87,1.0459770114942528,0.02258398432011167,538,Itty Bitty Kitty doesn't wanna play with me! Itty Bitty Kitty wants to cat nap in a tree!
2927,0,4,83,87,1.0459770114942528,0.02258398432011167,538,"""What's the matter, you can't take a little needler?"
2927,0,4,83,87,1.0459770114942528,0.02258398432011167,538,You're a rich fat cat I'm going through the eye.
2927,1,2,84,87,1.0459770114942528,0.02788089944985608,538,It was the butcher who gave me the 'pig in a poke'!
2927,0,4,83,87,1.0459770114942528,0.02258398432011167,538,Does this pin bring out the worst in otherwise reasonable cats?
2927,1,2,84,87,1.0459770114942528,0.02788089944985608,538,"Oh no... Now now there Lily, I know I haven't treated you the best lately, but lets just put those sharp claws down."
2927,0,4,83,87,1.0459770114942528,0.02258398432011167,538,you know my name is not MICKEY
2927,0,4,83,87,1.0459770114942528,0.02258398432011167,538,playing pokecat
2927,0,4,83,87,1.0459770114942528,0.02258398432011167,538,"Back off, or I'll fluff your Garfield!"
2927,0,4,83,87,1.0459770114942528,0.02258398432011167,538,I'm not a tailor-made cat!
2927,0,4,83,87,1.0459770114942528,0.02258398432011167,538,"This taxidermist gig isn't as easy at it 'seams.'"" Or ... ""Hey! Don't make me use this, Stitches!"
2927,0,4,83,87,1.0459770114942528,0.02258398432011167,538,Stop being a scaredy cat! I just want to sew in a couple of stiches where you cut yourself
2927,0,4,83,87,1.0459770114942528,0.02258398432011167,538,Watch out for the giant mouse!
2927,0,4,83,87,1.0459770114942528,0.02258398432011167,538,"Hi, I'm Lachesis. I just came to tell you that you've already used eight."
2927,1,2,84,87,1.0459770114942528,0.02788089944985608,538,It all started when she went big on social
2927,0,4,83,87,1.0459770114942528,0.02258398432011167,538,Looks Like the tables of turned now i am the master!
2927,0,4,83,87,1.0459770114942528,0.02258398432011167,538,You won't pull my yarn!
2927,0,4,83,87,1.0459770114942528,0.02258398432011167,538,"It's a good thing the relative sizing in this image is totally disproportionate, I know your (sic) not real."
2927,0,4,83,87,1.0459770114942528,0.02258398432011167,538,Don't give me that. You did it so you should repair it!
2927,0,4,83,87,1.0459770114942528,0.02258398432011167,538,He's really struggling with the writing process.
2927,1,2,84,87,1.0459770114942528,0.02788089944985608,538,How not to be a novice survivalist? Identify the most likely threats and prep for those first.
2927,0,4,83,87,1.0459770114942528,0.02258398432011167,538,I thought you were supposed to be grinning up a tree.
2927,0,4,83,87,1.0459770114942528,0.02258398432011167,538,This is good for you too.
2927,1,2,84,87,1.0459770114942528,0.02788089944985608,538,Success? I'll show you success!
2927,0,4,83,87,1.0459770114942528,0.02258398432011167,538,"I killed the aardvark and I can take you too, kitty!"
2927,0,4,83,87,1.0459770114942528,0.02258398432011167,538,Take it easy! Your litter-tasting beer will be out next week.
2927,0,4,83,87,1.0459770114942528,0.02258398432011167,538,"I will seweth thy great maw, if you don't shut your big yapper."
2927,0,4,83,87,1.0459770114942528,0.02258398432011167,538,"OK, you're smarter than I thought. But you can use your shrink ray for better things than this."
2927,0,4,83,87,1.0459770114942528,0.02258398432011167,538,A needle in the hand is worth two in the spool.
2927,0,4,83,87,1.0459770114942528,0.02258398432011167,538,"Every body, big or small, has the right to say ‘yes’ or ‘no’. My forest cousin told me so."
2927,0,4,83,87,1.0459770114942528,0.02258398432011167,538,Your prenuptial claws won't help you now!
2927,1,2,84,87,1.0459770114942528,0.02788089944985608,538,Didn't you read the sign? This is a longitudinally-fluid safe zone.
2927,0,4,83,87,1.0459770114942528,0.02258398432011167,538,"We don't test for steroids or growth hormones in this sport, Ron."
2927,0,4,83,87,1.0459770114942528,0.02258398432011167,538,I could sew you up before you can move that paw.
2927,0,4,83,87,1.0459770114942528,0.02258398432011167,538,"If only he could carry the scissors, life would be much easier"
2927,0,4,83,87,1.0459770114942528,0.02258398432011167,538,Darn it! Now you tell me you aren't willing to wear a Hillary saddle blanket?
2927,1,2,84,87,1.0459770114942528,0.02788089944985608,538,"This is for the one in the Sept 19 issue (it is still Sept. 18 in Montana where I live): ""Yeah, he's moved on to paleo-retro-maker-ironic."""
2927,0,4,83,87,1.0459770114942528,0.02258398432011167,538,Theranos said that we will make it work with just one drop of blood. Now go bother someone else.
2927,0,4,83,87,1.0459770114942528,0.02258398432011167,538,I have GOT to lay off the sauna.
2927,1,2,84,87,1.0459770114942528,0.02788089944985608,538,"This won't hurt at all, I just want to wipe your server clean."
2927,0,4,83,87,1.0459770114942528,0.02258398432011167,538,"Mine’s longer. Checkmate, Dorothy."
2927,1,2,84,87,1.0459770114942528,0.02788089944985608,538,my rod keeps pussies away
2927,1,2,84,87,1.0459770114942528,0.02788089944985608,538,"Kitty, I shrunk myself."
2927,1,2,84,87,1.0459770114942528,0.02788089944985608,538,My bear grandfather fought for my right to bear arms.
2927,0,4,83,87,1.0459770114942528,0.02258398432011167,538,"Cool it, hairball, before my giant taxidermy colleague RIGHT BEHIND YOU gets angry."
2927,0,4,83,87,1.0459770114942528,0.02258398432011167,538,"You may be running for presidency, but your ""usual"" tailor-made solutions won't solve my day-to-day problems !"
2927,1,2,84,87,1.0459770114942528,0.02788089944985608,538,"O.K., O.K., so Cowboys and Indians isn't a thing anymore."
2927,0,4,83,87,1.0459770114942528,0.02258398432011167,538,"Our disclosure statement said that declawing reversal is possible, but it might be painful."
2927,0,4,83,87,1.0459770114942528,0.02258398432011167,538,"We were promised ""jumbo tax returns,"" but ""jumbo taxidermy"" has its perks."
2927,1,2,84,87,1.0459770114942528,0.02788089944985608,538,"I mean that's LIVES it saves, LIVES!"
2927,0,4,83,87,1.0459770114942528,0.02258398432011167,538,Just think of it as skinny yarn.
2927,0,4,83,87,1.0459770114942528,0.02258398432011167,538,Remember? It's the season for your Stitch-in-Time shot.
2927,0,4,83,87,1.0459770114942528,0.02258398432011167,538,I have a right to bear arms . . . and to bare arms!!!
2927,0,4,83,87,1.0459770114942528,0.02258398432011167,538,I'm sorry. I didn't realize that Brobdingnagian cats weren't into crop-tops.
2927,1,2,84,87,1.0459770114942528,0.02788089944985608,538,Donald Trump's inability to see the grave consequence of his actions.
2927,1,2,84,87,1.0459770114942528,0.02788089944985608,538,SQUEAK-squeak! SQUEAK! Squeak-SQUEAK!
2927,0,4,83,87,1.0459770114942528,0.02258398432011167,538,Sharp weapons? I was actually going for sharp wits.
2927,0,4,83,87,1.0459770114942528,0.02258398432011167,538,"I wanted a minimalist life, but this goes too far."
2927,0,4,83,87,1.0459770114942528,0.02258398432011167,538,"Back Off! Darn, Cat!"
2927,0,4,83,87,1.0459770114942528,0.02258398432011167,538,"You kinda look like a naked, skinny mouse. I don't care. I am gonna eat you anyways. Meow"
2927,1,2,84,87,1.0459770114942528,0.02788089944985608,538,"'Borrow this mouse finder?"""
2927,1,2,84,87,1.0459770114942528,0.02788089944985608,538,"It's my claw, dude."
2927,1,2,84,87,1.0459770114942528,0.02788089944985608,538,"He's named it ""X"". It's his tribute to irony."
2927,0,4,83,87,1.0459770114942528,0.02258398432011167,538,Are we friends now?
2927,1,2,84,87,1.0459770114942528,0.02788089944985608,538,Don't get all tangled up in stitches...it takes several acupuncture sessions to unfreeze that puss.
2927,0,4,83,87,1.0459770114942528,0.02258398432011167,538,"Yeah, and now you're ACTING like Hitler, too."
2927,0,4,83,87,1.0459770114942528,0.02258398432011167,538,His therapist told him to get a hobby to help work out his mommy issues.
2927,0,4,83,87,1.0459770114942528,0.02258398432011167,538,Come on i have to make you a sweater.
2927,0,4,83,87,1.0459770114942528,0.02258398432011167,538,You'd think he just invented sliced bread.
2927,0,4,83,87,1.0459770114942528,0.02258398432011167,538,Take That! And I didn't Borrow this needle - I'm keeping it!
3003,0,4,84,88,1.0454545454545454,0.022331985656387145,538,"Peter Pan stitched his shadow back on his foot, so I figured I could sew you back on Matt Lauer."
3003,1,2,85,88,1.0454545454545454,0.027567201584687385,538,"Personally, I liked the dogtooth on you."
3005,1,2,87,90,1.0444444444444445,0.026960511703019788,538,Oh my gosh bro. You always have to be doing some dumb ass shit bro.
3006,1,1,83,85,1.035294117647059,0.026181112483020547,538,I keep telling you my name's not Roy!
3006,1,1,83,85,1.035294117647059,0.026181112483020547,538,Don't get mad at me for all the Hollywood remakes.
3006,0,3,82,85,1.035294117647059,0.02013302277430409,538,Do you want me to call Clyde Beatty?
3006,0,3,82,85,1.035294117647059,0.02013302277430409,538,Bye Philipo
3006,0,3,82,85,1.035294117647059,0.02013302277430409,538,I promise you- Kit Kat- no more kneadling about your donating to 'Cat's Paw' heels
3006,1,1,83,85,1.035294117647059,0.026181112483020547,538,"Look, I can’t darn a sock for a notorious micromanager."
3006,0,3,82,85,1.035294117647059,0.02013302277430409,538,Who got more of the soft power?
3006,0,3,82,85,1.035294117647059,0.02013302277430409,538,This will bring us closer.
3006,0,3,82,85,1.035294117647059,0.02013302277430409,538,This isn't what I had in mind when I joined that maker group.
3006,1,1,83,85,1.035294117647059,0.026181112483020547,538,"Vestigial or not, you still forgot the hole."
3006,0,3,82,85,1.035294117647059,0.02013302277430409,538,"No, I don't want that new disease!"
3006,0,3,82,85,1.035294117647059,0.02013302277430409,538,"Calm down, I only said you were so and so pal."
3006,1,1,83,85,1.035294117647059,0.026181112483020547,538,OK. OK. No thread the nasal.
3006,0,3,82,85,1.035294117647059,0.02013302277430409,538,Who farted?
3006,0,3,82,85,1.035294117647059,0.02013302277430409,538,"First, let me see your Feline Haute Couture certificate please."
3006,0,3,82,85,1.035294117647059,0.02013302277430409,538,Don't be such a kitty.
3006,0,3,82,85,1.035294117647059,0.02013302277430409,538,One of us is wearing an Oculus Rift.
3006,0,3,82,85,1.035294117647059,0.02013302277430409,538,"Okay, okay! I don't want to be a haystack!"
3006,1,1,83,85,1.035294117647059,0.026181112483020547,538,He hasn't given me a Big O lately
3025,0,3,83,86,1.0348837209302326,0.019901772591551077,538,How many times do I have to tell you: No Knot; No Tail;!
3025,0,3,83,86,1.0348837209302326,0.019901772591551077,538,"I would love to expand my range a bit, maybe do Shakespeare, but my stupid agent won't put me up for those parts."
3025,0,3,83,86,1.0348837209302326,0.019901772591551077,538,"Well, I suppose this is what I get for doing my sewing on the floor."
3025,1,1,84,86,1.0348837209302326,0.025878144514306353,538,But to whom would you deliver me?
3025,0,3,83,86,1.0348837209302326,0.019901772591551077,538,"If I shrink anymore, I won't even be able to defend myself."
3025,0,3,83,86,1.0348837209302326,0.019901772591551077,538,"Here Pusey, Pusey, Pusey. Don't be frightened."
3025,0,3,83,86,1.0348837209302326,0.019901772591551077,538,I hate Mondays!
3025,0,3,83,86,1.0348837209302326,0.019901772591551077,538,Cm'on kitty don't make me hurt you for eating my food again!
3025,0,3,83,86,1.0348837209302326,0.019901772591551077,538,Yarn's in the back.
3025,0,3,83,86,1.0348837209302326,0.019901772591551077,538,"""I know a stitch in time saves nine, but my eight lives have already been plenty"" Joyce Grimm, Pittsburgh, PA 15228"
3025,0,3,83,86,1.0348837209302326,0.019901772591551077,538,"Your eyeball will be my space helmet, murdercat."
3025,0,3,83,86,1.0348837209302326,0.019901772591551077,538,A Cut Above Taxidermy
3025,0,3,83,86,1.0348837209302326,0.019901772591551077,538,"Silk, 15 denier."
3025,0,3,83,86,1.0348837209302326,0.019901772591551077,538,Almost done with the face...
3025,1,1,84,86,1.0348837209302326,0.025878144514306353,538,"""Great news! I used the rabbit""."
3025,1,1,84,86,1.0348837209302326,0.025878144514306353,538,I'm so tired.
3041,0,3,84,87,1.0344827586206897,0.019675772488188144,538,Witness me...
3042,0,2,81,83,1.0240963855421688,0.01693450430117418,538,"Trust me, ceiling concussions are a one ticket to a catatonic state."
3042,0,2,81,83,1.0240963855421688,0.01693450430117418,538,Meow no! You have to take off your pants or this is going to hurt.
3042,0,2,81,83,1.0240963855421688,0.01693450430117418,538,That doesn't mean you get a Persian rug
3042,0,2,81,83,1.0240963855421688,0.01693450430117418,538,Go away or I'll poke you.
3042,1,0,82,83,1.0240963855421688,0.024096385542168693,538,PISS ON ME FUCKING PISS ON ME BUT DO IT IN THE ANTARCTIC SO THAT THE PEE FREEZES IN MID AIR WHILE YOU ARE PISSING OFF
3042,0,2,81,83,1.0240963855421688,0.01693450430117418,538,You take the yarn; I'll stick to using string!
3042,0,2,81,83,1.0240963855421688,0.01693450430117418,538,I thought there was a bull at the other end of this thread.
3042,0,2,81,83,1.0240963855421688,0.01693450430117418,538,"Quid pro quo my eye! If you hadn't merrily pushed all my sewing stuff off the table, I wouldn't have gotten stuck."
3042,0,2,81,83,1.0240963855421688,0.01693450430117418,538,"we gotta spay you. dog fucking's sort of funny? but cat fucking? no, no... not funny at all."
3042,0,2,81,83,1.0240963855421688,0.01693450430117418,538,"Huh, the joke worked. They all out ran me."
3042,0,2,81,83,1.0240963855421688,0.01693450430117418,538,"I am friendly, I am not a threat to you"
3042,0,2,81,83,1.0240963855421688,0.01693450430117418,538,"Didn't we meet before in the movie ""The Shrinking Man?"" Man?"""
3042,1,0,82,83,1.0240963855421688,0.024096385542168693,538,"Some your mewling, Gulliver, a stitch in time will save you nine."
3042,0,2,81,83,1.0240963855421688,0.01693450430117418,538,"Let's see some respect. I do the thimble, needle and scissors."
3042,0,2,81,83,1.0240963855421688,0.01693450430117418,538,"What's your read on The Needles' album: ""Night of 1000 Cats""?"
3042,0,2,81,83,1.0240963855421688,0.01693450430117418,538,We're reinventing our marriage
3042,0,2,81,83,1.0240963855421688,0.01693450430117418,538,Now I'll shrink you to nothing!
3042,0,2,81,83,1.0240963855421688,0.01693450430117418,538,""" Excuse me cat, would you help me sew my wild oats"". I sow will not."
3042,0,2,81,83,1.0240963855421688,0.01693450430117418,538,Hold up. I'm a pussy-pokin' mah fokka. Yo!
3042,0,2,81,83,1.0240963855421688,0.01693450430117418,538,Franz just tells ‘em. He don’t explain ‘em.
3042,0,2,81,83,1.0240963855421688,0.01693450430117418,538,I hope that I've sufficiently camouflaged my intentions.
3042,0,2,81,83,1.0240963855421688,0.01693450430117418,538,"Sorry,iam is not recognized as an official Oympics country"
3042,0,2,81,83,1.0240963855421688,0.01693450430117418,538,"All I said was, I don't want you to reinvent YOURSELF. (""yourself"" should be italicized; I don't know how to do that.)"
3042,0,2,81,83,1.0240963855421688,0.01693450430117418,538,The spools over there
3042,0,2,81,83,1.0240963855421688,0.01693450430117418,538,A fur coat for milk—I’d say that’s a fair trade.
3042,0,2,81,83,1.0240963855421688,0.01693450430117418,538,Millennials just don't get any Respect !
3042,0,2,81,83,1.0240963855421688,0.01693450430117418,538,"His life hanging by a thread, he said: - Hey, giant pussy, let's paws and avoid this needless violence!"
3042,0,2,81,83,1.0240963855421688,0.01693450430117418,538,Errrr... man!
3042,0,2,81,83,1.0240963855421688,0.01693450430117418,538,Maybe if I just poke at it with some stringy and shiny things...
3042,1,0,82,83,1.0240963855421688,0.024096385542168693,538,"(Sorry I'm a day late foe last week's...hope it makes you laugh). ""Confidentially, I haven't had 'the Big O' in years"""
3042,0,2,81,83,1.0240963855421688,0.01693450430117418,538,"Now boots, we've been over this. Today is your day for cleaning. Now, get started with sewing my shirt buttons. Now, 'm going to go get rid of Garfield. He"
3042,0,2,81,83,1.0240963855421688,0.01693450430117418,538,Without the W!
3042,0,2,81,83,1.0240963855421688,0.01693450430117418,538,"Life is short, be aware of the dangers ahead."
3075,0,2,82,84,1.0238095238095237,0.01673414746533015,538,He thinks he's reinventing the cronut.
3076,0,1,80,81,1.0123456790123457,0.012422599874998832,538,"Oh, poor Kiddy, did I really prickle you?!"
3076,0,1,80,81,1.0123456790123457,0.012422599874998832,538,"Oh, no! A very large cat!"
3076,0,1,80,81,1.0123456790123457,0.012422599874998832,538,Oh God my cat is huge. He's a savage who makes me feel like a shrimp.
3076,0,1,80,81,1.0123456790123457,0.012422599874998832,538,No one blames you for the click striking one.
3076,0,1,80,81,1.0123456790123457,0.012422599874998832,538,And how does that make you honk?
3076,0,1,80,81,1.0123456790123457,0.012422599874998832,538,"I'll take the tooth pick, and the tooth picker"
3076,0,1,80,81,1.0123456790123457,0.012422599874998832,538,Make America Great Again... Fight the Fi-lyin' Trump
3076,0,1,80,81,1.0123456790123457,0.012422599874998832,538,"Remember, the seventh rule of fight club is fights will go on as long as they have to."
3076,0,1,80,81,1.0123456790123457,0.012422599874998832,538,Thought makes the greatness of Man
3076,0,1,80,81,1.0123456790123457,0.012422599874998832,538,Quiet down or I'll sew more spider eggs into your abdomen. Now go take a swipe at that filthy Jap!
3076,0,1,80,81,1.0123456790123457,0.012422599874998832,538,This ain't no cat and mouse game. Yippie-ki-yay motherf**ker!!!
3076,0,1,80,81,1.0123456790123457,0.012422599874998832,538,Bring the needle back. I am not hungry yet.
3076,0,1,80,81,1.0123456790123457,0.012422599874998832,538,"""Mouseman"", from the Land of Lilliputian strikes back."
3076,0,1,80,81,1.0123456790123457,0.012422599874998832,538,This tuna tastes like human. I fart on you. Bbfffhhphphphphphgahghg.
3076,0,1,80,81,1.0123456790123457,0.012422599874998832,538,Why does my girlfriend have such a catlike personality
3076,0,1,80,81,1.0123456790123457,0.012422599874998832,538,"Bring it pussy, I'll stab a bitch!"
3076,0,1,80,81,1.0123456790123457,0.012422599874998832,538,"My name is Grant Williams, I've played some rather small rolls, and SCAT DAMN IT!"
3076,0,1,80,81,1.0123456790123457,0.012422599874998832,538,It's not my fault you were a seamstress in a past life.
3076,0,1,80,81,1.0123456790123457,0.012422599874998832,538,Don’t try anything smart big guy. With my new app “WrapCat” in a nanosecond dude you’ll be toast!
3076,0,1,80,81,1.0123456790123457,0.012422599874998832,538,"Now, c'mon Spike...don't just go stating the obvious!"
3076,0,1,80,81,1.0123456790123457,0.012422599874998832,538,I don't do patchwork.
3097,0,0,79,79,1.0,0.012739111916124871,538,"Where ARE your guts, you scardy cat!"
3097,0,0,79,79,1.0,0.012739111916124871,538,"I saw you do this to a bear, so I thought I'd do it to you!"
3097,0,0,79,79,1.0,0.012739111916124871,538,I didn’t think the movie prop from “The Incredible Shrinking Man” I purchased on eBay would actually work.
3097,0,0,79,79,1.0,0.012739111916124871,538,"Since he retired, he keeps saying he'll get around to it."
3097,0,0,79,79,1.0,0.012739111916124871,538,Naming him Michelangelo may have been a slightly presumptuous.
3097,0,0,79,79,1.0,0.012739111916124871,538,"Listen, MacPherson! Touch not the cat bot a glove."
3097,0,0,79,79,1.0,0.012739111916124871,538,"Don't be so sure that ""Time for some traffic problems."", is a sewn up case!"
3097,0,0,79,79,1.0,0.012739111916124871,538,I just thought you could spare a square.
