rank,funny,somewhat_funny,unfunny,count,score,precision,contest,caption
1,25,28,61,114,1.6842105263157894,0.07611489761628426,540,"I know a specialist, but he's in prison."
2,18,23,50,91,1.6483516483516483,0.08323969299130105,540,When was your last dial movement?
3,21,17,56,94,1.627659574468085,0.08554138429274818,540,I will need to see the family jewels at some point.
4,22,23,63,108,1.6203703703703705,0.07751505017232346,540,"Well, frankly, I think it's a combination of things..."
5,17,33,59,109,1.614678899082569,0.07128291024280159,540,I'll leave the room while you get unlocked.
6,17,26,57,100,1.6,0.07654139963827326,540,You're lucky someone was on the sidewalk to break your fall.
7,21,27,68,116,1.5948275862068966,0.07241647028677187,540,Are you having night deposits? Suspicious withdrawals?
8,17,25,58,100,1.59,0.07666666666666666,540,"Well, the family jewels are fine."
9,13,25,52,90,1.5666666666666667,0.07749189478779536,540,Maybe escape artist wasn't the best career choice for you.
10,11,30,52,93,1.5591397849462365,0.07246150594427025,540,Are you allergic to any explosives?
11,16,21,58,95,1.5578947368421052,0.07878669727256324,540,Well...it could be a combination of things.
12,11,30,53,94,1.553191489361702,0.07193285538902977,540,"In my medical opinion, it's a combination of things."
13,15,29,64,108,1.5462962962962963,0.07008902421353737,540,And now I'm afraid I'm going to have to check the family jewels.
14,16,30,68,114,1.543859649122807,0.06840652077575757,540,I'm going to refer you to a locksmith.
15,10,34,57,101,1.5346534653465347,0.06684451655294354,540,I'm referring you to a locksmith for a second opinion.
16,18,13,61,92,1.5326086956521738,0.08387857660404317,540,Let's talk about safe sex.
17,11,27,55,93,1.5268817204301075,0.0726693309578801,540,"The last time I saw you, you were just a piggy bank."
18,18,14,63,95,1.5263157894736843,0.08175305626699181,540,And how long have you felt you'd rather be sorry?
19,14,25,62,101,1.5247524752475248,0.07256824634379681,540,We need to get your numbers down.
19,13,27,61,101,1.5247524752475248,0.0711908040089012,540,I'd say it's a combination of things
21,12,22,54,88,1.5227272727272727,0.07747530150020544,540,When was your last fiscal?
22,14,22,60,96,1.5208333333333333,0.07547970371241941,540,...and have you been having safe sex?
23,16,22,66,104,1.5192307692307692,0.07355880582657691,540,Have you been engaging in any unsafe behaviors?
23,15,24,65,104,1.5192307692307692,0.07227856817373968,540,Okay. Time to examine the family jewels.
25,13,23,59,95,1.5157894736842106,0.07462209066620011,540,You sound like a million bucks.
26,11,22,53,86,1.5116279069767442,0.07713080907803256,540,"Well, I think we can rule out an iron deficiency."
27,14,20,60,94,1.5106382978723405,0.07674557652790939,540,Is that to my right or your right?
27,11,26,57,94,1.5106382978723405,0.07213557872773799,540,Your problem may be a combination of things.
29,15,21,64,100,1.51,0.07452882297839847,540,"Next time, warn your Mommy before you practice your magic act."
30,15,16,60,91,1.5054945054945055,0.08025238937804632,540,I'm also going to need a jewel sample.
31,12,28,63,103,1.5048543689320388,0.06881248631565717,540,Well it's probably a combination of things
31,16,20,67,103,1.5048543689320388,0.07413924675460869,540,"If you don't open up, I can't help you."
33,15,29,73,117,1.5042735042735043,0.06607153865654862,540,"When I told you to practice safe sex, I didn't mean it literally"
34,16,20,68,104,1.5,0.07358320748783083,540,I'm a bit concerned about the 1250 pounds for your 3' height.
34,14,33,75,122,1.5,0.06295139123842947,540,"Well, I'd say you have a combination of problems."
34,12,24,60,96,1.5,0.07254762501100116,540,I'd say you are suffering from a combination of things.
34,16,27,75,118,1.5,0.0667426772242434,540,The specialist you need is doing 5 to 10.
38,17,20,72,109,1.4954128440366972,0.07213064044988579,540,"Let's face it, Mr. Jenkins ... you're no Houdini."
39,12,24,61,97,1.4948453608247423,0.07198061878231413,540,The chart says you are a dorm room fridge. Tell me what happened.
40,13,34,75,122,1.4918032786885247,0.0618614532951334,540,I think you might be in need of a cash infusion.
41,16,26,76,118,1.4915254237288136,0.06673807856249378,540,It could be a combination of things.
42,10,27,59,96,1.4895833333333333,0.0694508403487402,540,Do you always feel bloated after a large deposit?
43,6,30,50,86,1.4883720930232558,0.06768436047525571,540,You have a combination of problems.
44,12,26,65,103,1.4854368932038835,0.06879905555797765,540,You've got a lot foreign deposits I'll need to remove.
45,12,23,62,97,1.4845360824742269,0.07196523666465109,540,You're suffering from a combination of things.
46,15,20,69,104,1.4807692307692308,0.07227856817373968,540,I think you're healthy enough to have safe sex.
47,8,32,60,100,1.48,0.06432242017658958,540,"Unfortunately, our specialist in this area is currently serving 10 years for burglary."
48,16,23,76,115,1.4782608695652173,0.0680420587019243,540,Spin clockwise and cough.
49,12,26,67,105,1.4761904761904763,0.06779526128971193,540,"Mr. and Mrs. Smith, please come out, that's not what I meant by ""safe sex""."
50,10,29,64,103,1.4757281553398058,0.06594602924304804,540,I'm afraid we'll need to open you up.
51,10,37,73,120,1.475,0.059128237411441194,540,Forgetting your combination is a normal part of aging.
52,13,30,75,118,1.4745762711864407,0.06335982017425042,540,Take 2 sticks of dynamite and see me in the morning
53,10,25,60,95,1.4736842105263157,0.06994175350336927,540,"Open wide, please."
54,10,24,59,93,1.4731182795698925,0.07104278690457831,540,Hmmm ... I'd say it's a combination of things.
55,15,28,80,123,1.4715447154471544,0.06357470987829901,540,And how are the family jewels doing?
56,14,21,69,104,1.4711538461538463,0.07094361692854002,540,"Yes, you are healthy enough for safe sex."
57,10,26,62,98,1.469387755102041,0.06834905282304886,540,It sounds like a combination of things.
58,7,38,66,111,1.4684684684684686,0.0583976874266129,540,I think it's a combination of things.
59,11,20,59,90,1.4666666666666666,0.07445180428336637,540,"It's no wonder you feel terrible. You're overweight, sedentary, and you keep everything locked up inside."
59,12,25,68,105,1.4666666666666666,0.0677566571708241,540,"Well, it appears to be a combination of things."
61,9,22,55,86,1.4651162790697674,0.07341144738394262,540,"Tell me, are you practicing safe sex?"
62,13,27,74,114,1.4649122807017543,0.06496009853524203,540,"Actually, it's a combination of things."
63,5,36,58,99,1.4646464646464648,0.05974095683833895,540,You have a combination of symptoms.
64,14,26,77,117,1.4615384615384615,0.0648497566910738,540,I'm assuming you practice safe sex?
65,18,22,86,126,1.4603174603174602,0.06536908026023491,540,"Relax; I said depository, not suppository."
66,13,23,71,107,1.4579439252336448,0.06807473285037238,540,I can't help you if you don't open up
67,12,28,74,114,1.456140350877193,0.06370581216925368,540,I assume you'll be paying for this visit in cash?
68,10,31,71,112,1.4553571428571428,0.061992330525169816,540,"Let me take a listen, it could be any combination of things."
69,10,25,64,99,1.4545454545454546,0.0677596356818118,540,Is money an issue?
70,11,27,70,108,1.4537037037037037,0.06496299138042354,540,I think you have a combination of ailments....
71,8,28,61,97,1.4536082474226804,0.06557408810055458,540,"Well, your numbers are good."
72,12,19,64,95,1.4526315789473685,0.07296077433700096,540,Now if you could just open wide.
73,12,27,74,113,1.4513274336283186,0.06408841282986728,540,How long has it been since your last fiscal examination ?
74,5,31,55,91,1.4505494505494505,0.06302069792705221,540,The problem is you're keeping everything locked up inside.
75,9,26,63,98,1.4489795918367347,0.06666351784700711,540,Just as I thought--it's a combination of things.
75,13,18,67,98,1.4489795918367347,0.07270212070247647,540,"Of course, it could be a combination of things."
77,11,30,75,116,1.4482758620689655,0.06164271429632317,540,You must avoid crackers
78,8,27,61,96,1.4479166666666667,0.0660106843868201,540,"Worst case scenario, we'll have to open you up."
78,12,19,65,96,1.4479166666666667,0.07235055933213312,540,You can come out now. The election is over.
80,10,27,68,105,1.4476190476190476,0.0648765415041297,540,"I can help you, but you need to open up"
81,10,18,57,85,1.4470588235294117,0.07578881603955955,540,I think we need to talk about safe sex.
82,7,30,62,99,1.4444444444444444,0.06294861215349853,540,I can't tell exactly what's wrong-- it could be a combination of things.
83,9,37,78,124,1.4435483870967742,0.05645161290322582,540,Your case is going to be a tough one to crack.
84,12,15,61,88,1.4431818181818181,0.07727387976274983,540,I believe we'll find it's a combination of things.
85,10,22,63,95,1.4421052631578948,0.06973921904292898,540,"Well, it certainly sounds like an unhealthy combination."
86,18,17,85,120,1.4416666666666667,0.06777354917852516,540,Are you practicing safe sex?
87,12,25,74,111,1.4414414414414414,0.06486258982269294,540,We may have to open you up.
88,9,27,66,102,1.4411764705882353,0.06471647078082306,540,Turn left to 52 and cough.
89,10,21,62,93,1.4408602150537635,0.0708301895593604,540,"I cant help, if you don't open up."
90,7,38,73,118,1.4406779661016949,0.05586346022947444,540,Can you describe the spinning sensations?
90,17,18,83,118,1.4406779661016949,0.06759712793641605,540,"Well, you seem perfectly fine. I only wish I could say the same about that coyote you landed on."
92,10,28,71,109,1.4403669724770642,0.06309385576123867,540,Stay away from crackers.
93,12,27,77,116,1.4396551724137931,0.06278015842104537,540,I have a combination therapy I'd like to prescribe for you
94,12,19,67,98,1.4387755102040816,0.07115755141972316,540,It sounds like it may be a combination of things.
95,13,20,72,105,1.438095238095238,0.06890537324647604,540,I'm going to prescribe nitroglycerin for you.
95,11,24,70,105,1.438095238095238,0.06619403368836055,540,"I hope you don't mind, but I'm going to have to check your jewels."
97,15,23,83,121,1.43801652892562,0.0641672251238312,540,"Just relax, I need to check your family jewels."
98,11,23,69,103,1.4368932038834952,0.06712658259671728,540,I suspect that you suffer from a combination of problems.
98,11,23,69,103,1.4368932038834952,0.06712658259671728,540,"One way or another, you're going to have to open up to me if you want me to help you"
100,11,26,73,110,1.4363636363636363,0.0639631784287469,540,I think your problem is a combination of things.
101,10,21,63,94,1.4361702127659575,0.0702294025755063,540,"""I think your problem might be a combination of things""."
102,8,21,56,85,1.4352941176470588,0.07188354031303279,540,I'm going to rule out an iron deficiency.
103,13,21,74,108,1.4351851851851851,0.06743219373960156,540,"When I advised you to practice safe sex Mr. Mishkin, this is not what I meant."
104,10,21,64,95,1.431578947368421,0.06963773091875845,540,"Don't worry, we stopped using drills years ago."
105,14,15,71,100,1.43,0.07282884321503674,540,Now three turns to the right and cough.
105,11,21,68,100,1.43,0.06854181058288289,540,"Take a deep breath to the right and then two to the left."""
105,10,23,67,100,1.43,0.06705191716841208,540,Your problem is a combination of things.
108,11,27,76,114,1.4298245614035088,0.06226249485136532,540,"I've got to run some tests in the morning , so no deposits after midnight."
109,9,27,69,105,1.4285714285714286,0.0632703699801529,540,"Next time you come in, we'll need to take a look inside."
109,11,20,67,98,1.4285714285714286,0.06956327351174989,540,"An even deeper breath, Mr. Houdini."
111,8,22,59,89,1.4269662921348314,0.06944924229038377,540,Take two turns to the left and cough
112,13,20,75,108,1.4259259259259258,0.06734301733681271,540,And do you practice safe sex?
113,14,15,72,101,1.4257425742574257,0.07222974162312663,540,Looks like we are going to have to open you up!
113,12,19,70,101,1.4257425742574257,0.06943411244469995,540,"Well, I'm afraid that's not a healthy combination."
113,6,31,64,101,1.4257425742574257,0.06027418318900761,540,We may need to open you up and have a look.
116,9,22,63,94,1.425531914893617,0.06846581958643384,540,Are you allergic to any combinations?
117,9,21,62,92,1.423913043478261,0.06952451927042388,540,Is there a history of metal illness in your family?
118,15,20,83,118,1.423728813559322,0.06526867511213456,540,Turn your dial and cough.
119,13,21,77,111,1.4234234234234233,0.06594558791182911,540,"Let's take a look inside, shall we?"
120,8,28,68,104,1.4230769230769231,0.06215616053189266,540,It's not healthy to hold everything inside.
120,12,20,72,104,1.4230769230769231,0.06789855875945267,540,"OK, now, open wide for me."
122,13,23,80,116,1.4224137931034482,0.06380120698966564,540,Safe yes. Sound ... no.
122,11,27,78,116,1.4224137931034482,0.06140638353115774,540,"Hmm, when you have sex is it always safe sex?"
124,6,31,65,102,1.4215686274509804,0.05982611590925974,540,Congratulations! You're in mint condition.
125,12,26,81,119,1.4201680672268908,0.06143120271991589,540,Now open wide.
125,11,28,80,119,1.4201680672268908,0.06026079002401272,540,"Well, it may be a combination of things."
127,11,17,65,93,1.4193548387096775,0.07223568744540966,540,It's probably a combination of things.
128,7,27,64,98,1.4183673469387754,0.06309812786702135,540,It's a combination of symptoms.
129,7,31,70,108,1.4166666666666667,0.05901727809616634,540,"Turn 14 to the left, 7 to the right, and cough."
129,7,26,63,96,1.4166666666666667,0.06398099132915955,540,I think we'll have to use combination therapy
129,10,25,73,108,1.4166666666666667,0.0632633378305703,540,"And lastly, I presume you practice safe sex."
132,14,14,73,101,1.4158415841584158,0.07212108456029431,540,...and of course I can assume you are still practicing safe sex.
132,12,18,71,101,1.4158415841584158,0.06932107352164078,540,"Yes, I am aware of how important the family jewels are"
132,11,20,70,101,1.4158415841584158,0.06787776832080242,540,Are you feeling any symptoms of withdrawal?
135,8,21,60,89,1.4157303370786516,0.06930449159079861,540,It's like you're holding something in.
135,8,21,60,89,1.4157303370786516,0.06930449159079861,540,Now turn a quarter to the left and cough.
137,13,23,82,118,1.4152542372881356,0.06291746993905505,540,"Mr. Houdini, are you sure you don’t want to reschedule your appointment?"
138,12,22,77,111,1.4144144144144144,0.06458900298715287,540,"If I may be honest, Mr. Houdini, I would recommend retirement at this point."
138,10,26,75,111,1.4144144144144144,0.06200112079046729,540,I'm afraid we will have to probe further. Are you allergic to dynamite?
140,11,19,69,99,1.4141414141414141,0.06887214755429566,540,"""You have no heart. have you thought about banking?"
141,13,17,74,104,1.4134615384615385,0.06914955613266946,540,Okay now open wide
141,10,23,71,104,1.4134615384615385,0.06497339163986192,540,"Sorry, it sounds like a combination of things."
141,10,23,71,104,1.4134615384615385,0.06497339163986192,540,"It appears to be a combination of things. Physically, you're strong but emotionally I'm guessing you're empty inside."
144,6,33,70,109,1.4128440366972477,0.05713009691825506,540,I'm hearing a lot of deposit buildup.
145,10,32,84,126,1.4126984126984128,0.05664687751922656,540,I'm just giving you a check-up. It's the billing department that figures out how to get the money out of you.
146,10,20,67,97,1.4123711340206186,0.06835162983132675,540,"Ok, I need you to relax, take a deep breath. And now think of the first 3 numbers that pop into that head of yours...."
147,9,24,69,102,1.411764705882353,0.06438475936652872,540,I think we can dispense with the iron supplement now.
147,10,29,80,119,1.411764705882353,0.05896578724808001,540,"Frankly, your options are safe sex or no sex."
147,8,19,58,85,1.411764705882353,0.07158493348643535,540,You're absolutely sure it was safe sex?
150,8,28,71,107,1.411214953271028,0.06078495389778408,540,I'm impressed. Most patients your age have an iron deficiency.
151,15,18,84,117,1.4102564102564104,0.06554521632971044,540,"Honest doc, I only have safe sex."
152,8,19,59,86,1.4069767441860466,0.07090948542752387,540,You sound like a million bucks...and some jewelry.
152,9,17,60,86,1.4069767441860466,0.07281313710322973,540,I'm going to recommend we cut back on those iron supplements.
154,10,17,64,91,1.4065934065934067,0.07157400428836615,540,Do you and your partner routinely practice safe sex?
154,8,21,62,91,1.4065934065934067,0.0680767038087962,540,Have you been practicing safe sex?
156,8,25,68,101,1.4059405940594059,0.06321144435450443,540,Any feelings of withdrawal?
156,5,31,65,101,1.4059405940594059,0.05832347118821047,540,Take two turns to the right and call me in the morning.
158,9,20,65,94,1.4042553191489362,0.06818084095271891,540,I don't have to explain safe sex to you.
159,8,24,67,99,1.404040404040404,0.06407966323571289,540,It's not healthy to keep everything locked up inside you.
160,10,22,72,104,1.4038461538461537,0.0648420133921871,540,It seems that you're healthy enough for safe sex.
160,7,28,69,104,1.4038461538461537,0.060368594555399786,540,Your test results show elevated iron levels.
162,11,11,60,82,1.4024390243902438,0.0792538147202697,540,"Take a deep breath , hold it, and count to 15 left, 21 right, and 9 left."
163,11,19,72,102,1.4019607843137254,0.06719813961190614,540,The solution to your problem is a combination of things.
164,16,13,83,112,1.4017857142857142,0.06884296268809863,540,"It's the strangest thing: your pulse is 24, 71, 63, 8!"
165,9,20,66,95,1.4,0.06759340930122587,540,You say you were practicing safe sex?
165,7,30,73,110,1.4,0.058047175315730164,540,You seem to have a combination of issues.
165,6,26,63,95,1.4,0.0624257677867289,540,I want you to cut way back on the iron supplements.
165,7,24,64,95,1.4,0.06419455311392144,540,So you say you’re feeling empty inside…
165,11,14,65,90,1.4,0.07377801844041189,540,"Well, it really could be a combination of factors."
165,8,30,77,115,1.4,0.05766893070162214,540,Not sure about the diagnosis. I believe it's a combination of things.
165,9,24,72,105,1.4,0.06289709020331509,540,I've never seen this combination of symptoms before.
165,10,22,73,105,1.4,0.06433656922150993,540,I see you brought your co-pay with you.
165,11,18,71,100,1.4,0.06816498108607269,540,And are you practicing safe sex?
165,12,18,75,105,1.4,0.0671229804574745,540,I trust you've been practicing safe sex?
175,12,25,86,123,1.3983739837398375,0.05969829225930219,540,I'm going to have to check the family jewels.
176,10,23,75,108,1.3981481481481481,0.06300952201142133,540,Your family jewels are just fine !
176,10,23,75,108,1.3981481481481481,0.06300952201142133,540,"Hmm, sounds like it could be a combination of things."
178,12,17,74,103,1.3980582524271845,0.06806985950432017,540,Yes. Your heart is strong enough for safe sex.
178,9,23,71,103,1.3980582524271845,0.06373698726516025,540,I guess I don't need to ask if you're having safe sex.
178,10,21,72,103,1.3980582524271845,0.0652132728417978,540,I really can't tell. It looks as though we're going to have to open you up.
181,11,17,70,98,1.3979591836734695,0.06916866191380466,540,Well this confirms it. You ARE a heartless capitalist.
181,9,21,68,98,1.3979591836734695,0.06605692181366463,540,So I assume you're practicing safe sex.
183,10,17,66,93,1.3978494623655915,0.07029588329076554,540,I did my residency at Leavenworth.
183,10,17,66,93,1.3978494623655915,0.07029588329076554,540,No. When I said safe sex I meant...
185,11,30,90,131,1.3969465648854962,0.05597519511140699,540,Any changes in your combination since you were last here?
186,13,24,89,126,1.3968253968253967,0.05971292708343609,540,It's normal to forget your combination. Don't worry unless you forget what a combination is.
187,8,26,72,106,1.3962264150943395,0.06095856823264258,540,"Well actually, the expression is ""it is better to be safe than sorry"" not ""in a safe and sorry""."
187,10,22,74,106,1.3962264150943395,0.06383835899839581,540,You're in luck - we do take cash.
187,10,22,74,106,1.3962264150943395,0.06383835899839581,540,The meds will work—we just have to find the right combination.
187,11,20,75,106,1.3962264150943395,0.06523059557389634,540,I can't help you unless you open up.
191,9,22,70,101,1.396039603960396,0.06460727960821959,540,You can come out now. Trump lost.
191,13,14,74,101,1.396039603960396,0.07047112732385838,540,"When I recommended 'safe sex,' this isn't what I meant."
191,11,18,72,101,1.396039603960396,0.06760281194103589,540,I understand you have some questions about safe sex.
191,7,26,68,101,1.396039603960396,0.061465933446212886,540,You're going to have to open up a little if you want me to help you.
191,10,20,71,101,1.396039603960396,0.06612201131510494,540,"'Now, cough 27 times to your left."""
196,8,20,63,91,1.3956043956043955,0.06789908636327331,540,I think there's a combination of things going on here.
197,11,12,63,86,1.3953488372093024,0.0763014214357556,540,"I'm sorry Mr. Houdini, our time is up."
198,13,19,82,114,1.394736842105263,0.06428571752830808,540,"OK, I'll speak louder. I think your parents have been a little overprotective."
199,9,25,75,109,1.3944954128440368,0.06116207951070337,540,Good. Now open wide
199,7,29,73,109,1.3944954128440368,0.05831818446641306,540,"Well, your problem could be a combination of things."
201,10,19,70,99,1.393939393939394,0.06706464668757431,540,"Yes, I am familiar with Houdini Disorder."
201,6,27,66,99,1.393939393939394,0.0606060606060606,540,"Don't be embarrassed, I've seen the family jewels before."
201,7,25,67,99,1.393939393939394,0.062283526276788556,540,I think it's safe to say it's a combination of things.
201,10,19,70,99,1.393939393939394,0.06706464668757431,540,I hear some clicking...but that's normal.
201,11,17,71,99,1.393939393939394,0.0685843269166877,540,"So, you mentioned that you have some questions about safe sex."
201,8,23,68,99,1.393939393939394,0.06391698294473333,540,"Next, I want you to open wide."
207,7,23,64,94,1.3936170212765957,0.06455961919538175,540,Sounds like you're having a hard time opening up.
208,8,17,59,84,1.3928571428571428,0.07189321051773706,540,You have an unusual combination of symptoms.
209,10,18,69,97,1.3917525773195876,0.06804318960022725,540,Exhale on the count of 38-16-22.
210,8,27,75,110,1.3909090909090909,0.059319823489213254,540,Sounds like our best option will be a combination therapy.
211,9,16,62,87,1.3908045977011494,0.07193124267360433,540,I assume you're still practicing safe sex.
212,10,19,71,100,1.39,0.06650738547884981,540,I suggest we try a combination therapy.
212,9,21,70,100,1.39,0.06497085593719787,540,Keeping everything locked up inside isn't healthy for you
214,12,13,70,95,1.3894736842105264,0.07223009277872436,540,Really? 36-24-26?
215,6,32,75,113,1.3893805309734513,0.05541708923970591,540,I'm afraid it's a combination of issues.
216,9,24,75,108,1.3888888888888888,0.061471138099105184,540,It sounds like a combination of a number of things
216,11,20,77,108,1.3888888888888888,0.06422492781043573,540,I cannot find any one thing wrong with you; I'm afraid it's a combination.
218,8,29,79,116,1.3879310344827587,0.057132308795169104,540,"When you say you're feeling empty inside, do you mean that literally?"
219,12,19,80,111,1.3873873873873874,0.06421091777010976,540,Now try turning to the right
219,8,27,76,111,1.3873873873873874,0.05888838005650302,540,"Actually, a lot of men do this after I recommend prostate exams."
221,5,29,67,101,1.386138613861386,0.057969430369522575,540,Your iron levels came back a little high
222,15,14,85,114,1.3859649122807018,0.06652924657992805,540,"Well, my last patient was an open book."
223,7,18,58,83,1.3855421686746987,0.070327986279922,540,"The good news is, your health has taken a turn for the better, the bad news is it's taken three turns for the worse."
224,12,13,71,96,1.3854166666666667,0.07158878622288199,540,I'm so sorry. We don't accept FDIC insurance.
224,6,25,65,96,1.3854166666666667,0.06171843192419334,540,You really just need to open up.
226,9,24,76,109,1.385321100917431,0.061008982701100924,540,Cough once to the left and twice to the right.
227,8,31,83,122,1.3852459016393444,0.055146614343005634,540,Do you know if your prescription plan covers dynamite?
228,8,19,64,91,1.3846153846153846,0.06770118711881566,540,"No, this is not at all what I meant by safe sex."
228,15,10,79,104,1.3846153846153846,0.07140394654685989,540,You'll need your combination reset in safe mode by a vault-support specialist.
228,10,20,74,104,1.3846153846153846,0.06453674221353506,540,Turn to the right and then the left and then the right again and cough.
228,9,27,81,117,1.3846153846153846,0.05802292534277813,540,I have good news. You can afford the co-pay.
232,12,19,81,112,1.3839285714285714,0.06372895432545032,540,Your have an upper repository tract infection.
233,7,27,73,107,1.3831775700934579,0.058856528578260264,540,You have the tumbler of a safe half your age.
233,8,25,74,107,1.3831775700934579,0.060335948650358726,540,Turn your head and click.
233,9,23,75,107,1.3831775700934579,0.06177995178691776,540,You will feel better if you open up.
233,10,21,76,107,1.3831775700934579,0.06319096601610899,540,If you want me to help I'm going to need you to open up.
237,6,24,64,94,1.3829787234042554,0.06255884071437662,540,"As I thought, we're going to have to open you up."
238,9,13,59,81,1.382716049382716,0.07570227020620193,540,Turn your dial twice to the left and cough
239,8,23,71,102,1.3823529411764706,0.06238033412563501,540,It's safe to assume you have a combination of problems.
239,7,25,70,102,1.3823529411764706,0.060804350377756396,540,"Deep click...Good, now clack."
241,6,22,61,89,1.3820224719101124,0.0649223980418123,540,These days it's normal to feel empty inside.
241,10,14,65,89,1.3820224719101124,0.0723627544193297,540,"Well, if you would just open up, we could talk about it"
243,10,22,78,110,1.3818181818181818,0.06191524538953285,540,Don't worry a bit. I'll have you cleaned out in no time.
243,7,28,75,110,1.3818181818181818,0.057732838120670864,540,It's not healthy to keep holding everything inside.
243,9,24,77,110,1.3818181818181818,0.060553215771362974,540,And would you say you've been having withdrawals recently?
246,11,15,71,97,1.3814432989690721,0.06942835278424347,540,Practicing safe sex?
246,7,23,67,97,1.3814432989690721,0.0629379824996301,540,"I'm sorry, but we're going to need to open you up and have a look inside."
248,7,26,72,105,1.380952380952381,0.05957872924288002,540,You just can't keep everything locked up.
248,8,24,73,105,1.380952380952381,0.061096441478588503,540,We're going to try a combination of treatments.
250,7,21,64,92,1.3804347826086956,0.06528703082371227,540,Try to cut down on the crackers!
250,8,19,65,92,1.3804347826086956,0.0670916383539389,540,"""Therapy might work if you could open up""."
252,12,14,74,100,1.38,0.06931118527366564,540,"""Yes, your heart is healthy enough for safe sex""."
253,13,15,80,108,1.3796296296296295,0.06671544502185331,540,"Please turn 32 left, 45 right and cough...."
254,9,29,86,124,1.3790322580645162,0.05562125812634781,540,We're going to have to change up your meds until we find a combination that works.
255,11,20,80,111,1.3783783783783783,0.0627698812657157,540,Your heart is healthy enough for safe sex.
255,11,20,80,111,1.3783783783783783,0.0627698812657157,540,We may have to go in.
257,12,21,86,119,1.3781512605042017,0.060843892842297846,540,Open wide.
258,10,14,66,90,1.3777777777777778,0.07167999663119506,540,Your symptoms aren't from any one cause. It's a combination.
259,8,21,69,98,1.3775510204081634,0.0640772370216083,540,Good news. You can afford the co-pay.
260,9,22,75,106,1.3773584905660377,0.0620882920424406,540,"If this doesn't work, do you have any dynamite allergies?"
261,9,25,80,114,1.3771929824561404,0.058959501120901224,540,Turn twice to left and cough.
262,5,22,58,85,1.3764705882352941,0.06476951289477273,540,It's OK to open up. This is a safe space.
263,12,11,70,93,1.3763440860215055,0.07318631161120162,540,"Really sir, you can't stay in there until November 9."
264,9,20,72,101,1.3762376237623761,0.06425734946371467,540,You have too much iron.
265,9,18,69,96,1.375,0.0666392487478979,540,There's only so much I can do if you won't open up.
265,10,19,75,104,1.375,0.06436264763629829,540,Next I'll have you open wide.
265,7,25,72,104,1.375,0.05985341192109241,540,And when did you start feeling unsafe?
265,8,23,73,104,1.375,0.06139330106764154,540,It may be a combination of things...
269,6,31,78,115,1.373913043478261,0.05448723538607835,540,Just give me two deep clicks.
270,9,22,76,107,1.3738317757009346,0.061606318458313845,540,"Your heart's good enough for sex, just make sure it's safe sex."
271,8,18,65,91,1.3736263736263736,0.06748282764125625,540,And now take a breath counter-clockwise.
271,5,24,62,91,1.3736263736263736,0.06181691753766736,540,Turn your dial and cough for me please.
273,6,32,80,118,1.3728813559322033,0.05355209665623421,540,It's a combination of things.
274,8,25,77,110,1.3727272727272728,0.05898656341689123,540,Relax. A lot of safes feel empty inside.
274,11,19,80,110,1.3727272727272728,0.06308590712602469,540,I must advise you to engage only in safe sex.
276,8,19,67,94,1.372340425531915,0.06590281203751787,540,And do you feel safe at home?
276,10,15,69,94,1.372340425531915,0.06928738581634288,540,Do you practice safe sex?
278,5,22,59,86,1.372093023255814,0.06416145765063452,540,I’m afraid we may have to open you up again.
279,9,21,75,105,1.3714285714285714,0.06239591018276215,540,"Please Mr. Houdini, I can hear you. Try to stay calm."
279,9,21,75,105,1.3714285714285714,0.06239591018276215,540,I can only help you if you'll open up!
279,6,27,72,105,1.3714285714285714,0.05782559172273788,540,"Don't worry, the procedure is perfectly... well, you know."
279,7,25,73,105,1.3714285714285714,0.05938812373896783,540,I warned you about unsafe sex.
283,7,22,68,97,1.3711340206185567,0.06272654411089969,540,My best guess is claustrophobia.
284,11,24,89,124,1.3709677419354838,0.057789218282787186,540,"This is interesting. You're not only dying, you're also dead broke."
285,6,28,74,108,1.3703703703703705,0.05672587553709887,540,I'd say the family jewels are safe for another year.
285,8,24,76,108,1.3703703703703705,0.059698957181066846,540,"Other than the claustrophobia, is there anything else bothering you Mr. Houdini?"
287,10,17,73,100,1.37,0.0661418738375885,540,How long have been having these feelings of insecurity?
288,9,16,67,92,1.3695652173913044,0.06863175677010006,540,Anything alarming that I should know about?
288,7,20,65,92,1.3695652173913044,0.06505793534128973,540,"As your internist, I'd say you're problem is a combination of things."
288,7,20,65,92,1.3695652173913044,0.06505793534128973,540,"""How long have you had that ‘empty’ feeling”?"
291,8,25,78,111,1.3693693693693694,0.05854910778647798,540,Why do you feel your wife thinks of you only as a source for money?
291,6,29,76,111,1.3693693693693694,0.055681214920225014,540,"Well yes, I did tell you to go to your safe place when anxiety hits."
293,11,23,88,122,1.3688524590163935,0.05843186265310088,540,We'll have all that icky money out of you in no time.
294,11,20,83,114,1.368421052631579,0.06137577833255689,540,"Everything sounds normal, but I'm concerned about your weight."
294,9,24,81,114,1.368421052631579,0.05879179684001161,540,I'm just trying to get you to open up.
296,12,19,86,117,1.3675213675213675,0.06141840796345578,540,"Frankly, I'm surprised you could even hop up on the table."
297,5,26,67,98,1.3673469387755102,0.05871861799919235,540,Sounds like you've got a combination of problems.
297,8,20,70,98,1.3673469387755102,0.06386749100214828,540,Your deposits show no sign of having grown.
297,8,20,70,98,1.3673469387755102,0.06386749100214828,540,"Ok. I'm just going to turn your dial very gently, and I'd like you to click when it feels right."
297,8,20,70,98,1.3673469387755102,0.06386749100214828,540,"Well, we can rule out a sexually transmitted disease, as you obviously practice safe sex."
297,10,16,72,98,1.3673469387755102,0.06708087118068087,540,"First, let's take care of the copay."
302,6,21,63,90,1.3666666666666667,0.06408873374282763,540,"I have some bad news, Jake. Your 9 to the right and 36 to the left are fine, but your 23 to the right is in really bad shape."
302,8,17,65,90,1.3666666666666667,0.0678729811709616,540,You were right to call me. It's better to be safe than sorry.
304,8,21,72,101,1.3663366336633664,0.06249399539825544,540,Perhaps 'go to your safe place' wasn't a great choice of words.
304,7,23,71,101,1.3663366336633664,0.060889076679294246,540,Just relax and open up.
306,8,29,86,123,1.3658536585365855,0.05447860610962299,540,You're hiding something from me.
307,6,22,65,93,1.3655913978494623,0.06263824586399258,540,"The tests will confirm, but I'd say you are still impregnable."
307,5,24,64,93,1.3655913978494623,0.06074368900734789,540,Bad news! You will outlive your money.
307,4,26,63,93,1.3655913978494623,0.05878810818120285,540,I can't help if you don't open up to me.
310,7,24,73,104,1.3653846153846154,0.05965060753279403,540,"Mr. Houdini, time's up, Mr. Houdini?"
310,7,24,73,104,1.3653846153846154,0.05965060753279403,540,"Well, it's a combination of things, but your main problem is that you're way too heavy."
312,8,26,81,115,1.3652173913043477,0.0570444642805146,540,It's most likely a combination of things
313,8,15,62,85,1.3647058823529412,0.07070485231612221,540,I'm afraid I'm going to have to refer you to a locksmith.
314,7,21,68,96,1.3645833333333333,0.06303680292806588,540,"Let me assure you, I take patient confidentiality quite seriously."
315,9,21,77,107,1.3644859813084111,0.0614187797630331,540,You're hiding something
315,11,17,79,107,1.3644859813084111,0.06422568017615914,540,I'm going to have to refer you to an auditor.
317,10,23,85,118,1.3644067796610169,0.058551314627692606,540,Your numbers are very good. 36-8-14.
318,7,30,84,121,1.3636363636363635,0.05378254348272378,540,It seems you're suffering from an odd combination of things.
318,7,22,70,99,1.3636363636363635,0.06167881752716453,540,"As your doctor, I can't really help you unless you open up."
318,7,18,63,88,1.3636363636363635,0.06699595696916148,540,"No. Not so unusual, a couple of weeks ago I had a small car full of clowns come in."
318,10,16,73,99,1.3636363636363635,0.0665034263884728,540,"So, how long have you struggled with these feelings of insecurity?"
318,9,22,79,110,1.3636363636363635,0.0602015972778779,540,"Are you comfortable getting undressed now, Mr. Baxter?"
318,8,24,78,110,1.3636363636363635,0.05879988642348698,540,"Try not to worry, we have several procedures available to us before we even contemplate dynamite."
318,6,20,62,88,1.3636363636363635,0.06501711490338546,540,"I'm a triple threat. Psychiatrist, Cardiologist, and Locksmith."
318,8,16,64,88,1.3636363636363635,0.0689180039617185,540,I suggest nitroglycerin.
326,10,21,82,113,1.3628318584070795,0.060369106587134215,540,"If this is going to work, you'll have to open up for me."
326,10,21,82,113,1.3628318584070795,0.060369106587134215,540,Do you tend to keep things in?
326,10,21,82,113,1.3628318584070795,0.060369106587134215,540,I'm afraid it's a combination of things.....
329,9,19,74,102,1.3627450980392157,0.06352918407268339,540,I'm afraid we're going to have to open you up.
330,6,21,64,91,1.3626373626373627,0.06350849791999952,540,Turn to your left 3 clicks and cough.
330,4,25,62,91,1.3626373626373627,0.05953930483012121,540,I recommend reducing your junk bond intake.
332,7,28,81,116,1.3620689655172413,0.055298768356355145,540,And how often are you going through withdrawal?
333,8,22,75,105,1.361904761904762,0.060709796573247675,540,"Mr. Houdini, I'm going to need you to cough a little louder."
333,10,18,77,105,1.361904761904762,0.06365516291916533,540,Hmmm. Your heart rate is 36-11-18.
333,9,20,76,105,1.361904761904762,0.06219991626292835,540,You're very lucky. The piano you landed on cushioned your fall.
333,6,26,73,105,1.361904761904762,0.057614052397524936,540,There are many therapies available. We'll just have to find the right combination.
333,6,26,73,105,1.361904761904762,0.057614052397524936,540,"If you want to change, you have got to stop keeping everything locked inside you."
338,8,18,68,94,1.3617021276595744,0.06567158961380372,540,"It's safe to say, you have a combination of things."
339,9,12,62,83,1.3614457831325302,0.07388770309814092,540,Hmmm. Sounds like a bad combination.
340,10,23,86,119,1.361344537815126,0.058137905142702076,540,"Sounds like 120 over 80, then back to the right to 60 ..."
340,9,25,85,119,1.361344537815126,0.05689979051881099,540,"If you want me to help you, you have to open up."
342,8,19,70,97,1.3608247422680413,0.06419198915196786,540,'I'm assuming you have the funds to pay for this.'
343,9,26,87,122,1.360655737704918,0.05590163735770806,540,"Yeah, we're going to have to open you up."
344,5,21,60,86,1.3604651162790697,0.06387571443067051,540,"Well, it's certainly not an iron deficiency."
344,4,23,59,86,1.3604651162790697,0.06169691307359761,540,"If you really trusted me, you'd open up."
344,7,17,62,86,1.3604651162790697,0.06802427887499866,540,It's what's inside that counts.
347,11,14,75,100,1.36,0.06744994402884964,540,Withdrawal pains are perfectly normal.
347,6,24,70,100,1.36,0.05949280577846315,540,You've got a combination of problems
347,10,16,74,100,1.36,0.06593538312222616,540,"Sooner or later, you're going to have to open up"
347,7,22,71,100,1.36,0.0611671001553461,540,No problem here! You sound like a million bucks.
351,5,22,62,89,1.3595505617977528,0.062398417982428823,540,We'll need time to get you to open up.
352,7,23,73,103,1.3592233009708738,0.05991041114697438,540,I want to run a stress test. What bank are you with?
352,7,23,73,103,1.3592233009708738,0.05991041114697438,540,"I know I told you about the importance of having safe sex, but this isn't what I was talking about."
352,9,19,75,103,1.3592233009708738,0.0630078739682481,540,"Clearly, you don't understand safe sex."
352,5,27,71,103,1.3592233009708738,0.05664382177784606,540,I think you're suffering from a combination of things.
356,7,24,75,106,1.3584905660377358,0.05872052872132804,540,"So, when was the last time you opened yourself up to anyone?"
357,5,24,66,95,1.3578947368421053,0.05970399074989401,540,"Unfortunately Sir , as I suspected , you have a lethal combination."
357,9,16,70,95,1.3578947368421053,0.06678639962146006,540,"Nope, it's still not safe to come out, Congressman Ryan."
359,8,19,71,98,1.3571428571428572,0.0636401888565905,540,"Cough to the right, cough to the left and cough to the right again."
360,10,16,75,101,1.3564356435643565,0.06537653076918486,540,"Still practicing safe sex, Howard?"
360,8,20,73,101,1.3564356435643565,0.062274000766401535,540,I can only help if you are willing to open up.
360,8,20,73,101,1.3564356435643565,0.062274000766401535,540,Better to be safe than sorry!
363,7,28,83,118,1.3559322033898304,0.05452894924516757,540,you need to work on not keeping everything locked up inside
364,7,23,74,104,1.3557692307692308,0.05943200976480874,540,Are there any numbers you do remember?
364,8,21,75,104,1.3557692307692308,0.06098254079710381,540,I'm afraid I hear the clicking too.
364,12,13,79,104,1.3557692307692308,0.06682586528893485,540,And you say that he locked you in here with his tax returns and enough food until November 9th?
367,6,21,66,93,1.3548387096774193,0.06237687505732702,540,Take a tumbler of WD-40 and call me in the morning.
367,8,17,68,93,1.3548387096774193,0.06601804846638955,540,I guess I don't need to apologize for my cold hands.
367,4,25,64,93,1.3548387096774193,0.058509540764940304,540,I'm hearing a combination of symptoms.
370,11,17,82,110,1.3545454545454545,0.06272431125232868,540,Now open wide and cough up.
370,7,25,78,110,1.3545454545454545,0.0571586960707441,540,If you want to make progress you're going to have to open up.
372,11,23,93,127,1.3543307086614174,0.056484918904357195,540,46 left. 49 right. And 5 undecided.
373,9,16,71,96,1.3541666666666667,0.0661921158358789,540,I'd say you're well enough now to have safe sex.
373,10,14,72,96,1.3541666666666667,0.06782841915041544,540,You shouldn't keep things locked inside.
373,8,18,70,96,1.3541666666666667,0.06451432362829494,540,Your blood pressure is normal...120 left over 40 right.
376,7,26,80,113,1.3539823008849559,0.05610677295940836,540,"Your heart rate seems to be a little elevated, Mr. Houdini."
377,9,17,73,99,1.3535353535353536,0.06471020872951995,540,Say the second number louder.
377,7,21,71,99,1.3535353535353536,0.06144204576058807,540,How many francs did you eat?
379,5,31,80,116,1.353448275862069,0.05231422524173341,540,I'm afraid it's your clicker.
379,10,21,85,116,1.353448275862069,0.059045773346185534,540,Have you been engaging in unsafe behavior?
381,9,18,75,102,1.3529411764705883,0.0633116048875717,540,"And click twice for me, please?"
381,10,16,76,102,1.3529411764705883,0.06482666406815095,540,Drop your tumblers and cough for me
381,4,28,70,102,1.3529411764705883,0.055115097837303104,540,I can't help you unless you open up to me.
381,5,26,71,102,1.3529411764705883,0.056849019959717806,540,I'd like to get a second opinion from a locksmith.
385,13,17,92,122,1.3524590163934427,0.060394461752465364,540,"I'm going to run some more tests, but I'm pretty sure you're stuck in a safe."
386,8,21,76,105,1.3523809523809525,0.06049392604292199,540,I'm afraid we're going to have to crack you open.
386,7,23,75,105,1.3523809523809525,0.05896070644875562,540,I'm going to prescribe you a combination therapy.
388,5,21,62,88,1.3522727272727273,0.06268082041150161,540,Just a few more minutes and we'll see why you feel so empty inside.
389,7,24,77,108,1.3518518518518519,0.057817126770041305,540,It appears to be a combination of things.
389,4,30,74,108,1.3518518518518519,0.0531376453031031,540,"Well, your condition is a combination of things."
389,7,24,77,108,1.3518518518518519,0.057817126770041305,540,I recommend cutting back on iron.
392,7,18,66,91,1.3516483516483517,0.06513558016233036,540,"No one risk factor stands out, it's the combination that concerns me."
392,4,24,63,91,1.3516483516483517,0.05924561646639043,540,"I know you keep a lot inside, but this is a safe place."
394,9,21,81,111,1.3513513513513513,0.05954873797739833,540,"Yes, I can hear you, but no, my card was not the seven of clubs."
394,5,29,77,111,1.3513513513513513,0.05376663965229916,540,Will you be paying in cash?
396,9,15,70,94,1.351063829787234,0.0671467161788019,540,I still don't understand how you could forget your own combination.
396,6,21,67,94,1.351063829787234,0.061825073355242094,540,"Give me a nice, big click."
396,8,17,69,94,1.351063829787234,0.06542095149255632,540,I've never felt this safe in a doctor's office.
399,6,22,69,97,1.3505154639175259,0.060498425743842794,540,"If I'm going to help you, you have to let me inside."
400,10,16,77,103,1.3495145631067962,0.06428558300277,540,"Turn once to the right, twice to the left, once to the right, and then cough."
401,8,13,62,83,1.3493975903614457,0.07157547598713887,540,"I don't think it's serious, but we're going to have to open you up to be sure."
401,8,13,62,83,1.3493975903614457,0.07157547598713887,540,You're a robbery waiting to happen...
403,7,16,63,86,1.3488372093023255,0.06773134719419151,540,You have better coverage under FDIC than the Affordable Healt Care Act
404,10,18,81,109,1.348623853211009,0.061657018818519725,540,I recommend we try combination therapy.
404,6,26,77,109,1.348623853211009,0.05587494347520414,540,"Given your weight, even safe sex has risks."
404,10,18,81,109,1.348623853211009,0.061657018818519725,540,"As your psychiatrist, I can't help you feel safe until you open up to me"
407,8,15,66,89,1.348314606741573,0.06798786843411783,540,I'd say the fact that you drove yourself here is a good sign.
408,13,14,88,115,1.3478260869565217,0.06303229864840354,540,I am afraid your cat is dead Dr. Schrodinger.
409,5,31,82,118,1.347457627118644,0.05159644418838746,540,"I believe that you are suffering from a combination of problems, but I can't really help you unless you open up."
410,7,19,69,95,1.3473684210526315,0.06308319584052381,540,This isn't what I meant when I told you to go to your safe place.
410,6,21,68,95,1.3473684210526315,0.061282341924247634,540,It's totally normal to feel like you're going to crack.
410,7,19,69,95,1.3473684210526315,0.06308319584052381,540,I can tell you keep your emotions locked up
410,7,19,69,95,1.3473684210526315,0.06308319584052381,540,I am trying to get you to open up.
414,9,16,73,98,1.346938775510204,0.06503335630603123,540,It appears you gained a few pounds while in Britain.
414,5,24,69,98,1.346938775510204,0.05820449887704549,540,I hear some clicks but no murmurs.
414,4,26,68,98,1.346938775510204,0.05636816702539816,540,I took the liberty of removing your co-pay during surgery.
414,6,22,70,98,1.346938775510204,0.05998464074455056,540,You really shouldn't keep it all inside.
418,11,21,92,124,1.346774193548387,0.05730684823191831,540,Glad to hear you two are practicing safe sex.
418,8,27,89,124,1.346774193548387,0.053765079964523614,540,I'm glad you came in--better safe than sorry.
420,8,19,74,101,1.3465346534653466,0.062037426526021955,540,It's very important that you're open with me.
420,7,21,73,101,1.3465346534653466,0.06042038139561331,540,"Its a good thing you came in when you did, your pulse is 36-17-20."
420,8,19,74,101,1.3465346534653466,0.062037426526021955,540,[small caps to show she's speaking loudly] Mr Smith? Can you hear me? Knock once if you have health insurance...
423,8,20,76,104,1.3461538461538463,0.06075396145882811,540,I can't help you if you won't open up to me.
423,4,28,72,104,1.3461538461538463,0.054260647281398476,540,"Yes, we accept cash."
423,9,18,77,104,1.3461538461538463,0.062271585256253766,540,"You are generally healthy, but I think we should get some of your numbers a little lower."
423,7,22,75,104,1.3461538461538463,0.05919744365726161,540,Sometimes the only way out is to let someone in.
423,6,24,74,104,1.3461538461538463,0.057598878792634096,540,I am going to have to ask you to open wide
423,7,22,75,104,1.3461538461538463,0.05919744365726161,540,How did you get in there in the first place?
423,7,22,75,104,1.3461538461538463,0.05919744365726161,540,Turn 3 to the left and cough.
423,9,18,77,104,1.3461538461538463,0.062271585256253766,540,Any questions about safe sex?
423,8,20,76,104,1.3461538461538463,0.06075396145882811,540,"C'mon, open up so I can check the family jewels."
432,11,15,81,107,1.3457943925233644,0.06382671907966365,540,You say you fell from the twelfth floor?
432,11,15,81,107,1.3457943925233644,0.06382671907966365,540,Please come out Mr. Mankoff...we need you to once again judge this week's New Yorker Cartoon Caption Contest.
432,11,15,81,107,1.3457943925233644,0.06382671907966365,540,I still can't tell if the cat is dead or alive
432,8,21,78,107,1.3457943925233644,0.059538582773768035,540,There's a combination of things I'm checking.
436,6,26,78,110,1.3454545454545455,0.055455297442227686,540,I can't help you if you don't learn to open up.
436,8,22,80,110,1.3454545454545455,0.05838579756406175,540,I think you're a candidate for combination therapy.
436,9,20,81,110,1.3454545454545455,0.05979721589325398,540,Rotate your dial assembly to the right and cough.
439,8,13,63,84,1.3452380952380953,0.07084047438415259,540,How long have you had these urges to fall from a tall building and squash an innocent passer-by?
440,9,21,83,113,1.345132743362832,0.05865365719171705,540,I'm here to help you open up.
441,5,21,64,90,1.3444444444444446,0.061526789656790475,540,Turn your dial and cough please.
442,6,30,86,122,1.3442622950819672,0.051754859475962256,540,"There's good news and bad news. You have a heart of gold, but it's not beating."
443,9,15,72,96,1.34375,0.0659414363379794,540,"Now, inhale once, and then say the first three numbers that come to mind..."
443,6,21,69,96,1.34375,0.06074848384506139,540,It might be helpful to open up once in a while.
445,11,12,76,99,1.3434343434343434,0.0675904094004639,540,"If you won't open up to me, I'm afraid I can't help you."
445,10,14,75,99,1.3434343434343434,0.06604786430791232,540,"That's not what I meant by practicing safe sex, Mr. Smith."
445,8,18,73,99,1.3434343434343434,0.06284929795204205,540,It appears you've been practicing safe sex.
445,6,22,71,99,1.3434343434343434,0.059478972137157145,540,"Turn to the left, cough, then to the right, cough, then back to the left"
449,6,23,73,102,1.3431372549019607,0.058279043498732024,540,I do sense that you are holding a lot inside.
449,10,15,77,102,1.3431372549019607,0.06459872409101204,540,"I'm sorry, but I can't help you unless you're willing to open up."
449,7,21,74,102,1.3431372549019607,0.059921481723101605,540,"120 over 80 - yes, keep going."
452,10,16,79,105,1.3428571428571427,0.06322900327420725,540,"Yes, you're in good enough condition for safe sex."
452,9,18,78,105,1.3428571428571427,0.061763716467676456,540,"'Tell me, do you practice safe sex?'"
454,3,33,78,114,1.3421052631578947,0.04957347554990201,540,"Now, turn your handle and cough"
455,5,30,82,117,1.3418803418803418,0.051734422875160495,540,"As your doctor, I need you to be open with me"
456,8,25,87,120,1.3416666666666666,0.054869125335043206,540,You can pick up our pamphlet on safe sex on your way out.
457,9,13,69,91,1.3406593406593406,0.06850894119124418,540,What do I have to do to get you to open up?
457,5,21,65,91,1.3406593406593406,0.06096453105162358,540,You need to stop holding everything in.
459,9,14,71,94,1.3404255319148937,0.06688341251177492,540,So you're saying you felt a click at 33 when it should have been at 31?
459,4,24,66,94,1.3404255319148937,0.05770171463825314,540,"Just to be safe, I'm going to prescribe a combination of treatments."
461,10,13,74,97,1.3402061855670102,0.06697725856892776,540,How long have you had this coffer?
462,4,26,70,100,1.34,0.055450405541776465,540,Turn to the left . . . now cough.
462,6,22,72,100,1.34,0.058981250230796894,540,"Cough once to the left, four to the right, and three to the left."
464,9,17,77,103,1.3398058252427185,0.06255155582830443,540,"No, you're safe."
464,10,15,78,103,1.3398058252427185,0.06405516798542525,540,I need you to relax and click normally.
466,6,25,78,109,1.3394495412844036,0.055637325378165896,540,Well it's safe to say you're not suffering from an iron deficiency.
467,6,26,80,112,1.3392857142857142,0.054633403595055446,540,"""Cough!"" 3 times right, 16 times left , 20 times right."
467,13,12,87,112,1.3392857142857142,0.06411657285371967,540,"I do believe your heart is healthy enough for sex, Mr. Houdini, but I still want you to read the pamphlet on safe sex."
467,7,24,81,112,1.3392857142857142,0.05608639718555095,540,You have to open up if you want me to help you.
467,7,24,81,112,1.3392857142857142,0.05608639718555095,540,"Now turn your dial to the right, 2 times to the left, once to the right, and cough."
471,8,23,84,115,1.3391304347826087,0.05644834758737767,540,Do you know how long you've had this clicking sound in your chest?
472,8,24,86,118,1.3389830508474576,0.05544434049132399,540,I'm going to need you to open up for me.
473,7,27,87,121,1.3388429752066116,0.05320799538122272,540,"I resent the term, ""Cracker."""
474,6,17,63,86,1.3372093023255813,0.06535280474395304,540,You'd feel so much better if you opened up a little.
475,3,24,62,89,1.3370786516853932,0.057492328006007315,540,Thinking inside the box appears to be your problem.
475,9,12,68,89,1.3370786516853932,0.06955245120791498,540,And you _always_ practice safe sex?
475,7,16,66,89,1.3370786516853932,0.06577855455392008,540,"When I said you should go to your ""safe-place"", this is not what I meant!"
475,7,16,66,89,1.3370786516853932,0.06577855455392008,540,Some of us are just meant to keep things inside.
479,7,17,68,92,1.3369565217391304,0.06424461641960307,540,Turn your wheel and cough.
479,8,15,69,92,1.3369565217391304,0.06607769882601316,540,I assume you're having safe sex.
481,7,18,70,95,1.3368421052631578,0.06280228367219882,540,It's to protect patient confidentiality. Now cough.
481,8,16,71,95,1.3368421052631578,0.06456075433401327,540,My advice is to rest up and lay off the junk bonds.
481,6,20,69,95,1.3368421052631578,0.06099313624261215,540,The problem is: you're not opening up.
481,4,24,67,95,1.3368421052631578,0.05720344690001541,540,Turn your handle and cough.
485,7,19,72,98,1.336734693877551,0.0614432587692449,540,"Mr. Schrodinger, can you hear me now?"
485,5,23,70,98,1.336734693877551,0.05791793484521681,540,It’s not healthy to keep these things locked up.
485,5,23,70,98,1.336734693877551,0.05791793484521681,540,I think if you just open up a little you'll feel better.
485,8,17,73,98,1.336734693877551,0.0631321430327626,540,Well I don't hear anything now. How often do you hear this clicking sound?
489,5,24,72,101,1.3366336633663367,0.05677335123497605,540,You'll feel a lot better if you open up.
489,8,18,75,101,1.3366336633663367,0.06178408222504038,540,You have fatty deposits.
491,10,15,79,104,1.3365384615384615,0.06352035204405569,540,It's OK to open up - you're in a safe space.
492,5,26,76,107,1.3364485981308412,0.05466095178218717,540,"It's a bad clicker, I'm afraid."
492,6,24,77,107,1.3364485981308412,0.05625082570940402,540,"Everything you say is just between us, so don't be afraid to open up."
494,7,23,80,110,1.3363636363636364,0.056705894048990776,540,"Well, I think you have a combination of things going on..."
494,4,29,77,110,1.3363636363636364,0.05210701877594693,540,Your high blood pressure is because you keep everything locked up inside.
494,8,21,81,110,1.3363636363636364,0.05815809566421682,540,"Now when I touch your tumbler, turn your dial and cough"
494,10,17,83,110,1.3363636363636364,0.060958801120706514,540,"I'm not hearing a heartbeat, you must be in finance."
498,8,22,83,113,1.336283185840708,0.057070580136378536,540,How long have you been feeling unsafe?
499,6,28,85,119,1.3361344537815125,0.05239908937112819,540,You're going to have to be more open with me.
500,10,22,93,125,1.336,0.0555837061295554,540,InYale.....ExYale.
501,6,18,66,90,1.3333333333333333,0.06320606175199696,540,Is it a chest cold?
501,6,23,76,105,1.3333333333333333,0.05688280263535928,540,I'd say your issues stem from a combination of things.
501,6,19,68,93,1.3333333333333333,0.06178983315544386,540,"What's wrong? Well, it could be a combination of things."
501,9,11,67,87,1.3333333333333333,0.07063818503771734,540,How long have you felt un-safe?
501,6,20,70,96,1.3333333333333333,0.060456354175834316,540,You just need to open up.
501,8,21,82,111,1.3333333333333333,0.05771137955900318,540,"I understand your need for privacy, but if I'm going to help you, you'll need to open up."
501,6,22,74,102,1.3333333333333333,0.058008985395295434,540,How long have you felt empty inside?
501,7,16,67,90,1.3333333333333333,0.06515131719569899,540,"My apologies, it'll warm up in a sec."
501,5,23,71,99,1.3333333333333333,0.0574307323005264,540,"If you want the proper diagnosis, I'm going to need you to open up."
501,7,22,79,108,1.3333333333333333,0.05734400634796978,540,How do you feel about combination therapy?
501,6,19,68,93,1.3333333333333333,0.06178983315544386,540,You have a complex combination of symptoms.
501,6,26,82,114,1.3333333333333333,0.053834010708841286,540,Is the combination therapy helping?
501,7,19,73,99,1.3333333333333333,0.06091449038731727,540,You're going to have to let me in if you want my help.
501,6,22,74,102,1.3333333333333333,0.058008985395295434,540,"So, you always use protection?"
501,7,17,69,93,1.3333333333333333,0.0636532604983765,540,"Even during safe sex, accidents can happen."
501,6,21,72,99,1.3333333333333333,0.059198243857910574,540,I'm hearing a combination of things.
501,5,22,69,96,1.3333333333333333,0.05861461007820391,540,How the devil do you expect me to do my job if you won't open up?
501,7,18,71,96,1.3333333333333333,0.0622436262266905,540,I'm afraid we're gonna have to open you up.
501,7,20,75,102,1.3333333333333333,0.05965885891765362,540,You need to come out. This is not what I meant by finding a safe place.
501,4,26,72,102,1.3333333333333333,0.05455976782448583,540,And when did you first notice this clicking sound?
501,2,25,60,87,1.3333333333333333,0.05584438862490346,540,When did you first notice these feelings of insecurity?
501,8,26,92,126,1.3333333333333333,0.05285499781147279,540,I'm detecting security issues.
501,3,26,67,96,1.3333333333333333,0.0547455571109822,540,I am here to help you release what you are keeping locked up inside.
501,3,25,65,93,1.3333333333333333,0.055827602575140446,540,Good. You're sounding like you're ready to open up.
501,7,20,75,102,1.3333333333333333,0.05965885891765362,540,"And how long have you been feeling, as you put it, unsafe?"
501,11,16,87,114,1.3333333333333333,0.0606166452768919,540,"Sir, I know prostate exams are uncomfortable, but I can't properly examine you this way!"
527,8,22,85,115,1.3304347826086957,0.056224649011225605,540,Don't be afraid to open up... You're safe with me.
527,6,26,83,115,1.3304347826086957,0.0534424976385093,540,"Okay, open up and let's have a look inside."
529,10,17,85,112,1.3303571428571428,0.060014467444351786,540,I'm checking to see if you can afford your copay
530,8,20,81,109,1.3302752293577982,0.05837161387245833,540,So the Tin Man referred me to you?
530,8,20,81,109,1.3302752293577982,0.05837161387245833,540,Just remember it's what's inside that counts.
532,6,23,77,106,1.330188679245283,0.056431303581759185,540,You think that sounds like a healthy combination?
532,4,27,75,106,1.330188679245283,0.053151697859074504,540,You'll be just fine. In your case feelings of withdrawal are normal.
534,8,18,77,103,1.3300970873786409,0.06075285889408112,540,You need to learn how to open up.
534,5,24,74,103,1.3300970873786409,0.05585523821903766,540,I think it's safe to say you're going to need a combination therapy.
534,7,20,76,103,1.3300970873786409,0.059165382232387966,540,You've got to open up!
537,5,23,72,100,1.33,0.05695115752497349,540,Turn your dial to the left and cough.
537,7,19,74,100,1.33,0.060394327113353526,540,It's safe to say you have a combination of issues.
537,7,19,74,100,1.33,0.060394327113353526,540,I'm afraid some of this money needs to come out.
540,6,20,71,97,1.3298969072164948,0.05992845369964017,540,You seem to have a combination of symptoms.
541,4,22,65,91,1.3296703296703296,0.0585851603619773,540,Now turn clockwise past zero and cough.
542,8,26,94,128,1.328125,0.05215505232734137,540,Turn your tumbler to the left and cough.
543,9,16,79,104,1.3269230769230769,0.06177954085067226,540,You just need to be more open.
543,6,22,76,104,1.3269230769230769,0.05706655917051207,540,Sounds to me like you have a combination of problems.
543,8,18,78,104,1.3269230769230769,0.0602495242332566,540,"Right 37, left 16, right 9 and call me in the morning."
546,9,15,77,101,1.3267326732673268,0.06310279354110175,540,"Yes, I understand that you have a hard tine opening up to strangers."
546,7,19,75,101,1.3267326732673268,0.05988257633678194,540,We are not going to get anywhere unless you are willing to open up.
546,4,25,72,101,1.3267326732673268,0.05469792996805201,540,"Yes, Mr. Zimmerman, if you come out I'll forego the prostate exam."
546,8,17,76,101,1.3267326732673268,0.06151376066142205,540,I need you to open up if I am going to help you
550,5,22,71,98,1.3265306122448979,0.057611316528512514,540,"I don't think your problem is physical, it seems like you are keeping something locked up inside you"
550,4,24,70,98,1.3265306122448979,0.055755451360594815,540,I would like to try to a new combination therapy.
550,8,16,74,98,1.3265306122448979,0.06285096736982555,540,"Cough to the right, left and right again."
550,7,18,73,98,1.3265306122448979,0.061154318437850894,540,So you feel a little empty inside.
550,8,16,74,98,1.3265306122448979,0.06285096736982555,540,Explain to me again exactly how you got up onto the couch
555,5,21,69,95,1.3263157894736841,0.05880882775937453,540,"Yes, I'll only take out enough to cover the deductible."
555,4,23,68,95,1.3263157894736841,0.056872788367533886,540,Your height to weight ratio might be part of the problem.
557,5,20,67,92,1.326086956521739,0.06007777975825816,540,"""You've taken quite a tumble, but I think you're safe."
557,6,18,68,92,1.326086956521739,0.0620341129050875,540,Sir? Sir. You're going to have to stop screaming. I can't hear the tumblers.
559,3,23,63,89,1.3258426966292134,0.057116802576714996,540,I can see that you're going to be a tough one to crack.
559,3,23,63,89,1.3258426966292134,0.057116802576714996,540,It sounds like a combination of problems.
561,5,18,63,86,1.3255813953488371,0.06285905991314623,540,Have you experienced any withdrawal since you've stopped taking currency?
562,5,16,59,80,1.325,0.06602406542458496,540,"Well, you don't suffer from an iron deficiency."
563,7,23,84,114,1.3245614035087718,0.05501635447956964,540,Now please describe the pain using three different numbers between one and one hundred.
563,6,25,83,114,1.3245614035087718,0.0535867881580589,540,I am listening for a combination of things.
565,7,21,80,108,1.3240740740740742,0.05708492592953681,540,Wait!! Wait!! Left 24...... is that MY left or YOUR left?
565,5,25,78,108,1.3240740740740742,0.05396802975210679,540,I'm trying to figure out what makes you tick.
567,8,18,79,105,1.3238095238095238,0.059754133143233565,540,"Let's just get your co-pay, then the doctor will be right with you."
567,9,16,80,105,1.3238095238095238,0.06126750044558263,540,We have to get you to open up.
569,9,15,78,102,1.3235294117647058,0.0625631340314206,540,Life is much simpler since I started treating the money directly rather than go through the patient.
569,5,23,74,102,1.3235294117647058,0.05601426154805487,540,It's a combination of factors.
569,6,21,75,102,1.3235294117647058,0.05772117945380879,540,"Okay, let's have you turn your dial to the left and cough."
569,5,23,74,102,1.3235294117647058,0.05601426154805487,540,Let's continue to work on your privacy issues.
569,8,17,77,102,1.3235294117647058,0.06099187387733384,540,"So, what makes you think that you're no longer safe?"
574,7,18,74,99,1.3232323232323233,0.06062323676075036,540,I'm afraid we have to crack you open.
574,4,24,71,99,1.3232323232323233,0.055287861646949536,540,Nothing wrong with the 'ol clicker. ..
574,7,18,74,99,1.3232323232323233,0.06062323676075036,540,"Take one turn plus two to the right, thirty three to the left and then fifteen to the right and call me in the morning."
574,7,18,74,99,1.3232323232323233,0.06062323676075036,540,When did you start forgetting your combination?
578,5,21,70,96,1.3229166666666667,0.05829220041013182,540,You say it only hurts when you're open?
579,6,18,69,93,1.3225806451612903,0.06146354792751873,540,I'm going to put you on a combination therapy.
580,10,19,92,121,1.322314049586777,0.05654769072975016,540,You have to want to be opened.
581,2,24,61,87,1.3218390804597702,0.055430209444874944,540,It sounds like you're ready to open up.
581,7,14,66,87,1.3218390804597702,0.06640067131371775,540,You're gonna need to be open with me.
583,5,27,83,115,1.3217391304347825,0.05173986756649167,540,We'll only make progress if you open up to me.
583,11,15,89,115,1.3217391304347825,0.05993618025515487,540,Been having safe sex?
585,8,19,82,109,1.3211009174311927,0.058117386724160454,540,I think we'll have to open you up.
586,3,20,58,81,1.3209876543209877,0.06041819409008473,540,"Well, at least you don't have an iron deficiency..."
587,8,18,80,106,1.320754716981132,0.05926651063843898,540,"If I'm to help you, you need to open up for me."
587,6,22,78,106,1.320754716981132,0.056152740312667544,540,Turn your tumbler and cough.
587,10,14,82,106,1.320754716981132,0.06222466007854541,540,Of course your public still love you Mr Houdini.
587,7,20,79,106,1.320754716981132,0.057730622410805864,540,It's safe to say we have a combination of things going on here.....
591,6,20,74,100,1.32,0.05839607015973771,540,I think we're going to have to drill.
591,6,20,74,100,1.32,0.05839607015973771,540,And how long would you say you've felt empty?
591,4,24,72,100,1.32,0.05482755334738734,540,You need a spin doctor.
591,4,24,72,100,1.32,0.05482755334738734,540,How long have you had this feeling of emptiness?
595,8,23,91,122,1.319672131147541,0.053677134019231014,540,"This would be a lot easier, if you'd just open up a little bit."
596,7,17,73,97,1.3195876288659794,0.0613885569929548,540,"The good news is you are SAFE, the bad news is we lost the combination."
596,5,21,71,97,1.3195876288659794,0.057784095260481914,540,"Yes, she's still ahead in the polls. No Bill, you can't come out until after the election."
598,4,22,68,94,1.3191489361702127,0.057022847306584766,540,Let's see if we can't get you to open up a little
599,5,26,82,113,1.3185840707964602,0.05223434795061094,540,"Yes, but when I said to go to your safe place, I was thinking to your room or maybe your favorite chair."
599,14,8,91,113,1.3185840707964602,0.06442575123257097,540,"Your 'BADA-BING' rhythm is normal, but I'm concerned about that 'BADA-BOOM' ."
601,6,23,81,110,1.3181818181818181,0.05469121475257513,540,"When you feel safe, I'm sure you'll open up."
601,4,27,79,110,1.3181818181818181,0.05155111665450746,540,Your third tumbler has a murmur.
601,8,19,83,110,1.3181818181818181,0.05766056116530558,540,Definitely no swimming until this clears up.
601,6,23,81,110,1.3181818181818181,0.05469121475257513,540,Now turn your dial clockwise to 23 and cough.
605,7,20,80,107,1.3177570093457944,0.057267051827607045,540,..and exhale to 13 on the left.
605,8,18,81,107,1.3177570093457944,0.05878648627262042,540,"Say ""ah,"" then turn two clicks to the left."
605,5,24,78,107,1.3177570093457944,0.054100311815326124,540,You're the only one who can afford my fees.
608,10,13,81,104,1.3173076923076923,0.06300957031775932,540,Yikes! Both the emails and the tax returns are in there.
608,7,19,78,104,1.3173076923076923,0.05839594557390375,540,The stethoscope may be a little warm.
608,6,21,77,104,1.3173076923076923,0.05677481802775082,540,"No, I'm afraid you're not too big to fail."
608,2,29,73,104,1.3173076923076923,0.04976498741625264,540,I'd recommend combination therapy.
612,10,12,79,101,1.316831683168317,0.06437928002775785,540,"Of course, this wouldn't have happened if you had practiced safe sex."
612,4,24,73,101,1.316831683168317,0.05437437709998407,540,You seem to have a combination of problems.
612,8,16,77,101,1.316831683168317,0.061226236965308135,540,You're pressure's very good -- 120 to the left over 80 to the right.
615,3,32,85,120,1.3166666666666667,0.04731344514515158,540,You really need to open up to me.
615,9,20,91,120,1.3166666666666667,0.05548782051907472,540,You will need to answer three security questions before I can change or reset your code.
617,5,21,72,98,1.316326530612245,0.05728432190197447,540,You're going to need to open up in order for me to help.
617,7,17,74,98,1.316326530612245,0.060846367247508235,540,I'll just need a bullion sample before you go.
617,7,17,74,98,1.316326530612245,0.060846367247508235,540,"If you're feeling insecure about yourself, remember, it's what you have inside you that counts."
620,7,23,87,117,1.3162393162393162,0.053810822104237,540,Great. Now I’ll just hold onto your handle while you cough.
620,7,23,87,117,1.3162393162393162,0.053810822104237,540,"Turn to 21, 7, and 18 and cough."
622,6,18,71,95,1.3157894736842106,0.060352005684042,540,"...Well if it was *all* safe sex, we wouldn't be starting you on penicillin, would we?"
622,5,20,70,95,1.3157894736842106,0.058467088386143826,540,"I'm sorry, if we can't find the combination, we're going to have to drill"
622,5,26,83,114,1.3157894736842106,0.05184949118976792,540,I now have the combination..but do you have insurance?
622,3,24,68,95,1.3157894736842106,0.05450203751132786,540,Please turn your dial and cough.
626,6,23,82,111,1.3153153153153154,0.05427201483361608,540,Now turn your head and cough up $500.
627,4,21,67,92,1.315217391304348,0.057685382884157636,540,You need to lose a few pounds.
628,7,20,81,108,1.3148148148148149,0.05681056213643335,540,"Nothing serious, just a small coffer."
628,6,22,80,108,1.3148148148148149,0.05526635236497289,540,I'm afraid we'll have to open you up?
628,10,14,84,108,1.3148148148148149,0.061209891111177334,540,"This may take a few sessions, but we'll get you to open up."
631,8,23,93,124,1.314516129032258,0.0529325381108483,540,"How's the claustaphobia now, Mrs. Swanson?"
632,5,23,77,105,1.3142857142857143,0.0546622759911792,540,"Your vitals are good; $200,000 in cash, some blue chips and a 3 carat ring."
632,5,23,77,105,1.3142857142857143,0.0546622759911792,540,You will feel better if you let go of the things you've been harboring inside.
632,8,17,80,105,1.3142857142857143,0.05947617141331808,540,go ahead and turn your knob and cough please.
635,3,21,62,86,1.313953488372093,0.05792024307021145,540,This works best if you are completely open with me...
635,5,17,64,86,1.313953488372093,0.06246559196667713,540,36-24-36? I don't think so.
637,4,24,74,102,1.3137254901960784,0.05392818653022643,540,What do I have to say to get you to open up to me?
637,8,16,78,102,1.3137254901960784,0.060702533270848714,540,Unfortunately I think we'll have to open you up.
639,4,18,61,83,1.3132530120481927,0.06163534627535529,540,"If you want to get better, you're going to have to open up."
640,8,15,76,99,1.3131313131313131,0.06199870435480761,540,You have taken a turn for the worse.
640,4,23,72,99,1.3131313131313131,0.05494785790666601,540,Spin your dial for me and cough.
640,7,17,75,99,1.3131313131313131,0.06031331758731997,540,This isn't what I meant when i said to practice safe sex.
643,4,22,70,96,1.3125,0.05602415675716037,540,"If you can't open up for me, you'll never feel safe again."
643,5,20,71,96,1.3125,0.05794829062159566,540,"You're OK, but your mover has a hernia."
643,6,23,83,112,1.3125,0.053858891972730416,540,"Just to be safe, let's open you up and take few samples"
643,5,20,71,96,1.3125,0.05794829062159566,540,"No, the election is over...it's safe to come out..."
643,4,22,70,96,1.3125,0.05602415675716037,540,I think you're suffering a symptom of combinations.
648,7,20,82,109,1.311926605504587,0.05636100284109719,540,I'm afraid we're going to need to open you up.
649,6,17,70,93,1.3118279569892473,0.06111496119161818,540,"It's ok, this is a safe place."
650,6,21,79,106,1.3113207547169812,0.055857615720622894,540,"If you keep things locked up, it leads to stress and high blood pressure."
650,10,13,83,106,1.3113207547169812,0.06195846440367467,540,"Now please turn left, then right, hold it, left, then right...."
650,8,17,81,106,1.3113207547169812,0.05898696697260421,540,It's okay to open up. This office is a safe place.
653,6,16,68,90,1.3111111111111111,0.06249982660539133,540,You have to open up and talk about this.
653,8,12,70,90,1.3111111111111111,0.0663747249032238,540,I'm afraid one type of treatment won't be enough. We'll need to use a combination.
653,6,16,68,90,1.3111111111111111,0.06249982660539133,540,"Yes, now you are healthy enough for safe sex"
653,3,22,65,90,1.3111111111111111,0.05618865237120389,540,I think we should try a combination therapy.
657,7,23,89,119,1.3109243697478992,0.0530348034807317,540,I assume you've been practicing Safe sex?
658,8,16,79,103,1.3106796116504855,0.06018741940563755,540,"Hello, are you in there? When I said safe sex this is not what I meant."
658,5,22,76,103,1.3106796116504855,0.05523968887866249,540,And you only hear this clicking sound when others are around?
660,4,19,64,87,1.3103448275862069,0.059648674770869235,540,Relax! It's a routine procedure. Open and shut.
660,6,24,86,116,1.3103448275862069,0.05254225557783599,540,"Cough, when I grab the dial."
662,2,27,71,100,1.31,0.05064233865696235,540,This therapy only works if you open up to me.
662,7,17,76,100,1.31,0.05978919195596703,540,"Yes, I think your heart is good enough for safe sex."
662,10,11,79,100,1.31,0.06465916857498308,540,"Turn 4 to the left, 6 to the right, 3 to the left and cough."
662,5,21,74,100,1.31,0.05630903187506485,540,"Relax,relax you're numbers are fine."
662,7,17,76,100,1.31,0.05978919195596703,540,Your number's not up .
667,5,25,83,113,1.3097345132743363,0.05195246967372173,540,It sounds to me like you're hiding something.
667,8,19,86,113,1.3097345132743363,0.05633065367882912,540,"We accept all medical insurance, not FDIC."
669,7,12,65,84,1.3095238095238095,0.06769754560591097,540,There's a copay.
670,2,26,69,97,1.309278350515464,0.051524909612968545,540,Next I'm going to check your numbers.
670,9,12,76,97,1.309278350515464,0.06448451548039588,540,So I assume you are practicing safe sex every time?
670,7,16,74,97,1.309278350515464,0.06106307781414728,540,"You've taken ""safe place"" way too far, Dennis."
670,7,16,74,97,1.309278350515464,0.06106307781414728,540,You're in good wealth.
674,5,24,81,110,1.309090909090909,0.05285108123995779,540,"I know you say,'Better safe than sorry,' but you shouldn't keep everything locked up inside."
674,4,26,80,110,1.309090909090909,0.05124871819704169,540,"It's a combination of symptoms, really..."
676,5,28,90,123,1.3089430894308942,0.049156664069002654,540,It sounds to me like you’re having trouble opening up.
677,6,13,62,81,1.308641975308642,0.06722446118549126,540,"Dammit, Jim! I'm a doctor, not a safecracker!"
678,4,21,69,94,1.3085106382978724,0.0566481507384142,540,Don't worry. We can crack this thing.
678,6,17,71,94,1.3085106382978724,0.060552243400987533,540,"Take 16 deep breaths right, 27 deep breaths left, and 42 deep breaths right."
680,8,17,82,107,1.308411214953271,0.058505478515013275,540,I need you to open up for me.
680,7,19,81,107,1.308411214953271,0.05697855099083797,540,Try to relax. You are perfectly safe.
682,5,18,68,91,1.3076923076923077,0.05989879069168814,540,Sounds like a case of the common code
682,7,14,70,91,1.3076923076923077,0.06384563896404478,540,Have you been having unsafe sex?
682,9,14,81,104,1.3076923076923077,0.06122492944857226,540,... and exhale on 75-29-61-0.
682,6,20,78,104,1.3076923076923077,0.056465675359676025,540,36-12-4...the numbers are a little irregular but nothing to worry about.
682,6,20,78,104,1.3076923076923077,0.056465675359676025,540,Are you insured?
682,6,24,87,117,1.3076923076923077,0.052158731047754654,540,I'm not sure what your problem is. It could be a combination of things.
682,8,16,80,104,1.3076923076923077,0.05968069611353861,540,"Cough once to the right. Okay, now twice to the left. Then, once more to the right."
689,8,19,87,114,1.3070175438596492,0.05590040517964037,540,And what makes you feel so unsafe?
689,7,21,86,114,1.3070175438596492,0.05449403549126256,540,Your tumblers are spasmodic. Was the recent entry consensual?
689,9,17,88,114,1.3070175438596492,0.05727225064874738,540,"Inhale to right 20, exhale to 5 left, then inhale to 17 right"
689,6,23,85,114,1.3070175438596492,0.053050395936298185,540,Now exhale slowly and turn right two clicks.
693,3,25,73,101,1.306930693069307,0.05216609850423561,540,Sounds like you've got something in your chest.
693,6,19,76,101,1.306930693069307,0.057579173657618665,540,I feel like you're not opening up to me
693,6,19,76,101,1.306930693069307,0.057579173657618665,540,How long have you had this empty feeling?
693,8,15,78,101,1.306930693069307,0.060921267575901626,540,"No, I don't view my patients as ATMs"
693,6,19,76,101,1.306930693069307,0.057579173657618665,540,That's OK. Sometimes it's hard to open up.
693,4,23,74,101,1.306930693069307,0.05403074712729605,540,I need you to come out of your safe space.
699,6,15,67,88,1.3068181818181819,0.06334038873171759,540,I'm not sure. It could be a combination of things.
699,5,17,66,88,1.3068181818181819,0.06124354516870644,540,"There's no such thing as ""safe sex."""
701,9,16,86,111,1.3063063063063063,0.05835977094987886,540,I think we can rule out claustrophobia.
702,6,18,74,98,1.3061224489795917,0.05875516865196881,540,You're locked up for a combination of reasons.
702,6,18,74,98,1.3061224489795917,0.05875516865196881,540,I need you to be open with me if I'm going to help.
702,9,12,77,98,1.3061224489795917,0.0639010966298366,540,"If you don't start opening up to people, you will always feel empty inside."
705,4,29,88,121,1.3057851239669422,0.0481660568940759,540,We really need to explore your trust issues
705,5,27,89,121,1.3057851239669422,0.04957529711010628,540,"If we are going to make any progress, you're going to have to open up a little."
707,11,11,86,108,1.3055555555555556,0.06234476510324979,540,"Okay, now six to the right and another deep breath, please? Good."
707,7,19,82,108,1.3055555555555556,0.05652069240257545,540,Turn your head and cough while I examine your tumblers.
709,5,19,71,95,1.305263157894737,0.05810305593288958,540,This may feel a little cold to the touch.
709,6,17,72,95,1.305263157894737,0.05999941061772172,540,"I assure you, the clicking sound is completely normal."
711,7,22,89,118,1.305084745762712,0.05316094828682091,540,You could lose a little weight.
712,6,20,79,105,1.3047619047619048,0.05600204327088937,540,"As I've told you before, the clicking is perfectly normal."
712,3,26,76,105,1.3047619047619048,0.05086038046519133,540,"I'm glad you came, better safe than sorry"
712,4,24,77,105,1.3047619047619048,0.05263011005322143,540,You have a combination of conditions.
712,7,18,80,105,1.3047619047619048,0.057614052397524936,540,Good news- your blood pressure is 96 right over 68 left
712,6,20,79,105,1.3047619047619048,0.05600204327088937,540,"Doctor, I just don't feel safe enough to open up to anyone."
717,6,23,86,115,1.3043478260869565,0.05265478876691291,540,This is what you get for keeping things locked up inside.
717,6,16,70,92,1.3043478260869565,0.06131839168480321,540,Ok. Now what's your mothers' maiden name?
717,7,14,71,92,1.3043478260869565,0.06323635585681953,540,It sounds like I can retire.
717,8,12,72,92,1.3043478260869565,0.0650978359493592,540,"Would you prefer to reschedule your prostate exam, Mr. Adams?"
717,4,27,84,115,1.3043478260869565,0.04967309309369387,540,The three drugs didn't work. It's safe to say you'll need a new combination.
717,5,18,69,92,1.3043478260869565,0.05933846657583573,540,I'm afraid it's not an open and shut case.
723,9,13,80,102,1.303921568627451,0.06198241821820111,540,How long have you been experiencing these feelings of insecurity?
723,4,23,75,102,1.303921568627451,0.053582971776036166,540,I've never worked this hard for a copay.
723,6,19,77,102,1.303921568627451,0.05709123387947828,540,"That's it relax, open up, let it all out."
723,9,13,80,102,1.303921568627451,0.06198241821820111,540,You have poor circulation.
723,7,17,78,102,1.303921568627451,0.05876687882341709,540,"You sir, are one tough nut to crack."
728,6,12,61,79,1.3037974683544304,0.0682569899447785,540,It appears you're right after all. You are empty inside.
729,5,24,83,112,1.3035714285714286,0.052048273730341064,540,Don't be nervous -- it's a routine audit.
729,6,22,84,112,1.3035714285714286,0.05357142857142856,540,Good you came in. Better safe than sorry.
729,8,18,86,112,1.3035714285714286,0.056494674801559785,540,"Sir, if you can hear me, I've figured out why you're feeling claustrophobic."
729,7,20,85,112,1.3035714285714286,0.05505245789298452,540,It's nothing that a little infusion of cash won't cure.
733,7,13,69,89,1.303370786516854,0.06472321516829782,540,"We'll need an X-ray, but I suspect the family jewels are still intact"
733,4,19,66,89,1.303370786516854,0.05850646747994829,540,A feeling of emptiness is not uncommon. There are some great new combination therapies I can suggest.
735,5,27,90,122,1.3032786885245902,0.04923110777692677,540,You'll have to open up to me eventually.
735,9,19,94,122,1.3032786885245902,0.05445763454722344,540,"Yes, it will probably be effective. But no form of birth control is 100%."
737,3,24,72,99,1.303030303030303,0.05266461065193263,540,It's hypertension. You've got to learn to open up.
737,8,14,77,99,1.303030303030303,0.06167881752716453,540,"Don't worry. Thanks to physician-patient privilege, your combination is safe with me."
737,5,20,74,99,1.303030303030303,0.0564433108675554,540,"And a deep breath for me in 1, 32, 16."
737,4,22,73,99,1.303030303030303,0.05458666758839174,540,You need to learn to open up!
737,3,24,72,99,1.303030303030303,0.05266461065193263,540,"Yes, Mr. Morris, I did advise you to lock up your meds, but I didn't expect you to stay with them."
737,4,22,73,99,1.303030303030303,0.05458666758839174,540,Maybe you shouldn't keep everything locked up inside of you.
737,5,20,74,99,1.303030303030303,0.0564433108675554,540,This will never work unless you open up.
744,7,19,83,109,1.3027522935779816,0.05606987285089937,540,"I'm not a psychiatrist, but I sense you have a problem opening up."
745,5,19,72,96,1.3020833333333333,0.05758249548734154,540,Believing you're Harry Houdini is one thing. Five minutes without oxygen is another.
745,5,19,72,96,1.3020833333333333,0.05758249548734154,540,How's your family life? Are you still locking everyone out?
747,7,18,81,106,1.3018867924528301,0.05714031423930504,540,It's safe to open up and share your feelings with me.
747,6,20,80,106,1.3018867924528301,0.0555456658259613,540,Combination therapy? It mostly works from the inside out.
747,9,14,83,106,1.3018867924528301,0.060203027747787304,540,You have to stop keeping everything inside
750,7,21,88,116,1.3017241379310345,0.053679915901996444,540,"Ok, left 31. Wait...is that your left or mine?"
751,7,11,65,83,1.3012048192771084,0.0679988499648567,540,I think you're experiencing feelings of insecurity.
752,4,20,69,93,1.3010752688172043,0.05676519684479411,540,This calls for a combination therapy
753,5,21,77,103,1.3009708737864079,0.054904086204536746,540,You're going to need a cash infusion.
753,8,15,80,103,1.3009708737864079,0.05987955334881756,540,You're lucky. I'm one of the few doctors with a rap sheet.
753,5,21,77,103,1.3009708737864079,0.054904086204536746,540,"Your tumblers are fine, but your Wells Fargo shares are collapsing."
753,8,15,80,103,1.3009708737864079,0.05987955334881756,540,"There's no simple diagnosis, sir. It's a combination of things."
753,8,15,80,103,1.3009708737864079,0.05987955334881756,540,You can relax. You're in a safe space.
758,6,22,85,113,1.3008849557522124,0.05316314927886814,540,"Just a warning, my stethoscope may feel a bit cold...."
759,4,19,67,90,1.3,0.05795085954795724,540,"OK, two spins to the right and cough"
759,5,23,82,110,1.3,0.05254173447414248,540,It sounds like you're keeping something locked up inside you.
759,6,21,83,110,1.3,0.054105817921403974,540,"If you want this therapy to work, you're going to have to open up."
759,5,20,75,100,1.3,0.05595813731096785,540,Since when have you been feeling so empty on the inside?
759,6,21,83,110,1.3,0.054105817921403974,540,I don't hear anything. I think your safe.
759,6,18,76,100,1.3,0.05773502691896258,540,You've got stones- I'd say about 25 carats worth of diamonds.
759,7,13,70,90,1.3,0.06408873374282763,540,I'm going to prescribe a combination therapy.
759,2,20,58,80,1.3,0.057368451613289434,540,It seems to be a combination of things.
759,1,25,64,90,1.3,0.05108070528032167,540,Your sickness could be due to a combination of things.
759,5,17,68,90,1.3,0.06006654653369374,540,Try to be more open.
759,8,17,85,110,1.3,0.05710561159579481,540,"It sounds like you're saying, ""I'm locked in this vault""."
770,6,23,88,117,1.2991452991452992,0.05188029089833095,540,I think we should open you up and take a look.
771,4,24,79,107,1.2990654205607477,0.05179710507006375,540,I want to try combination therapy.
771,6,20,81,107,1.2990654205607477,0.05509638445623759,540,"I'm sorry sir, but I wouldn't recommend even safe sex."
773,5,19,73,97,1.2989690721649485,0.05707080302488788,540,Do't worry this is a safe operation
773,4,21,72,97,1.2989690721649485,0.055157047832558495,540,I'm afraid you may be getting too much iron in your diet.
775,8,10,69,87,1.2988505747126438,0.06763848452873501,540,"Still no trace of that $915,729,293."
775,5,16,66,87,1.2988505747126438,0.06142507607043006,540,"So, he cleaned you out, ran off with the nanny, and left you scared to ever open up again."
777,6,22,86,114,1.2982456140350878,0.05276079981200326,540,"So, you've been feeling empty since your bonds matured?"
778,6,19,79,104,1.2980769230769231,0.05613884368939095,540,I suppose we can count on you paying your deductible upfront.
778,8,15,81,104,1.2980769230769231,0.05937156529479484,540,"The cat is alive! ... wait - dead .... no, wait - alive!"
778,6,19,79,104,1.2980769230769231,0.05613884368939095,540,You're a tough case to crack....
778,5,21,78,104,1.2980769230769231,0.05445055806321695,540,Your mother was right. It's not healthy to keep everything locked up inside of you.
782,5,18,71,94,1.297872340425532,0.05824746872144231,540,I can't help unless you are open with me.
783,6,21,84,111,1.2972972972972974,0.053684238623566895,540,"Your heart sounds good, but your iron levels are a little high."
784,4,22,75,101,1.297029702970297,0.05366665438759467,540,It's hard to diagnose your problem -- I've never run across this combination before.
784,7,16,78,101,1.297029702970297,0.058942083430246414,540,When Houdini did it--he remembered the combination.
784,6,18,77,101,1.297029702970297,0.05723765715958271,540,"It's a combination of symptoms, but I think you're safe."
784,5,20,76,101,1.297029702970297,0.05548089396483922,540,"Yes, I understand, but I think you'll find that you still can't take it with you."
788,4,19,68,91,1.2967032967032968,0.0574052396312373,540,It sounds like that WD-40 is working.
788,3,21,67,91,1.2967032967032968,0.055237317937419206,540,"Don't be embarassed, a lot of men have trouble opening up."
788,5,17,69,91,1.2967032967032968,0.059494216368652354,540,You'll feel better if you just open up and let it all out.
791,6,23,89,118,1.2966101694915255,0.05150118180537397,540,I assume your copay is inside.
792,5,22,81,108,1.2962962962962963,0.0530470954299222,540,"Don't be embarassed, you can open up to me."""
792,9,14,85,108,1.2962962962962963,0.059213810886178525,540,The withdrawal you're experiencing is very common after a divorce.
792,8,16,84,108,1.2962962962962963,0.057733916662009895,540,Opening up will make you feel better.
792,4,24,80,108,1.2962962962962963,0.05138992184293592,540,"I think we need to open you up, just to be safe."
792,6,20,82,108,1.2962962962962963,0.05465404468179352,540,So your wife says you have trouble opening up. Tell me about that.
792,2,28,78,108,1.2962962962962963,0.047903898943266,540,I'm going to need you to open up so I can help you.
798,3,23,72,98,1.2959183673469388,0.05271741207780622,540,I'm going to try a combination of therapies.
798,3,23,72,98,1.2959183673469388,0.05271741207780622,540,"You can't stay in there forever, Mr. Houdini"
800,7,20,88,115,1.2956521739130435,0.05380121765467388,540,"Now, I warned you before about practicing safe sex!"
800,8,18,89,115,1.2956521739130435,0.05520078190046145,540,If you want to be cracked I recommend you see a chiropractor.
802,3,25,77,105,1.2952380952380953,0.05049899270712218,540,Relax. You're in a safe place.
802,6,19,80,105,1.2952380952380953,0.05567404075405816,540,"But really, I can't help you if you don't open up."
802,5,21,79,105,1.2952380952380953,0.054004153828519016,540,"This is a safe space, you can open up to me."
805,6,24,92,122,1.2950819672131149,0.050318757127076404,540,You're safe for now.
805,6,24,92,122,1.2950819672131149,0.050318757127076404,540,You'd rather be safe than sorry.
807,5,13,60,78,1.294871794871795,0.06607036269638067,540,These HIPAA rules are a bit much.
808,8,12,75,95,1.2947368421052632,0.06326977772044287,540,"Yes, yes. 25. Good. Now tell me about some other numbers important to you."
808,7,14,74,95,1.2947368421052632,0.061474389846998614,540,I hope she doesn't want to see my family jewels.
810,7,24,98,129,1.2945736434108528,0.04971222999372348,540,I hear you-- it's awful when they only want you for your money.
811,2,31,86,119,1.2941176470588236,0.045213795529116786,540,Now just click your tumblers for me.
811,6,18,78,102,1.2941176470588236,0.05674849111013065,540,I'm going to need you to cough while I hold your ball bearings.
813,6,20,83,109,1.2935779816513762,0.05421849601211906,540,"I don't know what makes you click, but getting you to open up is the goal of this session."
813,6,20,83,109,1.2935779816513762,0.05421849601211906,540,Sounds like we'll have to open you up.
813,3,26,80,109,1.2935779816513762,0.04929463778032701,540,I see you've been taking your iron pills.
813,6,20,83,109,1.2935779816513762,0.05421849601211906,540,"Say ""Click""."
813,7,18,84,109,1.2935779816513762,0.055763249323579414,540,"I don't like it any more than you, but my hand does need to go in there."
813,6,20,83,109,1.2935779816513762,0.05421849601211906,540,"I'm sorry to say, but these numbers don't sound good."
813,6,20,83,109,1.2935779816513762,0.05421849601211906,540,'Then why do I feel you're not being open?'
820,6,15,71,92,1.2934782608695652,0.06092542314536813,540,"Come on out, Mr. Dorning. A colonoscopy is nothing to be afraid of."
820,6,15,71,92,1.2934782608695652,0.06092542314536813,540,"It's not a dead bolt, and you're not unhinged, but maybe it's a combination."
822,13,3,83,99,1.292929292929293,0.06923400020718704,540,TO the New Yorker Judges. I thought that last weeks cartoon (Hiker on the cliff) closed October 3. If so how do I submit? Thank you.
823,7,10,65,82,1.2926829268292683,0.06829053207780028,540,Do you have insurance or will you be paying out of pocket?
824,4,23,79,106,1.2924528301886793,0.051860239877552804,540,You have a combination of issues.
824,9,13,84,106,1.2924528301886793,0.059899558234957975,540,It's in your best interests to open up.
824,5,21,80,106,1.2924528301886793,0.05356471786049544,540,Dial twice to your left and cough.
827,8,10,71,89,1.2921348314606742,0.06627828320860067,540,And have you been practicing safe sex?
827,8,10,71,89,1.2921348314606742,0.06627828320860067,540,I need to know more about that combination of symptoms. Could you open up a bit?
827,4,18,67,89,1.2921348314606742,0.05806341675639466,540,"""And how long have you had these feelings locked up?"
827,6,14,69,89,1.2921348314606742,0.062306384867468645,540,I have some bad news about your family jewels.
831,6,21,86,113,1.2920353982300885,0.05285977192705318,540,You'll get a lot more out of our sessions if you open up to me.
832,6,23,91,120,1.2916666666666667,0.05075871595662061,540,You really need to open up.
832,7,14,75,96,1.2916666666666667,0.06090808913139065,540,And I recommend you stop falling onto coyotes.
832,5,18,73,96,1.2916666666666667,0.05719439509610499,540,So when did you first start feeling unsafe?
832,3,22,71,96,1.2916666666666667,0.053222197804875436,540,"I'm going to run some tests, you know, just to be on the safe side."
832,6,16,74,96,1.2916666666666667,0.059080428874741533,540,I really think it would be best if you opened up
837,4,22,77,103,1.2912621359223302,0.052775737798031803,540,"I'm a firm believer in doctor-patient confidentiality. Now, open wide."
837,9,12,82,103,1.2912621359223302,0.06113195192061524,540,Next time I will have to insist on check or credit card.
837,8,14,81,103,1.2912621359223302,0.05955458115481001,540,I'm sorry. Your number's up.
840,3,26,81,110,1.290909090909091,0.04891730958351892,540,I think it's a combination of maladies.
840,5,22,83,110,1.290909090909091,0.05221603699703269,540,Take 2 - 28 -14 and call me in the morning.
842,6,13,67,86,1.2906976744186047,0.06377602538914648,540,"Mr. Johnson, would you be more comfortable with a male urologist?I"
843,6,22,89,117,1.2905982905982907,0.051588142404591565,540,"The good news is, I don't think you've been cracked."
844,8,11,74,93,1.2903225806451613,0.0641057542154897,540,Let's follow up next week to be on the safe side.
844,8,11,74,93,1.2903225806451613,0.0641057542154897,540,There's no such thing as safe sex. I recommend abstinence.
844,8,11,74,93,1.2903225806451613,0.0641057542154897,540,You're definitely a coffer.
847,9,11,80,100,1.29,0.06243380332784315,540,And how long have you had these feelings of insecurity?
847,5,19,76,100,1.29,0.055586859867229325,540,"Before I try dynamite, you'll need to sign a release."
847,2,25,73,100,1.29,0.049838121792844324,540,"Yes, I'm listening, but I won't know anything for sure until I crack you open and get a look inside."
850,6,19,82,107,1.2897196261682242,0.05476637319503821,540,I am afraid I will need to remove your cash.
850,6,19,82,107,1.2897196261682242,0.05476637319503821,540,"You'll be OK, it's only money."
850,7,17,83,107,1.2897196261682242,0.05635327298563374,540,Now cough up the money.
850,4,23,80,107,1.2897196261682242,0.05144593420696998,540,"Your condition could get worse, but you're safe for now."
850,5,21,81,107,1.2897196261682242,0.05313209848747781,540,"I can hear you, but you still sound a bit guarded."
855,4,27,90,121,1.2892561983471074,0.047583501390032326,540,"Yes, we practice patient confidentiality."
856,4,18,68,90,1.288888888888889,0.05750632477714423,540,Maybe we should try a different combination.
856,6,14,70,90,1.288888888888889,0.06169564951963022,540,I will tell you the bill when I see what's inside.
856,3,20,67,90,1.288888888888889,0.05529276172553749,540,"Don't worry, Mr. Houdini, your secret is safe with me."
859,8,12,77,97,1.288659793814433,0.062105737360576695,540,Safe to say it's a large chest cold.
859,8,12,77,97,1.288659793814433,0.062105737360576695,540,"Yes, I think your heart is strong enough for safe sex."
859,7,14,76,97,1.288659793814433,0.060351851510939795,540,I'm afraid you have taken a turn for the worse
859,4,20,73,97,1.288659793814433,0.05475414216195255,540,"Ok, now try thinking outside the box."
863,6,18,80,104,1.2884615384615385,0.05579401216041786,540,Do your valuables hurt?
863,8,14,82,104,1.2884615384615385,0.05904561616012719,540,Your combination will remain confidential.
865,8,16,87,111,1.2882882882882882,0.05635297001677271,540,I detect a lack of openness on your part.........
865,7,18,86,111,1.2882882882882882,0.054880388718659065,540,"Well sir, your illness could be caused by a combination of many things."
865,6,20,85,111,1.2882882882882882,0.05336718937803411,540,Click. Hold it ... Click again...
865,6,20,85,111,1.2882882882882882,0.05336718937803411,540,It's safe to say you have nerves of steel and a cast iron stomach.
869,10,14,94,118,1.2881355932203389,0.05658402711433219,540,"True, you're better than sorry."
869,7,20,91,118,1.2881355932203389,0.0526037875969292,540,"So you say you practice safe sex, right?"
871,6,9,58,73,1.2876712328767124,0.07161820612492294,540,"Governor Pence, if you give me the combination, I promise to prescribe complete bed rest until Nov. 8."
872,4,17,66,87,1.2873563218390804,0.05874033212156991,540,It's not healthy to keep things locked up inside.
872,1,23,63,87,1.2873563218390804,0.05146359877298256,540,I just want to check your clicker.
874,4,19,71,94,1.2872340425531914,0.05582586504349464,540,Your condition calls for a combination therapy.
874,4,19,71,94,1.2872340425531914,0.05582586504349464,540,"If you genuinely want my help, you'll have to be more open."
874,5,17,72,94,1.2872340425531914,0.057838635938787894,540,The stethoscope didn't work on the Tin Man either
874,5,17,72,94,1.2872340425531914,0.057838635938787894,540,"Don't worry, it is an entirely safe procedure."
874,6,15,73,94,1.2872340425531914,0.05978368010305837,540,"If you cough up the combination, I can check the family jewels"
874,3,21,70,94,1.2872340425531914,0.05373775775420209,540,I'm afraid you're empty inside.
874,3,21,70,94,1.2872340425531914,0.05373775775420209,540,I know you two are in there.I can hear your heavy breathing. But this is definitely not what I meant when I suggested safe sex.
881,6,17,78,101,1.2871287128712872,0.05687685788651514,540,"No, I'm sure. You're not impregnable."
881,7,15,79,101,1.2871287128712872,0.058591780695102944,540,"God, that's cold!"
881,5,19,77,101,1.2871287128712872,0.05510859425772574,540,Exactly how long ago did you start feeling empty?
881,7,15,79,101,1.2871287128712872,0.058591780695102944,540,"Sounding good, Mr. Hamilton. We may not have to open you up after all."
881,4,21,76,101,1.2871287128712872,0.05328167939435134,540,There could be too much iron in your diet
881,3,23,75,101,1.2871287128712872,0.05138985850439993,540,I think we'll just open you up and see what we've got.
881,6,17,78,101,1.2871287128712872,0.05687685788651514,540,And you're sure you can pay for this?
881,2,25,74,101,1.2871287128712872,0.04942567910633144,540,"Unfortunately, this physical is not covered by the FDIC."
889,4,23,81,108,1.287037037037037,0.0510379051440824,540,"Look, if you can open up now, you'll save fifteen years of therapy."
889,7,17,84,108,1.287037037037037,0.05589345722963452,540,You seem tense. Keeping anything locked up?
889,6,19,83,108,1.287037037037037,0.05432318376671947,540,Are you sure you practiced safe sex?
889,5,21,82,108,1.287037037037037,0.052706147914873866,540,Out! That's not what I meant by safe sex.
893,7,21,94,122,1.2868852459016393,0.05137258167851918,540,I know you don't like either candidate but you can't stay in there forever.
894,6,18,81,105,1.2857142857142858,0.05532833351724881,540,Sounds like it's time for another cashectomy.
894,6,14,71,91,1.2857142857142858,0.06109644147858852,540,It's all right - your secret's safe with me!
894,4,14,59,77,1.2857142857142858,0.06365798173681603,540,You can't keep your emotions locked up like this.
894,6,12,66,84,1.2857142857142858,0.0646528054078931,540,Shall we start with exploring your defensiveness?
894,3,20,68,91,1.2857142857142858,0.054773848036684974,540,Don't worry Mr. Jones. Just a couple more weeks and the elections will be over.
894,6,18,81,105,1.2857142857142858,0.05532833351724881,540,"Don't worry, we'll have you emptied out in no time."
894,6,18,81,105,1.2857142857142858,0.05532833351724881,540,If you want me to be your doctor you have to open up with me!
894,5,18,75,98,1.2857142857142858,0.056177411259972464,540,I'm ruling out an iron deficiency.
894,6,16,76,98,1.2857142857142858,0.05801978086477823,540,I'm going to have to ask you to dial it back a notch.
894,7,12,72,91,1.2857142857142858,0.06306326510375779,540,You should cut down on those 'combination platters.'
894,7,10,67,84,1.2857142857142858,0.066834474485521,540,Need I remind you again about safe sex practices?
894,8,6,63,77,1.2857142857142858,0.07361652421459294,540,"Okay, now turn to the right and cough."
894,6,18,81,105,1.2857142857142858,0.05532833351724881,540,"If this therapy is going to work, your going to have to open up to me."
894,5,20,80,105,1.2857142857142858,0.053647686871343615,540,"As you know, I've only started taking patients who are financially secure."
894,6,18,81,105,1.2857142857142858,0.05532833351724881,540,I'm trying to hear the money talk
909,4,27,92,123,1.2845528455284554,0.04692365390058747,540,I can listen to you all day but for this therapy to work you're going to have to really open up to me.
910,4,25,87,116,1.2844827586206897,0.048679773132767,540,My personal diagnosis is that you need to open up more.
910,3,27,86,116,1.2844827586206897,0.047114703382027195,540,"""Not good. I hear only pennies."
912,5,21,83,109,1.2844036697247707,0.05228672213346447,540,"Just to be safe, I'm going to need to look inside."
913,6,17,79,102,1.2843137254901962,0.0563867909723063,540,You'll have to remove all jewelry prior to the procedure.
913,7,15,80,102,1.2843137254901962,0.05808276213231825,540,Bob took his doctor's admonition of having safe sex a bit too far.
915,3,21,71,95,1.2842105263157895,0.05325498655943968,540,And when was your last break-in?
915,7,13,75,95,1.2842105263157895,0.06108969026259694,540,You should really lay off the crackers.
915,4,19,72,95,1.2842105263157895,0.05531778881318001,540,You need to open up more often.
915,5,17,73,95,1.2842105263157895,0.05730638642344382,540,We can't get anywhere if you won't open up.
915,5,17,73,95,1.2842105263157895,0.05730638642344382,540,"Do you have insurance, or would you like to pay cash?"
920,2,19,60,81,1.2839506172839505,0.05620335624735821,540,Do you tend to hold a lot in?
921,9,16,95,120,1.2833333333333334,0.05446882969212648,540,"No, Trump is still running - you can't come out yet!"
921,7,20,93,120,1.2833333333333334,0.05183378592397002,540,"Frankly, for your age, withdrawal anxieties are quite normal."
923,6,20,87,113,1.2831858407079646,0.05254133666830936,540,A combination of things could be making you feel unsafe
924,4,22,80,106,1.2830188679245282,0.05149118153223209,540,Don't you think it's time you just open up to me?
924,5,20,81,106,1.2830188679245282,0.053207483448312415,540,I know you've got a co-pay in there somewhere.
924,3,24,79,106,1.2830188679245282,0.04971566409360453,540,I suspect someone has hacked your Tumbler account!
924,5,20,81,106,1.2830188679245282,0.053207483448312415,540,Now turn left and click.
928,6,16,77,99,1.2828282828282829,0.05750320013036443,540,"...it's a combination of symptoms, but it's what's on the inside that really matters."
928,5,18,76,99,1.2828282828282829,0.055681908749133445,540,Turn your cylinders to the left and cough.
928,5,18,76,99,1.2828282828282829,0.055681908749133445,540,I just want you to go back to when you were just a little safety deposit box.
928,4,20,75,99,1.2828282828282829,0.05379899533133405,540,We're going to have to open you up.
928,6,16,77,99,1.2828282828282829,0.05750320013036443,540,"Until we do some tests, I would say it's not one thing -- it's a combination."
933,7,12,73,92,1.2826086956521738,0.06245129388654502,540,"Mr. Fulton, the prostate exam isn't that bad…just tell me the combination."
933,6,14,72,92,1.2826086956521738,0.06050845035913782,540,Turn your head to the side and click twice.
933,8,10,74,92,1.2826086956521738,0.06433549293619335,540,You mustn't keep everything locked inside you.
936,8,17,92,117,1.2820512820512822,0.05407932337178789,540,I'm going to recommend you see a metal health specialist.
936,10,13,94,117,1.2820512820512822,0.05673885484397681,540,"Sorry, you're in no condition to have safe sex."
936,5,12,61,78,1.2820512820512822,0.0655351085197591,540,You two inside need to review my lecture on safe sex.
939,9,13,88,110,1.2818181818181817,0.05794912810540388,540,We'll have to open you up but the only safecracker I know is out of network.
939,5,21,84,110,1.2818181818181817,0.05187368082761431,540,It's not healthy to keep it locked up inside.
941,3,23,77,103,1.2815533980582525,0.05053958934365407,540,Just tell me your safe word...
941,5,19,79,103,1.2815533980582525,0.05417550100575275,540,"I'm prescribing an antibiotic because, paradoxically, you haven't been practicing safe sex."
941,7,15,81,103,1.2815533980582525,0.057582286576893085,540,you know you shouldn't keep things all locked up inside
944,4,19,73,96,1.28125,0.054818530370029296,540,Your illness is not your vault.
944,8,11,77,96,1.28125,0.06230781856545745,540,I see you took my advice on adding more greens to your lifestyle.
944,6,15,75,96,1.28125,0.058682772285892346,540,"Knock once for 'yes', two for 'no'."
944,8,11,77,96,1.28125,0.06230781856545745,540,A little to the left - or a little to the right?
948,8,18,95,121,1.28099173553719,0.05277837191625511,540,Well how many times have I told you not to play in mommy's safe?
949,6,13,70,89,1.2808988764044944,0.061867357959051864,540,"Well, heartless doesn't necessarily mean without value."
949,5,15,69,89,1.2808988764044944,0.05976794597374316,540,"If it weren't for this side job, my student loans would still be over $150,000."
949,4,17,68,89,1.2808988764044944,0.05759205458226946,540,I think it is important for you to be more open
952,5,22,87,114,1.280701754385965,0.05062682993229085,540,If you open up it will be good for the both of us
953,4,22,81,107,1.280373831775701,0.051076219531363376,540,"I want to run some tests, just to be safe."
953,7,16,84,107,1.280373831775701,0.05601595693533672,540,You have nerves of steel.
955,4,20,76,100,1.28,0.05333333333333333,540,Good news: Your children are going to have to wait a little longer for their inheritance.
955,5,18,77,100,1.28,0.055194788218315013,540,"""Better to be safe than sorry -- I'm calling in a locksmith for a second opinion.'"
955,8,12,80,100,1.28,0.06043612539305653,540,All I need is for you to open up.
955,7,14,79,100,1.28,0.05874099974042875,540,"Frankly, I think you're carrying this obsession about people trying to see your tax returns a bit too far, Mr. Trump...."
955,5,18,77,100,1.28,0.055194788218315013,540,"Well if you're so worried about the 'family jewels,' you should practice safe sex."
960,6,14,73,93,1.2795698924731183,0.05993137613320423,540,You have to want to change your combination.
961,5,21,85,111,1.2792792792792793,0.051466887283750935,540,Turn your dial to the left and cough please.
961,5,21,85,111,1.2792792792792793,0.051466887283750935,540,If you can hear me in there...this is not a drill. I repeat: This is not a drill. It's a stethoscope.
963,3,18,65,86,1.2790697674418605,0.05646000918945887,540,I haven't had to crack a case this tough in years!
964,7,15,82,104,1.2788461538461537,0.05709014851737027,540,Does it burn when you make a withdrawal?
964,5,19,80,104,1.2788461538461537,0.053720313317805364,540,"So you've turned into a cold, heartless, money-grubber, eh?"
964,4,21,79,104,1.2788461538461537,0.05195349425762494,540,Your numbers were pretty revealing.
964,5,19,80,104,1.2788461538461537,0.053720313317805364,540,"Unfortunately, I think we're going to have to open you up this time."
964,5,19,80,104,1.2788461538461537,0.053720313317805364,540,Let me guess: you have a combination of symptoms.
969,6,22,94,122,1.278688524590164,0.04974163716327462,540,"Okay, now just cough up the combination."
969,2,30,90,122,1.278688524590164,0.043957917149784274,540,"Unfortunately, an MRI is not a safe alternative."
971,5,17,75,97,1.2783505154639174,0.056269838123068086,540,So sorry--the stethoscope is cold
971,6,15,76,97,1.2783505154639174,0.05814698027153854,540,Nothing showed up on your x-rays.
971,2,23,72,97,1.2783505154639174,0.05021916751091231,540,I want you to relax and open up.
971,5,17,75,97,1.2783505154639174,0.056269838123068086,540,Are you sure you have been practicing safe sex?
971,4,19,74,97,1.2783505154639174,0.05432787544248239,540,I can hear you in there. There's nothing to be afraid of. It's just a rectal exam.
971,3,21,73,97,1.2783505154639174,0.05231387404686711,540,Turn your spindle and cough please.
971,3,21,73,97,1.2783505154639174,0.05231387404686711,540,Well your current condition could be explained by a combination of factors.
971,4,19,74,97,1.2783505154639174,0.05432787544248239,540,Its safe to say a combination of an angry mother and cold father makes it difficult for you to open up
979,7,18,90,115,1.2782608695652173,0.05319369508780919,540,I'm going to have to refer you to a locksmith for a combination of reasons.
979,4,24,87,115,1.2782608695652173,0.04870218981939781,540,"When exactly did you start feeling ""un-safe""?"
979,8,16,91,115,1.2782608695652173,0.05460883168857887,540,'I gather you have been feeling a little insecure'
982,3,24,81,108,1.2777777777777777,0.04892993651103154,540,Sometimes we all feel a little empty inside.
982,7,11,72,90,1.2777777777777777,0.06326090433216465,540,"Well, I guess you should have used your safe word."
982,0,25,65,90,1.2777777777777777,0.04747764511811838,540,"""I think you need to cut down on the treasury bonds""."
985,6,21,92,119,1.2773109243697478,0.050526877536999686,540,"Now, please turn your dial and cough."
985,3,27,89,119,1.2773109243697478,0.046105051716132044,540,"Trust me, you're safe"
987,6,16,79,101,1.2772277227722773,0.05649640640668161,540,It is more serious than I thought. I am afraid I am going to have to crack you open.
987,4,20,77,101,1.2772277227722773,0.05287536603096511,540,"You're not broken, but you are broke."
987,7,14,80,101,1.2772277227722773,0.058222536348471916,540,It's unhealthy -- keeping everything locked up inside.
987,3,22,76,101,1.2772277227722773,0.0509684660444901,540,Just say the first click that comes to mind.
991,4,23,85,112,1.2767857142857142,0.04946597284198399,540,Now take a big spin of those tumblers and hold it......
992,3,20,71,94,1.2765957446808511,0.05327150239189492,540,Please think of my office as your safe place.
992,5,16,73,94,1.2765957446808511,0.05740569802641552,540,Breathe to the left. Now breathe to the right.
992,7,12,75,94,1.2765957446808511,0.06126153250376902,540,Your 100s are fine. Now rifle through your 20s.
995,5,24,94,123,1.2764227642276422,0.048019295357803964,540,Any history of depression in your family?
996,5,19,81,105,1.276190476190476,0.05327246657607053,540,"Take a deep breath, and cough it up"
996,5,19,81,105,1.276190476190476,0.05327246657607053,540,I'm not certain your insurance will cover a drilling of this size.
996,2,25,78,105,1.276190476190476,0.047838322981141414,540,I can tell you rarely open up.
996,8,13,84,105,1.276190476190476,0.058201428200252106,540,"Mr. Smith, please come out. Your feelings are not unusual and actually shared by an increasing number of voters."
996,6,17,82,105,1.276190476190476,0.054964587492755144,540,So you're self-insured?
1001,8,11,79,98,1.2755102040816326,0.06116309426030231,540,"No, but there is such a thing as safer sex."
1001,7,13,78,98,1.2755102040816326,0.05941826877122742,540,"Sorry, there's no heart on this side either."
1003,4,22,83,109,1.275229357798165,0.050265282715348136,540,Your really going to need to open up
1003,4,22,83,109,1.275229357798165,0.050265282715348136,540,Feel free to open up. This is a safe space.
1005,3,16,61,80,1.275,0.05893302355914537,540,Would you feel more comfortable opening up for a male physician?
1005,2,29,89,120,1.275,0.044221399942620025,540,"Well, you're certainly carrying too much weight."
1005,2,18,60,80,1.275,0.05618403304872525,540,You must feel like a million bucks!
1005,6,21,93,120,1.275,0.05015731554340811,540,It's safe to say you're suffering from a combination of issues. Try opening up more often.
1005,5,23,92,120,1.275,0.04874115591686399,540,"That's not what we mean by ""combination therapy"""
1010,0,25,66,91,1.2747252747252746,0.04705213398778438,540,It's a combination therapy. Works every time.
1010,3,19,69,91,1.2747252747252746,0.054281710044960324,540,You're still overweight. Divest some bonds.
1010,5,15,71,91,1.2747252747252746,0.05860805860805862,540,It's not broken - just cracked.
1010,4,17,70,91,1.2747252747252746,0.056486319490699606,540,I can't help you if you keep everything locked inside
1014,4,20,78,102,1.2745098039215685,0.05242491509755116,540,I'm afraid I'm going to have to open you up.
1015,8,15,90,113,1.2743362831858407,0.05515148029903649,540,It's just that I can't seem to open up.
1015,6,19,88,113,1.2743362831858407,0.052207567970408965,540,It all started when I was a piggy bank!
1017,8,18,98,124,1.2741935483870968,0.05164321821495643,540,"Perfect as always, Mr. Cheney..."
1018,3,17,64,84,1.2738095238095237,0.0570633171799703,540,You're going to need to stop taking those iron supplements.
1018,3,17,64,84,1.2738095238095237,0.0570633171799703,540,Not to worry---under HIPAA I cannot divulge your combination.
1020,5,16,74,95,1.2736842105263158,0.056872788367533886,540,"Don't worry, this is a safe space."
1020,5,16,74,95,1.2736842105263158,0.056872788367533886,540,"Louder, please. Was that 22 left or right?"
1020,7,12,76,95,1.2736842105263158,0.060683131001665225,540,You are on the Brinks of a relapse.
1020,4,18,73,95,1.2736842105263158,0.05486847811781201,540,"So, you're feeling a bit empty inside?"
1020,7,12,76,95,1.2736842105263158,0.060683131001665225,540,I think we can rule out anemia.
1020,8,10,77,95,1.2736842105263158,0.06250125241864155,540,"Yes, just to be safe."
1026,3,23,80,106,1.2735849056603774,0.049313378715940416,540,Your old clicker is doing just fine!
1027,10,12,95,117,1.2735042735042734,0.05644953932338094,540,"I can't be sure, but it sounds like Trump's tax returns."
1027,6,20,91,117,1.2735042735042734,0.050961766300933846,540,Sounds like you're suffering from a combination of health problems.
1027,5,22,90,117,1.2735042735042734,0.04949484223818946,540,How long have you been feeling empty inside?
1030,3,24,83,110,1.2727272727272727,0.048167574648873286,540,"Well, next time I encourage you not to keep it all inside."
1030,3,18,67,88,1.2727272727272727,0.05534935292479492,540,It isn't healthy to keep your emotions locked up like this.
1030,4,22,84,110,1.2727272727272727,0.049869037678178706,540,"Ok, now just turn your dial and cough."
1030,4,13,60,77,1.2727272727272727,0.06306254323811782,540,I can tell you right now you're going to have to cut back on the heavy bullion.
1030,4,22,84,110,1.2727272727272727,0.049869037678178706,540,Let's get you back to good wealth.
1030,7,13,79,99,1.2727272727272727,0.05888082471314044,540,The Zika Virus is something we more commonly see in offshore bank accounts.
1030,5,17,77,99,1.2727272727272727,0.05526902742339265,540,"I'm going to order some tests, just to be safe."
1030,3,18,67,88,1.2727272727272727,0.05534935292479492,540,I'll wait in the hallway while you open up for me.
1030,3,21,75,99,1.2727272727272727,0.05140407829886543,540,"I take it you want to defer your prostate exam, Mr. Jones?"
1039,7,17,90,114,1.2719298245614035,0.05328093954459305,540,"Now, take a deep breath and try to cough up some cash."
1039,5,21,88,114,1.2719298245614035,0.050282678215312064,540,I'm afraid you are really empty inside
1039,5,21,88,114,1.2719298245614035,0.050282678215312064,540,"No, you shouldn't keep things locked up inside."
1042,6,16,81,103,1.2718446601941749,0.05552335626607258,540,"Yes, you'll have to come out for me to treat your paranoia."
1042,4,20,79,103,1.2718446601941749,0.0519818071333625,540,You say you've been feeling empty?
1042,7,14,82,103,1.2718446601941749,0.05721197864214087,540,"Don't worry, anything you tell me goes straight into the vault."
1042,7,14,82,103,1.2718446601941749,0.05721197864214087,540,"Instead of the rubber glove exam, I'm going to have to use a 1/2 drill bit."
1046,4,17,71,92,1.2717391304347827,0.05594871053561892,540,Let's start by opening up a bit shall we?
1046,4,17,71,92,1.2717391304347827,0.05594871053561892,540,And how long have you had this clicking sound?
1048,5,25,99,129,1.2713178294573644,0.04637010121707519,540,I hear you've been neglecting your wealth.
1049,7,18,93,118,1.271186440677966,0.05199345971912271,540,It's all these extra pounds.
1050,3,23,81,107,1.2710280373831775,0.0489172006143902,540,"If this is to work, you've got to be more open with me."""
1050,6,17,84,107,1.2710280373831775,0.054054599672127536,540,Turn your tumbler and click.
1050,4,21,82,107,1.2710280373831775,0.05068755526954969,540,"Point taken, Mr. Jones, I'll warm my hands next time. Now, please give me the combination."
1050,7,15,85,107,1.2710280373831775,0.05566179559598422,540,But what makes you think you're a failure Mr Houdini?
1050,7,15,85,107,1.2710280373831775,0.05566179559598422,540,Too much bread.
1050,4,21,82,107,1.2710280373831775,0.05068755526954969,540,"Your heart sounds fine, but your BP's 36 to the right, 18 to the left, and 23 to the right."
1056,4,18,74,96,1.2708333333333333,0.054368718969083525,540,We won't know for sure until we open you up
1056,2,22,72,96,1.2708333333333333,0.050173310744967906,540,"It's natural for you to have a feeling of emptiness, from time to time."
1056,6,14,76,96,1.2708333333333333,0.0582628019714745,540,Have you been practicing safe sex lately?
1056,6,14,76,96,1.2708333333333333,0.0582628019714745,540,"I think a combination of rest, healthy diet, and left 21 is just the thing."
1056,2,22,72,96,1.2708333333333333,0.050173310744967906,540,Congratulations! You're pregnant.
1056,4,18,74,96,1.2708333333333333,0.054368718969083525,540,It's not healthy to keep everything locked up all the time...
1062,1,28,82,111,1.2702702702702702,0.044235143299121905,540,"Hmm, better run a few tests just to be safe."
1062,4,22,85,111,1.2702702702702702,0.04947876710362073,540,"You may be in good shape, but you still have a weight problem."
1064,4,19,77,100,1.27,0.052905480802936666,540,"Don't worry, this is a safe space, sir."
1064,4,19,77,100,1.27,0.052905480802936666,540,"I'm going to run some tests...you know, better safe than sorry."
1064,5,17,78,100,1.27,0.05478147589295219,540,"Geraldo, I know you're in there"
1064,3,21,76,100,1.27,0.05096047190685834,540,"If I'm to help you, you have to be open with me."
1064,4,19,77,100,1.27,0.052905480802936666,540,"You're cracked, but not broken."
1069,3,18,68,89,1.2696629213483146,0.05480964585554323,540,"""I think its safe to say that there is a combination of things going on here '"
1070,6,16,82,104,1.2692307692307692,0.055048978854826666,540,No need to be alarmed - you're safe.
1070,6,16,82,104,1.2692307692307692,0.055048978854826666,540,Take 17-42-2 aspirin and call me in the morning.
1070,6,16,82,104,1.2692307692307692,0.055048978854826666,540,I think you could lower your stress if you would open up more to people.
1070,2,24,78,104,1.2692307692307692,0.04778665172843477,540,Let's just play it safe
1070,3,22,79,104,1.2692307692307692,0.049701816675055514,540,You're doing great - lungs of steel
1070,2,24,78,104,1.2692307692307692,0.04778665172843477,540,I'm here to help. You can open up to me.
1076,3,26,90,119,1.26890756302521,0.04575324880937461,540,This isn't working. Just tell me the combination.
1077,3,19,71,93,1.2688172043010753,0.05327029558168083,540,It sounds like you're under a lot of financial pressure.
1077,7,11,75,93,1.2688172043010753,0.06142264040356775,540,And you're positive you've been practicing safe sex?
1077,3,19,71,93,1.2688172043010753,0.05327029558168083,540,I think you are spending too much time on Tumblr.
1077,5,15,73,93,1.2688172043010753,0.05749115212580819,540,Your symptoms are some combination.
1081,6,17,85,108,1.2685185185185186,0.05361052299778273,540,"We're going to do some tests, see what makes you tick."
1081,5,19,84,108,1.2685185185185186,0.051971318143448894,540,"Relax, you're in safe hands."
1083,6,14,77,97,1.268041237113402,0.05772658909736201,540,"I'll check your front now too, just to be on the safe side."
1083,3,20,74,97,1.268041237113402,0.051846207112077713,540,You're empty inside.
1083,5,16,76,97,1.268041237113402,0.0558353154957798,540,I can't let you out until you give me the 'safe' word.
1083,5,16,76,97,1.268041237113402,0.0558353154957798,540,You'll be cured of claustrophobia once the oxygen runs out
1083,6,14,77,97,1.268041237113402,0.05772658909736201,540,"If you feel uncomfortable, use the safe word."
1083,5,16,76,97,1.268041237113402,0.0558353154957798,540,"Relax, I'm not going to crack you."
1083,2,22,73,97,1.268041237113402,0.04973180631754744,540,Just rest normally for me. I want to hear your tumblers.
1090,5,20,87,112,1.2678571428571428,0.050706309304391906,540,How's the wife and safe deposit boxes?
1091,2,19,65,86,1.2674418604651163,0.05340503827774727,540,I don't think this is an open and shut case.
1091,2,19,65,86,1.2674418604651163,0.05340503827774727,540,"Yes, our patients without insurance must pay in cash."
1093,5,17,79,101,1.2673267326732673,0.05430221465664193,540,You need to be more open--try not to keep everything locked up inside.
1093,6,15,80,101,1.2673267326732673,0.056095902868179386,540,"Good news, I can open you. Bad news, it will take dynamite."
1093,7,13,81,101,1.2673267326732673,0.05783398759013954,540,It sounds like the cat is both dead and alive.
1096,7,17,92,116,1.2672413793103448,0.052462249754264334,540,"I'd like to run some more tests, just to be safe."
1096,7,17,92,116,1.2672413793103448,0.052462249754264334,540,I'm sorry I don't understand your insecurity
1096,4,23,89,116,1.2672413793103448,0.04798450309042525,540,"Mr. Houdini, take a deep breath and hold it."
1096,6,19,91,116,1.2672413793103448,0.05101335719002964,540,I hear you are not feeling safe?
1100,5,14,71,90,1.2666666666666666,0.058700024564689327,540,I'm going to prescribe something more effective but less safe.
1100,4,16,70,90,1.2666666666666666,0.05653322026700586,540,"Two deep rotations to the left, please."
1100,8,12,85,105,1.2666666666666666,0.057840672070294495,540,I had hoped your numbers would be better by now.
1100,3,18,69,90,1.2666666666666666,0.054279988058403936,540,Have you tried opening up and not keeping everything inside you?
1100,5,14,71,90,1.2666666666666666,0.058700024564689327,540,I don't think you're getting enough sun.
1100,6,12,72,90,1.2666666666666666,0.060789643641268855,540,"The symptoms you describe could be a number of things or, more likely, a combination of those numbers."
1100,5,14,71,90,1.2666666666666666,0.058700024564689327,540,Hold still...
1100,5,18,82,105,1.2666666666666666,0.0528780937259731,540,You'd be surprised how many patients have issues opening up.
1100,5,18,82,105,1.2666666666666666,0.0528780937259731,540,You're safe for the foreseeable future.
1100,3,22,80,105,1.2666666666666666,0.04929292474374421,540,Good. Now spin left to 36 and hold it.
1100,2,24,79,105,1.2666666666666666,0.04739875785969762,540,"Turn and cough up the money, please."
1100,6,16,83,105,1.2666666666666666,0.05458244204176815,540,Show me the money
1112,2,25,82,109,1.2660550458715596,0.04634482332994621,540,I will try but I am pretty sure only you can unlock your potential.
1112,5,19,85,109,1.2660550458715596,0.05155120411209087,540,The only way you're going to make progress is for you to open up.
1112,4,21,84,109,1.2660550458715596,0.049876166453517105,540,Sounds like this could be a combination of things.
1115,4,17,73,94,1.2659574468085106,0.05490269655464396,540,I'm going to prescribe you a combination of drugs.
1115,4,17,73,94,1.2659574468085106,0.05490269655464396,540,"It's OK, you can open up to me."
1115,5,15,74,94,1.2659574468085106,0.05694810522200439,540,What's your safe word?
1115,4,17,73,94,1.2659574468085106,0.05490269655464396,540,I think it's safe to say you're empty inside.
1119,2,17,60,79,1.2658227848101267,0.05613558943312265,540,I'm hearing you don't feel safe.
1119,4,13,62,79,1.2658227848101267,0.061646932532367985,540,Think hard -- You must have known the combination if you were able to open the door in the first place.
1121,7,16,90,113,1.2654867256637168,0.053360074817712475,540,"I know that! My question was, 'Do you FEEL safe at home?'"
1121,6,18,89,113,1.2654867256637168,0.05185816976771166,540,Now open up and say 'Aah'!
1123,2,22,74,98,1.2653061224489797,0.04929765582460097,540,"Whatever is troubling you, it would be better telling me rather than keeping it locked up."
1123,5,16,77,98,1.2653061224489797,0.055330273602931246,540,I'm afraid it's iron lung.
1123,3,20,75,98,1.2653061224489797,0.051387277662137534,540,My advice is to not keep things locked up inside you.
1123,5,16,77,98,1.2653061224489797,0.055330273602931246,540,Cough up some cash and you'll feel better.
1123,6,14,78,98,1.2653061224489797,0.05719993542566316,540,"No, you're not dying. His tax returns would make anyone feel this way."
1123,9,8,81,98,1.2653061224489797,0.06247409799168333,540,Cough!
1123,6,14,78,98,1.2653061224489797,0.05719993542566316,540,You’ll still have to get the shot.
1123,5,16,77,98,1.2653061224489797,0.055330273602931246,540,I can help if you let me unlock your inner self.
1131,3,16,64,83,1.2650602409638554,0.05707210525447058,540,Your cash pressure seems a little high.
1131,5,12,66,83,1.2650602409638554,0.0620075956534203,540,This is a safe place-you can tell me anything
1133,6,19,92,117,1.264957264957265,0.05062701807537747,540,Coffer.
1134,7,13,82,102,1.2647058823529411,0.05732412449504595,540,You know it's not healthy to keep everything locked inside.
1134,7,13,82,102,1.2647058823529411,0.05732412449504595,540,"Every since the robbery, I feel so empty inside."
1134,6,15,81,102,1.2647058823529411,0.05560501945291115,540,"How long has it been since your last physical, Mr. Houdini?"
1134,7,13,82,102,1.2647058823529411,0.05732412449504595,540,Hmm…safe but no sound.
1134,4,19,79,102,1.2647058823529411,0.051996577453028846,540,You're gonna have to lay off the dough.
1134,10,7,85,102,1.2647058823529411,0.062196996964630276,540,"For the last time, you have got to stop falling on cartoon characters."
1134,4,19,79,102,1.2647058823529411,0.051996577453028846,540,"Now, take a deep breath please, Mr. Houdini."
1134,7,13,82,102,1.2647058823529411,0.05732412449504595,540,Safe sex?
1142,6,11,70,87,1.264367816091954,0.06217085501930308,540,Take a deep breath on 1-22-13.
1142,5,13,69,87,1.264367816091954,0.059982555859760325,540,"In my opinion, it's a combination of things."
1142,3,17,67,87,1.264367816091954,0.05534700167800779,540,"This time, cough up the cash."
1145,5,18,83,106,1.2641509433962264,0.052437250040552504,540,It's not healthy to keep your feelings locked up
1145,6,16,84,106,1.2641509433962264,0.05412355966797255,540,"Everything sounds good, I think you are a safe."
1145,6,16,84,106,1.2641509433962264,0.05412355966797255,540,And how long have you been feeling insecure?
1148,4,16,71,91,1.2637362637362637,0.055985269375949595,540,"You will have to open up for the co-pay, anyway."
1148,5,14,72,91,1.2637362637362637,0.05812530112866413,540,"Doctor, like I told you before: I'm not coming out until the election over."
1150,6,17,87,110,1.2636363636363637,0.05274337564352528,540,Good news Mrs. Banks. you'll be delivering that little piggy back in a minute now
1150,7,15,88,110,1.2636363636363637,0.05430165140828447,540,The problem is I'm a urologist.
1152,6,18,90,114,1.263157894736842,0.051453989677285435,540,"I know the safe is a metaphor, Leonard, but it's also an actual safe and I can't get you out."
1152,7,16,91,114,1.263157894736842,0.0529411791409596,540,This is odd. Most of my patients come pre-cracked.
1152,3,19,73,95,1.263157894736842,0.052294553631162456,540,"It's safe to say you have a combination of ailments, but lack of iron is not among them."
1152,6,18,90,114,1.263157894736842,0.051453989677285435,540,Are you still thinking about your safe place?
1152,6,13,76,95,1.263157894736842,0.05836619601004484,540,"I would normally call a blockage like this unsafe, but you’re a special case."
1152,4,17,74,95,1.263157894736842,0.054393791053906224,540,This would be easier if you just opened up to me.
1152,5,15,75,95,1.263157894736842,0.05641496850082867,540,"I told you to stay safe,not stay in a safe!"
1159,2,22,75,99,1.2626262626262625,0.04887069039502482,540,Try to relax -- it's my job to listen and help you open up.
1159,5,16,78,99,1.2626262626262625,0.05483405483405484,540,How long have you felt this overpowering need to be safe?
1159,6,14,79,99,1.2626262626262625,0.056682595501882704,540,"Until we open you up, we have to assume that the cat is both alive and dead at the same time."
1159,6,14,79,99,1.2626262626262625,0.056682595501882704,540,I think we'll skip the prostate exam for today.
1159,4,18,77,99,1.2626262626262625,0.052920983610078645,540,I can't help but feel that you are keeping something from me.
1164,2,23,78,103,1.2621359223300972,0.047718088814447515,540,Looks like toxic shock to me. Are you holding any Deutsche Bank shares in there?
1164,4,19,80,103,1.2621359223300972,0.051553378340343764,540,This is really a tough case to crack!
1164,7,13,83,103,1.2621359223300972,0.05682299750630295,540,You can tell me. This is a safe place.
1164,6,15,82,103,1.2621359223300972,0.0551224603632834,540,I sense a tightness in your chest.
1164,5,17,81,103,1.2621359223300972,0.05336776393481544,540,"So you say you forgot your ""safe"" word?"
1164,7,13,83,103,1.2621359223300972,0.05682299750630295,540,Of course your secrets are safe with me
1170,3,22,82,107,1.2616822429906542,0.04849425301966832,540,"If you want me to help you, you've really got to start opening up."
1170,5,18,84,107,1.2616822429906542,0.052003500482620646,540,Well you definitely don't have any insecurities.
1170,8,12,87,107,1.2616822429906542,0.05686274080811968,540,Take a deep breathe and exhale large denominations.
1170,3,22,82,107,1.2616822429906542,0.04849425301966832,540,It's not healthy to keep everything locked away inside of you.
1170,5,18,84,107,1.2616822429906542,0.052003500482620646,540,You'll have to be more open if you want my help.
1175,2,25,84,111,1.2612612612612613,0.0456309156226219,540,It's just stress. You shouldn't keep everything locked up inside.
1175,5,19,87,111,1.2612612612612613,0.05073047360275016,540,Your tumblers aren't tumbling. Your locks are 98% blocked.
1175,4,21,86,111,1.2612612612612613,0.04908951810885056,540,"You need to be open with your doctor, you can't keep things locked up inside you."
1178,5,14,73,92,1.2608695652173914,0.05756146140293596,540,Are you sure you don't want me to let you out yet Mr Houdini?
1178,8,14,93,115,1.2608695652173914,0.053961249086833675,540,I hear you in there Mr. Davis. This is not an effective way to treat your agoraphobia.
1178,2,20,70,92,1.2608695652173914,0.05095730771070601,540,It sounds like you have a combination of issues.
1181,6,19,94,119,1.2605042016806722,0.04987119839993938,540,Relax. We can open you up safely and remove what's inside.
1182,4,17,75,96,1.2604166666666667,0.05389396604466397,540,I think we're going to have to open you up to see what's in there.
1182,4,17,75,96,1.2604166666666667,0.05389396604466397,540,"Of course Mr. Johnson, but can locking yourself in really make you feel any safer?"
1182,6,13,77,96,1.2604166666666667,0.05782003171264664,540,I suggest you get more iron.
1182,5,15,76,96,1.2604166666666667,0.055891482550004236,540,What can I say to get you to open up?
1182,3,19,74,96,1.2604166666666667,0.05181950723819513,540,"No, the election isn't over for another month."
1187,5,16,79,100,1.26,0.054346438278284205,540,You will neve feel safe unless you unlock your inner self.
1187,6,14,80,100,1.26,0.05617433182117573,540,Good news Mr. Johnson! Only two more weeks and the elections will be over!
1187,7,12,81,100,1.26,0.057944592134001244,540,"I assure you, the iron supplement is 100% safe."
1187,3,20,77,100,1.26,0.050492523699008654,540,Just as I suspected. Your irregular heartbeat is due to your high iron content.
1191,4,19,81,104,1.2596153846153846,0.05111744649348446,540,I hear you. It's a combination of things.
1191,5,17,82,104,1.2596153846153846,0.05291218983750678,540,"Sir, I respect patient privacy, but don't you think this is a little much?"
1191,7,13,84,104,1.2596153846153846,0.05633038991674542,540,"Mr. Evans, you have to speak up when you're in your safe place."
1191,4,19,81,104,1.2596153846153846,0.05111744649348446,540,How long has it been since you had a really good combination?
1195,5,18,85,108,1.2592592592592593,0.05157668171409739,540,Please turn three times to the left and cough.
1195,6,16,86,108,1.2592592592592593,0.053228041135904285,540,I think we’re going to need to open you up.
1197,3,23,86,112,1.2589285714285714,0.047024624074531236,540,"Shallow breaths, Houdini, shallow breaths."
1197,2,25,85,112,1.2589285714285714,0.045281785614922715,540,"Relax, you're safe here."
1197,8,13,91,112,1.2589285714285714,0.054915308191129976,540,What exactly did you say to your wife?
1200,3,16,66,85,1.2588235294117647,0.055893408901902156,540,Perhaps you could try to open up to me more.
1201,6,18,92,116,1.2586206896551724,0.05066379415575519,540,You probably wouldn't even be here if you had practiced safe sex.
1201,6,18,92,116,1.2586206896551724,0.05066379415575519,540,I specialize in safes because that's where the money is.
1203,3,17,69,89,1.2584269662921348,0.05425719471795436,540,It's not healthy to keep all these things locked up inside of you.
1203,3,17,69,89,1.2584269662921348,0.05425719471795436,540,"She wants to love you, but first you have to open up."
1203,3,17,69,89,1.2584269662921348,0.05425719471795436,540,Try thinking outside the box
1203,4,15,70,89,1.2584269662921348,0.056561522199947825,540,"Ok,now open widely"
1207,3,18,72,93,1.2580645161290323,0.05274872249394527,540,We'll skip the part where I use the little hammer to test your reflexes.
1208,6,13,78,97,1.2577319587628866,0.0572837906466311,540,We won't make any real progress here until you open up.
1208,3,19,75,97,1.2577319587628866,0.05135272898240018,540,Oh my God money really does talk
1208,4,17,76,97,1.2577319587628866,0.05340299061140911,540,You do seem withdrawn.
1211,6,14,81,101,1.2574257425742574,0.055674914532711096,540,"To be honest, I don't know how much more safe we can make you feel."
1211,8,10,83,101,1.2574257425742574,0.059124747036964825,540,Have you been having safe sex? You're pregnant!
1211,3,20,78,101,1.2574257425742574,0.0500563352861962,540,"I suspect it's affluenza, but I'll know more once I open you up."
1211,8,10,83,101,1.2574257425742574,0.059124747036964825,540,"No, no Mr. Giuliani, it's only November 7."
1211,4,18,79,101,1.2574257425742574,0.051996697051488655,540,"It's not just one symptom, it's really a combination."
1211,4,18,79,101,1.2574257425742574,0.051996697051488655,540,"Left to 27, now cough..."
1217,3,21,81,105,1.2571428571428571,0.04884859510086344,540,You're finally starting to open up
1217,6,15,84,105,1.2571428571428571,0.05418150784888373,540,I think we'll need to try something different to unlock your past.
1217,5,17,83,105,1.2571428571428571,0.052464136413634656,540,"You're lucky you found me, a lot of doctors are real thieves!"
1217,5,17,83,105,1.2571428571428571,0.052464136413634656,540,"I think with the right combination, we can see what going on in there"
1217,6,15,84,105,1.2571428571428571,0.05418150784888373,540,"Just to play safe, I'm looking at a combination of things"
1222,2,24,83,109,1.2568807339449541,0.045905525990612435,540,You need to open up and tell me why you don't feel safe anymore.
1222,2,24,83,109,1.2568807339449541,0.045905525990612435,540,I'll have to refer you to a psychologist because I think you need to really open up.
1222,3,22,84,109,1.2568807339449541,0.047720142306811104,540,I see you have a combination of problems. Your ticker is off and your numbers are high.
1222,4,20,85,109,1.2568807339449541,0.049468238770849854,540,"Now that you're in your safe place, you need to open up more."
1222,2,24,83,109,1.2568807339449541,0.045905525990612435,540,Keeping everything inside really isn't healthy.
1227,4,21,88,113,1.2566371681415929,0.04832654847926019,540,So you feel like you're always tumbling.
1227,5,19,89,113,1.2566371681415929,0.04993478848271368,540,Your wife seems to think you're keeping something from her.
1229,4,22,91,117,1.2564102564102564,0.047255733568745614,540,And you think that working at a bank has changed you somehow?
1230,3,16,67,86,1.255813953488372,0.05532158567646684,540,I'll be prescribing a combination of drugs
1230,5,12,69,86,1.255813953488372,0.060063911495953054,540,"""Just relax,there's nothing to worry about.You can open up to me."
1232,4,15,71,90,1.2555555555555555,0.056003190365495135,540,I feel you are trying to keep something from me.
1232,4,15,71,90,1.2555555555555555,0.056003190365495135,540,"Yes, I concur...safe sex is always the best option."
1234,4,16,74,94,1.2553191489361701,0.05440169827573315,540,Well fortunately it's not your clicker
1234,6,12,76,94,1.2553191489361701,0.05845601743271815,540,There is a murmur that the Fed is raising rates again.
1234,1,22,71,94,1.2553191489361701,0.04767811843045398,540,"Don't worry, i'm not going to ask to see your assets."
1237,6,13,79,98,1.2551020408163265,0.056757212101740374,540,This is so much easier without patients as middlemen.
1238,5,16,81,102,1.2549019607843137,0.05339616247371909,540,"Mr. Snowden, can you hear me?"
1238,6,14,82,102,1.2549019607843137,0.05518412115531701,540,"Now, two full deep breaths to the left."
1238,6,14,82,102,1.2549019607843137,0.05518412115531701,540,"To diagnose your feelings of insecurity, I will need you to open up."
1238,5,16,81,102,1.2549019607843137,0.05339616247371909,540,"Instead of numbers, I'm going to recommend a combination of diet, exercise and rest. If that doesn't get things to open up, we may have to consider an electronic keypad."
1238,6,14,82,102,1.2549019607843137,0.05518412115531701,540,"The Real You is in there, trying to get out."
1243,5,17,84,106,1.2547169811320755,0.05202342542836301,540,You really should include at least one special character or number
1243,5,17,84,106,1.2547169811320755,0.05202342542836301,540,"I'm so sorry, it appears you are impregnable."
1243,3,21,82,106,1.2547169811320755,0.0484463389191188,540,HOUDINI CAN YOU HEAR ME?
1243,7,13,86,106,1.2547169811320755,0.05536990005350171,540,I expect that you practice safe sex.
1243,6,15,85,106,1.2547169811320755,0.05372272622101011,540,"Fortunately for you, I worked my way through medical school as a bank robber."
1248,6,16,88,110,1.2545454545454546,0.05236104154445641,540,I'd recommend dropping a few pounds-- just not from a second story window.
1248,5,18,87,110,1.2545454545454546,0.050743206444089264,540,I think you have lock jaw.
1248,5,18,87,110,1.2545454545454546,0.050743206444089264,540,You're going to need to lose some weight.
1248,6,16,88,110,1.2545454545454546,0.05236104154445641,540,"It sounds fine, but I'll refer you to an accountant just to be safe."
1248,6,16,88,110,1.2545454545454546,0.05236104154445641,540,"Sir, I assure you...we take doctor-patient confidentiality very seriously here."
1253,5,19,90,114,1.2543859649122806,0.049545995794159706,540,"Your heart sounds good, so I think we can go ahead and talk about practicing safe sex."
1253,3,23,88,114,1.2543859649122806,0.046306532033665936,540,It's safe to open up to me.
1255,3,24,91,118,1.2542372881355932,0.04533334719873197,540,"There's no doubt about it, you're a tough case to crack..."
1256,0,21,62,83,1.2530120481927711,0.04800875830437278,540,Your symptoms are hard to crack.
1257,5,12,70,87,1.2528735632183907,0.05944227735348059,540,But you’ll suffocate before the election is over.
1257,4,14,69,87,1.2528735632183907,0.05714959431707434,540,No. You're not imagining it. There is a slight echo when you talk.
1257,4,14,69,87,1.2528735632183907,0.05714959431707434,540,I'm concerned about your BMI.
1260,6,11,74,91,1.2527472527472527,0.059696846263628915,540,"25 left, and cough"
1261,3,18,74,95,1.2526315789473683,0.051773520608508775,540,So when did you last feel this insecure?
1261,6,12,77,95,1.2526315789473683,0.05789982671304061,540,Your safe is secret with me.
1261,3,18,74,95,1.2526315789473683,0.051773520608508775,540,You can speak up. This is a safe place.
1261,4,16,75,95,1.2526315789473683,0.053893057084685454,540,"""You don't have to play it safe with me, I'm your doctor""."
1261,4,16,75,95,1.2526315789473683,0.053893057084685454,540,"In order for me to help you, you need to open up."
1266,5,15,79,99,1.2525252525252526,0.054376460841029636,540,"You know, you are a hard case to crack."
1266,3,19,77,99,1.2525252525252526,0.05044316967661914,540,You seem to be suffering from a combination of issues.
1266,4,17,78,99,1.2525252525252526,0.05244670085248555,540,"I assure you Mrs. Clinton, the normal parameters of 'doctor/patient confidentiality' should cover this examination."
1266,4,17,78,99,1.2525252525252526,0.05244670085248555,540,Your liquidity is OK but your tumblers need more exercise.
1270,5,16,82,103,1.2524271844660195,0.05293309499341509,540,"Ma'am, please just calm down and try to remember the combination."
1270,5,16,82,103,1.2524271844660195,0.05293309499341509,540,"If you want my help, you'll have to open up to me."
1270,7,12,84,103,1.2524271844660195,0.05641495691552932,540,Listen. You’re taking this whole safe space thing a little too far.
1273,2,23,82,107,1.2523364485981308,0.04617909586671277,540,"If you'd just open up, you'd feel better about yourself."
1273,7,13,87,107,1.2523364485981308,0.05490161756581346,540,Are you sure you've been having safe sex?
1273,4,19,84,107,1.2523364485981308,0.049851583541321576,540,We need to open you up.
1273,5,17,85,107,1.2523364485981308,0.05158988393893246,540,Don't worry you're in safe hands!
1273,5,17,85,107,1.2523364485981308,0.05158988393893246,540,Can you speak louder....was that 6 right or left?
1273,3,21,83,107,1.2523364485981308,0.048050438482101346,540,"As I promised, this is a safe space."
1273,5,17,85,107,1.2523364485981308,0.05158988393893246,540,"So, you're telling me that you don't feel safe anymore?"
1280,5,18,88,111,1.2522522522522523,0.05033624607450187,540,"I would recommend cutting back on your iron."""
1280,6,16,89,111,1.2522522522522523,0.05193782660713643,540,"Take two aspirin, change your combination, and you'll be fine."
1280,5,18,88,111,1.2522522522522523,0.05033624607450187,540,"Right 5, left 19, right 48. Good news, everything's normal."
1280,4,20,87,111,1.2522522522522523,0.04868200391389657,540,Therapy will not work if you refuse to open up.
1280,4,20,87,111,1.2522522522522523,0.04868200391389657,540,You need to cut back on the gold and take more $10's and $20's.
1285,5,20,94,119,1.2521008403361344,0.0480624258685221,540,"Stop chasing the almighty dollar, lose 2000 pounds, and exercise, exercise, exercise."
1285,7,16,96,119,1.2521008403361344,0.05093973387211289,540,Huh! You seem to be infected by the Root of all Evil.
1285,4,22,93,119,1.2521008403361344,0.04655713615623207,540,"Mr. Knox, I can't help you if you won't open up to me."
1288,8,17,106,131,1.251908396946565,0.048878810972769846,540,"Funny, last week we just had a self-drive car on the couch next door."
1289,6,17,93,116,1.25,0.05029895632611329,540,Sounds like someone's really done a number on you.
1289,5,15,80,100,1.25,0.053889149223571936,540,"I'm sorry but your tumblers are dry, your petty cash drawer is empty and you're overdrawn."
1289,4,19,85,108,1.25,0.04944307347557363,540,Now just relax; this is a safe environment.
1289,5,15,80,100,1.25,0.053889149223571936,540,"Sorry--I forgot your combination, and I think I left a surgical sponge in there."
1289,4,16,76,96,1.25,0.05339360629309896,540,Try opening for me.
1289,2,21,77,100,1.25,0.047937248544110224,540,"I know you're in there Houdini, I can hear you breathing."
1289,4,18,82,104,1.25,0.050667685353280145,540,I'm afraid I'm going to have to crack you.
1289,8,11,89,108,1.25,0.05600802246842692,540,"Can you please exhale for me, Mr. Houdini?"
1289,4,13,67,84,1.25,0.05836508438405425,540,"So your lungs sound fine, but I'm still very concerned about your safety"
1289,7,14,91,112,1.25,0.05305954499725111,540,"I don't hear the family jewels. Cough for me, please."
1289,5,16,83,104,1.25,0.052477812801650835,540,Safe and sound.
1289,4,17,79,100,1.25,0.0519809599951771,540,"take a deep breath, and open up wide"
1289,8,10,86,104,1.25,0.05756770213065166,540,Are you having safe sex in there?
1289,7,9,76,92,1.25,0.06109566566553756,540,"No, I said, ""Go TO your safe place."""
1289,6,15,87,108,1.25,0.05282762580097078,540,"If you're not ready to open up yet, we'll never get anywhere with your problem."
1289,8,19,113,140,1.25,0.046595281377622505,540,I'll order some tests to see if you have an iron deficiency.
1289,5,13,74,92,1.25,0.057051707044017595,540,Regular check-ups are the best way to ensure you stay safe.
1289,5,16,83,104,1.25,0.052477812801650835,540,I think you may be taking this HIPAA thing too seriously.
1289,3,22,87,112,1.25,0.04660273245009,540,"I assure you once you finish therapy, you will open up a lot easier."
1289,5,18,89,112,1.25,0.04993560847296239,540,I don't open up easily.
1289,4,19,85,108,1.25,0.04944307347557363,540,My patients usually open up to me more...
1289,4,16,76,96,1.25,0.05339360629309896,540,I sense resistance.
1289,4,19,85,108,1.25,0.04944307347557363,540,"...no sir, your FDIC insurance is still considered out-of-network..."
1289,1,25,82,108,1.25,0.043879456641193054,540,It's better to be safe than sorry!
1289,5,19,92,116,1.25,0.04878585829946003,540,"Don't worry, you're safe here."
1289,5,10,65,80,1.25,0.06289432567832845,540,"Mr. Houdini, did something in particular make you decide to stay inside?"
1315,6,20,103,129,1.248062015503876,0.046733161053439894,540,Say Open
1316,4,22,95,121,1.2479338842975207,0.04587831512036333,540,cough and say 54 - 18- 29
1316,5,20,96,121,1.2479338842975207,0.04735568440129775,540,"No, you did the safe thing by coming in today."
1318,3,23,91,117,1.2478632478632479,0.04526827212564247,540,Take a deep deposit.
1319,4,20,89,113,1.247787610619469,0.047919703189289425,540,But keeping everything locked up inside is kind of the idea.
1320,3,21,85,109,1.2477064220183487,0.04727714016434345,540,I'm confident that we're getting close to unlocking those pent up feelings.
1320,4,19,86,109,1.2477064220183487,0.0490410302443422,540,"Frankly, we're afraid we have some kind of deadly combination at work here."
1320,4,19,86,109,1.2477064220183487,0.0490410302443422,540,you seem to have trouble opening up...
1320,6,15,88,109,1.2477064220183487,0.05239095320798721,540,"It's called agoraphobia and boy, do you have it."
1320,5,17,87,109,1.2477064220183487,0.050743643077079084,540,You present a combination of challenges
1320,4,19,86,109,1.2477064220183487,0.0490410302443422,540,"Relax,your safe with me."
1326,2,22,81,105,1.2476190476190476,0.04645087282554565,540,"If anything hurts, just use your safe word."
1326,4,18,83,105,1.2476190476190476,0.050239267038397185,540,Just relax your tumblers and breath.
1326,4,18,83,105,1.2476190476190476,0.050239267038397185,540,I need you to open up.
1326,7,12,86,105,1.2476190476190476,0.05543856511496245,540,"I can hear them in there, Mr. Trump. Your tax returns are weeping and begging to be released."
1326,3,20,82,105,1.2476190476190476,0.048382163752825266,540,I can assure you that your secret is safe with me.
1326,5,16,84,105,1.2476190476190476,0.05203012719286361,540,"Just turn left, right, left, and open wide."
1326,2,22,81,105,1.2476190476190476,0.04645087282554565,540,It’s unhealthy to keep everything inside.
1333,5,15,81,101,1.2475247524752475,0.05341031270994525,540,I'm afraid you are not a safe weight.
1333,2,21,78,101,1.2475247524752475,0.04752475247524752,540,You say you had the combo meal at lunch?
1333,4,17,80,101,1.2475247524752475,0.05152321517329776,540,"Yes, I can tell money is near and dear to your heart."
1336,3,18,76,97,1.2474226804123711,0.05083268794669077,540,You'll open up sooner or later.
1336,5,14,78,97,1.2474226804123711,0.054895495520948266,540,That's one of the side effects of withdrawal.
1336,3,18,76,97,1.2474226804123711,0.05083268794669077,540,Ewww! The money IS talking.
1336,6,12,79,97,1.2474226804123711,0.05681806104393969,540,Stop playing it safe and open up to someone.
1340,4,15,74,93,1.2473118279569892,0.05439091527063355,540,"I want you to know, you are safe to open up here."
1340,4,15,74,93,1.2473118279569892,0.05439091527063355,540,You need to open up more
1342,6,9,70,85,1.2470588235294118,0.0624115785802593,540,Paying for Medical School shouldn't be this difficult.
1342,7,7,71,85,1.2470588235294118,0.06461669432660423,540,We need to keep working on trust.
1342,1,19,65,85,1.2470588235294118,0.049946420460231636,540,"Well, its seems the iron supplements are kicking in."
1345,3,14,64,81,1.2469135802469136,0.0570111105630559,540,We can't make progress if you don't open up to me.
1346,5,19,94,118,1.2457627118644068,0.048048156401865744,540,Certainly you can feel safe with me. I'm a doctor.
1347,5,17,88,110,1.2454545454545454,0.050330622710028694,540,So you've been practicing Safe Sex...
1347,8,11,91,110,1.2454545454545454,0.05507802280908182,540,"You can't stay in there until after the presidential race, there isn't enough oxygen."
1347,7,13,90,110,1.2454545454545454,0.053542347027048694,540,If only you had practiced safe sex.
1347,3,21,86,110,1.2454545454545454,0.046899469502261974,540,How long have you had this feeling of being not safe?
1351,7,12,87,106,1.2452830188679245,0.054962734667276865,540,This is not what I meant when I suggested closure.
1351,4,18,84,106,1.2452830188679245,0.049817854672336064,540,Cough when I push your tumblers. Again.
1351,4,18,84,106,1.2452830188679245,0.049817854672336064,540,I think it's safe to say you have a lot of locked up emotions.
1354,4,17,81,102,1.2450980392156863,0.051073269338898615,540,How long have you had these feelings locked up inside?
1354,5,15,82,102,1.2450980392156863,0.05293973839875468,540,"Come now Mr. Anderson, we can't start on your trust issues if you won't give me the combination"
1354,2,21,79,102,1.2450980392156863,0.0471190483714801,540,Don't worry; a 20-20-40 combination is healthy for a safe your age.
1354,4,17,81,102,1.2450980392156863,0.051073269338898615,540,High cholesterol is the least of your problems
1354,3,19,80,102,1.2450980392156863,0.04913595201274502,540,Relax. I just need to hear whats wrong with your clicker.
1359,8,8,82,98,1.2448979591836735,0.05991301726737148,540,Pulse elevated. Turn your head and cough up Donald Trump's tax returns and you will feel much better.
1359,4,16,78,98,1.2448979591836735,0.052421330536158,540,I have bad news. You're full of arcade tokens.
1359,5,14,79,98,1.2448979591836735,0.0543910776773722,540,"No problem, Mrs.Leary. You can come in, after the election, for the rest of your physical."
1359,5,14,79,98,1.2448979591836735,0.0543910776773722,540,You're in a safe space.
1359,6,12,80,98,1.2448979591836735,0.05629194228866812,540,"You can open up here, it's a safe space."
1359,4,16,78,98,1.2448979591836735,0.052421330536158,540,"So, how are the vault and piggy banks?"
1365,4,15,75,94,1.2446808510638299,0.053873459378738754,540,"It's okay, this is a safe space"
1365,3,17,74,94,1.2446808510638299,0.05170656656583808,540,"If you’d like a second opinion, I can refer you to a good second-story man."
1365,7,9,78,94,1.2446808510638299,0.05990568774038176,540,"I think you have taken the idea of ""safe space"" too far"
1365,6,11,77,94,1.2446808510638299,0.057964737765670564,540,I understand that safety is your main concern
1369,2,17,67,86,1.244186046511628,0.0521390504107696,540,We could try combination drug therapy.
1370,4,20,91,115,1.2434782608695651,0.04718030130356046,540,"Mr. Gore, are you still in there?"
1371,7,13,91,111,1.2432432432432432,0.05310385142562874,540,You were almost cracked. You need a stronger password.
1371,3,21,87,111,1.2432432432432432,0.04652760880417772,540,I'm a little worried. A normal heartbeat does not go ka-ching ka-ching.
1371,3,21,87,111,1.2432432432432432,0.04652760880417772,540,"After the exam, we need to discuss safe sex."
1374,7,12,88,107,1.2429906542056075,0.05449487752191869,540,"No, your chest is all clear."
1374,4,18,85,107,1.2429906542056075,0.04940328376093482,540,Your symptoms suggest you may be cracked.
1376,3,19,81,103,1.2427184466019416,0.04871471870276671,540,I have just the right combination for you.
1376,5,15,83,103,1.2427184466019416,0.052477220167314625,540,Yes I'd say you've taken more than adequate precautions to protect yourself from zika mosquitos.
1376,6,13,84,103,1.2427184466019416,0.05426072286275198,540,This is Mme. Schrodinger. Please Meow.
1376,3,19,81,103,1.2427184466019416,0.04871471870276671,540,I can't help you. Your heart just isn't in the right place.
1376,7,11,85,103,1.2427184466019416,0.05598744015123336,540,"It's alright, you're safe now."
1376,3,19,81,103,1.2427184466019416,0.04871471870276671,540,I always wanted my office to be a safe-space.
1376,3,19,81,103,1.2427184466019416,0.04871471870276671,540,"Sir, you are safe with me and I do not speak in metaphors."
1376,7,11,85,103,1.2427184466019416,0.05598744015123336,540,"Next, you'll need to open wide and say ""ah."""
1376,4,17,82,103,1.2427184466019416,0.05063093152796273,540,"It's tumbleritis!! You'll need one tablespoon of 3 in 1 oil, 4 times a day for 1 week."
1376,4,17,82,103,1.2427184466019416,0.05063093152796273,540,"Tell it to me straight, Doc. Have they unlocked a cure?"
1386,5,14,80,99,1.2424242424242424,0.05389566925536248,540,You blood pressure's a little high: 55-23-47
1386,6,12,81,99,1.2424242424242424,0.055775319163312236,540,I can hear your money talk but the problem is that it's not circulating.
1386,6,12,81,99,1.2424242424242424,0.055775319163312236,540,Have you been tested for lead poisoning?
1389,5,13,77,95,1.2421052631578948,0.05542423068342733,540,Your lab results were sub-prime
1389,5,13,77,95,1.2421052631578948,0.05542423068342733,540,Get Schrodinger on the phone.
1389,4,15,76,95,1.2421052631578948,0.053365543013411613,540,"Well, maybe if you opened up to me I could tell you what's wrong"
1392,3,16,72,91,1.2417582417582418,0.05262501097748857,540,You clearly have a combination of symptoms.
1392,4,14,73,91,1.2417582417582418,0.05489619317021023,540,You can't keep your feelings locked up like this.
1392,5,12,74,91,1.2417582417582418,0.05707707305723797,540,Let's just try to think outside the box.
1392,3,16,72,91,1.2417582417582418,0.05262501097748857,540,"When I touch the dial, I want you to turn your head and cough."
1392,3,16,72,91,1.2417582417582418,0.05262501097748857,540,Why don't you just tell me the combination.
1392,5,12,74,91,1.2417582417582418,0.05707707305723797,540,"Fifth generation Episcopalian, eh? I might have guessed as much."
1392,3,16,72,91,1.2417582417582418,0.05262501097748857,540,I think your blood pressure is a little on the high side: 135 left over 85 right.
1399,5,18,93,116,1.2413793103448276,0.04839351694219841,540,You are right to get a second opinion. Having a false sense of security can be deadly.
1399,6,16,94,116,1.2413793103448276,0.04991850878698305,540,"It's okay, you can be open with me."
1401,4,19,89,112,1.2410714285714286,0.04787225553270457,540,"As your psychiatrist, I am telling you that you need to open up and let me in."
1401,5,17,90,112,1.2410714285714286,0.04952401448452785,540,"I do detect an insecurity. Perhaps this is why you have trouble opening up."""
1403,3,14,66,83,1.2409638554216869,0.055785896507344584,540,"Yes, you're still safe."
1403,4,12,67,83,1.2409638554216869,0.058360299942670876,540,Yes Mr Houdini we can treat claustrophobia
1403,6,8,69,83,1.2409638554216869,0.06319526350874098,540,"Deep breath, Mr. Hoffa"
1406,5,16,87,108,1.2407407407407407,0.05073084824220075,540,It's hard to help when if you won't open up.
1406,4,18,86,108,1.2407407407407407,0.048995394649344264,540,"Now, a full deep turn to the right."
1406,4,18,86,108,1.2407407407407407,0.048995394649344264,540,"Don't worry, I'll have this open in a heartbeat."
1406,5,16,87,108,1.2407407407407407,0.05073084824220075,540,PTSD is very common after trauma. How soon after the robbery did these feelings of emptiness and worthlessness begin?
1406,5,16,87,108,1.2407407407407407,0.05073084824220075,540,"If you want to be safe, you should get a second opinion."
1411,6,13,85,104,1.2403846153846154,0.053787108883945514,540,"I think you need to stop the ""locker room"" talk."
1411,5,15,84,104,1.2403846153846154,0.052022558421393514,540,Cough louder.
1411,7,11,86,104,1.2403846153846154,0.05549558162123828,540,We can rule out anemia.
1411,2,21,81,104,1.2403846153846154,0.046327390305832834,540,I'm afraid your number's up.
1411,5,15,84,104,1.2403846153846154,0.052022558421393514,540,"The tick IS a bit faint but, in my professional opinion, you're safe."
1411,1,23,80,104,1.2403846153846154,0.044266472585500476,540,"I'd get a second opinion, just to be on the safe side."
1411,3,19,82,104,1.2403846153846154,0.04830045123945618,540,You can come out now Mr. Jones. I am not the proctologist.
1418,4,16,80,100,1.24,0.05148305595538256,540,"No, this is not how you practice safe sex!"
1418,7,10,83,100,1.24,0.057066326818585915,540,You can feel safe with me.
1418,3,18,79,100,1.24,0.04948216697442473,540,"If you feel safe, you can open up to me."
1418,7,10,83,100,1.24,0.057066326818585915,540,"Spenser, you're going to have to come out and face the election with the rest of us."
1418,5,14,81,100,1.24,0.053409037180286764,540,Let it out. Keeping things inside isn't healthy.
1418,4,16,80,100,1.24,0.05148305595538256,540,"Yes, this is a safe place..."
1424,5,13,78,96,1.2395833333333333,0.054901809613439975,540,"Your right, you are very empty inside"
1424,2,19,75,96,1.2395833333333333,0.048541878434896865,540,How long have you been feeling all empty inside?
1424,5,13,78,96,1.2395833333333333,0.054901809613439975,540,Welcome back. How's the claustrophobia treatment going for you?
1427,4,14,74,92,1.2391304347826086,0.05435976935181598,540,If we go by the numbers you're a little on the heavy side.
1427,3,16,73,92,1.2391304347826086,0.05211614894390474,540,I hear your pain . . . If only you would open up!
1427,4,14,74,92,1.2391304347826086,0.05435976935181598,540,Come on. Just open up and let it all out.
1427,3,16,73,92,1.2391304347826086,0.05211614894390474,540,Playing it safe has definitely paid off!
1427,3,16,73,92,1.2391304347826086,0.05211614894390474,540,"You feel like a million bucks? That's funny, so do I..."
1427,4,14,74,92,1.2391304347826086,0.05435976935181598,540,"Yes, I told you your secrets are safe with me."
1433,7,13,93,113,1.238938053097345,0.05224773279335481,540,Do you feel safe?
1433,3,21,89,113,1.238938053097345,0.045800811460775734,540,This will go a lot easier for the both of us if you just tell me what's going on inside.
1433,2,23,88,113,1.238938053097345,0.0440418723213541,540,"Don't worry sir, you're totally safe."
1433,6,15,92,113,1.238938053097345,0.05071289549168667,540,Too many locks and not enough bagels.
1433,5,17,91,113,1.238938053097345,0.04913013287439456,540,Sometimes a ball bearing is just a ball bearing.
1438,2,17,69,88,1.2386363636363635,0.051096437449348664,540,I see what you mean about feeling empty inside.
1438,5,11,72,88,1.2386363636363635,0.058262723756929945,540,Keyhole surgery is out. We're going to have to blast you open.
1440,4,18,87,109,1.238532110091743,0.048594032361072494,540,Your financial health is strong.
1440,5,16,88,109,1.238532110091743,0.05031177443120517,540,You need to open up and show me the problem.
1440,3,20,86,109,1.238532110091743,0.046813302765362025,540,It is not healthy to keep your feelings locked away!
1440,5,16,88,109,1.238532110091743,0.05031177443120517,540,"I think it would be best treat this problem, with a safe, combination therapy."
1440,5,16,88,109,1.238532110091743,0.05031177443120517,540,"Rotate left and stop on 10, then turn to the right and stop on 3, then the left and stop on 30, then cough"
1440,6,14,89,109,1.238532110091743,0.05197277471642225,540,Click twice for me.
1440,4,18,87,109,1.238532110091743,0.048594032361072494,540,It’s not healthy to keep your emotions locked up.
1440,2,22,85,109,1.238532110091743,0.0449621023807155,540,I think you've got a heart of gold
1440,4,18,87,109,1.238532110091743,0.048594032361072494,540,"Listen, if there is anyone you can open up to, it's me."
1449,5,21,104,130,1.2384615384615385,0.044766466379273236,540,"Calm down, you're safe now. Just give me three more clicks to the left."
1450,6,13,86,105,1.2380952380952381,0.0533215580930853,540,"Let's see what's going on in there, shall we?"
1450,4,17,84,105,1.2380952380952381,0.049768345272611834,540,"OK, I find you emotionally and physically ready for safe sex."
1450,4,17,84,105,1.2380952380952381,0.049768345272611834,540,"I wouldn't worry, a little dizziness is normal after two spins to the right and one spin to the left."
1450,8,9,88,105,1.2380952380952381,0.056652351440824034,540,"Stay calm, Mr. Feldman, we'll have you out of there in no time."
1450,5,15,85,105,1.2380952380952381,0.05157555985468396,540,Sounds like the money has stopped talking.
1450,3,19,83,105,1.2380952380952381,0.04789298495629314,540,Money talks--I can hear them!
1450,7,11,87,105,1.2380952380952381,0.05501216902308483,540,"Yes, I'd say there's a low risk of you getting pregnant."
1457,5,19,98,122,1.2377049180327868,0.04663631960750775,540,I know it's hard to trust me - but I'm nowhere near your prostate.
1457,4,21,97,122,1.2377049180327868,0.045160417509692276,540,You're not opening up to me.
1457,6,17,99,122,1.2377049180327868,0.048066925254456445,540,Don't bank on it but I think you're safe.
1460,5,14,82,101,1.2376237623762376,0.05293095605791548,540,We don’t accept FDIC as insurance.
1460,6,12,83,101,1.2376237623762376,0.05476957103342309,540,Just relax and tumble normally.
1460,7,10,84,101,1.2376237623762376,0.05654843687641044,540,Your codicil needs to come out.
1460,4,16,81,101,1.2376237623762376,0.05102613357118861,540,"To be sure, we'll have to open you up."
1464,3,13,64,80,1.2375,0.056935867763429085,540,You'll be safe for another year.
1464,2,15,63,80,1.2375,0.05408546331291017,540,"Seriously, it might feel weird at first but opening up is the best medicine for your condition."
1466,5,18,95,118,1.2372881355932204,0.04765691481847308,540,"Now, this maybe a little warm."
1467,2,19,76,97,1.2371134020618557,0.048102294430135445,540,It's not your vault.
1467,2,19,76,97,1.2371134020618557,0.048102294430135445,540,"So, how long have you been without food, Mr.Hoffa?"
1467,4,15,78,97,1.2371134020618557,0.05237732328067415,540,"I won't know how much I can help you, until I learn more about what's inside you."
1467,3,17,77,97,1.2371134020618557,0.05028525988543606,540,I'm afraid your inorganic diet and sedentary lifestyle is a terrible combination.
1467,4,15,78,97,1.2371134020618557,0.05237732328067415,540,I think I know why you are feeling trapped.
1467,6,11,80,97,1.2371134020618557,0.05632883150441754,540,I really don't think you have enough air in there to last until after the election.
1473,5,17,92,114,1.236842105263158,0.04874234413978753,540,"I've got plenty of time, if you ever want to open up."
1473,7,13,94,114,1.236842105263158,0.051829787791302415,540,You just can't keep things locked in.
1473,4,19,91,114,1.236842105263158,0.047122825860897805,540,It sounds like your insides are all locked up.
1476,4,23,104,131,1.2366412213740459,0.04311976666223454,540,I'm going to need you to cough up a little more money.
1477,2,18,73,93,1.2365591397849462,0.04930050553772512,540,"Hmm, have you traveled to Switzerland recently?"
1477,4,14,75,93,1.2365591397849462,0.05383352141248461,540,"Yes, Mrs. Hawkins the election campaigning is over. Go ahead and tell me the combination."
1477,4,14,75,93,1.2365591397849462,0.05383352141248461,540,You know the drill.
1480,4,18,88,110,1.2363636363636363,0.04819904644226626,540,"Mr. Trump, I have good news and bad news. The bad news is no one can hear you. The good news is no can hear you."
1480,5,16,89,110,1.2363636363636363,0.04989943636291464,540,Actually I have seen worse cases of agoraphobia.
1480,3,20,87,110,1.2363636363636363,0.04643643404214962,540,"Does it hurt when you do right three times to 43, the left once to 19?"
1483,6,9,74,89,1.2359550561797752,0.059839912220129965,540,"""Open wide and say 'It's all yours, Doc'""."
1483,5,11,73,89,1.2359550561797752,0.05766673633560064,540,"Open, and then say ""ah""."
1485,7,11,88,106,1.2358490566037736,0.054536990574855476,540,Any history of heart in your family?
1485,3,19,84,106,1.2358490566037736,0.04749216002345262,540,The odd thing is people usually open up when they feel safe.
1485,1,23,82,106,1.2358490566037736,0.04354441669214217,540,"In order to feel safe again, you need to unlock your inner self."
1485,3,19,84,106,1.2358490566037736,0.04749216002345262,540,If you were my patient all I would say is that you could lose 15 or 20 pounds.
1485,4,17,85,106,1.2358490566037736,0.049347743443954886,540,Tell me more about your feeling suffocated. Quickly.
1485,2,21,83,106,1.2358490566037736,0.04556106610227718,540,"When I said it can be helpful to compartmentalize, Mrs. Weinstein, I didn't mean it literally."
1491,6,16,97,119,1.2352941176470589,0.04877926170751816,540,"Louder, Mr. Carlson! I still can't hear your safe word!"
1491,3,18,81,102,1.2352941176470589,0.04861999805111321,540,Still... better safe than sorry!
1491,5,14,83,102,1.2352941176470589,0.05246120787801261,540,Your chest seems a bit tight.
1491,2,20,80,102,1.2352941176470589,0.04658075943697518,540,Heart rate is still too fast. You're keeping way too much locked up inside you.
1491,1,22,79,102,1.2352941176470589,0.044448060575917735,540,"Your pulse is a little high, are you hiding anything."
1496,0,27,88,115,1.2347826086956522,0.039698395317531235,540,You're not twenty anymore. Perhaps you and your wife should change the combination.
1497,5,13,80,98,1.2346938775510203,0.05388547206976688,540,"My diagnosis is that you need to get out more, Mr. Houdini."
1497,6,11,81,98,1.2346938775510203,0.055803562036006546,540,I think you're safe for now.
1499,5,16,90,111,1.2342342342342343,0.049493677083499193,540,You're safe here.
1499,5,16,90,111,1.2342342342342343,0.049493677083499193,540,Your money or your life.
1499,4,18,89,111,1.2342342342342343,0.0478102908111374,540,I'm afraid we won't know if you've met your deductible until I complete the procedure.
1499,5,16,90,111,1.2342342342342343,0.049493677083499193,540,"Yes, it's safe."
1499,3,20,88,111,1.2342342342342343,0.046065428942378965,540,There's nothing wrong here that a new combination won't fix.
1499,6,14,91,111,1.2342342342342343,0.051121661113913905,540,Trn your knob and cough
1505,4,14,76,94,1.2340425531914894,0.053317170212019274,540,How about next allergy season we just try an anti-histamine?
1505,8,6,80,94,1.2340425531914894,0.061301248250244605,540,"In my professional medical opinion, you've gotten yourself locked in a safe again Mr. Jones."
1507,3,19,85,107,1.233644859813084,0.04709782129030868,540,"Open up, and say aaaaaaah!"
1507,3,19,85,107,1.233644859813084,0.04709782129030868,540,Of course you can speak freely...this is a safe place.
1507,3,19,85,107,1.233644859813084,0.04709782129030868,540,You really need to open up about your medical history.
1507,4,17,86,107,1.233644859813084,0.04893404248117062,540,"You profess a steel exterior,but you're empty on the inside."
1507,8,9,90,107,1.233644859813084,0.05567659729697606,540,"I'd love to help you, but I can't get to your co-pay."
1512,3,15,72,90,1.2333333333333334,0.05252667118728806,540,Your tumblers are a little sludgy. I'd double the broccoli and cut the cheese.
1513,5,14,84,103,1.233009708737864,0.05199958173026883,540,Sounds like you didn't practice safe sex.
1513,4,16,83,103,1.233009708737864,0.05013570674702158,540,Let's get the copay out of the way first.
1513,5,14,84,103,1.233009708737864,0.05199958173026883,540,And what is your mother's maiden name?
1513,5,14,84,103,1.233009708737864,0.05199958173026883,540,How often do you exercise?
1517,4,19,93,116,1.2327586206896552,0.04639598581077646,540,It's normal to feel unsafe from time to time.
1517,8,11,97,116,1.2327586206896552,0.052462249754264334,540,I'm afraid I'll have to refer you to an internist
1519,1,18,67,86,1.2325581395348837,0.048716546920086694,540,"If you want help, you need to be more open"
1519,5,10,71,86,1.2325581395348837,0.05888712243510502,540,"Now please open and I'll say ""Ah!!!"""
1521,3,17,79,99,1.2323232323232323,0.04937933227205966,540,I thought money was supposed to talk.
1521,5,13,81,99,1.2323232323232323,0.05339105339105338,540,How's the old clicker?
1523,2,22,88,112,1.2321428571428572,0.043904773769739634,540,"Yes, I am a doctor of internal medicine."
1523,3,20,89,112,1.2321428571428572,0.045700156680772756,540,Your numbers are far worse than last year's.
1523,7,12,93,112,1.2321428571428572,0.05226858486842572,540,"I appreciate your frustration, sir, but we have no access to your password as long as you are in safe mode."
1523,3,20,89,112,1.2321428571428572,0.045700156680772756,540,"When I turn your dial, please cough."
1523,3,20,89,112,1.2321428571428572,0.045700156680772756,540,When did you start thinking there was more to life than money?
1523,2,22,88,112,1.2321428571428572,0.043904773769739634,540,"Since you don't have insurance, I'm going to have to open you up first."
1529,6,17,102,125,1.232,0.047022300817734855,540,I sense you are keeping something from me.
1530,2,15,65,82,1.2317073170731707,0.05291497070397462,540,When was the last time you were cracked?
1530,2,15,65,82,1.2317073170731707,0.05291497070397462,540,"Now, lets see what makes you tick."
1532,2,18,75,95,1.231578947368421,0.04838403570702222,540,This isn't a compliment but you have a heart of gold.
1532,4,14,77,95,1.231578947368421,0.05281044634128144,540,Now take a deep seventeen right.
1532,3,16,76,95,1.231578947368421,0.05064562248636977,540,"Over time, I am confident we will find a combination that will allow you to open up and be yourself again."
1535,5,15,88,108,1.2314814814814814,0.0502786996951927,540,Sorry if it's a little warm.
1535,3,19,86,108,1.2314814814814814,0.046709818132625494,540,It's safe to say your numbers don't add up.
1535,4,17,87,108,1.2314814814814814,0.0485270787963912,540,There's a 95 percent chance we won't need dynamite.
1535,6,13,89,108,1.2314814814814814,0.051971318143448894,540,I hear that you can't open up...
1535,5,15,88,108,1.2314814814814814,0.0502786996951927,540,Sorry if the stethoscope is too warm.
1535,4,17,87,108,1.2314814814814814,0.0485270787963912,540,you're going to need to open up for me
1535,6,13,89,108,1.2314814814814814,0.051971318143448894,540,"It's safe to come out now, Mr. Jenkins, Trump is way down in the polls."
1542,5,14,85,104,1.2307692307692308,0.05154587353209697,540,I'm beginning to regret naming this clinic 'A Safe Space'.
1542,2,20,82,104,1.2307692307692308,0.04579145756610733,540,This diagnosis would be a lot easier for both of us if you would just open up.
1542,2,17,72,91,1.2307692307692308,0.04960632092961231,540,I'm detecting a combination of symptoms.
1542,4,13,74,91,1.2307692307692308,0.054306422866657135,540,"Say: ""Open Sesame."""
1546,7,12,94,113,1.2300884955752212,0.051844684350823206,540,Sounds like a severe case of tumblelitis.
1546,4,18,91,113,1.2300884955752212,0.047050907076817174,540,Your chest results came back with a number of combinations.
1546,6,14,93,113,1.2300884955752212,0.050297549468551875,540,All square but you need to start practicing safe sex.
1549,4,15,81,100,1.23,0.05096047190685834,540,You've really got to open yourself up if you want the treatment to work.
1549,5,13,82,100,1.23,0.052905480802936666,540,Are we looking for a safecrack or a wisecrack?
1549,6,11,83,100,1.23,0.05478147589295219,540,"Well, at least you're better than sorry."
1549,2,19,79,100,1.23,0.0468287229478799,540,"You might have abs of steel, but you have no heart."
1549,7,9,84,100,1.23,0.05659532050470519,540,"You need to cut back on the junk bonds and derivatives, and go on a strict cash diet."
1549,3,17,80,100,1.23,0.04893822120745191,540,"Breathe in and out deeply, Mr. Houdini."
1549,2,19,79,100,1.23,0.0468287229478799,540,"It's normal to feel a certain degree of isolation, Mr Houdini."
1556,3,14,70,87,1.2298850574712643,0.053483689652870973,540,Your heart sounds wealthy.
1556,4,12,71,87,1.2298850574712643,0.055926856386234985,540,"I am going suggest a combination of therapies, and you tell me if your are open to it."
1556,2,16,69,87,1.2298850574712643,0.05092344109074604,540,How long have you felt like your insides were all locked up?
1556,1,18,68,87,1.2298850574712643,0.04822746775604901,540,You do not need to whisper. You are in a safe place.
1560,5,18,99,122,1.2295081967213115,0.046247751562393156,540,It's a combination psychosis.
1560,2,24,96,122,1.2295081967213115,0.04162217598738881,540,My professional opinion is that you need to be more open.
1560,4,20,98,122,1.2295081967213115,0.044759038502775586,540,These symptoms can arise from any combination of conditions.
1563,4,17,88,109,1.2293577981651376,0.04812669371707594,540,Sounds like newmoneya.
1563,3,19,87,109,1.2293577981651376,0.046328004304413195,540,I'm hearing security is an issue.
1563,5,15,89,109,1.2293577981651376,0.0498605386397374,540,"I am a doctor dammit, not a safecracker!"
1563,6,13,90,109,1.2293577981651376,0.05153608423961075,540,Some health issues are not easy to crack and your symptoms might be the result of a combination of things.
1563,3,19,87,109,1.2293577981651376,0.046328004304413195,540,Just whisper your safe word
1568,2,18,76,96,1.2291666666666667,0.047938114955607895,540,"If you would just open up, I'm sure I would feel much better."
1568,4,14,78,96,1.2291666666666667,0.052313089726426475,540,"You can open up to me, I'm a docotor."
1568,1,20,75,96,1.2291666666666667,0.045593471241867974,540,Tap if you can hear me.
1568,3,16,77,96,1.2291666666666667,0.050173310744967906,540,"Well, your X-rays showed nothing. . ."
1568,6,10,80,96,1.2291666666666667,0.05634940858565613,540,You are safe to open up here!
1573,3,21,94,118,1.228813559322034,0.044076988978739455,540,You're going to have to be more specific than to say you have an empty feeling.
1573,5,17,96,118,1.228813559322034,0.04724944508372923,540,"Trust me, you can open up now. This is a safe space."
1575,4,16,85,105,1.2285714285714286,0.049275228485861494,540,"Well yes, other people's opinions do determine your value."
1575,6,12,87,105,1.2285714285714286,0.05286159767387117,540,I want you to feel safe opening up to me.
1575,2,20,83,105,1.2285714285714286,0.04540647284290523,540,"Pardon, did you say acne or Acme?"
1575,6,12,87,105,1.2285714285714286,0.05286159767387117,540,Your tumblers are fibrillating.
1575,4,16,85,105,1.2285714285714286,0.049275228485861494,540,"You took a tumble, but you'll be okay."
1575,2,20,83,105,1.2285714285714286,0.04540647284290523,540,I follow your blogs on Tumblr.
1581,1,19,72,92,1.2282608695652173,0.04663359344550876,540,Do you want your blood pressure in dollars or Euros?
1581,6,9,77,92,1.2282608695652173,0.05804437745241002,540,"Sounds empty....you Do have insurance, right?"
1583,3,20,91,114,1.2280701754385965,0.04498630563125218,540,The referring physician tells me you're feeling empty inside.
1584,2,14,63,79,1.2278481012658229,0.0538952278235385,540,"The bad news is, that was your third failed login attempt."
1585,6,11,84,101,1.2277227722772277,0.054284159056921966,540,"Your secrets are protected by doctor-patient confidentiality, so its perfectly safe to open up here."
1585,4,15,82,101,1.2277227722772277,0.05050475542517563,540,Feel secure; your tumblers sound fine.
1585,4,15,82,101,1.2277227722772277,0.05050475542517563,540,"Of course you can open up, this is a safe environment."
1585,2,19,80,101,1.2277227722772277,0.04641864621675659,540,Just a few more appointments and we should be able to crack this.
1585,4,15,82,101,1.2277227722772277,0.05050475542517563,540,It's nothing to be alarmed about.
1585,3,17,81,101,1.2277227722772277,0.0485047473818451,540,"It's a combination of things, but I think you're safe."
1591,3,19,88,110,1.2272727272727273,0.04595223779440721,540,This is the easy part. We'll need a whole team to open you up for the colonoscopy.
1591,4,12,72,88,1.2272727272727273,0.05534935292479492,540,Can I be hearing sounds of safe sex?
1591,4,12,72,88,1.2272727272727273,0.05534935292479492,540,You definitely show symptoms of being cracked.
1591,5,15,90,110,1.2272727272727273,0.0494491607724479,540,"The good news is you’re still breathing; the bad news: Your policy doesn’t cover safe cracking and there’s a $5,000 deductible."
1591,6,13,91,110,1.2272727272727273,0.0511079756250649,540,"And when did your breathing problems start, Mr. Blaine?"
1591,4,17,89,110,1.2272727272727273,0.04773273331484981,540,I hear the ticking and I believe you're about to take a turn for the worse.
1597,5,17,97,119,1.226890756302521,0.04689014880207883,540,your iron seems to be a bit high
1598,4,14,79,97,1.2268041237113403,0.05182484925036314,540,How can I help your Mr. Houdini?
1598,3,16,78,97,1.2268041237113403,0.049709540005118326,540,"If you'd just open up, we could really get to the bottom of what's happenening to you."
1598,7,8,82,97,1.2268041237113403,0.05770740764174112,540,Dr. Johnson are you asking me if I engage in something other than safe sex?
1598,3,16,78,97,1.2268041237113403,0.049709540005118326,540,"Just remember, it's what's on the inside that counts"
1602,4,16,86,106,1.2264150943396226,0.048855764148690535,540,"Once you feel comfortable opening up, I think you'll make progress in therapy."
1602,3,18,85,106,1.2264150943396226,0.046980753199957474,540,Your iron level is through the roof!
1602,3,18,85,106,1.2264150943396226,0.046980753199957474,540,"Sir, I know that you're shy ... but you have to come out of your safe space."
1602,3,18,85,106,1.2264150943396226,0.046980753199957474,540,"If I'm going to help you, you'll have to open yourself up to me."
1606,2,15,67,84,1.2261904761904763,0.05179284412244766,540,Can you hear me now?
1607,6,14,95,115,1.2260869565217392,0.0494991999491816,540,"Try as she might, Anna began to realize that traditional psychoanalysis methods are probably not going to work with Mr Gittinger's severe agoraphobia."
1608,5,11,77,93,1.2258064516129032,0.05539824001906587,540,Turn your head and cough up the money.
1608,6,16,102,124,1.2258064516129032,0.04699006049296338,540,"I would like to run a few tests, just to be safe."
1608,6,9,78,93,1.2258064516129032,0.05746928821472055,540,"A classic case of ""Pneumoney"""
1611,5,13,84,102,1.2254901960784315,0.0519599601404218,540,You'll do best on a combination drug.
1611,3,17,82,102,1.2254901960784315,0.04807872020202308,540,"I'm sorry, but, you'll never be totally safe."
1611,6,11,85,102,1.2254901960784315,0.05379567379036276,540,I may need to do a bypass and crack your chest!
1611,1,21,80,102,1.2254901960784315,0.043855321395865086,540,"Believe me, it's who you are on the inside that counts."
1611,5,13,84,102,1.2254901960784315,0.0519599601404218,540,"The Feds are gone, Mr Trump"
1611,3,17,82,102,1.2254901960784315,0.04807872020202308,540,"When I said this is a safe place, I didn't mean that literally."
1617,3,19,89,111,1.2252252252252251,0.04558238068711177,540,You're not alone.We all feel emptiness inside.
1617,3,19,89,111,1.2252252252252251,0.04558238068711177,540,The cause is just stress from your job at the bank. Seeing it more and more these days.
1617,5,15,91,111,1.2252252252252251,0.04904440596750161,540,Turn your dial and cough up $200.
1617,3,19,89,111,1.2252252252252251,0.04558238068711177,540,We'll let you out on November 8th.
1621,6,15,99,120,1.225,0.04801741630812266,540,"If you start feeling uncomfortable, use your safe word."
1621,4,19,97,120,1.225,0.04500622428164394,540,Do you feel safe at home?
1621,2,14,64,80,1.225,0.0532934318037197,540,We've talked about you locking away your emotions.
1624,5,12,81,98,1.2244897959183674,0.053354962259045804,540,"Actually, by law, I'm required to provide a safe space."
1624,6,10,82,98,1.2244897959183674,0.05529145895514973,540,Sounds like Geraldo Rivera
1624,4,14,80,98,1.2244897959183674,0.051345482390755634,540,Not to worry...your secret will be safe with me.
1624,7,8,83,98,1.2244897959183674,0.05716239033764957,540,"I'm afraid Mr. Trump won't let you out until after the election, Hillary"
1628,6,12,89,107,1.2242990654205608,0.05195594354493409,540,'I'm-Locked-In-A-Safe' Who?
1628,2,20,85,107,1.2242990654205608,0.044655090377511794,540,I'm going to prescribe for you a combination of drugs.
1628,3,18,86,107,1.2242990654205608,0.046587689789030155,540,So you say it's a hollow feeling?
1628,6,12,89,107,1.2242990654205608,0.05195594354493409,540,I think it's safe to say that I see no need to crack you open.
1628,3,18,86,107,1.2242990654205608,0.046587689789030155,540,I'd say you are safe.
1628,4,16,87,107,1.2242990654205608,0.04844325116189109,540,"Under your plan, the patient is responsible for the copay when the doctor cracks the case."
1628,2,20,85,107,1.2242990654205608,0.044655090377511794,540,For a safe your age you are pretty sound.
1635,3,20,93,116,1.2241379310344827,0.044293905443672864,540,The things I do for money!
1635,3,20,93,116,1.2241379310344827,0.044293905443672864,540,I'm hesitant to order an x-ray.
1635,7,12,97,116,1.2241379310344827,0.05061274749880775,540,Now turn around and bend over. Your health plan requires us to check your bottom line.
1635,4,18,94,116,1.2241379310344827,0.04595514222515574,540,You can pay with cash or bearer bonds.
1635,7,12,97,116,1.2241379310344827,0.05061274749880775,540,"I'm afraid we'll have to open you up, but it will be a safe procedure."
1635,3,20,93,116,1.2241379310344827,0.044293905443672864,540,Please turn your dial and click
1641,3,13,69,85,1.223529411764706,0.053912655234774585,540,"No, 1000 lbs is not good, and yes, it is your vault."
1642,6,9,79,94,1.2234042553191489,0.056905351383228574,540,"I assure you, Mr. Carlson, a flu shot is just as effective, and far less confining."
1643,2,19,82,103,1.2233009708737863,0.045619117803674204,540,"Nope, no pulse, but I'm detecting a heart of gold."
1643,3,17,83,103,1.2233009708737863,0.047659955080602695,540,"Relax, this is a safe space."
1643,3,17,83,103,1.2233009708737863,0.047659955080602695,540,"I am doing all I can, but you have to want to open up."
1643,4,15,84,103,1.2233009708737863,0.049616919769214105,540,This is the only place I feel safe.
1643,5,13,85,103,1.2233009708737863,0.051499574138862456,540,O happy day -- you're going to have a padlock!
1643,6,11,86,103,1.2233009708737863,0.053315790771438,540,What do your wear to the dentist?
1643,4,15,84,103,1.2233009708737863,0.049616919769214105,540,I see you've decided on the non-invasive treatment approach.
1643,2,19,82,103,1.2233009708737863,0.045619117803674204,540,I'm confident that I can get you to open up more if I use combination therapy.
1651,3,19,90,112,1.2232142857142858,0.045218299028335816,540,You can open up to me
1651,5,15,92,112,1.2232142857142858,0.04864611894865116,540,I would feel safer if you have a look inside.
1651,4,17,91,112,1.2232142857142858,0.046963493565653276,540,"No, 36-24-36 are my measurements not your combination"
1651,4,17,91,112,1.2232142857142858,0.046963493565653276,540,"Hmmm, and how does that make you feel when you keep it all locked up inside?"
1651,3,19,90,112,1.2232142857142858,0.045218299028335816,540,I'll need your combination to complete the examination.
1656,5,17,99,121,1.2231404958677685,0.04618743002437898,540,"Louder, tell me the combination again!"
1657,3,18,87,108,1.2222222222222223,0.046201009590497714,540,"Nothing to worry about, just a mild panic attack. Do you feel safe now?"
1657,4,16,88,108,1.2222222222222223,0.048037522351901875,540,it sounds bad... I'm afraid we're going to have to open you up and remove your money.
1657,3,18,87,108,1.2222222222222223,0.046201009590497714,540,I wouldn't worry--I think you just had some bad debt.
1657,6,10,83,99,1.2222222222222223,0.054777064635215894,540,But you’ll suffocate before November 9th.
1657,3,16,80,99,1.2222222222222223,0.048806737446717936,540,"In your case, I'd say - 'Better sorry than safe'."
1657,2,18,79,99,1.2222222222222223,0.04664712806708402,540,You said that you don't have health insurance so I'm checking you for cash or valuables.
1657,3,16,80,99,1.2222222222222223,0.048806737446717936,540,"This is a safe environment, I assure you."
1657,4,14,81,99,1.2222222222222223,0.050874754873893785,540,Would it help if I said open sesame?
1657,3,14,73,90,1.2222222222222223,0.05187562620058012,540,Not to worry. You have a heart of gold.
1657,4,14,81,99,1.2222222222222223,0.050874754873893785,540,"Yes, Mrs. Smith. This is what I meant by a safe treatment for claustrophobia."
1657,3,18,87,108,1.2222222222222223,0.046201009590497714,540,Your numbers look good but they aren't unlocking the answer.
1657,3,16,80,99,1.2222222222222223,0.048806737446717936,540,Turn to the right and cough.
1657,2,16,72,90,1.2222222222222223,0.04941045135965656,540,I'm going to give you a combination of drugs and therapy.
1670,4,17,92,113,1.2212389380530972,0.04658792862879463,540,You need to store fewer junk bonds and more greenbacks.
1670,2,21,90,113,1.2212389380530972,0.043062506524023,540,Open up and say ch-ching.
1670,6,13,94,113,1.2212389380530972,0.04986472420170196,540,"After I unlock you, you'll be able to think outside the box."
1673,3,17,84,104,1.2211538461538463,0.04724827321830709,540,"Hmmm, 867- 53- 09. Where've I heard that before?"
1673,4,15,85,104,1.2211538461538463,0.04918440626354967,540,"As I turn your nob, please cough when I hit the right number."
1673,5,13,86,104,1.2211538461538463,0.051047157774787154,540,You'll need to arrange an alternate means of payment until we can get you open.
1673,2,19,83,104,1.2211538461538463,0.04522933588640989,540,"It's normal. Without intimacy, it's difficult to open up."
1673,4,15,85,104,1.2211538461538463,0.04918440626354967,540,"As far as I can tell."" Mr Schrodenger, ""your cat is both alive and dead. How exactly did you manage to lock him in your safe?"""
1673,3,17,84,104,1.2211538461538463,0.04724827321830709,540,You can feel safe opening up to me.
1679,3,15,77,95,1.2210526315789474,0.050036822652392024,540,Your numbers are up.
1679,4,13,78,95,1.2210526315789474,0.0522268875856145,540,We're making progress but I feel you are still having difficulty opening up to me.
1679,1,19,75,95,1.2210526315789474,0.04534043768734446,540,Shout me your insurance identification and the combination and we might be able to get you out.
1682,1,17,68,86,1.2209302325581395,0.04794308866997278,540,I think we need to try an outside-the-box kind of medication.
1682,1,17,68,86,1.2209302325581395,0.04794308866997278,540,"Now, open wide and say ahhh."
1682,1,17,68,86,1.2209302325581395,0.04794308866997278,540,Don't worry. You'll be feeling much better tomorrow morning once you've been cleaned out.
1682,5,9,72,86,1.2209302325581395,0.05824887120010922,540,"Yeah, I'd say you have a heart of gold."
1686,4,18,96,118,1.2203389830508475,0.04525203171228205,540,So that's was safe sex sounds like.
1687,2,20,87,109,1.2201834862385321,0.043927546231223726,540,You're not a nut but you're still tough to crack.
1687,6,12,91,109,1.2201834862385321,0.05108040699844056,540,I'm hearing significant congestion. Do you think you could cough some of that up for me?
1687,6,12,91,109,1.2201834862385321,0.05108040699844056,540,Locking yourself in there with your tax returns wasn't a great idea!
1687,4,16,89,109,1.2201834862385321,0.047638415680113844,540,Your symptoms are probably psychosomatic. It's just not healthy keeping everything locked up inside.
1687,4,16,89,109,1.2201834862385321,0.047638415680113844,540,You can't keep it all inside. The stress will kill you.
1687,4,16,89,109,1.2201834862385321,0.047638415680113844,540,"I'm pleased to say that, as far as your health is concerned, you are safe."
1687,6,12,91,109,1.2201834862385321,0.05108040699844056,540,Are you on Medicaid?
1694,5,12,83,100,1.22,0.05237780391954538,540,You click. I listen.
1694,4,14,82,100,1.22,0.05041244034376972,540,How can I help you if you won't open up to me?
1694,4,14,82,100,1.22,0.05041244034376972,540,Your left ventricular tumbler has a murmur!
1694,3,16,81,100,1.22,0.048367281703584904,540,You need to open up!
1694,5,12,83,100,1.22,0.05237780391954538,540,Now turn to the left.
1694,6,10,84,100,1.22,0.05427204202399745,540,"Good, I'm reading 16-34-50."
1694,5,12,83,100,1.22,0.05237780391954538,540,"All clear, I only hear safe sounds."
1701,3,14,74,91,1.2197802197802199,0.05136048423833291,540,"You seem to have misinterpreted the term 'safe space,' Mr. Calloway."
1701,4,12,75,91,1.2197802197802199,0.05368518962801833,540,Don't worry about currency devaluation. You have a heart of gold.
1701,4,12,75,91,1.2197802197802199,0.05368518962801833,540,"Screw Cirque du Soleil, Steve. There are plenty of other companies looking for a man with your talents."
1701,3,14,74,91,1.2197802197802199,0.05136048423833291,540,Someday it will click.
1701,5,10,76,91,1.2197802197802199,0.05591332425814558,540,"Yes, you're fit enough to be president."
1701,4,12,75,91,1.2197802197802199,0.05368518962801833,540,I'll crack you open in a heartbeat.
1701,6,8,77,91,1.2197802197802199,0.05805600807665625,540,"Now, Mrs. Gardall, I'm required to ask you; do you feel safe at home?"
1708,5,17,101,123,1.2195121951219512,0.04550512530337219,540,"It's because you keeping it all locked up, you need to open up more."
1708,2,14,66,82,1.2195121951219512,0.052128412091250256,540,Take two diamonds and you'll feel better in the morning.
1710,4,17,93,114,1.219298245614035,0.046218216889008214,540,Apparently you haven't been practicing safe sex.
1710,6,13,95,114,1.219298245614035,0.04946346492765509,540,"We will need to address your Social Phobia, Mr. Houdini"
1710,5,15,94,114,1.219298245614035,0.04786835037396196,540,It could be a Combination of things. We better do an MRI just to play it Safe.
1710,7,11,96,114,1.219298245614035,0.05100872236955505,540,"In your case, a condom is optional."
1714,1,21,83,105,1.2190476190476192,0.042755271681801814,540,You're safe for a few more years.
1714,2,19,84,105,1.2190476190476192,0.04484599691984634,540,Have you ever been cracked open before?
1716,3,15,78,96,1.21875,0.04956637628367376,540,I think you have a heart of gold.
1716,3,15,78,96,1.21875,0.04956637628367376,540,So you say you feel empty inside?
1718,7,12,100,119,1.218487394957983,0.049437317959208596,540,Can you use the doll to show me where they touched you?
1719,3,18,89,110,1.2181818181818183,0.04544620440567174,540,Sounds to me like it's just a coffer. You're safe.
1719,4,16,90,110,1.2181818181818183,0.0472457740573157,540,I understand. Have you considered going digital?
1719,5,14,91,110,1.2181818181818183,0.04897926946849812,540,"Oh, please, it's the East River for me if you don't open up."
1719,7,10,93,110,1.2181818181818183,0.052274087083883224,540,Can't help unless you open up about it...
1719,2,20,88,110,1.2181818181818183,0.04357237454499434,540,"I assure you, it would be a safe procedure."
1719,6,12,92,110,1.2181818181818183,0.05065347479749617,540,Now when I cup your spindle Im going to need you to cough
1719,4,16,90,110,1.2181818181818183,0.0472457740573157,540,It's OK. You're safe. You're safe.
1719,4,16,90,110,1.2181818181818183,0.0472457740573157,540,"I don't care what the Surgeon General says, in your condition I am recommending against safe sex."
1727,1,20,80,101,1.2178217821782178,0.04360933771395099,540,"You know, I could lose my license over this."
1727,3,16,82,101,1.2178217821782178,0.04793551856202062,540,Everything is going to be just fine. All I need you to do is to open up for me.
1727,2,18,81,101,1.2178217821782178,0.04582351075408372,540,"I'm sensing you have a heart of gold, and other forms of jewelry as well."
1727,5,12,84,101,1.2178217821782178,0.051902346226063996,540,"Calm down, this is a safe space."
1727,5,12,84,101,1.2178217821782178,0.051902346226063996,540,"I didn't go into medicine for the money, I went into medicine for what I can buy with the money."
1732,6,13,96,115,1.2173913043478262,0.049068529882333456,540,No need to be anxious. This is a safe space.
1732,0,20,72,92,1.2173913043478262,0.04323870939989972,540,It's not healthy to keep your feelings locked inside.
1732,3,14,75,92,1.2173913043478262,0.050855290976328946,540,You really never recovered from 2008.
1732,5,10,77,92,1.2173913043478262,0.055353804808394365,540,I know it's unprofesssional but we're a perfect combination and it will be totally safe.
1736,3,17,86,106,1.2169811320754718,0.04644547176488884,540,I'm sensing a certain lack of trust in our doctor-patient relationship.
1736,2,19,85,106,1.2169811320754718,0.04446894790914134,540,The only way I can know is to open you up and have a look.
1738,0,18,65,83,1.216867469879518,0.04551011283857881,540,It's not about safety. We have to help you learn to be more comfortable opening up.
1739,6,14,100,120,1.2166666666666666,0.047608542258559663,540,You're right. It DOES sound like Geraldo Rivera.
1740,3,15,79,97,1.2164948453608246,0.049104533204272306,540,Your secrets are safe with me.
1740,2,17,78,97,1.2164948453608246,0.04686660376971086,540,Having trouble opening up to strangers is perfectly normal
1740,3,15,79,97,1.2164948453608246,0.049104533204272306,540,It seems you're cracked.
1743,4,16,91,111,1.2162162162162162,0.04685944516544137,540,I'd say it's a virus; your combination has gone from 9-8-6 to 1-0-3.
1743,4,16,91,111,1.2162162162162162,0.04685944516544137,540,My diagnosis considers a combination of factors. No one is totally safe.
1743,7,10,94,111,1.2162162162162162,0.05183828790202757,540,"Mankoff, ENOUGH with the shrink/couch toons! Funny once or twice a year (maybe), but you are turning the contest in to a one trick pony."
1743,2,20,89,111,1.2162162162162162,0.04322276337316575,540,"Your numbers look great, but you need a tumbler transplant."
1743,3,18,90,111,1.2162162162162162,0.045077793173721833,540,We're seeing more and more diseases of affluence.
1743,3,18,90,111,1.2162162162162162,0.045077793173721833,540,You need to be more open.
1743,4,16,91,111,1.2162162162162162,0.04685944516544137,540,Your stethoscope is cold.
1750,3,16,83,102,1.2156862745098038,0.04751125295676055,540,Regarding the burning sensation in your tumblers... Have you been practicing safe sex?
1750,2,18,82,102,1.2156862745098038,0.04542226432881113,540,The election will be over soon.
1750,4,14,84,102,1.2156862745098038,0.049512182523962604,540,Your cylinders are fine. I think you're suffering from an accumulation of gilt.
1750,3,16,83,102,1.2156862745098038,0.04751125295676055,540,No combination of pills can keep you safe.
1750,5,12,85,102,1.2156862745098038,0.05143533103860699,540,My honest opinion -- you're cracked.
1750,5,12,85,102,1.2156862745098038,0.05143533103860699,540,I'm going to run a few more tests... better safe than sorry.
1756,5,15,96,116,1.2155172413793103,0.047114703382027195,540,Say mool-aagh!
1756,3,19,94,116,1.2155172413793103,0.04381717927724109,540,I promise you it is safe to open up.
1756,7,11,98,116,1.2155172413793103,0.05019606906660046,540,Just relax. You're safe.
1759,6,8,79,93,1.2150537634408602,0.05689787765730301,540,"Yes, you are safe with me, but you will just have to open up a bit more!"
1759,4,12,77,93,1.2150537634408602,0.05262946228598813,540,You really ought to dial it back a little.
1759,5,10,78,93,1.2150537634408602,0.05480524054512337,540,We are only a few clicks away from a therapeutic breakout!
1762,4,15,88,107,1.2149532710280373,0.04793024780990183,540,At four months a healthy ATM is just beginning to count twenties.
1762,3,17,87,107,1.2149532710280373,0.04605402166872554,540,All this for one EpiPen?
1762,6,11,90,107,1.2149532710280373,0.05147795782302281,540,Oh no! You're broke!
1762,5,13,89,107,1.2149532710280373,0.049735745680282675,540,"I'm sorry, safe-cracking isn't covered by your HMO."
1762,7,9,91,107,1.2149532710280373,0.05316310642620569,540,It's OK. You're safe now.
1762,4,15,88,107,1.2149532710280373,0.04793024780990183,540,Do you still hear voices saying you're not safe?
1768,7,7,84,98,1.2142857142857142,0.05664362183691366,540,"Your iron lung's doing just fine, but it's that ticking noise I'm still worried about."
1768,1,19,78,98,1.2142857142857142,0.044115068632548333,540,"Well, it is a safe treatment, but..."
1768,4,10,70,84,1.2142857142857142,0.05635573779886005,540,"It may be time to consider a psychiatrist, I've never seen a patient so closed off."
1768,2,17,79,98,1.2142857142857142,0.04643848313822551,540,It's still ticking.
1768,2,14,68,84,1.2142857142857142,0.05101221145533816,540,"Sorry, we can't accept cash."
1768,4,10,70,84,1.2142857142857142,0.05635573779886005,540,29...36...what?
1768,4,13,81,98,1.2142857142857142,0.05076730825668095,540,I'm hearing 8-2-5-? One more...
1768,4,13,81,98,1.2142857142857142,0.05076730825668095,540,Finally... an Obamacare that Wall Street likes...
1768,3,12,69,84,1.2142857142857142,0.05375041813985263,540,"Yes, I can hear you and no, this is not covered by Obamacare."
1768,3,18,91,112,1.2142857142857142,0.04471519236255008,540,"Turn your dial to the right, then the left, then the right, and cough."
1768,2,20,90,112,1.2142857142857142,0.04287858751340459,540,How long have you had chest pain?
1768,5,11,82,98,1.2142857142857142,0.05279879755594507,540,I'll need you to be more open with me.
1780,1,20,82,103,1.2135922330097086,0.0428618467774595,540,I can help you if only you would open up to me.
1780,3,16,84,103,1.2135922330097086,0.0470942961235598,540,"You know, it's not healthy to keep things locked away."
1780,3,16,84,103,1.2135922330097086,0.0470942961235598,540,How long have you had these secrets?
1780,3,16,84,103,1.2135922330097086,0.0470942961235598,540,We can't approach your deeper insecurities if you're not more open with me.
1784,2,15,72,89,1.2134831460674158,0.04918100989726316,540,We should run more tests...better safe than sorry.
1784,5,9,75,89,1.2134831460674158,0.056434560149382106,540,I feel empty inside
1784,3,13,73,89,1.2134831460674158,0.05171203292685246,540,"You do come across as secure, Mr Fargo, but we both know it's what's inside that counts."
1787,5,16,101,122,1.2131147540983607,0.045423995988459524,540,It's what's on the inside that matters.
1788,3,17,88,108,1.212962962962963,0.04566899344097394,540,"My hands are a little cold, but I'm just going to open you up a wee little bit so we can settle our copay."
1788,3,17,88,108,1.212962962962963,0.04566899344097394,540,"Get the x-ray, it's better to be safe than sorry."
1788,3,17,88,108,1.212962962962963,0.04566899344097394,540,It appears you have heavy metal poisoning.
1788,2,19,87,108,1.212962962962963,0.0437331304091476,540,It sounds like your gold bullion is acting up.
1792,4,12,78,94,1.2127659574468086,0.05211680303793997,540,"Safe to say, it is a combination of a number of factors."
1792,2,16,76,94,1.2127659574468086,0.04752472998434697,540,"I'm putting you on nitroglycerin for the angina, but we should discuss the side effects."
1792,2,16,76,94,1.2127659574468086,0.04752472998434697,540,I understand you've been feeling empty since 2009.
1792,3,14,77,94,1.2127659574468086,0.049873645941421386,540,When we are through you will be able to open up and reveal what's really inside.
1792,4,12,78,94,1.2127659574468086,0.05211680303793997,540,The proctologist loves a challenge.
1792,3,14,77,94,1.2127659574468086,0.049873645941421386,540,"Cough again, and this time cough up the combination."
1798,4,9,67,80,1.2125,0.058173001480633806,540,Have you stopped taking in junk bonds and gotten some exercise?
1799,2,20,91,113,1.2123893805309736,0.04253972530566686,540,Odd indeed! Most patients open up to me.
1799,4,16,93,113,1.2123893805309736,0.04610513913732104,540,I think it is safe to say you don't have a heart.
1801,2,17,80,99,1.2121212121212122,0.046017947241275524,540,I'm afraid we're going to have to open you up -- just to be safe.
1801,2,17,80,99,1.2121212121212122,0.046017947241275524,540,Try to relax. You're in a safe place.
1801,2,17,80,99,1.2121212121212122,0.046017947241275524,540,Describe the pain from 1 to 100.
1801,5,11,83,99,1.2121212121212122,0.05230755832724922,540,Now do you feel safe?
1801,3,15,81,99,1.2121212121212122,0.048205752059134375,540,Perhaps more openness is not the best remedy here.
1801,2,17,80,99,1.2121212121212122,0.046017947241275524,540,I'm not sure why your physiatrist called me in
1801,5,11,83,99,1.2121212121212122,0.05230755832724922,540,"38-24-36. Hey, wait a minute!"
1801,2,17,80,99,1.2121212121212122,0.046017947241275524,540,I think we need to expand your safe space
1809,6,13,99,118,1.2118644067796611,0.04792023243577968,540,You never open up about anything.
1810,1,16,68,85,1.2117647058823529,0.047615752069189415,540,I may have to increase my fees.
1810,5,8,72,85,1.2117647058823529,0.058204020689177696,540,Cough up for me!
1812,2,18,84,104,1.2115384615384615,0.04464003593905589,540,I'm glad you feel safe with me.
1812,3,16,85,104,1.2115384615384615,0.046684465360827584,540,Open and say ka-ching!!!
1812,6,10,88,104,1.2115384615384615,0.05234079477983342,540,"When I suggested that you needed a safe place to express your emotions Mr Dingley, this isn't what I had in mind."
1815,3,13,74,90,1.211111111111111,0.05118921460128822,540,"I need a depository , not s suppository."
1815,4,11,75,90,1.211111111111111,0.05357260103480199,540,"Unless you open up, I can't tell you what's wrong."
1815,2,15,73,90,1.211111111111111,0.04868929863285577,540,I can sense your inner worth.
1818,4,15,90,109,1.2110091743119267,0.04712854742331021,540,Now cough.
1818,4,15,90,109,1.2110091743119267,0.04712854742331021,540,Come on. you can open up to me.
1818,5,13,91,109,1.2110091743119267,0.048897797982513584,540,"Mr. Schrodinger, are you ok in there?"
1818,5,13,91,109,1.2110091743119267,0.048897797982513584,540,Please relax. You are really very safe here.
1818,2,19,88,109,1.2110091743119267,0.04337407810681607,540,"Good news, Mosler--your lock is healthy enough for safe sex."
1823,6,12,96,114,1.2105263157894737,0.04901400775435974,540,"You can open up, this is a safe space."
1823,2,20,92,114,1.2105263157894737,0.042206058518233065,540,I'll take good care of you. Don't worry about a thing - you're safe with me.
1823,4,12,79,95,1.2105263157894737,0.05161390135865942,540,"OK, now firmly press your right index finger into the area where your thigh meets your groin, turn your head to the left, and cough."
1823,2,16,77,95,1.2105263157894737,0.04707511531578504,540,just relax and let it all out
1823,1,18,76,95,1.2105263157894737,0.04463297341944604,540,I think I need an infusion of cash.
1823,3,18,93,114,1.2105263157894737,0.04400689458220717,540,You know that I can't let you out unless you give me the combination.
1823,2,20,92,114,1.2105263157894737,0.042206058518233065,540,"You say left-right-left, but out here it may be right-left-right."
1830,2,17,81,100,1.21,0.045604802157206865,540,"""Just checking the ticker,not planning a heist""."
1830,1,19,80,100,1.21,0.043333333333333335,540,"There's a lot to unlock here, you'll need more appointments."
1830,1,19,80,100,1.21,0.043333333333333335,540,Now turn your head and click a few times for me.
1830,3,15,82,100,1.21,0.047768380565162374,540,A steady diet of bitcoin could explain your empty feeling inside.
1830,3,15,82,100,1.21,0.047768380565162374,540,You sound really congested. I'd feel a whole lot better if we could open you up a little...
1830,4,13,83,100,1.21,0.049838121792844324,540,Are you feeling safe now?
1830,4,13,83,100,1.21,0.049838121792844324,540,"As far as I can tell, Mr. Trump, your tax records are in perfectly good order."
1837,4,9,68,81,1.2098765432098766,0.05751019604371416,540,I feel like I'm having trouble opening myself up to people.
1837,2,13,66,81,1.2098765432098766,0.051866547006419766,540,Take it easy- you're safe here.
1839,5,12,88,105,1.2095238095238094,0.05008278512052043,540,Is the election over yet?
1839,3,16,86,105,1.2095238095238094,0.0462815838009878,540,You're not too big to fail
1839,4,14,87,105,1.2095238095238094,0.04821965555951266,540,I'd like to check your prostate next but I know you tend to lock up.
1839,4,14,87,105,1.2095238095238094,0.04821965555951266,540,I thought you were great in Ocean's Eleven.
1839,5,12,88,105,1.2095238095238094,0.05008278512052043,540,You know you'll never make any headway in these sessions if you don't open up to me.
1839,6,10,89,105,1.2095238095238094,0.05187904729829188,540,You've got safety in numbers... I just can't remember which numbers.
1839,4,14,87,105,1.2095238095238094,0.04821965555951266,540,It is safe to say that you keep all of your emotions locked up inside.
1846,4,10,72,86,1.2093023255813953,0.055148795293926356,540,"It's called PTSD, Mr. Trump. You need to stop counting and come out of there."
1847,3,17,90,110,1.209090909090909,0.0449175958423419,540,I only went into this line of practice because of my med school loans.
1847,6,11,93,110,1.209090909090909,0.050179751199407645,540,I sense tax returns.
1847,2,19,89,110,1.209090909090909,0.04302074784174658,540,"Your ok, but a little more pressure and you would have cracked."
1850,1,17,73,91,1.2087912087912087,0.045604027831460565,540,I really need you to open up about what going on inside.
1850,4,11,76,91,1.2087912087912087,0.053031387753417904,540,I thought I told you it was my back that needed cracking.
1852,4,16,95,115,1.208695652173913,0.045374368134300666,540,Take a deep breath and cough up the copay now
1852,4,16,95,115,1.208695652173913,0.045374368134300666,540,Don't worry. You are safe with me.
1854,7,11,102,120,1.2083333333333333,0.04864527944160098,540,Don't keep it all locked up; the truth will set you free.
1854,6,8,82,96,1.2083333333333333,0.05524400949239042,540,Good thing you dropped in
1854,4,12,80,96,1.2083333333333333,0.05112048604588235,540,"You took quite a tumble, but I think you're going to be OK."
1854,1,18,77,96,1.2083333333333333,0.04422001081778641,540,You should consider my office your safe place.
1854,4,12,80,96,1.2083333333333333,0.05112048604588235,540,"I AM listening, but you've got to open up."
1854,2,16,78,96,1.2083333333333333,0.046633760328105456,540,"I'm here for you, I'm listening. You're in a safe space now."
1860,2,17,82,101,1.2079207920792079,0.04519886023965674,540,Your tumblers do sound congested.
1860,4,13,84,101,1.2079207920792079,0.04938599569639575,540,"you've got to stop locking up your emotions,it's not healthy"
1860,3,15,83,101,1.2079207920792079,0.04733874490250266,540,I'm sensing the last time you opened up was around 1997.
1860,3,15,83,101,1.2079207920792079,0.04733874490250266,540,"You're safe, but you need to open up."
1860,3,15,83,101,1.2079207920792079,0.04733874490250266,540,You say that you hear clicking noises only when someone turns your crank?
1860,4,13,84,101,1.2079207920792079,0.04938599569639575,540,"I get a pulse. Yes, it is his living will."
1860,3,15,83,101,1.2079207920792079,0.04733874490250266,540,You keep everything inside you....you need to open up to me.
1867,4,14,88,106,1.2075471698113207,0.04780347070761396,540,"If you don't have insurance, just give me the combination."
1867,3,16,87,106,1.2075471698113207,0.04588548019119496,540,You can tell me anything. This is a safe space.
1867,1,20,85,106,1.2075471698113207,0.04178622085977893,540,Sounds like it could be a combination of both letters and numbers.
1867,3,16,87,106,1.2075471698113207,0.04588548019119496,540,Could you please coffer for me?
1867,4,14,88,106,1.2075471698113207,0.04780347070761396,540,Don't worry. Your secret is safe with me.
1867,3,16,87,106,1.2075471698113207,0.04588548019119496,540,I've seen worse germophobes.
1873,4,9,69,82,1.2073170731707317,0.05686215517169996,540,You are safe... Just open up to me.
1873,1,15,66,82,1.2073170731707317,0.048269683280641934,540,Repressed? Shut in? You just need to open up more.
1873,3,11,68,82,1.2073170731707317,0.05414970515633626,540,"I understand the situation, Mr. Johnson, but you're just not going to make it to Nov. 9."
1876,5,13,93,111,1.2072072072072073,0.048087275823962834,540,"I wouldn't worry about it, it sounds safe."
1876,6,11,94,111,1.2072072072072073,0.0497612927883716,540,you seem completely safe to me.
1876,3,17,91,111,1.2072072072072073,0.04455093454204471,540,Don't worry. Whatever you have is safe.
1876,3,17,91,111,1.2072072072072073,0.04455093454204471,540,(Hmm...it's true. Money CAN talk!)
1880,2,14,71,87,1.206896551724138,0.049423111543959376,540,I'm really just trying to get you to open up to me.
1880,2,14,71,87,1.206896551724138,0.049423111543959376,540,"I am sorry to hear about the break-in, you are safe now."
1882,4,11,77,92,1.2065217391304348,0.052500866778413105,540,Just breathe normally.
1882,4,11,77,92,1.2065217391304348,0.052500866778413105,540,We're required to ask: Do you feel safe at home?
1882,4,11,77,92,1.2065217391304348,0.052500866778413105,540,We have our ways of getting it out of you.
1885,2,16,79,97,1.2061855670103092,0.0462004455661469,540,I think it's safe to say that you have no heart.
1885,3,14,80,97,1.2061855670103092,0.04846914279015989,540,I can help—with the right combination.
1885,1,18,78,97,1.2061855670103092,0.043814432989690705,540,"If you were open to it, I could help you lose some weight."
1885,4,12,81,97,1.2061855670103092,0.05063629562986725,540,'So what if they say you look square! It's what's inside that counts.'
1885,5,10,82,97,1.2061855670103092,0.052714429404269555,540,Two aspirin and 22R-35L-14R should do the trick.
1885,3,14,80,97,1.2061855670103092,0.04846914279015989,540,I'm picking up the sound of money - so let's begin treatment.
1885,2,16,79,97,1.2061855670103092,0.0462004455661469,540,I'm concerned that you don't feel safe.
1885,4,12,81,97,1.2061855670103092,0.05063629562986725,540,This is the last time I agree to see a patient with a Houdini complex.
1885,1,18,78,97,1.2061855670103092,0.043814432989690705,540,The procedure will be minimally invasive if you just tell us the combination.
1894,2,17,83,102,1.2058823529411764,0.04479993988272699,540,"Well, I think it's safe to say you've cracked."
1894,3,15,84,102,1.2058823529411764,0.046916646025273935,540,Now spin your dial three turns to the right.
1894,5,11,86,102,1.2058823529411764,0.05088659740826314,540,I need to find the right combination of treatments for you.
1894,5,11,86,102,1.2058823529411764,0.05088659740826314,540,Are you empty inside?
1894,4,13,85,102,1.2058823529411764,0.04894189141242656,540,"If it's STDs you are worried about, there are some alternative methods of safe sex."
1894,4,13,85,102,1.2058823529411764,0.04894189141242656,540,"Don't worry, your medical secrets are safe with me."
1900,3,16,88,107,1.205607476635514,0.04549598868304171,540,"Come on, Mr. Greenspan. You can come out now"
1900,3,16,88,107,1.205607476635514,0.04549598868304171,540,"I know you're bashful, but I think it's time you opened up a little."
1900,5,12,90,107,1.205607476635514,0.04921947249572851,540,You're a hard nut to crack.
1900,3,16,88,107,1.205607476635514,0.04549598868304171,540,"Keep calm Mr Blaine. Now did you say,""Three to the left?"""
1900,5,12,90,107,1.205607476635514,0.04921947249572851,540,You're ticking a little faster than I would like.
1905,3,17,92,112,1.2053571428571428,0.044190110926074416,540,"2 to the left and 3 to the right. Now open and say ""Awwwww..."""
1905,2,19,91,112,1.2053571428571428,0.04233073047779356,540,"So, have you ever tried opening up a little?"""
1905,4,15,93,112,1.2053571428571428,0.04597435224702924,540,"I said think OUTSIDE the box, not IN it."
1908,2,20,95,117,1.205128205128205,0.04123509749376133,540,Safe but no sound.
1908,6,12,99,117,1.205128205128205,0.04785166800259878,540,You need to stop taking so many direct deposits and shed a few hundred dollars.
1908,4,16,97,117,1.205128205128205,0.044666068754430015,540,Wait...wait...I hear four heartbeats. You're having quarters!
1911,3,19,100,122,1.2049180327868851,0.041868246759702375,540,"You're the strong, silent type, aren't you?"
1912,0,17,66,83,1.2048192771084338,0.04456679569425884,540,"You've been investing, haven't you?"
1913,5,8,75,88,1.2045454545454546,0.05635916994471799,540,"Wow doc, that thing is cold"
1913,3,12,73,88,1.2045454545454546,0.05151591984183321,540,You can't expect change if you won't open up.
1915,1,26,110,137,1.2043795620437956,0.03609699930584985,540,You just cannot continue to keep everything locked up so tightly inside.
1916,3,13,77,93,1.2043010752688172,0.04968140616939365,540,"You still have a touch of the Houdini syndrome, so you'll just have to wait it out."
1916,4,11,78,93,1.2043010752688172,0.0519807292144392,540,"Yes, the world is a scary place, Mr. Jenson. But a little fresh air wouldn't hurt you."
1916,4,11,78,93,1.2043010752688172,0.0519807292144392,540,Take a deep debt.
1916,3,13,77,93,1.2043010752688172,0.04968140616939365,540,Shall I extract your co-pay now or would you prefer to settle your bill on your way out?
1916,2,15,76,93,1.2043010752688172,0.04727037156900375,540,Your inability to open up is due to a combination of things.
1916,3,13,77,93,1.2043010752688172,0.04968140616939365,540,How often do you spin your tumblers?
1916,3,13,77,93,1.2043010752688172,0.04968140616939365,540,Let's take a look inside just to be.. umm ...safe.
1916,4,11,78,93,1.2043010752688172,0.0519807292144392,540,"Don't worry, the ticking sound is normal. You're safe."
1924,3,14,81,98,1.2040816326530612,0.048018124763472565,540,Are you using protection?
1924,4,12,82,98,1.2040816326530612,0.050161077954179,540,"Open up and say ""Ahh-ffordable Care Act."""
1924,4,12,82,98,1.2040816326530612,0.050161077954179,540,A combination of light exercise and a healthy diet will keep you safe.
1924,1,18,79,98,1.2040816326530612,0.043416050423211075,540,Hmm. . . let's open you up just to be sure.
1924,2,16,80,98,1.2040816326530612,0.045774958984969194,540,"It won't hurt, but you may feel a little click. Say ""aaahh…"""
1924,4,12,82,98,1.2040816326530612,0.050161077954179,540,This is not what I meant when I asked if you had a safe space to go to.
1924,2,16,80,98,1.2040816326530612,0.045774958984969194,540,I'm a doctor. Of course your secret is safe with me.
1924,1,18,79,98,1.2040816326530612,0.043416050423211075,540,You've cracked in front of everyone else. I think it's about time you opened up to me.
1932,6,9,88,103,1.203883495145631,0.05228315346732527,540,"Your pulse is a little high, are you hiding anything from me?"
1933,5,12,91,108,1.2037037037037037,0.0487987568205456,540,So you have children? What are their birthdays?
1933,2,18,88,108,1.2037037037037037,0.043152147891456286,540,"I am going with 'guarded but stable', for now."
1933,1,20,87,108,1.2037037037037037,0.04109790263648383,540,Safe to say...any combination of problems.
1933,4,14,90,108,1.2037037037037037,0.04699200358255153,540,"It's okay Geraldo, you can come out now."
1933,2,18,88,108,1.2037037037037037,0.043152147891456286,540,I've done this before. I promise I will get you to open up.
1933,3,16,89,108,1.2037037037037037,0.045112948630901144,540,This isn't quite what I meant when we discussed establishing your personal safe space.
1939,4,15,94,113,1.2035398230088497,0.04560190938547957,540,"Don't worry, this office is a safe space."
1939,4,15,94,113,1.2035398230088497,0.04560190938547957,540,I still can't hear your safe word.
1941,7,10,101,118,1.2033898305084745,0.04897814575882605,540,The bitcoins seem to have caused the problem.
1942,2,13,69,84,1.2023809523809523,0.05018543326712824,540,Your ticker doesn't sound right.
1942,2,13,69,84,1.2023809523809523,0.05018543326712824,540,You just need to open up to me.
1942,5,7,72,84,1.2023809523809523,0.058130567777581334,540,I'm afraid drugs are messing with your numbers.
1942,2,13,69,84,1.2023809523809523,0.05018543326712824,540,Sounds like a number of combinations.
1946,2,14,73,89,1.202247191011236,0.04841664403947964,540,"No signs of life, Mr Schrodinger. Perhaps use a conventional box next time."
1946,4,10,75,89,1.202247191011236,0.05343123290615736,540,"Don't worry, I'm sure we'll get the right combination of meds this time."
1946,5,8,76,89,1.202247191011236,0.05576969844624596,540,"""I'll do my best to help... but 'the safe has to want to open' ""."
1946,5,8,76,89,1.202247191011236,0.05576969844624596,540,One of us is very sick.
1950,1,17,76,94,1.202127659574468,0.04430450164682011,540,Which drugs? I think I'll use a combination.
1950,4,11,79,94,1.202127659574468,0.05147067771448707,540,"You know, it's what's on the inside that counts."
1950,3,13,78,94,1.202127659574468,0.04919806972822639,540,Keeping your feelings locked up inside can be bad for your health.
1950,1,17,76,94,1.202127659574468,0.04430450164682011,540,It was a panic attack. But you should feel safe now.
1950,4,11,79,94,1.202127659574468,0.05147067771448707,540,I'm going to need to do some x-rays before we decide to open you up or not.
1955,4,12,83,99,1.202020202020202,0.0496945897769771,540,The strong-box and silent type.
1955,4,12,83,99,1.202020202020202,0.0496945897769771,540,It's not uncommon for an ATM your age to experience some occasional stiffness.
1955,4,12,83,99,1.202020202020202,0.0496945897769771,540,I think it's safe to say the combination of your holding on to things and not opening-up enough is affecting your health.
1958,3,15,86,104,1.2019230769230769,0.04609429503917236,540,"I know it's there, Banker; sometimes your heart is just a little hard to find."
1958,2,17,85,104,1.2019230769230769,0.04402246628452523,540,I don't know how you're going to pay your hospital bills if we don't open you up.
1958,2,17,85,104,1.2019230769230769,0.04402246628452523,540,"If the tests show a problem, we’ll have to crack you open."
1958,4,13,87,104,1.2019230769230769,0.04807692307692308,540,Let's try to figure out why you don't feel safe.
1958,5,11,88,104,1.2019230769230769,0.0499809666766309,540,"If you won't open up to, the proctologist will be in next..."
1963,2,18,89,109,1.201834862385321,0.0427952487863065,540,You can be safe here.
1963,3,16,90,109,1.201834862385321,0.044736204398555954,540,I'm going to have to crack you open.
1963,4,14,91,109,1.201834862385321,0.046596380216674414,540,You have a combination mood and anxiety disorder.
1963,4,14,91,109,1.201834862385321,0.046596380216674414,540,"To be fair, I think my suggestion was that you should consider using condoms."
1967,3,17,94,114,1.2017543859649122,0.04348543980269309,540,"I know you're worried about heart disease, but I think you're safe."
1967,2,19,93,114,1.2017543859649122,0.041662070036289175,540,I'm hearing that you feel empty inside.
1967,5,13,96,114,1.2017543859649122,0.04692008381368906,540,"Well I'm sorry, but there's definitely something alive in there, Professor Schrodinger."
1970,3,18,98,119,1.2016806722689075,0.042328992625491904,540,Your coronary arteries are the hardest I've ever seen.
1970,5,14,100,119,1.2016806722689075,0.045569763256829085,540,"I don't want to alarm you, but you seem empty."
1972,6,12,102,120,1.2,0.04674263524428026,540,Life is a combination of left turns and right turns... only then will you open up
1972,6,8,86,100,1.2,0.05318160234783104,540,You're telling me you feel trapped?
1972,3,15,87,105,1.2,0.04569367667316878,540,I hate to tell you this. Your assets have inflated.
1972,3,14,83,100,1.2,0.04714045207910317,540,"Your therapist asked me here to help open you up, Mr. Jenkins."
1972,3,13,79,95,1.2,0.04872391770757884,540,"So, you feel a little left out, is that right? or left?"
1972,3,15,87,105,1.2,0.04569367667316878,540,"Don't worry, I'm a doctor...your secret's safe with me."
1972,5,11,89,105,1.2,0.04954000862144107,540,"I'll prescribe the combination therapy, but only if you promise to practice safe sex."
1972,2,17,86,105,1.2,0.04364357804719849,540,I will let you out as soon as you give up this Houdini nonsense.
1972,7,7,91,105,1.2,0.05310850045437945,540,I see this in about one percent of patients.
1972,4,10,76,90,1.2,0.0528819853025402,540,I would say you are safe for the time being.
1972,5,12,93,110,1.2,0.047978310362298264,540,"I can't confirm this without opening you up, but you seem to have a heart of gold."
1972,4,11,80,95,1.2,0.0509704259596523,540,"Yes, you are healthy enough to be President."
1972,2,16,82,100,1.2,0.044946657497549475,540,Next time use a safe word.
1972,2,18,90,110,1.2,0.04244409559694416,540,You can assure your husband that your method of contraception is safe.
1972,4,12,84,100,1.2,0.04923659639173309,540,It's congenital lockjaw.
1972,4,14,92,110,1.2,0.046207278580632616,540,"Usually it's heart, lungs or the combination!"
1972,2,17,86,105,1.2,0.04364357804719849,540,"Next time, you need to choose a safe word."
1972,5,12,93,110,1.2,0.047978310362298264,540,"The safecracker will be here in just a minute, Melania."
1972,3,12,75,90,1.2,0.05046599329648382,540,How many diamonds would you say you have a week?
1972,2,13,70,85,1.2,0.04964862530219501,540,"If you want to remain safe, I'd better check your tumblers."
1972,2,17,86,105,1.2,0.04364357804719849,540,Just take 2 million and call me in the morning.
1972,0,19,76,95,1.2,0.04125684985035172,540,This confirms money does talk
1972,2,15,78,95,1.2,0.04636869624047491,540,"Oh no, everything is kept strictly confidential."
1995,4,16,101,121,1.1983471074380165,0.04331293445076264,540,You need to lose weight. My bill should cure that.
1996,3,17,96,116,1.1982758620689655,0.04280254792505459,540,I'd like to recommend a new combination...
1996,3,17,96,116,1.1982758620689655,0.04280254792505459,540,Because of the Doctor patient privilege your problems are safe with me.
1996,4,15,97,116,1.1982758620689655,0.044519469295554885,540,"A little slow on the uptick, we're going to have to open you up."
1996,2,19,95,116,1.1982758620689655,0.04101381561614739,540,Just relax .. you're in a safe place now
2000,1,20,90,111,1.1981981981981982,0.04010596084093461,540,Sounds like you need a safe space.
2000,3,16,92,111,1.1981981981981982,0.04400100479051482,540,"Don't worry, you're safe for now."
2000,1,20,90,111,1.1981981981981982,0.04010596084093461,540,Your heart doesn't seem to be in the right place.
2003,2,17,87,106,1.1981132075471699,0.04327104097035949,540,"Yes, it was touch-and-go there for awhile but now we think you're safe."
2003,3,15,88,106,1.1981132075471699,0.04529986209665202,540,"It was a close call, but you're a safe now."
2003,6,9,91,106,1.1981132075471699,0.050903448448284656,540,"At last, a patient with a heart of gold."
2003,4,13,89,106,1.1981132075471699,0.04724163444772896,540,"I don't want to alarm you, but it could be a crack."
2003,4,13,89,106,1.1981132075471699,0.04724163444772896,540,"Oh yes, there's certainly a rumble in your tumble"
2008,4,12,85,101,1.198019801980198,0.04878687126635613,540,Your anxiety stems from a combination of factors.
2008,2,16,83,101,1.198019801980198,0.0445434529869386,540,And how are the anxiety medications working for you?
2008,3,14,84,101,1.198019801980198,0.046713370740932486,540,You need to open up about your problems.
2008,2,16,83,101,1.198019801980198,0.0445434529869386,540,"Now breathe in deeply, release slowly, and cough up the copay."
2008,1,18,82,101,1.198019801980198,0.04226226924834268,540,Ahh...a little to the right...then to the left please.
2008,3,14,84,101,1.198019801980198,0.046713370740932486,540,"Upon initial examination, it looks like you've got a simple case of agoraphobia."
2008,3,14,84,101,1.198019801980198,0.046713370740932486,540,We also accept Visa.
2008,3,14,84,101,1.198019801980198,0.046713370740932486,540,Good news! You've got a heart of gold.
2016,4,11,81,96,1.1979166666666667,0.05047969816570406,540,How again did the banana get stuck in there?
2016,4,11,81,96,1.1979166666666667,0.05047969816570406,540,I think I've found Trump's tax returns.
2016,3,13,80,96,1.1979166666666667,0.04825869539561291,540,Don't worry. We accept payment in small unmarked bills.
2016,3,13,80,96,1.1979166666666667,0.04825869539561291,540,"Right 16 and Left 43 are fine, but I'd like to hear a stronger click on Right 28."
2016,2,15,79,96,1.1979166666666667,0.04593041950246607,540,"You seem fine, other than forgetting your combination."
2016,4,11,81,96,1.1979166666666667,0.05047969816570406,540,You seem to be very guarded. You should open up more.
2016,4,11,81,96,1.1979166666666667,0.05047969816570406,540,"I'm glad you came in, it isn't normal to wake up feeling empty."
2023,1,16,74,91,1.1978021978021978,0.044802592971196056,540,I'm hearing 'left - right - left'
2023,3,12,76,91,1.1978021978021978,0.049956709512768704,540,Mr. Brinks? Can we talk?
2023,3,12,76,91,1.1978021978021978,0.049956709512768704,540,"Take a breath and say 8 to the right, sixteen to the left and 42 to the right, and then say 'Open'"
2023,3,12,76,91,1.1978021978021978,0.049956709512768704,540,It may be the money
2023,1,16,74,91,1.1978021978021978,0.044802592971196056,540,I can't help you if you keep things hidden from me.
2028,3,11,72,86,1.197674418604651,0.051833067425708014,540,All I hear is debt debt... debt debt... debt debt
2028,5,7,74,86,1.197674418604651,0.05686705989580447,540,"Before we can proceed, please tap once to indicate we have provided you with a HIPAA disclosure."
2030,2,12,67,81,1.1975308641975309,0.05097734030138908,540,We all get forgetful at times. What was your manufacture date?
2030,2,12,67,81,1.1975308641975309,0.05097734030138908,540,The stethoscope might be a little cold. Try to breath normally.
2032,2,10,59,71,1.1971830985915493,0.05537404657552627,540,"This is just a routine audit of your tax forms, Donald."
2033,2,20,100,122,1.1967213114754098,0.03971061876147311,540,It's important to have a sense of self-worth.
2034,5,13,99,117,1.1965811965811965,0.04580761072155073,540,And you're coughing up money?
2034,3,17,97,117,1.1965811965811965,0.042468962400341995,540,When did you have your last holdup...I mean checkup?
2036,4,14,94,112,1.1964285714285714,0.045448015961182156,540,Uh=oh! I'm putting you on nitroglycerine.
2036,0,22,90,112,1.1964285714285714,0.03770970049347017,540,"Now, click four times to the left."
2036,4,14,94,112,1.1964285714285714,0.045448015961182156,540,"You have to open up to me a bit, or I won't be able to afford to continue your sessions..."
2036,3,16,93,112,1.1964285714285714,0.04364226155841041,540,I think you need to be more open with your feelings.
2036,4,14,94,112,1.1964285714285714,0.045448015961182156,540,"It's ok, you're safe here."
2041,4,13,90,107,1.1962616822429906,0.046834653903772186,540,Your exactly the patient the affordable care act was designed for
2041,3,15,89,107,1.1962616822429906,0.044912682652352945,540,"So, you believe many of your problems stem from parents that were tight-fisted and miserly?"
2041,3,15,89,107,1.1962616822429906,0.044912682652352945,540,"All I said was: ""Wouldn't you rather be safe than sorry?"""
2044,2,16,84,102,1.196078431372549,0.04414729692425362,540,"Sir, I think you have something inside of you."
2044,6,8,88,102,1.196078431372549,0.05220662859041765,540,"I know you think it's safe, but you really need to lose a few pounds."
2044,3,14,85,102,1.196078431372549,0.04629385365772775,540,Has your diet been particularly rich as of lately?
2044,5,10,87,102,1.196078431372549,0.0503129705743252,540,"I am sorry to report, contrary to your expectations, there is nothing in there."
2044,3,14,85,102,1.196078431372549,0.04629385365772775,540,And you're sure your insurance card is inside?
2044,2,16,84,102,1.196078431372549,0.04414729692425362,540,Turn this way a little and I'll check your ticker.
2044,0,20,82,102,1.196078431372549,0.03950581861179962,540,If you open up for me you'll get a lollipop.
2044,3,14,85,102,1.196078431372549,0.04629385365772775,540,I think I've found the problem. Are you sure that you're practicing safe sex?
2044,4,12,86,102,1.196078431372549,0.048345195699759175,540,I'd like to take a crack at you on this couch in the safest way possible.
2044,2,16,84,102,1.196078431372549,0.04414729692425362,540,"If you open up to me, I promise I'll listen."
2044,6,8,88,102,1.196078431372549,0.05220662859041765,540,"Feynman, you in there?"
2044,4,12,86,102,1.196078431372549,0.048345195699759175,540,Now take a deep breath. and cough up your combination.
2044,2,16,84,102,1.196078431372549,0.04414729692425362,540,"So we can start to cure your Social Anxiety Disorder today, or you can just stay in there until November 9th."
2057,2,15,80,97,1.1958762886597938,0.04550021538441706,540,"It's okay to say anything, Mrs. Johnson. You're in a safe space."
2057,4,11,82,97,1.1958762886597938,0.04999822861495349,540,"You can come out of your Safe Place now, Mr. Houdini."
2057,4,11,82,97,1.1958762886597938,0.04999822861495349,540,"I have good news or bad news, Mr. Scrhodinger."
2057,2,15,80,97,1.1958762886597938,0.04550021538441706,540,"If you don't tell me now, I'll get it out of you eventually."
2057,3,13,81,97,1.1958762886597938,0.04780215719327684,540,"It's OK, your inner secrets are safe with me."
2062,2,14,76,92,1.1956521739130435,0.046980316386280786,540,Cough it up!
2062,5,8,79,92,1.1956521739130435,0.054072402919355736,540,"Take a deep breath, exhale, saying any random numbers that come to mind."
2062,2,14,76,92,1.1956521739130435,0.046980316386280786,540,"Don't worry, you're safe"
2065,4,9,74,87,1.1954022988505748,0.05382727149237504,540,Juuust to be safe.
2065,4,9,74,87,1.1954022988505748,0.05382727149237504,540,"It's not an irregular heartbeat, you just changed your combination again!"
2065,3,11,73,87,1.1954022988505748,0.051284178358943375,540,"Once I get my fee, we can begin."
2068,4,8,70,82,1.1951219512195121,0.05606547660048022,540,I see your heart rate goes up during safe sex...
2068,3,10,69,82,1.1951219512195121,0.05331250832765854,540,Just because you had a flu shot it doesn't mean you're safe.
2070,4,14,95,113,1.1946902654867257,0.045077554815128755,540,"Don't worry, we'll get you out."
2070,3,16,94,113,1.1946902654867257,0.043289238099276685,540,"You can feel safe with me, I am here for you not for your money!"
2072,3,15,90,108,1.1944444444444444,0.04453197507374984,540,We are not going to make any progress if you insist on keeping your emotions locked up like this.
2072,3,15,90,108,1.1944444444444444,0.04453197507374984,540,I know you're afraid of needles but if you come out I'll give you a lollipop.
2072,4,13,91,108,1.1944444444444444,0.046434546089062695,540,Houdini receives his annual checkup.
2072,4,13,91,108,1.1944444444444444,0.046434546089062695,540,"Ah, yes! I know that empty feeling."
2072,2,17,89,108,1.1944444444444444,0.04254440665282414,540,"No, I am not going to break you. I just want to hear you tick."
2072,3,15,90,108,1.1944444444444444,0.04453197507374984,540,You're lonely--you need to open up.
2072,4,13,91,108,1.1944444444444444,0.046434546089062695,540,"Yes, Ms. Johnson, I understand that the HIPPA regulations can be confusing, but I'm going to need you to tap twice if you consent to me spinning your dial...."
2072,3,15,90,108,1.1944444444444444,0.04453197507374984,540,Since when do you feel this emptiness?
2080,2,16,85,103,1.1941747572815533,0.04375801017679495,540,You've got lockjaw.
2080,4,12,87,103,1.1941747572815533,0.04791135849494997,540,Why are you afraid of Bitcoins?
2080,4,12,87,103,1.1941747572815533,0.04791135849494997,540,Open up and say Ah.
2080,3,14,86,103,1.1941747572815533,0.04588170510924863,540,"I'd say you're safe from everything."""
2084,4,11,83,98,1.1938775510204083,0.04952576121200433,540,"Rest assured, you're safe and sound."
2084,5,9,84,98,1.1938775510204083,0.05160614749575169,540,"Absolutely, doc. I'm gonna take it with me!"
2084,3,13,82,98,1.1938775510204083,0.04735406622354269,540,TAP out the combination AGAIN and PAUSE between the numbers!
2084,2,15,81,98,1.1938775510204083,0.0450778676534157,540,You've got quite a coffer there.
2084,2,15,81,98,1.1938775510204083,0.0450778676534157,540,Well-you should have thought about the whole 'not enough air' thing before you locked yourself in this safe
2084,4,11,83,98,1.1938775510204083,0.04952576121200433,540,It sounds like your tumblers are in good shape.
2084,1,17,80,98,1.1938775510204083,0.04268044887831027,540,Just breathe deeply and try to relax. You're in a safe space now.
2091,1,16,76,93,1.1935483870967742,0.043935820942387044,540,Accepting the fact that you are locked in a box is the first step to recovery.
2091,1,16,76,93,1.1935483870967742,0.043935820942387044,540,I'm going to prescribe a combination of ingredients.
2091,2,14,77,93,1.1935483870967742,0.04652000056511267,540,"Your bonds are down 14%, You stocks can't cover the losses and you are short of cash flow. I think I need to recommend a specialist."
2091,2,14,77,93,1.1935483870967742,0.04652000056511267,540,Trying to hide your contents from people will only make things worse.
2091,4,10,79,93,1.1935483870967742,0.05129930441995542,540,"No, condoms won't work for you."
2091,3,12,78,93,1.1935483870967742,0.04896799509143365,540,"Physically, your fine. Mentally, you may need to open up to a psychiatrist."
2097,2,19,98,119,1.1932773109243697,0.0400777462009214,540,"Yes, I can assure you. You should feel absolutely safe."
2098,3,11,74,88,1.1931818181818181,0.05074665738242957,540,"Okay. Big breath in, then just open up and let it out."
2098,2,13,73,88,1.1931818181818181,0.04810395218312092,540,I can't hear the compounding
2100,5,12,97,114,1.1929824561403508,0.046416689667799826,540,"Yes I'm afraid you're right, I do hear ticking."
2100,3,16,95,114,1.1929824561403508,0.04294180119029562,540,"Safe sex, good. Combination of symptoms, troubling. How long have you been a coffer?"
2100,3,16,95,114,1.1929824561403508,0.04294180119029562,540,"So, why don't you feel safe at home?"
2100,1,20,93,114,1.1929824561403508,0.039159768886152954,540,"Everything seems fine individually, but the combination worries me."
2100,3,16,95,114,1.1929824561403508,0.04294180119029562,540,I just feel a little empty inside doc.
2105,4,8,71,83,1.1927710843373494,0.05543573906097862,540,"It's official, you're empty inside."
2106,5,11,93,109,1.1926605504587156,0.047850614573021776,540,The cat is alive......or may be dead Sir.
2107,5,10,89,104,1.1923076923076923,0.04941200769327116,540,Take a big breath and tell me your password.
2107,1,18,85,104,1.1923076923076923,0.041166983308659526,540,"Okay, now turn your knob to the left."
2107,3,19,108,130,1.1923076923076923,0.039520310737412155,540,And how many breaches have you had this week?
2107,3,14,87,104,1.1923076923076923,0.045476735915275075,540,"To be safe, we should do a stress test."
2107,4,12,88,104,1.1923076923076923,0.047485155647778804,540,"It's good to know that you always use protection, but I never date my patients."
2107,4,12,88,104,1.1923076923076923,0.047485155647778804,540,The Hurt Locker
2107,4,12,88,104,1.1923076923076923,0.047485155647778804,540,You may want to watch your weight.
2107,6,8,90,104,1.1923076923076923,0.05126649004628654,540,"I don't know, it is simply too early to say if you are safe."
2107,5,10,89,104,1.1923076923076923,0.04941200769327116,540,Your a hard nut to crack-but I will find out what makes you tic.
2107,0,15,63,78,1.1923076923076923,0.04491340062470325,540,You should open up more in our sessions.
2107,1,18,85,104,1.1923076923076923,0.041166983308659526,540,Be calm your number is coming up.
2107,5,10,89,104,1.1923076923076923,0.04941200769327116,540,"Your BMI is high; you could stand to lose a little weight. Slow pulse and low blood pressure. In summary, you are suffering from a combination of symptoms. And with regard to your other question, we still recommend safe sex."
2107,5,10,89,104,1.1923076923076923,0.04941200769327116,540,"The Locksmith is en route. Are you still OK, Tibbles?"
2120,1,17,81,99,1.1919191919191918,0.042292498960325685,540,"Don't worry, it's just part of the Fed's new stress test."
2120,5,9,85,99,1.1919191919191918,0.05111973905892743,540,Tell me if this is cold.
2120,4,11,84,99,1.1919191919191918,0.04906204906204907,540,I wish you had come to me sooner.
2120,0,19,80,99,1.1919191919191918,0.03978080447933687,540,"If you'd open up a little, I'd get a better diagnosis."
2120,3,13,83,99,1.1919191919191918,0.04691419395962154,540,You seem safe and sound to me.
2120,3,13,83,99,1.1919191919191918,0.04691419395962154,540,It's serious. Looks like we'll have to crack your chest.
2120,1,17,81,99,1.1919191919191918,0.042292498960325685,540,"I know, but I could give a more accurate diagnosis if I could examine your tax returns!"
2120,5,9,85,99,1.1919191919191918,0.05111973905892743,540,"Mr. Houdini, breathe deeply and tell me about your first Halloween."
2120,4,11,84,99,1.1919191919191918,0.04906204906204907,540,I'm sure one day he'll remember the right combination.
2120,2,15,82,99,1.1919191919191918,0.04466316750517219,540,Don't make me call a locksmith again!
2120,2,15,82,99,1.1919191919191918,0.04466316750517219,540,I hope you feel safe to open up to me.
2120,2,15,82,99,1.1919191919191918,0.04466316750517219,540,The blood bank is next door.
2120,4,11,84,99,1.1919191919191918,0.04906204906204907,540,"Yes, I am listening. Just let it all out. Let it all out."
2120,2,15,82,99,1.1919191919191918,0.04466316750517219,540,Your tumblers may need some WD-40.
2134,4,10,80,94,1.1914893617021276,0.0507923846035789,540,I'm hearing a combination of clicks and rattles.
2134,4,10,80,94,1.1914893617021276,0.0507923846035789,540,As soon as I adjust your tumblers I want you to cough!
2134,2,14,78,94,1.1914893617021276,0.046068483097531414,540,"Sounds like you're trying to feel safe by a combination of keeping your feelings locked up inside and presenting a cold, tough exterior to those around you. And you think if you open up more easily to others, you'll lose your self worth."
2134,5,8,81,94,1.1914893617021276,0.05299666907573578,540,"Please turn to over to your left side, turn over to your right side and open wide."
2134,2,14,78,94,1.1914893617021276,0.046068483097531414,540,How long have you had this hollow feeling?
2134,3,12,79,94,1.1914893617021276,0.048487995775374215,540,"Yes, I feel it is safe to say that you have some disturbing issues from your childhood locked away deep inside."
2134,1,16,77,94,1.1914893617021276,0.043514647367321815,540,Sorry. No discount for cash.
2134,6,6,82,94,1.1914893617021276,0.05511286177044538,540,You are only imagining that you're safe.
2142,4,14,97,115,1.191304347826087,0.044354256873596794,540,"My diagnosis, postpone your retirement."
2142,3,16,96,115,1.191304347826087,0.0425998216136205,540,Take a deep spin.
2142,4,14,97,115,1.191304347826087,0.044354256873596794,540,"I said, ""Breath deeply, and hold."" I didn't say, ""This is a hold up."""
2145,4,9,76,89,1.1910112359550562,0.052701300672173365,540,"I'm sorry, Mr. Hollon, but with your heart condition you shouldn't have any safe sex."
2146,1,19,90,110,1.190909090909091,0.03979818677571405,540,Have you been staying safe?
2146,2,17,91,110,1.190909090909091,0.041841383127562214,540,I'm a doctor. It is OK to open up to me.
2146,2,17,91,110,1.190909090909091,0.041841383127562214,540,"Hmm. A heart of gold, you say?"
2146,2,17,91,110,1.190909090909091,0.041841383127562214,540,That's funny—most people come to me for break OUTS.
2146,1,19,90,110,1.190909090909091,0.03979818677571405,540,Click...click is normal.
2151,7,6,92,105,1.1904761904761905,0.05258037297165626,540,I don't like what I'm hearing. I'm going to refer you to a Cartier-logist.
2151,2,16,87,105,1.1904761904761905,0.04299935704272291,540,Your heart won't survive any combination of safe sex.
2151,5,10,90,105,1.1904761904761905,0.04897341376234777,540,It's the heavy metals that are giving me cause for concern.
2151,2,12,70,84,1.1904761904761905,0.049310188462709244,540,This isn't what I meant when I said you needed to find a safe space for your feelings.
2151,4,12,89,105,1.1904761904761905,0.04706639005052258,540,"The click is faint, but I'm confident you'll be fine."
2151,3,14,88,105,1.1904761904761905,0.045078763173336374,540,Safe to say....your vitals sound good.
2157,1,21,99,121,1.1900826446280992,0.03769174959005415,540,It might be just anxiety. Sometimes keeping things locked up can cause health issues.
2157,1,21,99,121,1.1900826446280992,0.03769174959005415,540,"You had a bad tumbler, but I think you're safe now."
2159,3,13,84,100,1.19,0.046482319871173156,540,"Please take a deep breath, and hold it, and then open slowly!"
2159,1,17,82,100,1.19,0.041911402464790595,540,Just click slowly.
2159,5,9,86,100,1.19,0.05064233865696235,540,I can hear you now. You say you're an introverted Jewish contortionist who likes lox.
2159,1,17,82,100,1.19,0.041911402464790595,540,Your combination has gone up.
2159,2,15,83,100,1.19,0.04425591326123388,540,Guess I won't need the stirrups.
2159,2,15,83,100,1.19,0.04425591326123388,540,OK. You should feel safe enough to tell me what you're feeling.
2159,5,9,86,100,1.19,0.05064233865696235,540,David Blaine gets his annual.
2159,2,15,83,100,1.19,0.04425591326123388,540,They say money talks but I'm not picking up anything yet!
2167,2,18,96,116,1.1896551724137931,0.0404505975246002,540,And just when exactly did you stop feeling safe?
2167,3,16,97,116,1.1896551724137931,0.04226317401211664,540,If you have been having safe sex then you may be pregnant.
2167,2,18,96,116,1.1896551724137931,0.0404505975246002,540,"Doc, is that perfect 36-24-36 out there for me?"
2167,4,14,98,116,1.1896551724137931,0.04400114674709866,540,I'm afraid we'll need to crack you open to find what's really inside.
2171,0,18,77,95,1.1894736842105262,0.04041979281351409,540,"Exhale a few hundreds, please"
2171,1,16,78,95,1.1894736842105262,0.043101320360528265,540,Alright now tell me you don't feel safe
2171,3,12,80,95,1.1894736842105262,0.048017206793896844,540,I'm afraid it's more that just a bad dream.
2171,3,12,80,95,1.1894736842105262,0.048017206793896844,540,I'm listening to you. We'll crack this case.
2171,1,16,78,95,1.1894736842105262,0.043101320360528265,540,...and coffer.
2176,3,15,93,111,1.1891891891891893,0.04342712746002104,540,I knew this skill would somehow help me pay off my medical school loans.
2176,1,12,61,74,1.1891891891891893,0.04971475717491745,540,The doctor will be right in.
2176,5,11,95,111,1.1891891891891893,0.04704801512316158,540,Your voice is muffled. Give me that combination again.
2176,3,15,93,111,1.1891891891891893,0.04342712746002104,540,You really should have gone to a chiropractor.
2176,3,15,93,111,1.1891891891891893,0.04342712746002104,540,"Listen Harold, we didn't take the money out of your mattress so you could sleep in the safe."
2176,3,15,93,111,1.1891891891891893,0.04342712746002104,540,I'd recommend you see a specialist at Sing Sing
2182,4,9,77,90,1.1888888888888889,0.05215564061107554,540,"Unfortunately, Mrs. Trump, we don't know the combination either."
2183,3,14,89,106,1.1886792452830188,0.044687610008373936,540,"""And that was 4 left,11 right and what ?"
2183,5,10,91,106,1.1886792452830188,0.048542471371932065,540,Speak up! I got the 13 left and 24 right. What's the next number?
2183,2,16,88,106,1.1886792452830188,0.04262966067122,540,Still at sixes and sevens with you.
2183,2,16,88,106,1.1886792452830188,0.04262966067122,540,"No, I am not a crack doctor."
2183,2,16,88,106,1.1886792452830188,0.04262966067122,540,Your numbers aren't clear and you feel and sound strong. In my opinion you are safe.
2183,3,14,89,106,1.1886792452830188,0.044687610008373936,540,Yes my practice is cash only.
2183,0,20,86,106,1.1886792452830188,0.0381824426969915,540,Your heart is fine---you can come out now.
2190,6,11,105,122,1.1885245901639345,0.045576538549547026,540,"I think you are safe for now, but I'd recommend you start taking iron supplements."
2190,4,15,103,122,1.1885245901639345,0.04250005732220327,540,"The TV cameras are long gone, Geraldo."
2192,5,6,74,85,1.188235294117647,0.05674187869198083,540,"For the last time, this isn't what I meant when I said my office is a safe zone."
2192,2,12,71,85,1.188235294117647,0.048778116640986524,540,"Mz. Cravin, you'll need to come out of your safe space."
2194,4,11,86,101,1.188118811881188,0.048159946562436856,540,Your health insurance is one of the more complicated ones.
2194,1,17,83,101,1.188118811881188,0.04153698408594658,540,Good. Now cough up what’s inside your chest.
2194,6,7,88,101,1.188118811881188,0.05210969254233966,540,This drawing makes no sense whatsoever.
2194,3,13,85,101,1.188118811881188,0.04605823108757625,540,Did either of your parents have problems with their ticker?
2194,4,11,86,101,1.188118811881188,0.048159946562436856,540,You should consider donating your organs to the poor.
2194,1,17,83,101,1.188118811881188,0.04153698408594658,540,You have to promise you'll take the safe dosage.
2194,4,11,86,101,1.188118811881188,0.048159946562436856,540,My last doctor was in it just for the money.
2201,5,12,100,117,1.188034188034188,0.04530998763637655,540,"I'll take a crack at it Mr. Lock, but it's a safe bet that your symptoms are a combination of a number of possibilities."
2202,4,7,69,80,1.1875,0.05651747237398629,540,Perhaps you took my iron-rich diet recommendation a bit too far.
2202,3,12,81,96,1.1875,0.047555369390792634,540,Lose the weight.
2202,5,8,83,96,1.1875,0.05196257931553059,540,"All sounds good. Next, I'll have you remove your drawers as I go put on a glove."
2202,4,10,82,96,1.1875,0.04980774441298032,540,I know you feel safe in there but we need to discuss other options.
2202,1,16,79,96,1.1875,0.042695628191498324,540,I'll be with you as soon as we receive your copay.
2202,4,10,82,96,1.1875,0.04980774441298032,540,Just relax you're safe here
2202,3,12,81,96,1.1875,0.047555369390792634,540,"It must have been quite a shock to be robbed of all that money you held for so many years. We call it Separation Anxiety, and with the proper treatment, you'll be fine in no time."
2202,1,16,79,96,1.1875,0.042695628191498324,540,"Come now, Mr. V. You can't keep it all locked up inside: you've got to open up to me if you want me to help you."
2202,3,9,68,80,1.1875,0.053644841199706916,540,"Your iron levels are fine. Just need to check your pulse, and you'll be good to go."
2202,3,12,81,96,1.1875,0.047555369390792634,540,Just breathe in for me. You will be ok. Go to your safe place.
2202,5,11,96,112,1.1875,0.046656639619587055,540,"Your cold to the touch. But I bet there's a heart of gold inside. Or guns, classified documents and cash..."
2202,2,14,80,96,1.1875,0.04519087200177378,540,I don't want to lock in on any diagnosis just yet.
2202,2,14,80,96,1.1875,0.04519087200177378,540,"Calm down, you're safe now."
2215,5,13,105,123,1.1869918699186992,0.04373230073001501,540,"You have a heart of gold, thus your problem."
2216,5,10,92,107,1.1869158878504673,0.04811898407826445,540,"I said go to your ""Safe place"", not ""Safe""!"
2216,5,10,92,107,1.1869158878504673,0.04811898407826445,540,9... 1... 1.
2216,3,14,90,107,1.1869158878504673,0.04430310533375682,540,You definitely need to lose weight and stop sitting around all day.
2216,3,14,90,107,1.1869158878504673,0.04430310533375682,540,"Well Roger, you're going to have to start opening up to more people"
2216,2,16,89,107,1.1869158878504673,0.042266173223498654,540,Let’s order an x-ray just to be sure.
2221,1,15,75,91,1.1868131868131868,0.04395604395604396,540,Unlocking the subconscious isn't an exact science.
2221,2,13,76,91,1.1868131868131868,0.046651195530939105,540,You're safe now.
2221,1,15,75,91,1.1868131868131868,0.04395604395604396,540,Have you been taking your iron supplement?
2221,1,15,75,91,1.1868131868131868,0.04395604395604396,540,"If you want me to help you, you have to open up to me."
2221,2,13,76,91,1.1868131868131868,0.046651195530939105,540,"Listen to me, Harold: this is NOT the way to cure your claustrophobia!"
2221,1,15,75,91,1.1868131868131868,0.04395604395604396,540,I'm increasing your medication. Better to be safe than sorry.
2221,3,11,77,91,1.1868131868131868,0.04919892568609763,540,Is it safe?
2221,3,11,77,91,1.1868131868131868,0.04919892568609763,540,"I had helicopter parents, too."
2229,2,18,98,118,1.1864406779661016,0.03982642431771825,540,Let's try a combination of exercise and not letting everything stay locked up inside you.
2230,5,9,88,102,1.1862745098039216,0.04971358884367402,540,"Okay, 26 deep breaths to the left...13 to the right..."
2230,5,9,88,102,1.1862745098039216,0.04971358884367402,540,"Open up, or I send in the surgeon."
2230,5,9,88,102,1.1862745098039216,0.04971358884367402,540,Your shortness of breath is due to an iron deficiency.
2230,3,13,86,102,1.1862745098039216,0.045641722077372035,540,"No need to worry, you'll be safe with me."
2230,5,9,88,102,1.1862745098039216,0.04971358884367402,540,"If you are seeking closure, you'll have to open up so I can help you."
2235,2,12,72,86,1.186046511627907,0.048257256089076536,540,So you think there's safety in numbers?
2235,5,6,75,86,1.186046511627907,0.05612090696789607,540,Try to cut down on the yeggs.
2235,4,8,74,86,1.186046511627907,0.053627962740362745,540,You sound like a coffer.
2238,4,10,83,97,1.1855670103092784,0.04932947498266527,540,"I'm sorry, but Donald says the audit is still not over."
2238,2,14,81,97,1.1855670103092784,0.04476431433028531,540,I think you need an infusion of new funds.
2238,3,12,82,97,1.1855670103092784,0.04710223423323986,540,It's safe to say you're still as strong as you ever were
2238,3,12,82,97,1.1855670103092784,0.04710223423323986,540,Let it go.
2238,4,10,83,97,1.1855670103092784,0.04932947498266527,540,"Hold on Hubert, I'll have you out of there in no time at all."
2243,2,19,103,124,1.185483870967742,0.03860764374112212,540,You're safe with me now. I've got your combination.
2244,4,12,92,108,1.1851851851851851,0.0458528432905113,540,Why do you feel unsafe?
2244,2,16,90,108,1.1851851851851851,0.04190874258156364,540,"No, Mr. Trump and Mrs. Clinton, I am not letting you out until you learn to play nice"
2244,0,20,88,108,1.1851851851851851,0.037552658650371815,540,There's much of value in you if you'll only open up.
2244,1,18,89,108,1.1851851851851851,0.039790356095912936,540,"The rattle is gone, but now I have this empty feeling in my chest."
2244,3,14,91,108,1.1851851851851851,0.043925083623096,540,"I won't get an accurate pulse until you stop screaming, Mr. Johnson."
2249,5,12,102,119,1.184873949579832,0.044600789096914985,540,"This is no way to deal with your anxiety attacks, Mr. Jones. Please tell me the combination immediately, before you run out of air!"
2250,3,11,78,92,1.184782608695652,0.0487035648134137,540,"You know the rules, Mr. Kaminsky. I'm afraid I'll have to charge you for a missed appointment."
2250,5,7,80,92,1.184782608695652,0.05338370830143901,540,Getting reimbursed by the insurance company is becoming more challenging every year.
2250,3,11,78,92,1.184782608695652,0.0487035648134137,540,I'm not sure if your HMO covers magic tricks. Check with the front desk.
2250,2,13,77,92,1.184782608695652,0.04618599010841946,540,I think there's enough for ten sessions
2250,4,9,79,92,1.184782608695652,0.05109724815265259,540,I think I can detect some $20s and $100s.
2255,2,15,86,103,1.1844660194174756,0.04307691007839965,540,"I don't want to alarm you, but I don't like how you sound. Have you been exposed to anyone with bitcoins lately?"
2255,4,11,88,103,1.1844660194174756,0.04729011524728665,540,"Mr. Smith, if you can hear me: this is not what I had in mind when I recommended a safe place to depressurize after the evening commute."
2255,4,11,88,103,1.1844660194174756,0.04729011524728665,540,"I figured if Houdini could do it, why can't I."
2255,3,13,87,103,1.1844660194174756,0.04523259434304085,540,"Vice-President Gore, you can come out of the lockbox now."
2255,1,17,85,103,1.1844660194174756,0.04080750877967151,540,"It sounds normal. You're safe. I mean, it sounds normal. You are a safe."
2255,3,13,87,103,1.1844660194174756,0.04523259434304085,540,"Something keeps saying, ""Can Your Hear Me Now?"""
2255,4,11,88,103,1.1844660194174756,0.04729011524728665,540,We're trying to unlock your unconscious.
2255,3,13,87,103,1.1844660194174756,0.04523259434304085,540,"Your problems are not physical, but psychological. You keep things inside. Try to be more open."
2255,2,15,86,103,1.1844660194174756,0.04307691007839965,540,Your heartbeat seems fast.do you think you could open up for me?
2264,2,17,95,114,1.1842105263157894,0.0405018002012775,540,"Rest assured, your heart is beating at a safe rate."
2265,3,10,74,87,1.1839080459770115,0.050468893694394994,540,How long has it been since you've had a bowel movement?
2265,2,12,73,87,1.1839080459770115,0.04774726195683065,540,It's my job to unlock what's inside you
2265,2,12,73,87,1.1839080459770115,0.04774726195683065,540,I'm going to recommend a low-iron diet for a few months.
2268,6,6,86,98,1.183673469387755,0.052991587118977855,540,You have the heart of a Capitalist.
2268,4,10,84,98,1.183673469387755,0.048860223433162986,540,"Ah yes, it's the old ticker, alright..."
2268,5,8,85,98,1.183673469387755,0.05096778266379081,540,You need to open up. Release the combination things locked up within you. Share the contents of your inner self. Reward those closest to you.
2268,4,10,84,98,1.183673469387755,0.048860223433162986,540,Are you in a safe place now?
2268,3,12,83,98,1.183673469387755,0.04665756099726821,540,so what you are saying is you feel safe
2268,3,12,83,98,1.183673469387755,0.04665756099726821,540,"Now, turn a click to the right and cough out twenties."
2274,2,16,91,109,1.18348623853211,0.04155722142841897,540,"hang on, the locksmith is on his way!"
2274,3,14,92,109,1.18348623853211,0.0435533846923308,540,You're a tough nut to crack.
2274,6,8,95,109,1.18348623853211,0.04905691912544736,540,Your numbers are out of whack.
2274,2,16,91,109,1.18348623853211,0.04155722142841897,540,"Yes, for $200 an hour, your secrets are safe."
2278,4,16,111,131,1.183206106870229,0.040259765329072605,540,Relax. Better safe than sorry.
2279,0,15,67,82,1.1829268292682926,0.04295628044484378,540,"Your pulse is 34 clockwise, 16 counterclockwise, and 4 clockwise."
2280,3,11,79,93,1.1827956989247312,0.04821797883295062,540,"If you call me a cracker again, I'll knock you lock off!"
2280,4,9,80,93,1.1827956989247312,0.050583866730722175,540,"Shhh...I need to crack this code, my student loans are due."
2280,1,15,77,93,1.1827956989247312,0.04309832132858193,540,You say that your always feeling empty?
2280,1,15,77,93,1.1827956989247312,0.04309832132858193,540,I think you're safe.
2280,5,7,81,93,1.1827956989247312,0.05284393687196336,540,"Given your combination of symptoms, I'd say you're safe."
2280,3,11,79,93,1.1827956989247312,0.04821797883295062,540,"Ernistine, you are NOT in what I meant by your safe place."
2286,2,15,87,104,1.1826923076923077,0.04269755533620633,540,"Listen, nothing is safe. You can only be safer."
2286,5,9,90,104,1.1826923076923077,0.04881803687006196,540,"Who's the wisecracker now, mom?"
2286,3,13,88,104,1.1826923076923077,0.04483065613031456,540,Let me know when you're ready to open up.
2289,4,13,98,115,1.182608695652174,0.043812597054545245,540,It's safe to say the old ticker is fine.
2289,3,15,97,115,1.182608695652174,0.042035560652466934,540,"As part of your annual check-up, I need to ask you if you feel safe at home."
2289,3,15,97,115,1.182608695652174,0.042035560652466934,540,"Yes, yes, I hear your pain."
2289,4,13,98,115,1.182608695652174,0.043812597054545245,540,Its safe to say that you are in perfect health!
2293,4,15,107,126,1.1825396825396826,0.04125152218573835,540,...every time EpiPens overtake the price of gold...
2294,3,12,84,99,1.1818181818181819,0.046221117974161514,540,Mr. Houdini your heart sounds just fine.
2294,4,10,85,99,1.1818181818181819,0.048399739772722716,540,Have you ever been cracked before?
2294,1,16,82,99,1.1818181818181819,0.041522350851192366,540,"""Two to the left, three to the right ..."", sounds good."
2294,3,10,75,88,1.1818181818181819,0.04993583800023195,540,I was told this was a tough case to crack.
2294,4,12,94,110,1.1818181818181819,0.0450776703102937,540,"You're safe here"" ""You can open up for me"
2294,2,12,74,88,1.1818181818181819,0.04724780309106128,540,"So, you want a second opinion on whether to go under the blowtorch."
2294,4,12,94,110,1.1818181818181819,0.0450776703102937,540,You're in your safe space now.
2294,3,14,93,110,1.1818181818181819,0.04318785349158611,540,I'm afraid to say that I'm hearing a lot of echo.
2294,2,12,74,88,1.1818181818181819,0.04724780309106128,540,Cigarettes and coffee? That's a terrible combination!
2294,4,14,103,121,1.1818181818181819,0.04231587892051194,540,I just want to make sure you're safe.
2294,2,14,83,99,1.1818181818181819,0.04393459551987973,540,I think I will need my fee in advance.
2305,3,17,107,127,1.1811023622047243,0.039395067685066495,540,I think I have this cracked.
2306,4,13,99,116,1.1810344827586208,0.043461778915984337,540,"Well, the good new is you have a heart of gold."
2306,5,11,100,116,1.1810344827586208,0.04515364065081751,540,"She thinks you're keeping it all inside, and won't open up to her."
2308,3,13,89,105,1.180952380952381,0.04443572215126961,540,You can relax. This is a safe space.
2308,2,15,88,105,1.180952380952381,0.04232473532055043,540,Can you say more about your sense of not feeling safe?
2308,3,13,89,105,1.180952380952381,0.04443572215126961,540,"First, I'll need your health insurance card number, then tell me the combination."
2311,1,15,78,94,1.1808510638297873,0.0426816865724372,540,Anything invasive is out of the question.
2311,3,11,80,94,1.1808510638297873,0.047741884833740145,540,"No, you can't be your own insurance."
2311,3,11,80,94,1.1808510638297873,0.047741884833740145,540,Hmm. I think your tumblers are out of whack.
2311,3,11,80,94,1.1808510638297873,0.047741884833740145,540,Is it safe? Is it safe?
2311,3,11,80,94,1.1808510638297873,0.047741884833740145,540,I'm sorry you feel unsafe....take a deep breath
2311,2,13,79,94,1.1808510638297873,0.04528252387039548,540,You were young and needed the money?
2311,3,11,80,94,1.1808510638297873,0.047741884833740145,540,"Good news! It looks like we got all of it. Now, regarding your copay..."
2311,2,13,79,94,1.1808510638297873,0.04528252387039548,540,I hear a steady clicking - you're safe.
2319,3,9,71,83,1.180722891566265,0.05183831390483617,540,Let's find your safe-space.
2320,1,18,92,111,1.1801801801801801,0.03881580053961578,540,Its safe to say that its a combination of maladies.......let me crunch some numbers
2320,2,16,93,111,1.1801801801801801,0.04087134124703275,540,"Listen, I can't help you if you don't want to open."
2320,4,12,95,111,1.1801801801801801,0.04469974119535512,540,"Relax just breath , this is a safe space"
2323,3,12,85,100,1.18,0.045792681696639,540,Open up for me and I promise you'll have the best safe sex ever!
2323,4,10,86,100,1.18,0.04794778304562056,540,"You're a recumbent safe, that's a rare combination."
2323,3,12,85,100,1.18,0.045792681696639,540,That ticking sound is just your lock. You're safe.
2323,3,12,85,100,1.18,0.045792681696639,540,"I understand that you don't feel safe, but living in a safe is not the answer."
2323,4,10,86,100,1.18,0.04794778304562056,540,And now say 'TAAAAAAAAAX.'
2323,1,16,83,100,1.18,0.04114522199392406,540,Breath deep and cough up the copay
2323,2,14,84,100,1.18,0.04353101761904371,540,"Yes, I can hear you Mr. Gore, but I'm not sure everyone is going to see the humor in this."
2323,5,8,87,100,1.18,0.05001009999000302,540,Unsafe. That is all I will say until you open up some.
2323,3,12,85,100,1.18,0.045792681696639,540,Don't worry - you're safe with me.
2323,1,16,83,100,1.18,0.04114522199392406,540,Now breathe outside the box.
2333,3,10,76,89,1.1797752808988764,0.04941382071271396,540,Your mother asked me to speak with you about safe sex.
2333,5,6,78,89,1.1797752808988764,0.05433646020173372,540,Can you pay my fees?
2333,2,12,75,89,1.1797752808988764,0.04675856138200857,540,"I hear a little tumbler but I think it's safe to say, you're going to be alright."
2333,2,12,75,89,1.1797752808988764,0.04675856138200857,540,I've always wanted to do this.
2337,3,15,99,117,1.1794871794871795,0.041372319495311546,540,I’m sorry to have to tell you but…you will never have cash again
2337,4,13,100,117,1.1794871794871795,0.04311648219358659,540,You can’t be too safe.
2337,3,8,67,78,1.1794871794871795,0.05395941341632321,540,I'm afraid I have some bad news.... You're perfectly safe.
2340,4,11,91,106,1.179245283018868,0.0460422279928785,540,"Bear with me, I feel we're on the verge of a breakthrough."
2340,2,15,89,106,1.179245283018868,0.041958285473954755,540,Without the combination I can't free your ego or your id.
2340,5,9,92,106,1.179245283018868,0.047953949554394006,540,"Well, there may be cat in there, or not. We'll just have to open you up and see."
2340,1,17,88,106,1.179245283018868,0.039759315896991006,540,And are the clowns inside you now?
2340,4,11,91,106,1.179245283018868,0.0460422279928785,540,"I hear you. Don't worry, you'll be safe here."
2340,4,11,91,106,1.179245283018868,0.0460422279928785,540,"120/80 - 72, perfect"
2340,3,13,90,106,1.179245283018868,0.04404761332048586,540,"It's okay, Mr. Pence. Just stay in this ""safe"" house until after the election."
2340,4,11,91,106,1.179245283018868,0.0460422279928785,540,"Keep yelling, ""Get me outta here"", isn't going to get you out any faster."
2340,4,11,91,106,1.179245283018868,0.0460422279928785,540,"I don't know, Doc. Ever since the divorce I just haven't been able to open up."
2349,3,11,81,95,1.1789473684210525,0.04727501054750545,540,"I'm going to run a combination test so we know what's going on inside. Better safe than sorry, right Mr. Kincaid?"
2349,1,15,79,95,1.1789473684210525,0.04227290255943855,540,I'm afraid you're leading a rather hollow life.
2349,1,15,79,95,1.1789473684210525,0.04227290255943855,540,Stay on a diet of twenty dollars a day.
2349,4,9,82,95,1.1789473684210525,0.049587203873582494,540,Say Aaaaahh!
2349,2,13,80,95,1.1789473684210525,0.044843756048454156,540,It sounds right but your heart is in the wrong place.
2354,3,16,104,123,1.1788617886178863,0.040046155440119593,540,Now take a deep breath and hold it for twenty-four hours.
2355,2,16,94,112,1.1785714285714286,0.04053670999859967,540,"Well, you've come to the right docsmith."
2355,3,14,95,112,1.1785714285714286,0.04247469856733219,540,"Fear and anger, that's a tough combination to open up about."
2355,3,14,95,112,1.1785714285714286,0.04247469856733219,540,No insurance? I think we can work something out.
2355,3,14,95,112,1.1785714285714286,0.04247469856733219,540,"I'm sorry, but from what I am hearing you can't afford adequate health care."
2355,2,16,94,112,1.1785714285714286,0.04053670999859967,540,Just how long have you been experiencing feelings of claustrophobia?
2360,3,12,86,101,1.1782178217821782,0.04537203658372117,540,Your heartbeat's a bit fast but the real problem is your combination.
2360,2,14,85,101,1.1782178217821782,0.04313469487285536,540,Yo've got to cut back on your tumbling.
2360,3,12,86,101,1.1782178217821782,0.04537203658372117,540,I’m afraid you’re suffering from a Hamilton deficiency.
2360,2,14,85,101,1.1782178217821782,0.04313469487285536,540,You really should keep your combination written down.
2360,1,16,84,101,1.1782178217821782,0.04077477283559206,540,"You need to open up more, Mr. Jenkins."
2360,2,14,85,101,1.1782178217821782,0.04313469487285536,540,Roll that tumbler one more time for me........
2360,4,10,87,101,1.1782178217821782,0.047504120934238225,540,Are you even a doctor?
2360,2,14,85,101,1.1782178217821782,0.04313469487285536,540,"Just relax, my couch is a safe place."
2360,1,16,84,101,1.1782178217821782,0.04077477283559206,540,"Take a deep breath, this is routine procedure for getting FDIC insured."
2360,3,12,86,101,1.1782178217821782,0.04537203658372117,540,I'M SORRY TO TELL YOU THIS BUT I THINK IT MAY BE LOCK JAW....
2370,5,11,102,118,1.1779661016949152,0.04443759968114078,540,"Could you say more about your feelings of inadequacy, Mr. Houdini?"
2370,4,13,101,118,1.1779661016949152,0.042776579033124075,540,We'll get to you. But first who is your insurance provider?
2372,1,14,75,90,1.1777777777777778,0.04349803840706918,540,I think it's safe to say it's a combination of insecurity and keeping things inside.
2372,3,10,77,90,1.1777777777777778,0.04890250633185913,540,"OK Mr Jones, it sounds like this will cover your deductible. You can hop up on the table next."
2372,1,14,75,90,1.1777777777777778,0.04349803840706918,540,You sound stuffed
2372,2,12,76,90,1.1777777777777778,0.046279231145300956,540,I'm afraid this one's outside my area of expertise. I'll have to call in a locksmith.
2376,4,11,92,107,1.1775700934579438,0.045640650379366696,540,"Yes, it's a failsafe method of birth control."
2376,3,13,91,107,1.1775700934579438,0.04366615650359472,540,Sounds like you have a bad case of tumbleritis
2376,4,11,92,107,1.1775700934579438,0.045640650379366696,540,"I'm not worried about your weight, what concerns me is your spinning and tumbling."
2379,3,16,105,124,1.1774193548387097,0.039748070888559424,540,This prank always works with the new medical students.
2380,3,11,82,96,1.1770833333333333,0.04681709386300883,540,First we'll work on coming out of our shell.
2380,3,11,82,96,1.1770833333333333,0.04681709386300883,540,Appears to be a classic case of Locked-In Syndrome.
2380,2,13,81,96,1.1770833333333333,0.044413309178260335,540,I wouldn't even go swimming until you come out of this.
2383,5,10,98,113,1.176991150442478,0.04572441305652782,540,you may have cracked your code
2383,3,14,96,113,1.176991150442478,0.04212678866913348,540,You're right! This would be easier if you were to open up a bit more
2383,5,10,98,113,1.176991150442478,0.04572441305652782,540,What I'm hearing is that your life feels hollow.
2383,1,18,94,113,1.176991150442478,0.03819176217175236,540,I want you to feel absolutely safe during this exam.
2387,1,13,71,85,1.1764705882352942,0.04483543075566802,540,Bad news. I'm not hearing money.
2387,0,18,84,102,1.1764705882352942,0.037932811853078105,540,This is a safe place too.
2387,2,14,86,102,1.1764705882352942,0.04274543644192702,540,You need to open up about this
2387,2,11,72,85,1.1764705882352942,0.0478573703400451,540,The old ticker isn't working as well as it used to.
2387,4,10,88,102,1.1764705882352942,0.04706852938153712,540,Are you sure you don't remember your pass word?
2387,0,18,84,102,1.1764705882352942,0.037932811853078105,540,Thankfully your heart arrhythmia is in the safe zone.
2387,4,13,102,119,1.1764705882352942,0.04244194544170894,540,"Slow breath, you're in your safe place"
2387,4,7,74,85,1.1764705882352942,0.05339056082773511,540,I hear you have insurance.
2387,3,12,87,102,1.1764705882352942,0.04495897460325049,540,"I always dreamed of becoming a doctor but had to compromise to appease my dad, the banker."
2387,3,12,87,102,1.1764705882352942,0.04495897460325049,540,Don't worry. You're perfectly safe.
2387,2,14,86,102,1.1764705882352942,0.04274543644192702,540,It's hard to tell what's inside you - it could be a combination of things.
2387,3,12,87,102,1.1764705882352942,0.04495897460325049,540,"Your weight's good, but I'd like to see you get down to strongbox."
2387,3,12,87,102,1.1764705882352942,0.04495897460325049,540,"Well, you do seem to have a heart of gold."
2400,7,8,110,125,1.176,0.04552772994064591,540,"Hey out there, if you finally let me out, I'll vote for Grover Cleveland!"
2401,1,17,90,108,1.1759259259259258,0.03908946281414724,540,He might be in there. I hear a murmur.`
2401,4,11,93,108,1.1759259259259258,0.04524596007030054,540,I am the last specialist in this field; consultants won't touch anything bigger than a bank-card now.
2401,2,15,91,108,1.1759259259259258,0.04124386463010966,540,"Well, what have you been putting in yourself?"
2401,3,13,92,108,1.1759259259259258,0.04329118427757574,540,"No, I don't think you'll be vaulting any time soon."
2401,4,11,93,108,1.1759259259259258,0.04524596007030054,540,"Well, you sound better than the coffer I had in this morning"
2401,2,15,91,108,1.1759259259259258,0.04124386463010966,540,"Alternative medicine is an option, perhaps a safecracker."
2407,5,6,80,91,1.1758241758241759,0.05320820163492289,540,"Could you open your mouth and cough for me, Mr Hoffa?"
2407,2,12,77,91,1.1758241758241759,0.04580951853732888,540,You need a prescription for angina--the nitro should blow open the blockage in no time.
2407,1,14,76,91,1.1758241758241759,0.04306172017490284,540,"Now, open your Chakras, if you will."
2407,4,8,79,91,1.1758241758241759,0.05086169950977225,540,You feel this way because you haven't been practicing safe sex.
2407,0,16,75,91,1.1758241758241759,0.040126194689023155,540,How can I know what the combination is if you just keep murmuring?!
2407,2,12,77,91,1.1758241758241759,0.04580951853732888,540,It sounds like you have a bad case of lockjaw.
2413,4,12,98,114,1.1754385964912282,0.0436027252080137,540,"I know, I know. There are just so many numbers you have to keep up with, but this is really important."
2413,4,12,98,114,1.1754385964912282,0.0436027252080137,540,"We're going to have to open you up, but don't worry, we use safe procedures."
2415,1,15,81,97,1.175257731958763,0.04147803334904919,540,You have kidney stones as big as diamonds which I can remove for you at no extra charge.
2415,3,11,83,97,1.175257731958763,0.04636788236602624,540,"Do you have a last name, Geraldo ?"
2415,2,13,82,97,1.175257731958763,0.04399095228347804,540,My orders are to keep you secured and quiet until after the election.
2415,1,15,81,97,1.175257731958763,0.04147803334904919,540,How long have you had these feelings of vulnerableness.
2415,3,11,83,97,1.175257731958763,0.04636788236602624,540,"I know you were worried about the clanking sound, but I think you're safe."
2415,0,17,80,97,1.175257731958763,0.03880271405716913,540,"Considering stocks, bonds and all, you're doing very well..."
2415,2,13,82,97,1.175257731958763,0.04399095228347804,540,Your vital signs sound safe to me
2415,3,11,83,97,1.175257731958763,0.04636788236602624,540,The campaign is not over yet. Shelter in place until further instructions.
2415,1,15,81,97,1.175257731958763,0.04147803334904919,540,"Where there's a Will, there's a way."
2415,4,9,84,97,1.175257731958763,0.048628768721941266,540,"Yes, but the emotionally safe place mentioned in our last visit was figurative."
2415,4,9,84,97,1.175257731958763,0.048628768721941266,540,Click ... to the right; click... to the left. First I have to get at your $50 co-pay.
2415,2,13,82,97,1.175257731958763,0.04399095228347804,540,I'm sorry if this feels cold.
2415,3,11,83,97,1.175257731958763,0.04636788236602624,540,"If you really want to get over your fear of politicians, Mr. Smith, you're going to have to open up."
2428,3,15,102,120,1.175,0.04041538520594029,540,"Tick, for God's sake! Mouth to mouth isn't possible."
2429,4,10,89,103,1.174757281553398,0.0466407922327535,540,Okay. Now cough up.
2429,3,12,88,103,1.174757281553398,0.04455329495109556,540,Your inner child wants out.
2429,3,12,88,103,1.174757281553398,0.04455329495109556,540,"You keep giving me false clicks, and I call in the bomb squad."
2429,3,12,88,103,1.174757281553398,0.04455329495109556,540,"I'll know more when your labs come back, but I think it's safe to say you don't have shingles."
2429,3,12,88,103,1.174757281553398,0.04455329495109556,540,Is Light-Fingers Louie a doctor?
2429,3,12,88,103,1.174757281553398,0.04455329495109556,540,Well my first thought is that you're getting too much iron in your diet.
2429,4,10,89,103,1.174757281553398,0.0466407922327535,540,I'm afraid it's fruitcake.
2429,3,12,88,103,1.174757281553398,0.04455329495109556,540,I think it is safe to say you have a case of lockjaw.
2429,1,16,86,103,1.174757281553398,0.04005323049143718,540,And you're sure you heard a ticking noise?
2429,3,12,88,103,1.174757281553398,0.04455329495109556,540,That ticking is a good sign. You're getting ready to open up!
2439,1,20,105,126,1.1746031746031746,0.03577596085582426,540,Mastercardiac arrest
2440,2,11,73,86,1.1744186046511629,0.0473421069773523,540,Good news. I don't hear any bitcoins being mined.
2440,3,9,74,86,1.1744186046511629,0.05014850849499494,540,"No, I get it. Between his tax returns and the videotape, how much more are you expected to hold in?"
2442,4,11,94,109,1.1743119266055047,0.04485798313086264,540,"Dr. Schrödinger, after a week your cat is positively dead. It’s an airtight case."
2442,1,17,91,109,1.1743119266055047,0.03876279988140986,540,"You're not related to Al Capone's vault, are you?"
2442,3,13,93,109,1.1743119266055047,0.04292253470219632,540,"I rarely open up, and I've lost ALL interest."
2445,2,12,78,92,1.173913043478261,0.04534914100207275,540,"Your insurance doesn't cover safecracking, so I'll bill this as an upper GI exam."
2445,2,12,78,92,1.173913043478261,0.04534914100207275,540,It's time to open up.
2445,3,10,79,92,1.173913043478261,0.04791071000168172,540,Safe sex sob story
2445,3,10,79,92,1.173913043478261,0.04791071000168172,540,I regret to inform you that whatever protection you were using was not totally safe.
2445,1,14,77,92,1.173913043478261,0.042633942421344356,540,"now, just cough it up"
2445,3,10,79,92,1.173913043478261,0.04791071000168172,540,"Mr. Crabtree, it really would be easier for us to talk if you could come out of the safe."
2445,3,10,79,92,1.173913043478261,0.04791071000168172,540,"At our next session if you try opening up, it will really be rewarding."
2445,0,16,76,92,1.173913043478261,0.039733631889711976,540,"I hear you in there tumbling, what other symptoms are you having?"
2453,4,9,85,98,1.1734693877551021,0.048163211816236194,540,There's a bronchitis bug going around. You're not the only coffer I've seen today.
2453,3,11,84,98,1.1734693877551021,0.04592713290344639,540,It's just as I feared; the left click is weak and thready.
2453,1,15,82,98,1.1734693877551021,0.04109154006947437,540,I would agree you have a low risk of getting Zika.
2453,2,13,83,98,1.1734693877551021,0.043576462694968975,540,"Tumble, please."
2453,3,11,84,98,1.1734693877551021,0.04592713290344639,540,"I hear you, Trish. But you're a big girl now and safe spaces are so undergraduate."
2453,2,13,83,98,1.1734693877551021,0.043576462694968975,540,I think your rich diet is starting to catch up with you.
2453,4,9,85,98,1.1734693877551021,0.048163211816236194,540,It's locked-in syndrome.
2460,1,16,87,104,1.1730769230769231,0.039701809770923226,540,How long would you say the back-and-forth has been painful on your tumblers?
2460,5,8,91,104,1.1730769230769231,0.04819812951382046,540,"If you find this uncomfortable, wait till I check your prostrate."
2460,2,14,88,104,1.1730769230769231,0.04198738139575608,540,"It's quite normal to feel ""unsafe,"" from time to time."
2460,1,16,87,104,1.1730769230769231,0.039701809770923226,540,It's thinking of a number between 1 and 100...
2460,2,14,88,104,1.1730769230769231,0.04198738139575608,540,"Yes, I hear you...payment is due before I recommend treatment...Mr. Houdini."
2460,2,14,88,104,1.1730769230769231,0.04198738139575608,540,Will you shut up about metaphors? I can't hear a damn thing.
2466,2,15,93,110,1.1727272727272726,0.04055307976484437,540,"Doc, I just feel so empty inside."
2466,1,17,92,110,1.1727272727272726,0.038441469886322015,540,"Please stop singing ""If I Only Had a Heart."""
2466,3,13,94,110,1.1727272727272726,0.04256005110202121,540,I can crack any case
2466,2,15,93,110,1.1727272727272726,0.04055307976484437,540,"Do you have health insurance? One click for yes, two clicks for no."
2466,4,11,95,110,1.1727272727272726,0.044476551363606016,540,"On a scale of 1-10, how much are you worth?"
2471,1,18,97,116,1.1724137931034482,0.037291875366635134,540,"I'm picking up lots of money, no heart - but you say you're not happy in banking?"
2471,5,10,101,116,1.1724137931034482,0.04461372118850528,540,"I promise, anything you say here is safe with me"
2473,4,13,105,122,1.1721311475409837,0.041468477132567884,540,"Money doesn't typically cure patients' feelings of emptiness, but in your case—what the hell."
2474,0,16,77,93,1.1720430107526882,0.039348528120618634,540,Don't worry. Your deposit is safe with me.
2474,2,12,79,93,1.1720430107526882,0.04489782674754191,540,"Non-smoker? Mmhmm, good, good- and are you practicing ""safe sex""?"
2474,3,10,80,93,1.1720430107526882,0.047429620885569776,540,This may come as a shock to you sir but your heart rate is at an unsafe level.
2477,4,9,86,99,1.1717171717171717,0.047706422091822624,540,"I think you've spent far too much time on Tumblr, Ms. Hamilton."
2477,5,7,87,99,1.1717171717171717,0.04982013420384436,540,"I think it's safe to say, you're cracked."
2477,2,13,84,99,1.1717171717171717,0.043169625690192184,540,I think you'll need an X-ray.
2477,1,15,83,99,1.1717171717171717,0.040712080749396494,540,You're as good as gold.
2481,3,17,114,134,1.171641791044776,0.037492556255163983,540,"Come on, there must be a heart of gold underneath that tough exterior."
2482,3,12,90,105,1.1714285714285715,0.043763313740087635,540,Ok now please turn right four times and say 80.
2482,4,10,91,105,1.1714285714285715,0.04580805401524416,540,Another option you might want to consider is the flu vaccine.
2482,3,12,90,105,1.1714285714285715,0.043763313740087635,540,"You said ""safe in a womb,"" NOT ""a safe in my room""!"
2482,1,16,88,105,1.1714285714285715,0.039356413241211106,540,"'That's quite a story, but don't worry. Your secret is safe with me."""
2482,2,14,89,105,1.1714285714285715,0.04161823454164244,540,Tumbleitiss?
2482,1,16,88,105,1.1714285714285715,0.039356413241211106,540,Now I'll check you for ticks.
2482,5,8,92,105,1.1714285714285715,0.047765343040888024,540,It's safe to say that you're fiscally sound.
2489,5,9,97,111,1.1711711711711712,0.04592104799852884,540,"Slow down, I can't hear you...well it doesn't feel ethical to leave you in there until November 9th."
2489,3,13,95,111,1.1711711711711712,0.042203581858449676,540,With the price of health care rising I no longer feel safe.
2489,0,19,92,111,1.1711711711711712,0.03591297579263477,540,You'll have to start working very hard on your obsession about privacy.
2489,2,15,94,111,1.1711711711711712,0.040216192732314915,540,"So, you say Geraldo thinks you may have something?"
2493,6,9,108,123,1.170731707317073,0.04427405033586649,540,You'll need to speak louder to give me the combination.
2493,1,12,69,82,1.170731707317073,0.045266376933577414,540,"Just because Al Capone's safe is your father doesn't mean you'll relive his meaningless, empty life."
2495,2,11,75,88,1.1704545454545454,0.046343834769941326,540,I'm not saying that being safe is bad. I just thought that you wanted more.
2495,1,13,74,88,1.1704545454545454,0.043434064987402606,540,I'm sure you feel safe now!
2497,5,6,83,94,1.1702127659574468,0.05160055002894798,540,"""I understand your feelings of claustrophobia, Mister Johnson. But I can assure you, you're safe."
2497,2,12,80,94,1.1702127659574468,0.04445531425009222,540,"If you feel empty, then this session is over."
2497,1,14,79,94,1.1702127659574468,0.04180304254081611,540,"You need to open up a little more, otherwise you're safe!"
2500,2,13,85,100,1.17,0.042770234150550666,540,"Hmm, do you have any metal implants?"
2500,3,11,86,100,1.17,0.04507009131689365,540,Don't you feel safe here?
2500,1,15,84,100,1.17,0.04033946860424327,540,Billy...I don't have the combination and this is not what I meant when I said go to your safe place.
2500,4,9,87,100,1.17,0.047258156262526094,540,This is the worst case of white coat syndrome I've ever seen.
2500,2,13,85,100,1.17,0.042770234150550666,540,"It's Ok, your safe!"
2500,3,11,86,100,1.17,0.04507009131689365,540,"Relax! of course, I remember your diagnosis! Its left 18 right 23 left 63, Ask any numerologist !!"
2500,2,13,85,100,1.17,0.042770234150550666,540,"No tax return beats, just vesicular misogynistic murmurs and bankruptcy wheezes."
2500,2,13,85,100,1.17,0.042770234150550666,540,I'm afraid I can't make an accurate diagnosis until he's released his tax returns.
2500,3,11,86,100,1.17,0.04507009131689365,540,"And if I don't find a pulse, who do I send my bill to?"
2500,3,11,86,100,1.17,0.04507009131689365,540,I think it is safe to come out now
2510,3,12,91,106,1.169811320754717,0.04337864404159322,540,"Everything's okay, I just forgot our safe word."
2510,1,16,89,106,1.169811320754717,0.03901689019197877,540,I'm concerned about your financial health.
2510,2,14,90,106,1.169811320754717,0.04125545102856216,540,"If you insist, but we won't know for certain unless you open yourself up."
2510,1,16,89,106,1.169811320754717,0.03901689019197877,540,"Now if we're going to find out what's wrong with you, you'll have to give me the correct combination."
2510,2,14,90,106,1.169811320754717,0.04125545102856216,540,Let me help you open up. This is how I paid my way through medical school.
2510,1,16,89,106,1.169811320754717,0.03901689019197877,540,Just align your tumblers normally.
2516,2,15,95,112,1.1696428571428572,0.03988479399081371,540,Are you in your safe place now?
2516,4,11,97,112,1.1696428571428572,0.04373267786724215,540,Be honest. Have you been artificially inflating your currency?
2516,3,13,96,112,1.1696428571428572,0.04185298021126824,540,"Sir, if you don't come out, I'll have to administer a dose of dynamite."
2516,5,9,98,112,1.1696428571428572,0.0455348468133487,540,You can't hide in your empty vault Mr. Trump. We know you're in there.
2520,5,10,103,118,1.1694915254237288,0.04390256411968632,540,"I should mention my rate is $50,000/hour."
2521,2,9,66,77,1.1688311688311688,0.05029848501568073,540,"Cough up twice, please."
2522,1,12,70,83,1.1686746987951808,0.044764959391397526,540,And how long have you been feeling boxed in?
2522,1,12,70,83,1.1686746987951808,0.044764959391397526,540,Of course I’m listening. Are you feeling safe now?
2524,2,11,76,89,1.1685393258426966,0.04586016811409948,540,"I hear you practicing, but I'm not sure this is what was meant by ""safe sex."""
2524,0,15,74,89,1.1685393258426966,0.03990526017490819,540,I'm here to help you unlock your feelings
2524,3,9,77,89,1.1685393258426966,0.04856457180256656,540,"Well, Doc, my wife says I'm tough to crack...ba-dum-dum."
2524,3,9,77,89,1.1685393258426966,0.04856457180256656,540,We are starting to see a lot more of this since Trump won.
2528,1,14,80,95,1.168421052631579,0.04139945950425743,540,Hold on. I'm about to unlock your innermost assets.
2528,2,12,81,95,1.168421052631579,0.0440213517849933,540,Your fiscal health is good. No cause for concern.
2528,2,12,81,95,1.168421052631579,0.0440213517849933,540,Don't you think it's time you stopped playing it safe?
2528,4,8,83,95,1.168421052631579,0.04884473097935025,540,"Okay, now let everything out!"
2528,2,12,81,95,1.168421052631579,0.0440213517849933,540,Sounds like you have a heart of gold.
2528,3,10,82,95,1.168421052631579,0.0464956296732458,540,I think it's safe to say you're a safe.
2528,2,12,81,95,1.168421052631579,0.0440213517849933,540,"In your line of work, it's normal to be a little paranoid."
2535,1,15,85,101,1.1683168316831682,0.03997352324393338,540,I wish they wouldn't take me literally when told to keep their heart safe.
2535,2,13,86,101,1.1683168316831682,0.04237808823570832,540,That’s the interiority complex talking.
2535,3,11,87,101,1.1683168316831682,0.04465335557932548,540,"Good work. Now that you've created your safe space, how does opening up feel to you now?"
2535,2,13,86,101,1.1683168316831682,0.04237808823570832,540,Trying to answer the question. Is Schroeder's cat alive or dead?
2535,3,11,87,101,1.1683168316831682,0.04465335557932548,540,You may want to cut down on the Imodium.
2535,2,13,86,101,1.1683168316831682,0.04237808823570832,540,"Okay, big spin now.... LEFT.... right.... LEFT.... right...."
2535,1,15,85,101,1.1683168316831682,0.03997352324393338,540,You sound empty inside.
2542,4,10,93,107,1.1682242990654206,0.045004322581653655,540,"Nothing to worry about, this is a safe place"
2543,3,13,97,113,1.168141592920354,0.0415081040692339,540,"The bad news is that your insurance doesn't cover invasive surgery. The good news is that, depending on what we find, you'll probably be able to work something out with the hospital."
2543,6,7,100,113,1.168141592920354,0.046872232100760476,540,We've dated for months. I'd love it if you'd open up more.
2545,3,16,112,131,1.16793893129771,0.03777839974721517,540,The Good News is: you are finally going to open up to me. The Bad News is: all that will be accomplished is my new co payment will be satisfied and you'll just be sitting there feeling empty.
2546,2,12,82,96,1.1666666666666667,0.04359569698171643,540,"""So, you're in today due to a tumble?"
2546,3,12,93,108,1.1666666666666667,0.042629072222442395,540,This may be related to an issue of combinations
2546,4,9,89,102,1.1666666666666667,0.04638626689884598,540,I'll tell Mr. Benny you need more exercise.
2546,1,14,81,96,1.1666666666666667,0.041003494359720165,540,"I know, everyone locks up on their first visit."
2546,5,5,80,90,1.1666666666666667,0.052999894000318,540,And when was the first time you started not feeling safe?
2546,3,10,83,96,1.1666666666666667,0.04604218762109022,540,You're in safe hands now.
2546,3,11,88,102,1.1666666666666667,0.04424419392469564,540,It sounds like your safe space may have been marginalized.
2546,3,11,88,102,1.1666666666666667,0.04424419392469564,540,It doesn't sound good.
2546,2,13,87,102,1.1666666666666667,0.04199299507395459,540,You need to open up. I'm trying to help with that.
2546,4,9,89,102,1.1666666666666667,0.04638626689884598,540,How many clowns are in there?
2546,2,10,72,84,1.1666666666666667,0.047403413087928364,540,Feeling kinda empty inside.
2546,1,13,76,90,1.1666666666666667,0.04254688241805304,540,I want to hear you click.
2546,1,13,76,90,1.1666666666666667,0.04254688241805304,540,"Yes, I can feel your pain ... if I'd had to safeguard all the bonus money that sleazy Wells Fargo CEO stashed away, I'd probably have major heartburn too!"
2546,3,10,83,96,1.1666666666666667,0.04604218762109022,540,I can't help you. I'm going to refer you to Geraldo.
2546,3,10,83,96,1.1666666666666667,0.04604218762109022,540,"The biopsy results came back, it turns out you're safe."
2546,1,15,86,102,1.1666666666666667,0.03961407041085622,540,You're afraid of exposing your family jewels? I'm listening.
2546,2,13,87,102,1.1666666666666667,0.04199299507395459,540,Sorry your heart has run out of money
2546,2,11,77,90,1.1666666666666667,0.045386397671912215,540,If you had chicken pox it may still be inside you.
2546,2,16,102,120,1.1666666666666667,0.038042680832094666,540,All of your HIPPA information will be kept completely confidential.
2546,2,13,87,102,1.1666666666666667,0.04199299507395459,540,Its safe to say its not your heart.
2546,2,12,82,96,1.1666666666666667,0.04359569698171643,540,Could you make my reimbursement from Medicare a bit simpler?
2546,2,14,92,108,1.1666666666666667,0.04054833574905386,540,"Now, turn your head to the side and cough up your combination."
2546,3,11,88,102,1.1666666666666667,0.04424419392469564,540,"Mr. Capone, is that you?"
2546,1,13,76,90,1.1666666666666667,0.04254688241805304,540,"'I'm detecting an irregular clicking."""
2546,2,11,77,90,1.1666666666666667,0.045386397671912215,540,"Yes, it's always your vault."
2546,2,12,82,96,1.1666666666666667,0.04359569698171643,540,Sign the HIPPA forms and we can do this the old fashioned way...
2546,3,11,88,102,1.1666666666666667,0.04424419392469564,540,It really would be simpler just to have the flu shot
2546,3,10,83,96,1.1666666666666667,0.04604218762109022,540,OK tumble
2546,4,9,89,102,1.1666666666666667,0.04638626689884598,540,Don't be sorry -- I assure you that drilling it open will make you better.
2575,3,15,109,127,1.1653543307086613,0.038344343192484386,540,"Relax, you're safe here. You have no cracks."
2576,1,17,97,115,1.1652173913043478,0.036910502150087024,540,Take a deep breath. Do you feel too big to fail?
2576,4,11,100,115,1.1652173913043478,0.04266205659437598,540,Your vital signs are within the safe zone
2576,1,17,97,115,1.1652173913043478,0.036910502150087024,540,I just need a few more billing codes to crack this safe wide open!
2579,2,14,93,109,1.165137614678899,0.040203697844882806,540,"No, Geraldo, the news team is not on the way."
2579,5,8,96,109,1.165137614678899,0.04610879868664074,540,"Your heart is in good shape, but your paranoia is increasing."
2579,3,12,94,109,1.165137614678899,0.042263837801483954,540,How in the world did you get a hamster inside of you?
2579,4,10,95,109,1.165137614678899,0.04422812059106348,540,If there's psysiological involvement we might have to open you up.
2579,1,16,92,109,1.165137614678899,0.03803212661809914,540,I told you that wasn't a safe combination for your ticker.
2579,3,12,94,109,1.165137614678899,0.042263837801483954,540,When did you stop feeling safe?
2579,2,14,93,109,1.165137614678899,0.040203697844882806,540,"Now, cough it up."
2586,2,13,88,103,1.1650485436893203,0.04161476846774679,540,My assistant will write you a note for the TSA.
2586,3,11,89,103,1.1650485436893203,0.043842403717448415,540,"Cough! God damn it, cough!"
2586,1,15,87,103,1.1650485436893203,0.0392609417299765,540,We going to need Geraldo.
2586,2,13,88,103,1.1650485436893203,0.04161476846774679,540,"With just the right combination, you will open up to me."
2586,3,11,89,103,1.1650485436893203,0.043842403717448415,540,"Where's the ""Forgot Your Password?"" option for this thing?"
2586,3,11,89,103,1.1650485436893203,0.043842403717448415,540,I'll finally be able to make a dent in my student loan payments.
2586,3,11,89,103,1.1650485436893203,0.043842403717448415,540,I believe you're flush. I'm going to need to perform a cashectomy.
2593,3,10,84,97,1.1649484536082475,0.045597438177716845,540,"""You don't seem to have enough money to pay your medical bill""."
2593,3,10,84,97,1.1649484536082475,0.045597438177716845,540,"Encumber deeply, then expend."
2593,4,8,85,97,1.1649484536082475,0.047894707439059644,540,This may be a little cold
2593,1,14,82,97,1.1649484536082475,0.040614936953858476,540,You may need a tumbler transplant.
2593,3,10,84,97,1.1649484536082475,0.045597438177716845,540,"Just to be safe, I'm recommending therapy to help with your insecurity issues."
2598,2,11,78,91,1.164835164835165,0.04492222627620774,540,IT'S NOT HEALTHY TO KEEP ALL YOUR THOUGHTS LOCKED UP IN YOURSELF.
2598,3,9,79,91,1.164835164835165,0.047562660331514815,540,"I'm sorry, Mr. Trump, but I can't detect a heartbeat."
2598,1,13,77,91,1.164835164835165,0.04211657832030713,540,Trust me. I promise to keep your secret safe here.
2598,2,11,78,91,1.164835164835165,0.04492222627620774,540,For this i went to med school?
2602,3,8,74,85,1.1647058823529413,0.04978119863646624,540,"Well, I would say that you have a combination personality."
2602,2,10,73,85,1.1647058823529413,0.046883426633143835,540,"I hear a slight murmur, but I wouldn't worry. You're safe."
2602,3,8,74,85,1.1647058823529413,0.04978119863646624,540,"Safe, yes; sane, No!"
2605,1,18,103,122,1.1639344262295082,0.035611931878833145,540,This is a safe space for you to open up to me.
2606,1,17,98,116,1.1637931034482758,0.036618634128043406,540,"I promise, I won't do anything that requires gloves."
2607,3,12,95,110,1.1636363636363636,0.04190475862247781,540,I think it may be cracked.
2607,4,10,96,110,1.1636363636363636,0.043849908399003025,540,Astonishing. I think I've located the cat that swallowed Donald Trump's tax returns.
2607,0,18,92,110,1.1636363636363636,0.03543433054298679,540,This is a safe space
2607,2,14,94,110,1.1636363636363636,0.03986481059550266,540,You sound safe to me.
2607,3,12,95,110,1.1636363636363636,0.04190475862247781,540,"It's perfectly normal to feel violated, but you're in a safe space now."
2607,1,16,93,110,1.1636363636363636,0.03771468483790463,540,It appears your combination of sedentary lifestyle and keeping everything inside has led to an un-safe level of cholesterol.
2607,5,8,97,110,1.1636363636363636,0.04571236307601898,540,No heart issues. Ticker is fine. Just anxiety from hiding all those Trump tax returns.
2607,2,14,94,110,1.1636363636363636,0.03986481059550266,540,Don't worry. As soon as the Fed lifts rates people will acknowledge your value again.
2607,5,8,97,110,1.1636363636363636,0.04571236307601898,540,you have locked in syndrome !
2616,2,13,89,104,1.1634615384615385,0.04124322861360888,540,I'll help you unlock your problems if you give me the combination.
2616,0,17,87,104,1.1634615384615385,0.03643612097496368,540,"Please, I can't help you if you don't let it out."
2616,5,7,92,104,1.1634615384615385,0.04755127126200449,540,"Now, I may be placing this against some sensitive areas, but be assured that my greatest concern is that at all times you feel safe."
2616,4,9,91,104,1.1634615384615385,0.04554576710569956,540,Take a deep breath and let it all out.
2616,2,13,89,104,1.1634615384615385,0.04124322861360888,540,He says he doesn't want to come out.
2616,3,11,90,104,1.1634615384615385,0.04344778940130919,540,Definite circulatory problems.
2622,2,12,84,98,1.163265306122449,0.042768385142882594,540,I can tell you are going to be a hard nut to crack.
2622,3,10,85,98,1.163265306122449,0.04516113598498986,540,You see Mr. Washburn? My couch really IS a safe space.
2622,6,4,88,98,1.163265306122449,0.05167889811740535,540,"So you do have a heart, but you're going to have to open up to me if you want me to help you feel safe."
2622,1,14,83,98,1.163265306122449,0.04023358462783468,540,"Take her to surgery, we got to open this one up!"
2622,3,10,85,98,1.163265306122449,0.04516113598498986,540,"Yes, this is covered by insurance and doctor-patient confidentiality."
2622,4,8,86,98,1.163265306122449,0.047433338899760695,540,Sounds like you're safe.
2628,1,13,78,92,1.1630434782608696,0.04169478752204208,540,Let's see if I can crack your genetic code.
2628,1,13,78,92,1.1630434782608696,0.04169478752204208,540,"You sound so bad, I'm afraid we'll have to open you up."
2628,2,11,79,92,1.1630434782608696,0.044467368369936235,540,Relax: this is your safe place.
2628,4,7,81,92,1.1630434782608696,0.04954926776680301,540,I know a Tin Man with the same problem.
2632,2,10,74,86,1.1627906976744187,0.046374627232631714,540,I am not going to shout any more.
2633,3,14,106,123,1.1626016260162602,0.038934878905596916,540,You feel empty and closed in? It's probably just a panic attack.
2633,2,16,105,123,1.1626016260162602,0.03718393166501752,540,"The thieves are gone now, you can take a deep breath!"
2635,1,17,99,117,1.1623931623931625,0.03633128701735331,540,Your medical records are safe with me.
2635,2,15,100,117,1.1623931623931625,0.03830567363544256,540,Don't be anxious. You are in a safe space.
2637,4,10,97,111,1.162162162162162,0.04347806838951073,540,You're congested. Let me get my pillowcase.
2637,1,16,94,111,1.162162162162162,0.0374024322669326,540,"Ahem,doc, the money and my heart is on my left"
2637,1,16,94,111,1.162162162162162,0.0374024322669326,540,Inhale. Hold it. Now let it all out.
2637,1,16,94,111,1.162162162162162,0.0374024322669326,540,"Don't worry. I think you're, uh, safe."
2641,1,15,89,105,1.161904761904762,0.038573011318315774,540,"Don't worry, dear. You are safe."
2641,3,11,91,105,1.161904761904762,0.043060162197363853,540,You seem closed
2641,4,9,92,105,1.161904761904762,0.04513676718168312,540,We accept cash or gold bars.
2641,4,9,92,105,1.161904761904762,0.04513676718168312,540,Meow.
2641,3,11,91,105,1.161904761904762,0.043060162197363853,540,I think you may have taken the chastity belt a little too far.
2641,3,11,91,105,1.161904761904762,0.043060162197363853,540,"Yes, I agree. It's a great combination. Yes, I agree. It's a great combination. A beautiful combination. A combination like no one has ever seen."
2641,3,11,91,105,1.161904761904762,0.043060162197363853,540,Everything I hear indicates you are safe and sound!
2641,3,11,91,105,1.161904761904762,0.043060162197363853,540,Look closely at me--I am clearly not a cracker.
2641,1,15,89,105,1.161904761904762,0.038573011318315774,540,You know you're safe with me.
2650,3,10,86,99,1.1616161616161615,0.04473304473304475,540,Are you really listening to me?
2650,2,12,85,99,1.1616161616161615,0.042366286452823095,540,"Trust me, I have your number."
2650,1,14,84,99,1.1616161616161615,0.03985924189591093,540,"Bad news! ""Your savings are on life support."""
2650,3,10,86,99,1.1616161616161615,0.04473304473304475,540,It's just not safe for you to remain in denial!
2650,2,12,85,99,1.1616161616161615,0.042366286452823095,540,Cha-ching...cha-ching...cha-ching...
2650,1,14,84,99,1.1616161616161615,0.03985924189591093,540,Sometimes a safe is just a safe.
2650,1,14,84,99,1.1616161616161615,0.03985924189591093,540,I am not a real Dr. I am a safe cracker.
2650,2,12,85,99,1.1616161616161615,0.042366286452823095,540,"'Ka-ching ... ka-ching,' music to my ears."
2650,3,10,86,99,1.1616161616161615,0.04473304473304475,540,One more exhale and you'll be able to cover the copay for this visit.
2659,2,11,80,93,1.1612903225806452,0.0440215494550123,540,"No, you gave me the wrong combination."
2659,3,9,81,93,1.1612903225806452,0.04660097538803969,540,"Say ""ahhh"""
2659,3,9,81,93,1.1612903225806452,0.04660097538803969,540,Mr. Trump. I know you are hiding in there with your tax returns. Come out. It's time for your session.
2659,1,13,79,93,1.1612903225806452,0.04128126361587671,540,"""We can operate when you remember your combination""."
2659,2,11,80,93,1.1612903225806452,0.0440215494550123,540,Would you be more comfortable if a robot opened you to take a look?
2664,1,17,100,118,1.1610169491525424,0.03604835828267723,540,I'm having nightmares about bitcoins.
2664,1,17,100,118,1.1610169491525424,0.03604835828267723,540,"So, I’m thinking we need to play it on the *unsafe* side."
2664,0,19,99,118,1.1610169491525424,0.03397969368949713,540,I know there are people out there trying to crack you but you are in a safe place now.
2664,2,15,101,118,1.1610169491525424,0.03800458770359806,540,"We play doctor, but I always listen for the safe word."
2668,1,12,74,87,1.160919540229885,0.04286443578566523,540,It's a safe bet you will be fine.
2669,1,16,95,112,1.1607142857142858,0.03709524470371652,540,"After the preliminary tests are complete, I hope you'll feel safe to open up and share whatever you've been keeping inside."
2670,0,13,68,81,1.1604938271604939,0.04103893861381398,540,"Mr. Trump, i really don't think this is a good way to prove your company is healthy."
2671,4,9,93,106,1.1603773584905661,0.04473500381743927,540,"Open wide and say ""aha"""
2671,1,15,90,106,1.1603773584905661,0.03823790015932914,540,"I'm afraid you've got pneumonia, an arrhythmia, and your combination is WAY too easy to figure out."
2671,1,15,90,106,1.1603773584905661,0.03823790015932914,540,"As far as I can tell, you’re great at handling your insecurities!"
2671,3,11,92,106,1.1603773584905661,0.042679339817166165,540,So you thought this would help you feel safe?
2671,2,13,91,106,1.1603773584905661,0.04051952033171154,540,I promise Geraldo Rivera will not be here when you open
2671,0,17,89,106,1.1603773584905661,0.0358112061969108,540,This is how they always find the combination in movies.
2671,1,15,90,106,1.1603773584905661,0.03823790015932914,540,"Ok, now just turn to the left and cough it up."
2678,3,10,87,100,1.16,0.04431293675255978,540,"Come on now, you can't just hide until the election's over..."
2678,4,12,109,125,1.16,0.04000000000000001,540,"After this, I'm going to ask you to cough while I put my hand on your love handle."
2678,3,10,87,100,1.16,0.04431293675255978,540,Wall Street finally gets an Obamacare they can believe in...
2678,1,14,85,100,1.16,0.03949172013974524,540,I hear you have a heart of gold.
2678,2,12,86,100,1.16,0.04197161137740796,540,How long have you felt unsafe in your home?
2678,1,14,85,100,1.16,0.03949172013974524,540,Has there been a recent change in what is put inside you?
2678,5,6,89,100,1.16,0.04865877893737951,540,"Once I unlock the denial mechanism, we can make some progress."
2678,2,12,86,100,1.16,0.04197161137740796,540,"Just to be safe, I think we should go through with the procedure."
2678,2,12,86,100,1.16,0.04197161137740796,540,"You're heartbeat is a little high - 36 right, 48 left, 84 right."
2678,1,14,85,100,1.16,0.03949172013974524,540,It's safe to say you'll live to be 1-0-3.
2688,2,11,81,94,1.1595744680851063,0.0435845055714996,540,"I really wish we could plan the operation, but our specialized surgeon disappeared suddenly after a similar operation last week."
2688,1,13,80,94,1.1595744680851063,0.04087576943015152,540,"You have a really hard and protective exterior, but inside you have a heart of gold!"
2688,2,11,81,94,1.1595744680851063,0.0435845055714996,540,"Well Mr. Samsa, at least your condition is improving."
2688,2,11,81,94,1.1595744680851063,0.0435845055714996,540,"Sir, it's not good for your blood pressure to keep everything locked up inside!"
2688,1,13,80,94,1.1595744680851063,0.04087576943015152,540,"I'm so sorry, sir, but resetting your password is simply not an option."
2688,4,7,83,94,1.1595744680851063,0.04855069849881071,540,"""If we're going to do roleplay sex, I'll need your safeword.'"
2688,3,9,82,94,1.1595744680851063,0.046134474369144494,540,"Of course, you may ask. I received my PhD. from William Sutton University."
2688,2,11,81,94,1.1595744680851063,0.0435845055714996,540,Can you turn your tumbler and unlock for me?
2696,3,12,98,113,1.1592920353982301,0.04086294907432108,540,Now turn your head and cough it up!
2696,4,10,99,113,1.1592920353982301,0.042752876159922,540,There are easier ways to get you to unlock your feelings.
2696,3,12,98,113,1.1592920353982301,0.04086294907432108,540,"I said, Mr. Williams, that yours is one of the worst cases of avoidance that I've ever seen."
2696,2,14,97,113,1.1592920353982301,0.03888126533634789,540,Good news! Your clicks to the right are good. To ones to the left are a bit off.
2700,2,10,76,88,1.1590909090909092,0.045389190215201616,540,"To begin with: Can you turn right 3 times and stop at 35? If you can't, I'm very sorry, but I won't be able to help you."
2700,0,14,74,88,1.1590909090909092,0.039213678081561475,540,"Ironically, because you have Obamacare..."
2702,1,15,91,107,1.158878504672897,0.03790849387207977,540,"Don't worry, you're, er, safe with me"
2702,3,11,93,107,1.158878504672897,0.04230514619003018,540,This week's hour is finished. Let's plan to unlock those secrets next week.
2702,2,13,92,107,1.158878504672897,0.040167021932235245,540,"On the bright side, a money problem is better for your health than a drinking or drug problem."
2705,3,10,88,101,1.1584158415841583,0.043900592628505666,540,"Mr. Albert, I can't help you if you won't come out."
2705,3,10,88,101,1.1584158415841583,0.043900592628505666,540,"It's not too serious, Mr. fargo. Just take two credit cards and call me in the morning when the bank opens."
2705,3,10,88,101,1.1584158415841583,0.043900592628505666,540,"Have you and your boyfriend been the practicing … I mean, have you been using a condom?"
2705,3,10,88,101,1.1584158415841583,0.043900592628505666,540,"Now, two clicks to the right and hold...."
2705,3,10,88,101,1.1584158415841583,0.043900592628505666,540,Your heartbeat is normal. I think you're safe.
2705,3,10,88,101,1.1584158415841583,0.043900592628505666,540,"Yes, Mr Schrödinger, I can still hear your heartbeat... Mr Schrödinger? Mr Schrödinger!"
2705,3,10,88,101,1.1584158415841583,0.043900592628505666,540,"Come on out, Mr. Trump. I can hear your little heart ticking away in there."
2712,2,15,103,120,1.1583333333333334,0.03741626193688513,540,And you're eating three square meals a day?
2713,3,12,99,114,1.1578947368421053,0.040527011408325986,540,This isn't exactly what I meant when I said to practice safer sex
2713,1,13,81,95,1.1578947368421053,0.040478076611364315,540,Keeping your emotions locked up inside of you to stay safe?
2713,5,8,101,114,1.1578947368421053,0.044192187589443294,540,When did you first start to feel you were being used by people?
2713,1,13,81,95,1.1578947368421053,0.040478076611364315,540,It seems you may have a severely ruptured largess
2713,3,9,83,95,1.1578947368421053,0.04567716078766766,540,I have to send you for a CAT Scan to check the family jewels.
2713,1,13,81,95,1.1578947368421053,0.040478076611364315,540,It's safe to assume you cracked a bolt.
2713,4,10,100,114,1.1578947368421053,0.04239922226663557,540,I know there's a heart in there somewhere. I just have to find a way through your strong defenses.
2713,1,13,81,95,1.1578947368421053,0.040478076611364315,540,"Now, give me the combination again; SLOWLY!"
2713,3,9,83,95,1.1578947368421053,0.04567716078766766,540,"Relax, you're too locked up."
2713,2,11,82,95,1.1578947368421053,0.04315598280527234,540,It seems to be more than one thing inside you that is causing these symptoms. Now I just have to figure out what that combination is.
2713,1,13,81,95,1.1578947368421053,0.040478076611364315,540,When did you first realize that the two of you were no longer clicking.
2724,2,13,93,108,1.1574074074074074,0.03982054986990179,540,Deep breaths. Nobody's taking your job away.
2724,3,11,94,108,1.1574074074074074,0.04193741120371579,540,"I'm telling you Doc, ""I feel so empty inside!"""
2726,2,10,77,89,1.1573033707865168,0.04491188855445378,540,Your heart is pure gold.
2726,2,10,77,89,1.1573033707865168,0.04491188855445378,540,I wish I had a nickel for every time one of you guys used that line about not being ready to open up.
2726,1,12,76,89,1.1573033707865168,0.04197279021716926,540,"Sorry, I don't hear your co-pay."
2726,1,12,76,89,1.1573033707865168,0.04197279021716926,540,Spin left to 50 and breath deeply!
2730,3,13,105,121,1.1570247933884297,0.03893956690707354,540,Did you say 3 to the left Mr. Houdini?
2730,3,13,105,121,1.1570247933884297,0.03893956690707354,540,I understand that WebMD says you have ebola but for all kinds of reasons I doubt that's likely.
2732,2,12,88,102,1.1568627450980393,0.04120373319778469,540,It's much easier to open up about myself from inside here.
2732,2,12,88,102,1.1568627450980393,0.04120373319778469,540,"Obamacare is much more affordable without the middleman, don't you think?"
2732,1,14,87,102,1.1568627450980393,0.03877641768742085,540,"So you said you've been having issues opening up ever since you watched 'The Italian Job?"""
2732,2,12,88,102,1.1568627450980393,0.04120373319778469,540,You've had too many of those safe crackers.
2732,1,14,87,102,1.1568627450980393,0.03877641768742085,540,"Yes, I hear you. Sorry, can't let you out; you have the key!"
2732,4,8,90,102,1.1568627450980393,0.04567298710358262,540,You have to stop loading up on rich things if you want to get better.
2738,2,9,72,83,1.1566265060240963,0.04688951917827399,540,"Let me get this straight, you want me to certify that you have 10 billion dollars and are the most amazing safe ever, without looking inside?"
2739,1,16,98,115,1.1565217391304348,0.036202886947237084,540,Ooh. That one really made you tick.
2739,3,12,100,115,1.1565217391304348,0.04019651260878074,540,"No, it can't be a virus, you're analogue."
2741,4,7,85,96,1.15625,0.047591382549600894,540,"Mr. Trump, I've found your heart."
2741,3,9,84,96,1.15625,0.04522876791786861,540,"Ive never seen this before, Its as if you are empty"
2741,1,13,82,96,1.15625,0.04008796522823715,540,A turn for the worst.
2744,2,13,94,109,1.1559633027522935,0.039479952560727984,540,Now cough it up once for me.
2744,3,11,95,109,1.1559633027522935,0.04157597045776372,540,boy....you really seek closure.
2744,2,13,94,109,1.1559633027522935,0.039479952560727984,540,Mr. Gore... You can come out of the lock box now...
2744,3,11,95,109,1.1559633027522935,0.04157597045776372,540,"Turn left, ok.... Now turn right."
2744,1,15,93,109,1.1559633027522935,0.03726623121392641,540,"Calm down, you're safe in here."
2744,4,9,96,109,1.1559633027522935,0.04357127476689603,540,"Yes, I can hear something's not clicking. Maybe you should open up and let go."
2750,3,13,106,122,1.1557377049180328,0.038640513151905136,540,"Sweetie, I know it's cold, but I need you to sit still for me so I can hear how much you're paying out of pocket."
2751,1,12,77,90,1.1555555555555554,0.04154059161636941,540,Is it left - right - left or right - left - right?
2751,3,8,79,90,1.1555555555555554,0.04716986890073616,540,"So, the fish oils seems to be making a difference..."
2753,2,12,89,103,1.1553398058252426,0.04083014817602034,540,Relax. No one is going to break you open here.
2753,1,14,88,103,1.1553398058252426,0.03842829154381203,540,"Just relax, I want you to think of my office as a safe space."
2753,3,10,90,103,1.1553398058252426,0.04309835738372565,540,I think its safe to say that we won't be needing an x-ray.
2753,5,6,92,103,1.1553398058252426,0.04730965258141792,540,I'd say your paranoia has worsened a bit. Can you tell me how you got here?
2753,2,12,89,103,1.1553398058252426,0.04083014817602034,540,Any family history of safe cracking?
2753,1,14,88,103,1.1553398058252426,0.03842829154381203,540,I promise. No peeking at your tax returns.
2753,4,8,91,103,1.1553398058252426,0.0452530199906581,540,Combination Code Blue!
2753,2,12,89,103,1.1553398058252426,0.04083014817602034,540,"I've taken the hippocratic oath, there's no need to lock up."
2753,3,10,90,103,1.1553398058252426,0.04309835738372565,540,The cash isn't talking.
2753,0,16,87,103,1.1553398058252426,0.03586594738573977,540,There's a definite echo in the combination and some feedback in the tumblers.
2763,2,9,73,84,1.1547619047619047,0.0463654557243119,540,"After this, I'll open you up and you won't feel a thing"
2763,2,9,73,84,1.1547619047619047,0.0463654557243119,540,"Just relax, I'd like to see if you will open up for me and release some of what you've been hiding for so many years."
2763,1,11,72,84,1.1547619047619047,0.04316125289977414,540,"Trust me, I'm a doctor. You're in safe hands."
2763,2,9,73,84,1.1547619047619047,0.0463654557243119,540,I recommend you open up more.
2767,0,15,82,97,1.1546391752577319,0.03690160067854731,540,"It's not incontinence, your owner's just selling gold."
2767,2,11,84,97,1.1546391752577319,0.04232353242870654,540,I never said exposure therapy would be easy - on a scale of 1-10 how claustrophobic are you feeling now?
2767,1,13,83,97,1.1546391752577319,0.03970522339619019,540,"Yes, I agree with you. Money and love are not mutually exclusive."
2767,3,9,85,97,1.1546391752577319,0.044789039167481365,540,Password too weak...
2767,1,13,83,97,1.1546391752577319,0.03970522339619019,540,It's especially bad for a safe to have an empty feeling inside.
2767,0,15,82,97,1.1546391752577319,0.03690160067854731,540,I can hear your stomach tumbling.
2767,3,9,85,97,1.1546391752577319,0.044789039167481365,540,You're healthy enough for Viagra. Now can I give you a brochure on safe sex?
2767,3,9,85,97,1.1546391752577319,0.044789039167481365,540,"I promise, all pre-existing conditions will now be covered."
2775,1,15,94,110,1.1545454545454545,0.03695310382944123,540,Money talks. We just need the combination.
2775,2,13,95,110,1.1545454545454545,0.03914508339526551,540,You've got to loosen up. Your tumblers are too tight.
2775,4,9,97,110,1.1545454545454545,0.04319663061869463,540,"After all, this is your safe space."
2775,2,13,95,110,1.1545454545454545,0.03914508339526551,540,We're going to need to operate.
2775,2,13,95,110,1.1545454545454545,0.03914508339526551,540,I didn't realize it would take you so long to open up to me
2775,5,7,98,110,1.1545454545454545,0.045086079539041465,540,"No, Mr Clinton. Not until after the election."
2781,3,12,102,117,1.1538461538461537,0.039551316085490784,540,"You're only demonstrating just how crazy you are if you think you can hide there with your tax returns forever, Mr. Trump."
2781,2,12,90,104,1.1538461538461537,0.040463222334529564,540,You have to open up to others if you want to stop feeling so empty.
2781,3,10,91,104,1.1538461538461537,0.042708065503832895,540,"""The Health Authority regulations are very strict: You must give me your entire numerical sequence before I am permitted to treat you."
2781,1,16,100,117,1.1538461538461537,0.035631196604084675,540,You're safe in my hands.
2781,3,10,91,104,1.1538461538461537,0.042708065503832895,540,"Hmm, so what makes you think your anxiety attacks are caused by agoraphobia?"
2781,2,8,68,78,1.1538461538461537,0.048545007377001466,540,Bad news; I don't hear your tumblers clicking!
2781,3,10,91,104,1.1538461538461537,0.042708065503832895,540,"The clicking is normal, have you consumed anything strange lately?"
2781,1,14,89,104,1.1538461538461537,0.038086294966922986,540,It's safe to say that you're healthy.
2781,2,10,79,91,1.1538461538461537,0.04398655839495406,540,"Uh huh, I see. Any dreams involving break-ins?"
2781,2,12,90,104,1.1538461538461537,0.040463222334529564,540,I detect no cracks.
2781,3,8,80,91,1.1538461538461537,0.04667994819655381,540,"""Now I want you to relax. Before we begin,. it's very important that we make you feel safe""."
2781,4,10,103,117,1.1538461538461537,0.041372319495311546,540,If you can't be more open we can settle the bill right now.
2781,2,14,101,117,1.1538461538461537,0.03764232176376304,540,Trust me. Probiotics.
2781,5,4,82,91,1.1538461538461537,0.051647052694548175,540,"I'M JUST AS SICK OF THE CAMPAIGNING AS YOU, BUT YOU NEED TO FIND A BETTER COPING MECHANISM FOR DEALING WITH YOUR STRESS."
2781,0,18,99,117,1.1538461538461537,0.03349955156582251,540,It's safe to say that your cash deposits have built up significantly
2781,1,16,100,117,1.1538461538461537,0.035631196604084675,540,"Due to a complex combination of symptoms, we need to open you up and have a look inside."
2797,2,13,96,111,1.1531531531531531,0.03881580053961578,540,I hear better safe than sorry!
2797,2,13,96,111,1.1531531531531531,0.03881580053961578,540,"You seem a little congested. Not to worry, the bill should clear that right up."
2799,4,7,87,98,1.153061224489796,0.046669062922993845,540,I'm recommending a vacation in the Caymons.
2799,1,13,84,98,1.153061224489796,0.03932964692106888,540,You need to trust me - there's no Zika here.
2799,3,9,86,98,1.153061224489796,0.0443577276061968,540,"Unfortunately, your heart is made of steel, not gold."
2799,1,13,84,98,1.153061224489796,0.03932964692106888,540,I still think you're too sedentary for your own good.
2799,2,11,85,98,1.153061224489796,0.04191914315275001,540,I have never met someone so well-insured.
2799,2,11,85,98,1.153061224489796,0.04191914315275001,540,"Take a deep breath. You need to dial it back, because your not getting enough iron."
2799,1,13,84,98,1.153061224489796,0.03932964692106888,540,I haven't felt well since I lost the role of The Tin Man
2806,2,9,74,85,1.1529411764705881,0.04585289580871799,540,"Now, go to your ""safe"" place."
2806,1,11,73,85,1.1529411764705881,0.04268929619034754,540,It sounds like we'll need to remove the contents and deposit them into my bank account.
2806,3,7,75,85,1.1529411764705881,0.048811884811622214,540,"And when did you first realize you were living in an escapist reality, Mr. Houdini?"
2806,3,7,75,85,1.1529411764705881,0.048811884811622214,540,"Damn, you're cold."
2806,2,9,74,85,1.1529411764705881,0.04585289580871799,540,"My diagnosis is arteriosclerosis, usually an inside job."
2811,2,14,102,118,1.152542372881356,0.037344721527928434,540,I hear that. You ARE in a safe place.
2811,2,14,102,118,1.152542372881356,0.037344721527928434,540,The combination the HMO gave me was...
2811,2,14,102,118,1.152542372881356,0.037344721527928434,540,How many people have you protected assets from in the last 6 months?
2811,2,14,102,118,1.152542372881356,0.037344721527928434,540,My diagnosis is lockjaw.
2815,3,10,92,105,1.1523809523809523,0.04232473532055043,540,Better safe than sorry.
2815,2,12,91,105,1.1523809523809523,0.04010278091110972,540,"I feel it now, your code is cracked."
2815,3,10,92,105,1.1523809523809523,0.04232473532055043,540,"Don't worry, Mr. Schwartz. We'll let you out as soon as we confirm you don't have Ebola."
2815,4,8,93,105,1.1523809523809523,0.04443572215126961,540,That rapping you feel is just Hamilton telling Jefferson he isn't worth a nickel.
2815,2,12,91,105,1.1523809523809523,0.04010278091110972,540,Am I hearing just a little guardedness from you?
2815,3,10,92,105,1.1523809523809523,0.04232473532055043,540,So... Going going anywhere fun this summer?
2815,2,12,91,105,1.1523809523809523,0.04010278091110972,540,"Sorry, but you always knew your days were numbered."
2815,1,14,90,105,1.1523809523809523,0.03775026958386235,540,"Well, it seems you have the pulse of a very uncertain economy."
2823,3,8,81,92,1.1521739130434783,0.046200043353871234,540,"Four to eight years, tops."
2823,2,10,80,92,1.1521739130434783,0.04353794279315701,540,I want you to open up to the world and show them what your worth.
2823,2,10,80,92,1.1521739130434783,0.04353794279315701,540,"Oh please please please say ""ah""."
2823,3,8,81,92,1.1521739130434783,0.046200043353871234,540,"You know you did this to yourself, Mr. Trump."
2827,3,6,70,79,1.1518987341772151,0.05123786608343864,540,Did I mention this office is pay upfront?
2828,2,13,97,112,1.1517857142857142,0.03849196674571115,540,I know you're in there. You cannot escape the election!
2829,0,15,84,99,1.1515151515151516,0.036219048767708886,540,Try it again with the CAPS LOCK off
2829,3,14,115,132,1.1515151515151516,0.03644643207398979,540,"So many secrets, such a heavy heart."
2829,1,13,85,99,1.1515151515151516,0.038961038961038946,540,The ticker's OK.
2829,1,13,85,99,1.1515151515151516,0.038961038961038946,540,"So, tell me more about this Houdini obsession"
2829,3,9,87,99,1.1515151515151516,0.04393459551987973,540,"Just to confirm, that's 38 right, 46 left, and 3 right ?"
2829,0,15,84,99,1.1515151515151516,0.036219048767708886,540,You need to let it out
2829,3,9,87,99,1.1515151515151516,0.04393459551987973,540,"I know that you feel that you are going to get robbed,, but you are perfectly, safe."
2836,3,7,76,86,1.1511627906976745,0.048273734578916254,540,"Doc, 42 is not the answer to everything."
2836,1,11,74,86,1.1511627906976745,0.04222745348420426,540,"I told you, if you open up to just anyone, you might get hurt."
2838,3,10,93,106,1.150943396226415,0.04194818356325725,540,Find a safe space and get plenty of rest.
2838,3,10,93,106,1.150943396226415,0.04194818356325725,540,"MR. WILSON, YOU ARE SUFFERING FROM LOCKED-IN SYNDROME."
2838,2,12,92,106,1.150943396226415,0.039748655133722006,540,Your heart has a tick to it.
2838,2,12,92,106,1.150943396226415,0.039748655133722006,540,Stop wriggling.
2838,1,14,91,106,1.150943396226415,0.03742006234124155,540,Now I'm going to need you to cough up the loot.
2838,1,14,91,106,1.150943396226415,0.03742006234124155,540,Your chest X-ray was negative. You are completely broke! .
2838,1,14,91,106,1.150943396226415,0.03742006234124155,540,Sounds like a co-pay.
2845,3,13,110,126,1.1507936507936507,0.03748855540487213,540,Not until I hear an apology.
2846,1,12,80,93,1.1505376344086022,0.040295300106155195,540,"My relatives, the Tin Man and R2D2 also had heart palpitations."
2846,1,12,80,93,1.1505376344086022,0.040295300106155195,540,Your ticker sounds good. To live a safe lifestyle remember to open up to people and you will be fine.
2846,0,14,79,93,1.1505376344086022,0.037282128693900025,540,It's not good for your stress levels to lock all of your feelings inside like this.
2846,3,8,82,93,1.1505376344086022,0.045729852307199566,540,"'Take a deep tumbler and hold."""
2850,6,5,102,113,1.1504424778761062,0.0457091180525687,540,The side effects from the iron supplements also include nausea and vomiting. Any of that ? No?
2851,4,10,106,120,1.15,0.04039372056476633,540,"Breath in your insurance ID, breath out $1,000 bucks."
2851,1,13,86,100,1.15,0.03859920970562726,540,"... hold it. And now, exhale."
2851,1,13,86,100,1.15,0.03859920970562726,540,"What if I open up, and actually there's nothing there?"
2851,2,11,87,100,1.15,0.041132945334843116,540,You sound tight.
2851,1,13,86,100,1.15,0.03859920970562726,540,"To retrieve the soul requires surgery, Mr. Priebus."
2851,3,9,88,100,1.15,0.04351941398892446,540,"In addition to the mold and the mildew problem, the dampness has rusted your innards."
2851,4,7,89,100,1.15,0.04578165130223675,540,"""Let me guess: `34 -24-34, the combination to your heart?' Donald Trump said the same thing.''"
2851,2,11,87,100,1.15,0.041132945334843116,540,"Even with everything I've learned in medical school, I still can't get him to open up."
2851,2,11,87,100,1.15,0.041132945334843116,540,Sounds complicated.
2851,2,14,104,120,1.15,0.03676330529545051,540,"if you will just let me turn your love handles, we can get you to open up."
2861,3,13,111,127,1.1496062992125984,0.03721114666340636,540,Now bend over and cough it up.
2862,2,12,93,107,1.1495327102803738,0.03940068196980345,540,I believe the problem is too much gilt.
2862,4,8,95,107,1.1495327102803738,0.04364728200238717,540,I'd say you're a safe heartbeat away from being cracked!!!!
2862,0,16,91,107,1.1495327102803738,0.03463729569662273,540,I can tell you feel safe here so let's see if you can open up and discuss your inner self.
2862,3,10,94,107,1.1495327102803738,0.04157823328306234,540,You're a hard safe to hack.
2862,4,8,95,107,1.1495327102803738,0.04364728200238717,540,Please stop screaming and just tell me the combination!
2862,1,14,92,107,1.1495327102803738,0.03709552528850936,540,Please be calm. This will help you get over your claustrophobia.
2868,5,3,79,87,1.1494252873563218,0.0530510832792138,540,Do you ever feel stiff in the mornings?
2868,1,11,75,87,1.1494252873563218,0.04177540678018991,540,I agree that your feelings of insecurity could be career threatening.
2868,1,11,75,87,1.1494252873563218,0.04177540678018991,540,"Clinically speaking, there's nothing wrong with you, but if I had to guess, I'd say you're hanging on to too much inside."
2871,4,9,101,114,1.1491228070175439,0.041760021746811746,540,Five bucks says you can't give me a colonoscopy.
2871,3,11,100,114,1.1491228070175439,0.03985779749521051,540,You'll be safer inside.
2871,4,9,101,114,1.1491228070175439,0.041760021746811746,540,I'm listening in your safe space.
2874,1,12,81,94,1.148936170212766,0.039896476676276244,540,You appear to be empty and there are signs of hacking. Government safes are prone to these symptoms.
2874,0,14,80,94,1.148936170212766,0.03691812903947712,540,I'm sensing stress. Do you feel safe at home?
2874,2,10,82,94,1.148936170212766,0.0426674284505854,540,It is definitely safe for you to travel.
2874,2,10,82,94,1.148936170212766,0.0426674284505854,540,safe sex in combination with good diet...that's good...
2874,3,8,83,94,1.148936170212766,0.045269084925487445,540,"""I understand privacy laws are not perfect Mr. X, but isn't this going to far?"
2874,0,14,80,94,1.148936170212766,0.03691812903947712,540,"It appears to be the strong, silent type."
2874,3,8,83,94,1.148936170212766,0.045269084925487445,540,"Mr. Smith, you've got the worse case of white-coat syndrome I've ever seen."
2881,1,16,104,121,1.1487603305785123,0.03453978626701372,540,"Yes, I can perform gastric surgery, but I'll need the combination."
2882,4,7,90,101,1.1485148514851484,0.04535042570534174,540,Tell me more about your family history of Depression.
2882,2,11,88,101,1.1485148514851484,0.04075072401436967,540,I recommend you play it safe and continue practicing safe sex!
2882,0,15,86,101,1.1485148514851484,0.035560960388253425,540,You seem to have some open-ness issues. I'm prescribing a combination of things to help you out...
2882,1,13,87,101,1.1485148514851484,0.03824397607094648,540,it's safe to say the combination of diet and exercise is all you need. id recommend a spinning class.
2882,2,11,88,101,1.1485148514851484,0.04075072401436967,540,I think we can both feel safe here.
2882,3,9,89,101,1.1485148514851484,0.04311196248926188,540,Alright give me two to the right and now three to the left.
2882,1,13,87,101,1.1485148514851484,0.03824397607094648,540,"Thought I'd have a better chance of paying off my medical school debt doing this, than in a residency program."
2882,2,11,88,101,1.1485148514851484,0.04075072401436967,540,Does your family have a history of locked-in syndrome?
2890,5,9,114,128,1.1484375,0.04013057512412833,540,The claustrophobia aversion therapy will continue until your heartbeat slows down.
2891,1,14,93,108,1.1481481481481481,0.03677651537147867,540,I'll help you open up and draw some interest.
2891,5,6,97,108,1.1481481481481481,0.04521938908235546,540,"Don't worry, if I can't help you Donald Trump can. He knows more about locks than even the locksmiths do."
2891,1,14,93,108,1.1481481481481481,0.03677651537147867,540,It's safe to say you are going to be ok.
2891,3,10,95,108,1.1481481481481481,0.041214713585381466,540,"You don't need to worry, El Chapo is in prison now."
2891,2,12,94,108,1.1481481481481481,0.03905870388782527,540,Have you been Fire Tested recently?
2891,1,14,93,108,1.1481481481481481,0.03677651537147867,540,In psychotherapy each little adjustment of the dial seems to achieve nothing; only when everything is in place does the lock open.
2891,3,10,95,108,1.1481481481481481,0.041214713585381466,540,In my opinion SPF 70 would be a better option.
2891,3,10,95,108,1.1481481481481481,0.041214713585381466,540,I've never wanted a patient to open up this badly.
2899,0,17,98,115,1.1478260869565218,0.033242006686167405,540,You certainly safe to open up and speak here.
2899,4,9,102,115,1.1478260869565218,0.04141560350532247,540,"I'm your doctor, you can tell me."
2901,2,9,77,88,1.1477272727272727,0.04438059934877056,540,Olly olly oxen free!
2901,2,9,77,88,1.1477272727272727,0.04438059934877056,540,"I'm sorry, but I need to open you up to get a better look. We can worry about cost in a moment."
2901,2,9,77,88,1.1477272727272727,0.04438059934877056,540,I'm afraid your combination is reversed.
2904,2,14,106,122,1.1475409836065573,0.03619957615943701,540,Sounds safe to me.
2905,3,8,84,95,1.1473684210526316,0.044817462433734835,540,"Your heartbeat is fine, but I have no idea how I'm going to take your blood pressure."
2905,2,10,83,95,1.1473684210526316,0.04224500885626313,540,"Well, your tumblers seem to be clicking right along."
2905,3,8,84,95,1.1473684210526316,0.044817462433734835,540,If I could crack this I wouldn't be here.
2905,3,8,84,95,1.1473684210526316,0.044817462433734835,540,Don't give me that lock!
2905,1,12,82,95,1.1473684210526316,0.03950539972626866,540,You are a bit empty inside...
2905,1,12,82,95,1.1473684210526316,0.03950539972626866,540,I'm a doctor. Everything you tell me goes in the vault.
2905,3,8,84,95,1.1473684210526316,0.044817462433734835,540,Looks like a combination of locked personality and sheltered lifestyle.
2905,1,12,82,95,1.1473684210526316,0.03950539972626866,540,"You're suffering from a case of the common syllogism:because it's a safe, doesn't mean it's safe."
2905,4,6,85,95,1.1473684210526316,0.0472500698912998,540,Most of my patients wear a gown so that's why it feels cold.
2914,1,13,88,102,1.1470588235294117,0.037895161410199434,540,"In my opinion, this is a clear case of more money absolutely being able to fill your emptiness inside."
2914,1,13,88,102,1.1470588235294117,0.037895161410199434,540,"Once I crack the combination, please open up and say ""aah."""
2914,3,9,90,102,1.1470588235294117,0.042712028514633536,540,How was your asthma before you locked yourself inside?
2914,1,13,88,102,1.1470588235294117,0.037895161410199434,540,"If you really want a reliable diagnosis, you are going to have to get out of the safe."
2914,4,7,91,102,1.1470588235294117,0.04492721269564548,540,You have no beat so I can safely pronounce you dead.
2914,3,9,90,102,1.1470588235294117,0.042712028514633536,540,"Safe to say, you're dead."
2914,3,9,90,102,1.1470588235294117,0.042712028514633536,540,"I know you wanted to take it with you when you go Mr. Jones, but I am not sure this will work."
2914,2,11,89,102,1.1470588235294117,0.04037549156443755,540,It's your insurance company. I'm required to administer a metal status exam before we can start.
2914,1,13,88,102,1.1470588235294117,0.037895161410199434,540,"Your heart sounds good, but your feelings are all locked up inside you."
2914,2,11,89,102,1.1470588235294117,0.04037549156443755,540,This is not the place to play it safe. You need to open up.
2924,2,12,95,109,1.146788990825688,0.03872256863042321,540,It's good you came in; you wouldn't want to be sorry.
2924,2,12,95,109,1.146788990825688,0.03872256863042321,540,"You know, you do sound a little tight."
2924,4,8,97,109,1.146788990825688,0.042886205847018626,540,"I don't know what you've heard, but this is not really a safe environment."
2924,1,14,94,109,1.146788990825688,0.03646289423551464,540,This is the last time I tell people that this is a safe place.
2924,2,12,95,109,1.146788990825688,0.03872256863042321,540,How often does your chest feel tight like this?
2924,3,10,96,109,1.146788990825688,0.04085745937580242,540,It's starting to sound like you are opening up. You are safe in here.
2930,2,13,101,116,1.146551724137931,0.037248527827438795,540,This sounds safe.
2930,2,13,101,116,1.146551724137931,0.037248527827438795,540,You're a faulty vault.
2930,3,11,102,116,1.146551724137931,0.039209410385680904,540,You don't seem to want anyone to see inside of you.
2933,3,6,73,82,1.146341463414634,0.049453353904863585,540,"Come out Mr. Trump, I don't care about your taxes."
2934,2,9,78,89,1.146067415730337,0.043910490827793,540,How long have you been holding all this tension inside you?
2934,4,5,80,89,1.146067415730337,0.04938477938154676,540,I think it's safe to open up now!
2934,2,9,78,89,1.146067415730337,0.043910490827793,540,"I know, but the X-ray is the only way to know what is going on inside."
2937,1,12,83,96,1.1458333333333333,0.03912184819059489,540,I hear your clicks. We are about to unlock all those boxed in emotions!
2937,4,6,86,96,1.1458333333333333,0.046780484635049024,540,Well I can tell you have a heart of gold.
2937,2,10,84,96,1.1458333333333333,0.04183081700686693,540,There's not much time; I have never seen such an advanced case of devaluation.
2937,4,6,86,96,1.1458333333333333,0.046780484635049024,540,Sometimes I just feel withdrawn from everyone.
2937,3,8,85,96,1.1458333333333333,0.04437471686755897,540,You've lost a lot of weight since Brexit.
2942,4,7,92,103,1.145631067961165,0.044511792105617315,540,"Everybody knows you're in there, Mr. Trump. Now come out with your tax returns this instant!"
2942,5,5,93,103,1.145631067961165,0.046601148543284406,540,"Yes, it's safe effective"""
2942,1,13,89,103,1.145631067961165,0.0375525952386118,540,It's good to see you again David Blaine. Let's continue to talk about your childhood.
2942,3,9,91,103,1.145631067961165,0.0423194072188415,540,Don't worry. You're in a safe space.
2942,1,13,89,103,1.145631067961165,0.0375525952386118,540,"I assure you, Mr. Trump, Kellyanne has the combination."
2947,4,8,98,110,1.1454545454545455,0.04251549025732218,540,"Your secret is safe with me, Mr. Hyde."
2947,2,12,96,110,1.1454545454545455,0.038392128998465336,540,Just pretend that I'm Geraldo
2947,0,16,94,110,1.1454545454545455,0.033768983198330806,540,I'm sure you must have a heart of gold locked in there somewhere.
2947,2,12,96,110,1.1454545454545455,0.038392128998465336,540,Breathe and hold it...
2947,2,12,96,110,1.1454545454545455,0.038392128998465336,540,"""Schroedenger's cat is dead.""(I think)"
2947,3,10,97,110,1.1454545454545455,0.040506311118486585,540,"I'm sorry, but practicing safe sex doesn't entirely eliminate the risk of picking up an STI."
2953,4,9,104,117,1.1452991452991452,0.0407434543135619,540,I thought I was very clear about this last time -- NO MORE MAGICIANS!
2954,1,10,72,83,1.144578313253012,0.042451092394817716,540,Just checking to make sure you're safe...
2954,4,4,75,83,1.144578313253012,0.051804153562474115,540,We find ourselves in an unusual situation
2956,1,11,78,90,1.1444444444444444,0.04047505392571967,540,Don't worry. All your medical information is safe with me.
2956,4,5,81,90,1.1444444444444444,0.048859939221226015,540,How were you able to climb the exam table?
2956,0,13,77,90,1.1444444444444444,0.037263146675402856,540,It sounds like a bad case of inflation!
2956,2,9,79,90,1.1444444444444444,0.043450176989596294,540,I hear grossly inflated sounds.
2960,2,10,85,97,1.1443298969072164,0.041424616670931926,540,"""Take a deep breath and say 'MONEY' ""."
2960,1,12,84,97,1.1443298969072164,0.038745609222610576,540,No one's safe these days.
2960,4,6,87,97,1.1443298969072164,0.046320105040235635,540,Now open up.
2960,3,8,86,97,1.1443298969072164,0.043940590558571885,540,The clicking seems normal but we'll have to run test on lack of deposits.
2960,2,10,85,97,1.1443298969072164,0.041424616670931926,540,"Sounds like a million bucks, I'm afraid we have to crack you open"
2960,3,8,86,97,1.1443298969072164,0.043940590558571885,540,"And what did you say this ""Wizard of Oz"" gave you again?"
2960,3,8,86,97,1.1443298969072164,0.043940590558571885,540,"Open up and say...forget it, just say 'Ah'."
2960,2,10,85,97,1.1443298969072164,0.041424616670931926,540,We're going to have to perform open safe surgery.
2960,3,8,86,97,1.1443298969072164,0.043940590558571885,540,You're constipated.
2960,0,14,83,97,1.1443298969072164,0.035867054544928,540,"Yes, your personal information is secure with us."
2960,2,10,85,97,1.1443298969072164,0.041424616670931926,540,That's not a good combination if you wish to have safe sex.
2971,2,11,91,104,1.1442307692307692,0.0396452464001698,540,I'm worried about your heart. Your BMI is off the charts.
2971,3,9,92,104,1.1442307692307692,0.04193390107676945,540,You can open up your in a safe place
2971,1,13,90,104,1.1442307692307692,0.037216112971991955,540,I'm recommending two turns to the right and one turn to the left. And do not open for any bankers.
2971,1,13,90,104,1.1442307692307692,0.037216112971991955,540,"I keep the memory enhancement samples in this safe, but sometimes I forget the combination."
2971,2,11,91,104,1.1442307692307692,0.0396452464001698,540,Just breathe normally. You're safe.
2976,1,14,96,111,1.1441441441441442,0.035851287268776164,540,"I know I'm empty inside, that's the problem."
2976,2,12,97,111,1.1441441441441442,0.038067242645461935,540,Money talks !
2978,2,9,80,91,1.1428571428571428,0.04299935704272289,540,How else did they think I paid my way through medical school...
2978,1,12,85,98,1.1428571428571428,0.03837647782266681,540,Another hurdle to get paid for services! Ugh!
2978,0,13,78,91,1.1428571428571428,0.03688555567816587,540,It's OK. This is a safe zone.
2978,4,8,100,112,1.1428571428571428,0.041792877428904814,540,"If elected, I can state unequivocally, Mr. Trump's tax returns will be the healthiest ever hidden from the electorate."
2978,1,13,91,105,1.1428571428571428,0.03688555567816588,540,"Even if I did hear those voices, I still don't see how they could steal your money."
2978,3,8,87,98,1.1428571428571428,0.043514835648583675,540,"I can´t hear you, but if you´ll tap out the combination, I think I can get you out before the oxygen is exhausted."
2978,1,11,79,91,1.1428571428571428,0.04005926187397015,540,To be on the safe side....
2978,2,9,80,91,1.1428571428571428,0.04299935704272289,540,Vladimir. please come out. Donald didn't say you were fat!
2978,3,7,81,91,1.1428571428571428,0.04575090108716775,540,Any unexpected weight loss since your last checkup?
2978,2,11,92,105,1.1428571428571428,0.039289876569381814,540,I can hear why you haven't felt safe for a while.
2978,2,10,86,98,1.1428571428571428,0.04102618049244218,540,I would love the combination to your heart.
2978,3,10,99,112,1.1428571428571428,0.039821720742734115,540,Relax and take a deep breath. You're in a safe place now.
2978,2,10,86,98,1.1428571428571428,0.04102618049244218,540,I know it's your safe place but you need to come out.
2978,2,10,86,98,1.1428571428571428,0.04102618049244218,540,You'll breath easier if you release your taxes.
2978,1,11,79,91,1.1428571428571428,0.04005926187397015,540,"One tap, 'yes'; two taps, 'no'; three taps, 'maybe'...and four taps, 'none of your business.'"
2978,2,10,86,98,1.1428571428571428,0.04102618049244218,540,I'll just pretend to know the combination till you open up.
2978,0,15,90,105,1.1428571428571428,0.03431317581537582,540,You're safe with me.
2978,1,12,85,98,1.1428571428571428,0.03837647782266681,540,"In your case, what's inside *doesn't* count."
2996,1,15,104,120,1.1416666666666666,0.034086381726935476,540,You're not safe to drive.
2997,2,12,99,113,1.1415929203539823,0.037433583487972,540,I'm not a doctor but if you open up I'll take a look.
2997,3,10,100,113,1.1415929203539823,0.03948798533283307,540,We're catching this just in time Jerry — I'm due for a payment on my beach house tomorrow.
2997,4,8,101,113,1.1415929203539823,0.04144066600021179,540,Please come out Mr. Johnson. I can barely hear you.
3000,2,11,93,106,1.1415094339622642,0.03894078081719513,540,"HOWARD ""JUST TELL ME THE COMBINATION"""
3000,1,13,92,106,1.1415094339622642,0.036560769840577365,540,"They say money talks, but I don't hear anything from this currency."
3000,0,15,91,106,1.1415094339622642,0.03401463467418856,540,"Your cholesterol is a bit high, but I think your safe."
3000,2,11,93,106,1.1415094339622642,0.03894078081719513,540,You're too repressed... you've got to open up more.
3004,4,6,89,99,1.1414141414141414,0.04542590545078555,540,I'm not getting a heartbeat.
3004,1,12,86,99,1.1414141414141414,0.03801425648577054,540,I was told that this is a safe place.
3004,2,10,87,99,1.1414141414141414,0.04063528958247828,540,"I respect your safe space, but I'm still going to need you to try the couch."
3004,3,8,88,99,1.1414141414141414,0.043097213630788105,540,"I don't hear a heartbeat, but I hear Ca-Ching!"""
3004,2,10,87,99,1.1414141414141414,0.04063528958247828,540,Try opening up a bit you seem too closed off
3004,2,10,87,99,1.1414141414141414,0.04063528958247828,540,You need to open up to the idea that a combination of exercise and good nutrition is what you need to crack open and fix your empty but safe life.
3004,2,10,87,99,1.1414141414141414,0.04063528958247828,540,Now turn your dial and click.
3004,1,12,86,99,1.1414141414141414,0.03801425648577054,540,I hear a second heartbeat. You're going to have twin mailboxes.
3004,2,10,87,99,1.1414141414141414,0.04063528958247828,540,Uh-oh! Looks like you've been having unsafe sex!
3013,3,7,82,92,1.141304347826087,0.04527751066040476,540,Go to medical school they said...Doctors make great money they said...Now where did I put that plasma cutter?
3013,3,7,82,92,1.141304347826087,0.04527751066040476,540,"We'll run the tests, just to be safe."
3013,1,11,80,92,1.141304347826087,0.0396518585330414,540,"Sounds like an insecurity issue, Donald."
3013,2,9,81,92,1.141304347826087,0.04255774228461488,540,I don't care what Mr. Trump says—you're running on empty.
3013,2,9,81,92,1.141304347826087,0.04255774228461488,540,"And tell me, do you always wear protection?"
3013,3,7,82,92,1.141304347826087,0.04527751066040476,540,You wouldn't be in here if you got your affluenza vaccine.
3013,2,9,81,92,1.141304347826087,0.04255774228461488,540,Let's be safe and change your combination of iron supplements.
3013,4,5,83,92,1.141304347826087,0.04784291499106671,540,"No, I don't want to buy any furniture."
3013,1,11,80,92,1.141304347826087,0.0396518585330414,540,"So, in addition to ticking sounds, you say you don't feel safe?"
3022,2,13,106,121,1.140495867768595,0.03580207514332723,540,"Your stocks are going strong, but I will prescribe some hedges for your bonds"
3023,5,6,103,114,1.1403508771929824,0.04294180119029562,540,"Yep, you're dying."
3023,3,10,101,114,1.1403508771929824,0.039159768886152954,540,Take a deep breath - you're in a safe space.
3023,3,10,101,114,1.1403508771929824,0.039159768886152954,540,You should be taking a statin. Better safe than sorry.
3026,4,7,96,107,1.1401869158878504,0.042923901469651166,540,The people business has been slow; but now I have a purpose for my medical degree.
3026,0,15,92,107,1.1401869158878504,0.033721185393691164,540,Your heart rate is at a safe level.
3026,2,11,94,107,1.1401869158878504,0.038597795673665176,540,Hnh. You act like you're loaded. But there's really nothing there.
3026,3,9,95,107,1.1401869158878504,0.04081820150522514,540,I just want to see your tax returns.
3026,2,11,94,107,1.1401869158878504,0.038597795673665176,540,"My last patient had David Blaine inside, but I think you might just have stacks of twenties."
3026,4,7,96,107,1.1401869158878504,0.042923901469651166,540,Fox News-commissioned artist's rendering of mental healthcare under Obama Care.
3026,4,7,96,107,1.1401869158878504,0.042923901469651166,540,I think it's safe to say that your suffering from congestive gear failure.
3033,1,12,87,100,1.14,0.037658754867650863,540,I just feel totally worthless.
3033,2,10,88,100,1.14,0.04025173313289776,540,I am not breaking you open...it is just a check up.
3033,2,10,88,100,1.14,0.04025173313289776,540,"I'm sorry Mr. Banks, I can't find your heart"
3033,0,14,86,100,1.14,0.03487350880197769,540,"Take a deep breath and visualize Fort Knox,"
3033,0,14,86,100,1.14,0.03487350880197769,540,I understand your need to feel safe and sound.
3033,1,12,87,100,1.14,0.037658754867650863,540,"You've a combination of symptoms, but nothing serious, better safe than sorry."
3033,0,14,86,100,1.14,0.03487350880197769,540,Can you hear me?
3033,1,12,87,100,1.14,0.037658754867650863,540,I have to do it this way because X-rays are out of the question.
3041,2,9,82,93,1.1397849462365592,0.04212505550639789,540,I just want you to know that I am your Doctor and this is a safe place.
3042,1,15,106,122,1.139344262295082,0.03356514345620033,540,"You were right about the cracking part, but wrong about the rib."
3042,3,11,108,122,1.139344262295082,0.03738428612402663,540,So why do you think you have diabetes?
3044,2,12,101,115,1.1391304347826088,0.036820542225567035,540,"Hold still, as much as you can."
3045,3,9,96,108,1.1388888888888888,0.04045931624376092,540,"Cough, please."
3045,2,11,95,108,1.1388888888888888,0.03826076324884863,540,"we will have to open you up, don't worry though, it's a safe procedure"
3045,2,11,95,108,1.1388888888888888,0.03826076324884863,540,I hear something tumbling.
3048,1,12,88,101,1.1386138613861385,0.037309789468152006,540,It's safe to come out now!
3048,2,10,89,101,1.1386138613861385,0.03987530805069755,540,You're right it's empty
3048,2,10,89,101,1.1386138613861385,0.03987530805069755,540,"She couldn't hear the safe word, huh?"
3048,0,14,87,101,1.1386138613861385,0.0345543135972577,540,"Yes, undoubtedly you're safer in there, but are you really willing to give up the thrill of mass shootings, air disasters, and emerging diseases?"
3048,2,10,89,101,1.1386138613861385,0.03987530805069755,540,I will help you open up to me
3048,2,10,89,101,1.1386138613861385,0.03987530805069755,540,"Well, you seem healthy enough. If you really think you need a different combination to identify with, we can start the procedure tomorrow."
3048,1,12,88,101,1.1386138613861385,0.037309789468152006,540,"I'm sorry, but there's nothing medically wrong with you. You might want to see a psychatrist to figure out what's going on in there."
3048,0,14,87,101,1.1386138613861385,0.0345543135972577,540,You're going to die of starvation if you wait until the election is over.
3056,1,11,82,94,1.1382978723404256,0.03886123183444542,540,"So what I'm hearing you say is you feel trapped, metaphorically, in the choices you've made"
3056,2,9,83,94,1.1382978723404256,0.04170103043206108,540,COPD: C-hronic O-bstructive P-ayola D-epository
3056,0,13,81,94,1.1382978723404256,0.03579685377634945,540,So I hear you're experiencing a rattling in your chest?
3056,3,7,84,94,1.1382978723404256,0.0443594019177542,540,Whisper in my ear and we'll have safe sex.
3056,0,13,81,94,1.1382978723404256,0.03579685377634945,540,We'll get you out of that lockbox yet Mr. Vice-President.
3061,2,13,108,123,1.1382113821138211,0.03525426624238577,540,"Hey doc, thanks for squeezing me into your busy schedule. You can never be too safe these days."
3061,2,13,108,123,1.1382113821138211,0.03525426624238577,540,"Now tell me Mr Trump, how long have you been feeling 'unsafe' ?"
3061,3,11,109,123,1.1382113821138211,0.037096405615825154,540,"My sign asks if you are safe at home, not if you are A safe at home!"
3064,1,10,76,87,1.1379310344827587,0.040619414815555276,540,Theres two of you in there?
3064,3,10,103,116,1.1379310344827587,0.03851935731780324,540,"I can state unequivocally, if you are elected you will be the healthiest individual ever elected to the presidency. Ever!"
3064,0,12,75,87,1.1379310344827587,0.03718371489773737,540,"Apparently, I’m emotionally unavailable."
3064,2,8,77,87,1.1379310344827587,0.04378635707980383,540,This heart rate doesn't sound safe.
3064,2,12,102,116,1.1379310344827587,0.03652144371044692,540,Don't worry. Your medical records are strictly confidential.
3064,1,10,76,87,1.1379310344827587,0.040619414815555276,540,"Well, I think it's safe to say it's a combination of you being locked up about being cracked."
3070,3,9,97,109,1.1376146788990826,0.04010665764099083,540,"I'm afraid, Mr. Marvo, you're suffering from locked-in syndrome."
3070,2,11,96,109,1.1376146788990826,0.037929530999264126,540,"So the yoga instructor says imagine you're a safe; strong, sturdy, secure...."
3070,1,13,95,109,1.1376146788990826,0.035619582486556875,540,"frankly, I can hear nothing but greed and secrecy"
3070,1,13,95,109,1.1376146788990826,0.035619582486556875,540,Nothing alarming: Just the faint rustling sounds of crumpled $20 bills.
3070,2,11,96,109,1.1376146788990826,0.037929530999264126,540,The bad news is that based on this examination I don't think you can afford me.
3075,2,7,71,80,1.1375,0.04619629964906088,540,Mr. Jones if you won't talk to me how will we find the cause of your agoraphobia
3076,3,8,91,102,1.1372549019607843,0.04189089119311397,540,I'm Terry Gross and this is Fresh Air.
3076,0,14,88,102,1.1372549019607843,0.03424084669891522,540,Turn your dial and coffer for me.
3078,1,11,83,95,1.1368421052631579,0.038477539050399544,540,A heart of gold is just like any other heart to me.
3078,2,9,84,95,1.1368421052631579,0.041285411189771436,540,"And exhale, Mr. Trump."
3078,1,11,83,95,1.1368421052631579,0.038477539050399544,540,"No, I think my problem is more emotional. I sort of find it hard opening up to people....you know what I mean?"
3078,2,9,84,95,1.1368421052631579,0.041285411189771436,540,I see that you're overdue for a colonoscopy.
3078,2,9,84,95,1.1368421052631579,0.041285411189771436,540,Just because nobody can steal your heart doesn't mean I can't hear it.
3078,1,11,83,95,1.1368421052631579,0.038477539050399544,540,"Knowing the combination is one thing, unlocking it is a mother."
3078,2,9,84,95,1.1368421052631579,0.041285411189771436,540,"Deep breath. Good. Now, let it all out..."
3078,3,7,85,95,1.1368421052631579,0.043914113253508684,540,If you're not hiding something why won't you give me your combination?
3078,0,13,82,95,1.1368421052631579,0.03544794557716341,540,Yup. I detect safety issues.
3078,1,11,83,95,1.1368421052631579,0.038477539050399544,540,"""Its safe to say that you are more like a pressure cooker inside''."
3078,4,5,86,95,1.1368421052631579,0.04639411071004023,540,You need to buck up.
3089,1,14,102,117,1.1367521367521367,0.034132728623343565,540,Take a deep breath and hold it - and I mean really lock it up.
3089,4,8,105,117,1.1367521367521367,0.04008902358823445,540,"I don't care how much money you have, I'm not going out on a date with you."
3091,1,10,77,88,1.1363636363636365,0.04018575657895383,540,"I am afraid you have a cold, cold vault."
3091,5,5,100,110,1.1363636363636365,0.04375470469596744,540,"I realize Hillary won Mr. Trump, but do you really think hiding in there is the best recourse?"
3091,0,15,95,110,1.1363636363636365,0.03287013577804598,540,"You have a combination of a number of issues. You should open up to a few people, it may help."
3091,3,6,79,88,1.1363636363636365,0.046231602519600706,540,"Mr. Sanchez, if you want to go forward with this examination, you're going to have to tell me where your butthole is."
3095,2,13,110,125,1.136,0.034722865943853744,540,I told you to wear a condom.
3096,1,12,90,103,1.1359223300970873,0.03663076575859411,540,"We don't normally accept FDIC, but let me take a look..."
3096,3,8,92,103,1.1359223300970873,0.041503588016701815,540,Geraldo asked for a second opinion.
3096,2,10,91,103,1.1359223300970873,0.03914307613308582,540,I'll release my tax returns when my gastroenterologist stops writing bogus medical exam letters.
3096,2,10,91,103,1.1359223300970873,0.03914307613308582,540,There's been a lot of confusion since Tumblr came on the scene.
3096,1,12,90,103,1.1359223300970873,0.03663076575859411,540,Just monitoring your currency in circulation.
3101,4,8,106,118,1.1355932203389831,0.03976472571472534,540,I think I've found a solution to all your key problems.
3101,3,10,105,118,1.1355932203389831,0.037899457245759154,540,Your copayment should be covered if I can open it.
3101,3,10,105,118,1.1355932203389831,0.037899457245759154,540,"Unlike most of my patients, Mr. Honeywell, you need to open up both figuratively and literally."
3104,3,7,86,96,1.1354166666666667,0.043477640116023765,540,Let me just check your vitals and then I'll crack you open.
3104,2,9,85,96,1.1354166666666667,0.04087795181322621,540,Don't worry. I'm not a professional locksmith but I play one on TV.
3104,1,11,84,96,1.1354166666666667,0.03810129523822529,540,You have a combination of 30R-2L-27R.
3104,1,11,84,96,1.1354166666666667,0.03810129523822529,540,"Well, you're certainly a tough nut to crack!"
3104,0,13,83,96,1.1354166666666667,0.035105703998301666,540,"Rest assured, your heart is safe."
3104,0,13,83,96,1.1354166666666667,0.035105703998301666,540,"No, I said three clicks left"
3110,0,15,96,111,1.135135135135135,0.032595821035433896,540,I've found the problem. You've stopped trending on Tumblr.
3110,2,11,98,111,1.135135135135135,0.03728388226263948,540,It's not nearly as reckless as jumping.
3110,2,11,98,111,1.135135135135135,0.03728388226263948,540,Your insecurity complex is more complex than I thought.
3113,1,10,78,89,1.1348314606741574,0.039761197393568794,540,"Safe to say, we may need to dial in a specialist."
3113,1,10,78,89,1.1348314606741574,0.039761197393568794,540,"Yes, I do think you can meet someone and still feel safe"
3113,1,10,78,89,1.1348314606741574,0.039761197393568794,540,You came to the wrong doctor to get cracked.
3113,2,8,79,89,1.1348314606741574,0.0428522512020491,540,It's getting harder and harder to get reimbursements from insurance companies.
3117,1,12,91,104,1.1346153846153846,0.03630037204214463,540,"It sounds like you carry a lot of weight, and have a heart of gold, however I think its safe to say yours will be a tough case to crack."
3117,1,12,91,104,1.1346153846153846,0.03630037204214463,540,Turn and cough.
3117,1,12,91,104,1.1346153846153846,0.03630037204214463,540,"Now, tell me again. Why don't you feel 'safe'?"
3117,3,8,93,104,1.1346153846153846,0.04112335109363455,540,You need to be seen by a specialist
3117,1,12,91,104,1.1346153846153846,0.03630037204214463,540,"Don't worry, your medical records are safe with me."
3117,1,12,91,104,1.1346153846153846,0.03630037204214463,540,Do you have a family history of Lock Jaw?
3117,1,12,91,104,1.1346153846153846,0.03630037204214463,540,I don't hear anything but you could be pregnant is someone made a deposit.
3117,1,12,91,104,1.1346153846153846,0.03630037204214463,540,You really have to learn not to hide your emotions.
3117,4,6,94,104,1.1346153846153846,0.043334010921635704,540,You should be safe.
3117,2,10,92,104,1.1346153846153846,0.03878689866158706,540,"It's called, ""Atrial septal cash defect."""
3117,1,12,91,104,1.1346153846153846,0.03630037204214463,540,"No, nothing there. Maybe if you paid your taxes."
3128,3,10,106,119,1.134453781512605,0.037596895181131046,540,"Did you say, ""Mlurn mnial mleft?"""
3129,1,9,72,82,1.1341463414634145,0.04165427140633984,540,You keep me searching for a heart of gold.
3129,0,11,71,82,1.1341463414634145,0.03786771981702473,540,You can talk to me. You are in a safe place.
3131,2,9,86,97,1.134020618556701,0.04047841577109879,540,"I understand we're living in a post-9/11 world, but it makes my job harder."
3131,3,7,87,97,1.134020618556701,0.043049724454871305,540,"Hey, Siri!"
3131,1,11,85,97,1.134020618556701,0.03773228738143943,540,"Hmm, your balance sounds healthy but lets work on that tough exterior!"
3131,2,9,86,97,1.134020618556701,0.04047841577109879,540,"OK, let's see if you can cough it up"
3131,4,5,88,97,1.134020618556701,0.04547587720916167,540,"I know you have trust issues with your money, but our therapy session is over so you need to come out Wilfred."
3131,3,7,87,97,1.134020618556701,0.043049724454871305,540,...and hold it...
3131,1,11,85,97,1.134020618556701,0.03773228738143943,540,Take a deep breath and OPEN SESAME.
3131,1,11,85,97,1.134020618556701,0.03773228738143943,540,I'm listening for your inner vault.
3131,0,13,84,97,1.134020618556701,0.03476994217327846,540,I hear ticking 3 to the left........11 to the right......then 5 back to the left.
3131,2,9,86,97,1.134020618556701,0.04047841577109879,540,When is the last time you were screened for lead toxicity?
3131,3,7,87,97,1.134020618556701,0.043049724454871305,540,"Mr Trump, are you there?"
3131,2,9,86,97,1.134020618556701,0.04047841577109879,540,Special care is taken before a removal procedure.
3131,2,9,86,97,1.134020618556701,0.04047841577109879,540,I hear your pain.
3144,3,9,100,112,1.1339285714285714,0.03908447051747726,540,Well the good news is you won't be needing any vaccines!
3144,0,15,97,112,1.1339285714285714,0.03232600119108558,540,Exactly how much did they transfer to the safe deposit box?
3144,2,11,99,112,1.1339285714285714,0.03696918547596617,540,Having a blast is not the answer!
3147,3,11,113,127,1.1338582677165354,0.035987688191081606,540,"Physician, pay thyself."
3148,2,10,93,105,1.1333333333333333,0.03843711067980366,540,"Good news, Mr. Trump. You're still healthy enough to pay taxes."
3148,1,12,92,105,1.1333333333333333,0.03597584320431272,540,There's just one more test to do but you should be safe
3148,1,10,79,90,1.1333333333333333,0.03934545613983191,540,Supreme court ruled money has health care rights!
3148,2,10,93,105,1.1333333333333333,0.03843711067980366,540,And when did you first realize you were Donald Trump's 1040 form?
3148,1,12,92,105,1.1333333333333333,0.03597584320431272,540,"Yes, I know we did the psychiatrist's couch gag two issues ago."
3148,4,6,95,105,1.1333333333333333,0.04293846578199835,540,Eating a few gold bars will make your feeling of emptiness go away in no time.
3148,0,14,91,105,1.1333333333333333,0.033333333333333326,540,"I understand, no one likes to be seen in a surgical gown."
3148,2,10,93,105,1.1333333333333333,0.03843711067980366,540,"You may, literally speaking, possess a heart of gold."
3156,2,11,100,113,1.1327433628318584,0.03665972787294317,540,"Well, You have combination of things. Good news is your safe with me."
3156,1,13,99,113,1.1327433628318584,0.034437012571115644,540,You better pay well for this.
3158,0,13,85,98,1.1326530612244898,0.03444048004446828,540,I have bad news. You have Lockjaw!
3158,3,7,88,98,1.1326530612244898,0.04263011814278531,540,"As soon as you promise to take your medicine, I'll let you out."
3158,1,11,86,98,1.1326530612244898,0.0373703104271054,540,Stress can come from any number of places. For instance ... this security job that you mentioned.
3158,2,9,87,98,1.1326530612244898,0.04008657552277356,540,"Ok, now turn the dial to the right two times"
3158,2,9,87,98,1.1326530612244898,0.04008657552277356,540,"Well Ed, with a proper combination of diet and exercise, you'll be just fine."
3158,2,9,87,98,1.1326530612244898,0.04008657552277356,540,"While I do appreciate the compliment, I believe you'd feel safe with any number of doctors."
3158,0,13,85,98,1.1326530612244898,0.03444048004446828,540,maybe there's a reason you're in there
3158,2,9,87,98,1.1326530612244898,0.04008657552277356,540,Tell Al Gore we found it.
3158,3,7,88,98,1.1326530612244898,0.04263011814278531,540,I did not expect this kind of work when I trained as a radiologist
3167,2,7,74,83,1.1325301204819278,0.0446064988608806,540,Your vitals aren't showing but I think you're safe to go home.
3168,1,12,93,106,1.1320754716981132,0.03565702575558747,540,"Cold and hard, yes. As for the cash, I'm going to have to refer you to radiology."
3168,4,6,96,106,1.1320754716981132,0.042550053392282725,540,Now tell me when you feel the crack.
3168,2,10,94,106,1.1320754716981132,0.03809354282620335,540,Don't worry! A little oil and everything will be moving again.
3168,3,8,95,106,1.1320754716981132,0.040383319878000985,540,"Lockjaw, perhaps. Let me see what i have that will peak your interest...."
3168,3,8,95,106,1.1320754716981132,0.040383319878000985,540,Oh Dear: It sounds to me like you are NOT too big to fail!
3173,1,10,80,91,1.1318681318681318,0.038938263050310076,540,coffers for me please
3173,2,8,81,91,1.1318681318681318,0.04195698480080983,540,Perhaps we should discuss your fear of being outed.
3175,3,9,102,114,1.131578947368421,0.03843135552948524,540,I think the code is m-e-l-a-n-i-a.
3175,2,11,101,114,1.131578947368421,0.036355380519377256,540,"Mr. Lester, if you can hear me, there is no need to feel ashamed, it's becoming increasingly common in affluent males' mid-life crisis."
3175,1,13,100,114,1.131578947368421,0.03415345220594449,540,"I believe you have an issue regarding your confidence and lack of reinforcement, which I believe is in combination of your feeling safe."
3178,2,9,88,99,1.1313131313131313,0.03970221209869438,540,"Im sorry Mr. Honeywell, all the e-tranfers have really effected your lifespan."
3178,3,7,89,99,1.1313131313131313,0.04221858250599651,540,Your health is not what it's cracked up to be.
3178,0,13,86,99,1.1313131313131313,0.03411714406215551,540,Now please turn your dial and click.
3178,2,9,88,99,1.1313131313131313,0.03970221209869438,540,Your heart is safe with me
3178,4,5,90,99,1.1313131313131313,0.044593180780266785,540,And another deep breath...
3178,2,9,88,99,1.1313131313131313,0.03970221209869438,540,I can't help you if you won't come out.
3178,3,7,89,99,1.1313131313131313,0.04221858250599651,540,Mrs. Clinton? Donald?
3178,2,9,88,99,1.1313131313131313,0.03970221209869438,540,"Mr. Smedley, please repeat the combination, I keep getting hung up on right or left, quit using reference to Republican or Democrat !"
3178,2,9,88,99,1.1313131313131313,0.03970221209869438,540,I think we need to talk about how well defended you seem to be
3178,1,11,87,99,1.1313131313131313,0.0370151669217335,540,"Well, you're very safe and sound!"
3188,2,7,75,84,1.130952380952381,0.04410050166290234,540,Your secrtet is safe with me
3188,1,9,74,84,1.130952380952381,0.04071845422256088,540,Just relax; you are in a safe space.
3188,1,9,74,84,1.130952380952381,0.04071845422256088,540,I know I said it was a safe environment here but we still need to look inside you
3188,1,9,74,84,1.130952380952381,0.04071845422256088,540,"No, it's actually too low. Your systolic is only 32 and diastolic a mere 24. Getting enough iron?"
3192,4,6,97,107,1.1308411214953271,0.04216858322206496,540,"I can not perform open lock surgery, unless I hear a beat"
3192,3,8,96,107,1.1308411214953271,0.04002316413904654,540,Safe and sound? Great combination! Now you can open up.
3192,3,8,96,107,1.1308411214953271,0.04002316413904654,540,What's taking so long? The bank closes at 3.
3192,3,8,96,107,1.1308411214953271,0.04002316413904654,540,Mr. Jones?...I think you're taking the HIPAA Privacy Law a bit too far...
3196,1,10,81,92,1.1304347826086956,0.038539359149039935,540,"I'm sorry, Miss. I don't know what you think you're seeing here--your husband is still alive."
3196,1,13,101,115,1.1304347826086956,0.03387449157284589,540,''I feel like my emotions are all locked up.''
3196,1,13,101,115,1.1304347826086956,0.03387449157284589,540,"If you can hear me, I suspect a case of locked-in syndrome..."
3196,3,9,103,115,1.1304347826086956,0.03811288209926202,540,"You seem to be OK. Mr. Duck seems to have cushioned your fall. It was sort of hard on him, though."
3196,1,10,81,92,1.1304347826086956,0.038539359149039935,540,You finance guys have no heart.
3196,2,8,82,92,1.1304347826086956,0.041523171204257234,540,"Don't worry, this is a safe place. Now, pull down your pants."
3196,1,13,101,115,1.1304347826086956,0.03387449157284589,540,Don't worry. You're safe in my hands.
3203,2,9,89,100,1.13,0.03932511470376974,540,You're full of unpaid taxes and it's raised your pressure.
3203,0,13,87,100,1.13,0.033799766898963114,540,OK...clockwise...
3203,1,11,88,100,1.13,0.036666666666666674,540,You being closed off to the world is due to a combination of things.
3203,1,11,88,100,1.13,0.036666666666666674,540,So since your last safe-cracker no one has clicked with you?
3203,1,11,88,100,1.13,0.036666666666666674,540,Its safe to say that I don't hear any rumblers in your tumblers.
3203,2,9,89,100,1.13,0.03932511470376974,540,Ann often regrets getting a degree from her safe school
3209,2,10,96,108,1.1296296296296295,0.03742441925941165,540,"Don't you feel ""safe""? Open up now."
3209,2,10,96,108,1.1296296296296295,0.03742441925941165,540,"OK let's play it, safe."
3209,2,10,96,108,1.1296296296296295,0.03742441925941165,540,"Now, inflate...and deflate."
3212,0,11,74,85,1.1294117647058823,0.03662297611206199,540,"Yes, I feel safe out here, too!"
3212,2,7,76,85,1.1294117647058823,0.043605807743241236,540,You're in a safe place now Mr. Gore
3212,1,9,75,85,1.1294117647058823,0.0402660455486082,540,"""Yes, a second opinion is sometimes better safe than sorry. But I can assure you, you're safe""."
3215,2,11,103,116,1.1293103448275863,0.03576152148412504,540,My specialty in med school was ventilation therapy.
3215,3,9,104,116,1.1293103448275863,0.03779962243648468,540,My referring physician said you were a real wisecracker back in med school.
3215,0,15,101,116,1.1293103448275863,0.031289556466927076,540,I can hear you Mr. Farnsworth. Unfortunately your insurance policy doesn't cover safe-cracking.
3218,1,10,82,93,1.1290322580645162,0.03814849572328797,540,I haven't heard anything like this since Al Gore's lockbox.
3218,1,10,82,93,1.1290322580645162,0.03814849572328797,540,Locked-out syndrome is only curable with a precise treatment combination.
3218,1,10,82,93,1.1290322580645162,0.03814849572328797,540,YOU feel insecure! How do you think I feel holding a stethoscope to a steel box?
3218,1,10,82,93,1.1290322580645162,0.03814849572328797,540,What did you say Mr. Gore put inside you?
3218,2,8,83,93,1.1290322580645162,0.04109819724326491,540,You should really lose some weight.
3218,2,8,83,93,1.1290322580645162,0.04109819724326491,540,"Is this an agoraphobia flair up, or just poor judgement?"
3224,3,11,118,132,1.128787878787879,0.034691234183268006,540,It's just anxiety. Your baby is perfectly safe.
3225,4,5,92,101,1.1287128712871286,0.04374400402846439,540,"Well if you're going to be so negative about it, you can give me that amethyst back and go find a ""real"" doctor."
3225,0,13,88,101,1.1287128712871286,0.03348818717878763,540,"Listen, sir, there's a point where safety becomes life-threatening."
3225,1,11,89,101,1.1287128712871286,0.03632462639177056,540,Stick out your combination
3225,3,7,91,101,1.1287128712871286,0.0414188131947562,540,You won't need any stitches... I'll be bleeding you dry.
3225,1,11,89,101,1.1287128712871286,0.03632462639177056,540,"If I knew the combination, I would open it."
3225,2,9,90,101,1.1287128712871286,0.03895508034238811,540,You need to cut back on the paper money. I’m giving you a prescription for Bitcoin.
3225,1,11,89,101,1.1287128712871286,0.03632462639177056,540,It's conclusive. This bank has no soul.
3225,2,9,90,101,1.1287128712871286,0.03895508034238811,540,"Be strong, and tell me what the two million phony accounts did to you"
3233,3,8,98,109,1.128440366972477,0.03932171564115373,540,That diet is really working for you. You've built a bulletproof safe body.
3233,1,12,96,109,1.128440366972477,0.03473338437798332,540,"""Yes, I know disagreement is awful, but you're taking this whole safe spot notion too literally""."
3233,0,14,95,109,1.128440366972477,0.03219492700785678,540,"Your childhood really isn't all that relevant now, is it?"
3233,2,10,97,109,1.128440366972477,0.03709855328252363,540,Deep breaths will calm you and help you feel safe.
3233,4,6,99,109,1.128440366972477,0.04142574062429377,540,"So Senor Trump, that Wall you made us build, how's it working for you?"
3238,2,11,104,117,1.1282051282051282,0.03547177210595492,540,Only if you behave!
3238,2,11,104,117,1.1282051282051282,0.03547177210595492,540,"I feel safe cracking jokes about your diagnosis, Mr. Brinks...."
3240,1,9,76,86,1.127906976744186,0.03982352186952072,540,"You’re a safe and should feel safe, but what with all the talk that no one is safe these days, your paranoia is perfectly understandable."
3240,3,5,78,86,1.127906976744186,0.046185587757732564,540,Do you know how much cholesterol is in that jewelry?
3242,2,8,84,94,1.127659574468085,0.0406817968069462,540,You just can't be too safe when it comes to your health.....
3242,1,10,83,94,1.127659574468085,0.037765433825609464,540,"I assure you that you are a noun, not an adjective."
3242,1,10,83,94,1.127659574468085,0.037765433825609464,540,"'I've spent most of my life in hotel room floors being used by complete strangers.' 'Yes, you have very low wealth esteem'"
3242,1,10,83,94,1.127659574468085,0.037765433825609464,540,Breathe.
3246,1,11,90,102,1.1274509803921569,0.03598886944632537,540,It is safe to tell me the combination.
3246,0,13,89,102,1.1274509803921569,0.03318224921942079,540,"You know, there are better ways to prevent your biometrics from being stolen."
3246,2,9,91,102,1.1274509803921569,0.03859191346369796,540,"Doctor, I know you believe exposure therapy will cure my claustrophobia, but really, I can't breathe in here!"
3246,2,9,91,102,1.1274509803921569,0.03859191346369796,540,Turn 23 clicks to the right and then open wide.
3246,3,7,92,102,1.1274509803921569,0.041030145570719725,540,"""I keep on searching for a heart of gold""."
3246,3,7,92,102,1.1274509803921569,0.041030145570719725,540,If you really want children my advice is to practice safe sex.
3252,3,8,99,110,1.1272727272727272,0.038980097804767105,540,"Take a deep breath, Mr. Trump."
3252,2,10,98,110,1.1272727272727272,0.03677828644018617,540,I hear your pain: 18 - 37 -26...
3254,2,11,105,118,1.1271186440677967,0.03518665727632079,540,Not too serious...there's a new drug I can prescribe that will clear you right out.
3254,1,13,104,118,1.1271186440677967,0.03306412404158087,540,"So you feel all locked up inside, tight chest, afraid to go outside?"
3256,2,6,71,79,1.1265822784810127,0.04545949403645994,540,Introducing the world's most secure iPod
3257,1,10,84,95,1.1263157894736842,0.0373899438042335,540,Mr. Taylor I know I said you need better boundaries but this taking it too far.
3257,2,8,85,95,1.1263157894736842,0.040273714298748535,540,Looks like I'm going to have to crack you open and see what's inside.
3257,3,6,86,95,1.1263157894736842,0.04296435998767705,540,It sounds like you're dead inside.
3257,1,10,84,95,1.1263157894736842,0.0373899438042335,540,"YOU, must want to open."
3257,0,12,83,95,1.1263157894736842,0.03426432155975449,540,I don’t feel very safe in here...
3257,1,10,84,95,1.1263157894736842,0.0373899438042335,540,Just being big and rich doesn't mean you can run for president? You have to have a brain.
3257,1,10,84,95,1.1263157894736842,0.0373899438042335,540,My fees are high. I'll need an X-Ray.
3264,2,9,92,103,1.1262135922330097,0.03823542562589994,540,I'm going to need you to open your door for me.
3264,2,9,92,103,1.1262135922330097,0.03823542562589994,540,It's sick..no..six...
3264,3,7,93,103,1.1262135922330097,0.04064867995265391,540,This is Dr Frasier Crane. I'm listening.
3264,1,11,91,103,1.1262135922330097,0.03565922550608978,540,"No, really, I don't do this for the money, I love my job!"
3264,1,11,91,103,1.1262135922330097,0.03565922550608978,540,"Well, I do charge by the hour, but the absence of air holes in this safe might affect your rate."
3264,3,7,93,103,1.1262135922330097,0.04064867995265391,540,"The surgery will cost $500,000. Luckily I hear you have enough for that, plus a rhinoplasty."
3270,3,8,100,111,1.1261261261261262,0.03864434340455355,540,"I'm going to start you on something to help you with your paranoia, Donald."
3270,4,6,101,111,1.1261261261261262,0.04070854260433828,540,"It's called Electoral Imbalance. First you lean left, then right, then left again."
3270,2,10,99,111,1.1261261261261262,0.03646347643010602,540,"There's nothing beating, Mr. Fargo."
3273,1,12,99,112,1.125,0.03385610020713433,540,We'll run some more tests but my initial prognosis says it's Heart of Gold.
3273,2,9,93,104,1.125,0.03788543517838634,540,You sound so bloated. May I suggest a Wells Fargo enema?
3273,2,9,93,104,1.125,0.03788543517838634,540,"""No, Mr. Trump - you can't take it with you""!"
3273,1,10,85,96,1.125,0.037021804859943275,540,I'm hearing unsafe numbers on your tumbler.
3273,4,5,95,104,1.125,0.042529039413416465,540,They're screaming to get out Mr. Trump.
3273,3,8,101,112,1.125,0.038314303373359705,540,Speak louder. I only hear a murmur.
3273,1,10,85,96,1.125,0.037021804859943275,540,"Yes, Mr. Houdini, your heart still sounds safe."
3273,3,8,101,112,1.125,0.038314303373359705,540,As your doctor I recommend a try a less restrictive way to lose weight.
3273,2,7,79,88,1.125,0.042185897498493455,540,There's evidence of a turn in the right direction -- but your condition remains guarded.
3273,2,11,107,120,1.125,0.03462989592644989,540,"My next remark, the right combination of unexpected and hilarious,  can open, safe to say, the winning caption contest!"
3273,3,7,94,104,1.125,0.040274218751477006,540,"Face it, Sam, no one is safe while Congress is in session."
3273,2,10,100,112,1.125,0.03615398570158873,540,Ooooo! You are tickling my tumblers!
3273,0,12,84,96,1.125,0.033931044626914805,540,Let me have a look.
3273,1,10,85,96,1.125,0.037021804859943275,540,"Don't worry, you're in a safe pair of hands."
3273,1,11,92,104,1.125,0.03533553029557649,540,"In regard to the proper balance of nourishment, you have to be open to the right combination."
3273,1,8,71,80,1.125,0.041242567416306754,540,Your stress level is not safe--you need to let everything out immediately.
3273,1,12,99,112,1.125,0.03385610020713433,540,"Thank God, the donor heart is still sticking!"
3273,2,8,86,96,1.125,0.03987370412567353,540,Is it safe? Is it safe? Is it safe ...?
3291,3,8,102,113,1.1238938053097345,0.03798983363164784,540,Your heart rate is not what we consider safe.
3291,3,8,102,113,1.1238938053097345,0.03798983363164784,540,"Don't worry; according to your heartbeat, you're safe."
3293,2,9,94,105,1.1238095238095238,0.03754176696064163,540,"Yes, your time in the Trump Mansion has caused a combination of problems"
3293,1,11,93,105,1.1238095238095238,0.035017625324641026,540,Living in a bank doesn't mean you have no heart!
3293,0,13,92,105,1.1238095238095238,0.03229680944345366,540,"'It's safe to say you have a strong constitution""."
3293,2,9,94,105,1.1238095238095238,0.03754176696064163,540,It’s safe to say that you have sophisticated security concerns.
3293,1,11,93,105,1.1238095238095238,0.035017625324641026,540,Have you considered moving to Canada?
3293,1,11,93,105,1.1238095238095238,0.035017625324641026,540,"I know you are his surrogate, but would you like to talk about how you really feel about Trump?"
3299,0,12,85,97,1.1237113402061856,0.03360413610929201,540,I respect your decision to dress immodestly but I need the combination to examine you.
3299,1,10,86,97,1.1237113402061856,0.03666080462775236,540,"If you would just allow someone to get closer, I think you could really open up."
3299,2,8,87,97,1.1237113402061856,0.03948153021675622,540,Have you informed Wall Street?
3299,3,6,88,97,1.1237113402061856,0.04211374906795926,540,"Come now; I can only relieve your burden, if you open up."
3299,1,10,86,97,1.1237113402061856,0.03666080462775236,540,Focus on the copayment.
3299,2,8,87,97,1.1237113402061856,0.03948153021675622,540,We are professionals here. I promise not to laugh. Ready?
3299,2,8,87,97,1.1237113402061856,0.03948153021675622,540,I hear your pain. You're safe with me!
3299,0,12,85,97,1.1237113402061856,0.03360413610929201,540,"No worries, you're still Safe!!"
3307,1,9,79,89,1.1235955056179776,0.03855214395662027,540,"yes, it's beating, but moderation is good. Safe sex is not all it's cracked up to be."
3307,1,9,79,89,1.1235955056179776,0.03855214395662027,540,What concerns do you have? And feel free to really open up to me.
3309,1,8,72,81,1.123456790123457,0.040759442022763395,540,Take a deep breath
3310,0,9,64,73,1.1232876712328768,0.038745577051317676,540,"Healthy? Yes, I think you're safe."
3311,4,6,104,114,1.1228070175438596,0.03967800627733884,540,"You can stop whimpering Mr. Potter, the presidential debates are over."
3311,2,10,102,114,1.1228070175438596,0.03555043448250077,540,Doc: You look really familiar. Safe: Did you see The Italian Job? Doc: You're the safe they steal in The Italian Job?? Safe: I'm the safe they steal in The Italian Job.
3311,4,6,104,114,1.1228070175438596,0.03967800627733884,540,"OK, now breathe out, Dr. Feynman."
3311,1,12,101,114,1.1228070175438596,0.03329531493723402,540,Was the Tin Man a first degree relative?
3315,3,7,96,106,1.1226415094339623,0.039545554585232366,540,"""How long have you been feeling empty ? ""9"
3315,1,11,94,106,1.1226415094339623,0.03470535763854438,540,"No doctor, I won't open up wide. I won't do it."
3315,0,13,93,106,1.1226415094339623,0.032011987278238604,540,I can't get you out 'till you quit fibrillating.
3315,4,5,97,106,1.1226415094339623,0.04175578291411566,540,I'm afraid you have locked-in syndrome
3315,1,11,94,106,1.1226415094339623,0.03470535763854438,540,"Sorry, you're terminal but you can't take it with you."
3320,3,6,89,98,1.1224489795918366,0.0417009130885561,540,"Bob, you must come out. I'm sorry I said I wanted to steal your heart."""
3320,2,8,88,98,1.1224489795918366,0.039096965568884035,540,I’m afraid you’re suffering from locked-in syndrome
3320,4,4,90,98,1.1224489795918366,0.0441515524998172,540,"It's save to come out, Mr. Trump; You can finally seek the help you desperately need."
3320,0,12,86,98,1.1224489795918366,0.03328341697069117,540,"Yes, I know about the boy in the bubble ...but this is ridiculous."
3320,2,8,88,98,1.1224489795918366,0.039096965568884035,540,You're fine to travel. Just put your contents in baggage.
3320,0,12,86,98,1.1224489795918366,0.03328341697069117,540,"Open wide and say, 'Huge deductible!'"
3320,1,10,87,98,1.1224489795918366,0.03630673878179777,540,Relax. I'm sure Geraldo will understand.
3327,1,9,80,90,1.1222222222222222,0.03814610776373575,540,Claustrophobia is just a state of mind.
3328,3,9,111,123,1.1219512195121952,0.0357426603008457,540,If you'd just open up we'd all be happy.
3328,1,8,73,82,1.1219512195121952,0.040287449179724946,540,Your diagnosis is safe with me.
3330,2,10,103,115,1.1217391304347826,0.03525612093819921,540,Blame mobile pay for that empty feeling.
3331,2,9,96,107,1.1214953271028036,0.036872727325562495,540,"Truly, it might be nothing more serious than a tiny chip in your piggy bank."
3331,1,11,95,107,1.1214953271028036,0.034398579580705434,540,"You're safe and sound, but I agree with your therapist: you could safely be more open."
3331,1,11,95,107,1.1214953271028036,0.034398579580705434,540,And how many hours would you say you spend on eBay each day?
3334,0,12,87,99,1.121212121212121,0.03296871474399961,540,"Dr. Evelyn "" Sticky Fingers"" Wallace makes her examination."
3334,3,6,90,99,1.121212121212121,0.041296069325408906,540,One more time... is it safe?
3334,3,6,90,99,1.121212121212121,0.041296069325408906,540,The safe thinks it's Schrodinger's box.
3334,0,12,87,99,1.121212121212121,0.03296871474399961,540,And how long have you been feeling this tightness in your chest?
3338,0,11,80,91,1.120879120879121,0.03436202021848665,540,No worries. You are safe.
3338,1,9,81,91,1.120879120879121,0.03774849238970915,540,You and me make a great combination Doc!
3338,0,11,80,91,1.120879120879121,0.03436202021848665,540,This procedure is completely safe.
3338,0,11,80,91,1.120879120879121,0.03436202021848665,540,Sound like you paid too many doctors already.
3338,1,9,81,91,1.120879120879121,0.03774849238970915,540,"I wish I could help, but I'm a pediatrician."
3338,1,9,81,91,1.120879120879121,0.03774849238970915,540,Diagnosis: Unsafe
3344,4,6,106,116,1.1206896551724137,0.039019413178142275,540,Dr. Polly needs a cracker to be sure of her diagnosis.
3344,0,14,102,116,1.1206896551724137,0.0303778612618062,540,"Sorry, I'll have to refer you to Safe Specialist, I only work on Under the Mattress problems."
3346,1,8,74,83,1.1204819277108433,0.0398262106284982,540,Your breathing does sound heavy
3347,3,7,98,108,1.1203703703703705,0.03884270939937576,540,"Yes, Mr. Trump, you are well enough to run for President."
3348,0,12,88,100,1.12,0.032659863237109045,540,You're lucky you are insured.
3348,2,8,90,100,1.12,0.03834979883528818,540,"Doctor, with all due respect, YOU suggested I work on my trust issues."
3348,2,8,90,100,1.12,0.03834979883528818,540,"Your problems are ""safe"" with me."
3348,1,10,89,100,1.12,0.03561863092100634,540,"Why couldn't I keep you..oh, what's the word?"
3348,1,10,89,100,1.12,0.03561863092100634,540,"I'm afraid you may have Lyme disease, tell me, have you been around any ticks lately?"
3348,2,8,90,100,1.12,0.03834979883528818,540,I did not recommend THIS safe sex technique.
3348,1,10,89,100,1.12,0.03561863092100634,540,"Take a deep breath now, then cough. Yes, you are safe."
3348,2,8,90,100,1.12,0.03834979883528818,540,Your clicker sounds great Mr. Safe.
3348,2,8,90,100,1.12,0.03834979883528818,540,Politically you seem to be to the right......and to the left....and...
3348,3,6,91,100,1.12,0.04089898865164361,540,Did I put the cat in there?
3348,1,10,89,100,1.12,0.03561863092100634,540,Broken? No. Cracked? Working on it.
3359,1,12,104,117,1.1196581196581197,0.03248793823284051,540,Is it left first or right first?
3359,2,10,105,117,1.1196581196581197,0.03468181579658992,540,It's safe to say that we can help you open yourself to being more receptive
3359,4,6,107,117,1.1196581196581197,0.03869822708605733,540,"C'mon, c'mon one number away and its goodbye Dr. Evans, hello Dr. Feelgood"
3359,0,14,103,117,1.1196581196581197,0.030134762555778113,540,I'm sorry. Your call cannot go through. Please dial a different combination.
3363,2,7,83,92,1.1195652173913044,0.04043005587608424,540,"Some might say I'm vaulting to conclusions, but I think it's safe to say a combination of factors have locked-in my diagnosis."
3363,1,9,82,92,1.1195652173913044,0.037359040069358376,540,I just don't feel safe.
3363,1,9,82,92,1.1195652173913044,0.037359040069358376,540,You are not getting enough jewelry or cash.
3363,1,9,82,92,1.1195652173913044,0.037359040069358376,540,"There, there....no need to lock things inside....you're safe here......"
3363,0,11,81,92,1.1195652173913044,0.03401185575155456,540,Turn your head and cough up.
3363,2,7,83,92,1.1195652173913044,0.04043005587608424,540,Your paperwork says that your college just denounced safe spaces?
3369,2,9,98,109,1.1192660550458715,0.03622702475824028,540,"You think I'm stealing from you, but it's only transference."
3369,0,13,96,109,1.1192660550458715,0.031186663691698983,540,"Listen, my name isn't Jimmy, and I DO care very much."
3369,3,7,99,109,1.1192660550458715,0.03850054529667942,540,What's crackalackin?
3369,2,9,98,109,1.1192660550458715,0.03622702475824028,540,So you won't be needing a co-pay?
3369,2,9,98,109,1.1192660550458715,0.03622702475824028,540,perhaps you'll feel safe now that you're here and can open up a bit
3369,3,7,99,109,1.1192660550458715,0.03850054529667942,540,Feeling overweight? Give me six months.
3375,0,10,74,84,1.119047619047619,0.03554655583721293,540,"Not to worry, just a flicker of your clicker."
3375,1,8,75,84,1.119047619047619,0.03937536494475907,540,18 left 21 right?
3375,0,15,111,126,1.119047619047619,0.02896553585856296,540,I'm worried the rising cost of Obamacare may be causing you to crack.
3378,0,12,89,101,1.118811881188119,0.03235670225419444,540,You know you have to twist my knobs to hear my heart right?
3378,1,10,90,101,1.118811881188119,0.03528421719050586,540,"Slow deep breaths, are you feeling Safe now?"
3378,1,10,90,101,1.118811881188119,0.03528421719050586,540,Are you and your partner being safes?
3378,3,6,92,101,1.118811881188119,0.0405094505851065,540,Mr. Copperfield? Caesar's called and I'm afraid they're not going to pay you for tonight...
3382,3,3,70,76,1.118421052631579,0.04944287954751563,540,At least you don't think that you're more than a box of cash to us.
3383,0,11,82,93,1.118279569892473,0.03366870454347981,540,I'm afraid you've only got a week to pay.
3383,3,5,85,93,1.118279569892473,0.04283507835554757,540,Take two rate hikes and see me on tax day.
3383,0,11,82,93,1.118279569892473,0.03366870454347981,540,We'll have you up and on your feet in no time.
3383,1,9,83,93,1.118279569892473,0.036977503381552486,540,The combination of your problems is overwhelming.
3383,1,9,83,93,1.118279569892473,0.036977503381552486,540,I am afraid we have to blow it open.
3388,3,7,100,110,1.1181818181818182,0.038164339301215204,540,Is that a Spongebob reference?
3388,4,5,101,110,1.1181818181818182,0.0402904761164609,540,Everything's going to be ok. You're a safe now.
3390,2,10,107,119,1.1176470588235294,0.03412584806816734,540,"Yes, you do have pneumonia. And with your combination, no use trying to hide it."
3390,2,6,77,85,1.1176470588235294,0.04237938794574695,540,"So, despite being a safe at heart, you're always feeling sorry...?"
3390,3,4,78,85,1.1176470588235294,0.04556450995538138,540,Inhale.
3390,1,8,76,85,1.1176470588235294,0.03893456661937044,540,"You know, you really shouldn't lie to your doctor."
3390,0,12,90,102,1.1176470588235294,0.03205907733144528,540,"Once you're more open with me, we can start making some progress, and collect your copay."
3390,1,10,91,102,1.1176470588235294,0.03495599376513975,540,"I'm not sensing any sign of break-in, but are you feeling symptoms of inflation?"
3390,2,8,92,102,1.1176470588235294,0.03763055355523473,540,What? You've been robbed?
3390,1,10,91,102,1.1176470588235294,0.03495599376513975,540,"Don't worry -- we""ll be relieving your congestion."
3390,3,4,78,85,1.1176470588235294,0.04556450995538138,540,"I think we are making progress Mr Houdini. Now lets get to this thing about locking yourself in tight places. ""We are making good progress Mr. Houdini. Now let's get to this thing about locking yourself in tight places."""
3390,0,12,90,102,1.1176470588235294,0.03205907733144528,540,"Thirteen, right twenty-seven, left zero.....thank you for opening up to me!"
3400,2,9,100,111,1.117117117117117,0.035603464340034065,540,"OK, George, no more needles, I promise."
3400,0,13,98,111,1.117117117117117,0.03065952291559263,540,Keep repeating; This is a safe place.
3400,2,9,100,111,1.117117117117117,0.035603464340034065,540,I hear you. I always wanted to be an actress myself.
3400,2,9,100,111,1.117117117117117,0.035603464340034065,540,I hear dead people's unpaid taxes.
3400,3,7,101,111,1.117117117117117,0.03783393763292741,540,"Oh, it's treatable. But first you're gonna have to drop a thousand dollars."
3405,2,7,85,94,1.1170212765957446,0.03960564868328441,540,Keep very still and I can soon tell you how things are falling into place.
3405,0,11,83,94,1.1170212765957446,0.033332359784650815,540,Miss Smith? Let's see how the election turns out before taking such drastic measures.
3405,1,9,84,94,1.1170212765957446,0.03660364473954168,540,"Safe from his (imagined) enemies, Dr. Colon's patient agrees to be interviewed."
3405,1,9,84,94,1.1170212765957446,0.03660364473954168,540,"I'm listening, but your hands-off approach makes it difficult to open up."
3405,1,9,84,94,1.1170212765957446,0.03660364473954168,540,You've been cracked to hard.
3405,1,9,84,94,1.1170212765957446,0.03660364473954168,540,"According to our vaccination records, you're safe from lockjaw"
3405,2,7,85,94,1.1170212765957446,0.03960564868328441,540,If you open up for me I'll make you safe.
3405,0,11,83,94,1.1170212765957446,0.033332359784650815,540,I can hear the slightest heart beat of a health care program
3405,2,7,85,94,1.1170212765957446,0.03960564868328441,540,"Is someone in there with you? I hear a ""ter-ump ter-ump ter-rump.!"""
3405,0,11,83,94,1.1170212765957446,0.033332359784650815,540,"Just because I'm from Florida they call me a ""cracker."""
3415,1,10,92,103,1.116504854368932,0.034633791303501894,540,Did you cough out money lately?
3415,2,8,93,103,1.116504854368932,0.03728091883462753,540,"""I don't hear anything in there. It must have had a creditcardio infarction""."
3415,2,8,93,103,1.116504854368932,0.03728091883462753,540,"No, you can't pay your deductible in gold bars."
3415,1,10,92,103,1.116504854368932,0.034633791303501894,540,I've got to start rejecting patients without insurance.
3415,3,6,94,103,1.116504854368932,0.03975216117714417,540,"Now, cough really hard."
3420,3,9,117,129,1.1162790697674418,0.03414924454788003,540,"Tell me what you mean when you say ""eft hifty-hive."""
3420,2,11,116,129,1.1162790697674418,0.032327184724054804,540,"Mr. Trump, not even a beat, which proves you are a heartless mercenary."
3422,3,7,102,112,1.1160714285714286,0.03750919173982796,540,I'm glad to report that I don't hear any unusual sounds. You're SAFE!
3422,3,7,102,112,1.1160714285714286,0.03750919173982796,540,"I hear you in there, Mr. Capone."
3422,1,11,100,112,1.1160714285714286,0.03294220914305621,540,I'm going to refer you to a good chiropractor.
3422,2,9,101,112,1.1160714285714286,0.03529963603353464,540,"Kim Kardashian told the world that I was too old, and was no longer of value"
3426,1,9,85,95,1.1157894736842104,0.03623723591084756,540,I can tell from the random clicks you aren't being as active as you should.
3426,1,9,85,95,1.1157894736842104,0.03623723591084756,540,Again? Your bathroom breaks are kind of taking away from the mystique.
3426,1,9,85,95,1.1157894736842104,0.03623723591084756,540,"""I hope Mugsy brings some nitro if this doesn't work""."
3426,1,9,85,95,1.1157894736842104,0.03623723591084756,540,"With a combination of rest and medication, you'll be well in no time."
3426,0,11,84,95,1.1157894736842104,0.03300262263404133,540,truth be told...this profession is not all it is cracked up to be
3426,1,9,85,95,1.1157894736842104,0.03623723591084756,540,"No, I'm pretty sure there's no money and only tax returns in there."
3426,1,9,85,95,1.1157894736842104,0.03623723591084756,540,You're going to need open-safe surgery.
3426,1,9,85,95,1.1157894736842104,0.03623723591084756,540,"Yes, Mr. Sorenson, I saw ""The Italian Job"". But I can help you more if you'd open up by yourself."
3426,2,7,86,95,1.1157894736842104,0.03920588517291635,540,"Are you still there, Dr. Rogers?"
3435,2,10,109,121,1.115702479338843,0.033587357102209,540,"Your form says you only have 2-3 drinks a week and never smoke, correct?"
3436,2,5,71,78,1.1153846153846154,0.04462732509846742,540,My heart is a little more to the left.
3436,1,10,93,104,1.1153846153846154,0.034317446544848494,540,"We're in the countdown, honey, only 2 more debates and a few more weeks, and mommy will let you out to enjoy the peace and quiet."
3436,1,10,93,104,1.1153846153846154,0.034317446544848494,540,Nothing funny here.
3436,2,8,94,104,1.1153846153846154,0.036937699369947806,540,Sounds like Trump's ISIS plan.
3436,2,8,94,104,1.1153846153846154,0.036937699369947806,540,"I'm told that I keep everything locked up, that I don't have a heart."
3436,2,8,94,104,1.1153846153846154,0.036937699369947806,540,"You sound very congested. But I can guarantee that after just one night's stay in the hospital, you'll be clean as a whistle."
3442,2,9,102,113,1.1150442477876106,0.03500093097321651,540,"Vitals sound good, Mr. Bentley, but until you agree to the lab work I'm unable to make a diagnosis."
3443,2,6,79,87,1.1149425287356323,0.041443118108781485,540,"Okay, cough..."
3443,2,6,79,87,1.1149425287356323,0.041443118108781485,540,Please take your feet off the couch as soon as possible.
3443,2,6,79,87,1.1149425287356323,0.041443118108781485,540,Cash out....Cash out....Cash out....Cash out
3443,2,6,79,87,1.1149425287356323,0.041443118108781485,540,We can't have any secrets here.
3443,0,10,77,87,1.1149425287356323,0.03439354046699091,540,I detect a S3 S4 murmur.
3448,3,8,111,122,1.1147540983606556,0.03529871619173477,540,"Hmm; Well, I think it's safe to say...it's too late."
3449,3,5,88,96,1.1145833333333333,0.04154312826266159,540,"It's OK to come out, Don - you can leave the tax returns inside."
3449,2,7,87,96,1.1145833333333333,0.03881408584823192,540,"Breathe easy, I'm not going to make the obvious safe space joke."
3449,1,9,86,96,1.1145833333333333,0.03587805756475512,540,Your tumbler is very slow. The rust on your dial needs attention. Your paint is faded. How long were in the river bottom?
3449,1,9,86,96,1.1145833333333333,0.03587805756475512,540,"If you don't say Ahh, we'll have to go in !"
3453,1,10,94,105,1.1142857142857143,0.03400680204068025,540,"doctor, i can't just open up and reveal what it's inside. it just doesn't feel safe."
3453,1,10,94,105,1.1142857142857143,0.03400680204068025,540,"Yes, you're as sound as a dollar. Let's get you into hospice care ASAP."
3453,2,8,95,105,1.1142857142857143,0.03660072086973421,540,"Your heart rate has settled now, and I can see that you are feeling safe."
3453,1,10,94,105,1.1142857142857143,0.03400680204068025,540,You have a heart of gold!
3457,2,9,103,114,1.1140350877192982,0.03470722117441154,540,I think you need to see a safeologist.
3457,3,7,104,114,1.1140350877192982,0.03687609790602174,540,We're going to need Xrays and an MRI to find out what's going on inside you.
3457,4,5,105,114,1.1140350877192982,0.038924311065187546,540,"Donald, let me help you unlock the kindlier, gentler person within."
3460,3,4,81,88,1.1136363636363635,0.04406173290555045,540,We'll need to get you on a treadmill.
3460,3,4,81,88,1.1136363636363635,0.04406173290555045,540,How long have you been locked in there?
3462,3,5,89,97,1.1134020618556701,0.04112958489204751,540,Click!
3462,1,9,87,97,1.1134020618556701,0.03552589884559336,540,"Yes, I make people feel secure, but it's stressing me out big time."
3462,0,11,86,97,1.1134020618556701,0.03236221340521884,540,Side affects include corporate greed.
3462,2,7,88,97,1.1134020618556701,0.03843001588719079,540,"We used to televise cases like this, but now we know it's usually nothing."
3466,2,8,96,106,1.1132075471698113,0.036269815272575646,540,"I understand you're unwilling to open up, but I need you to in order to get your payment."
3466,2,8,96,106,1.1132075471698113,0.036269815272575646,540,Doctoring the books at Chaise Bank.
3466,2,8,96,106,1.1132075471698113,0.036269815272575646,540,I will say without reservation that you are safe!
3466,3,6,97,106,1.1132075471698113,0.03866773873947017,540,Are you done with your HIPAA forms yet Mr. Sneadley?
3466,1,10,95,106,1.1132075471698113,0.03370170590028939,540,Now say 'Ahhh'.
3471,2,9,104,115,1.1130434782608696,0.034418382860979466,540,"I know you are big. But I'm telling you, you have failed."
3471,2,9,104,115,1.1130434782608696,0.034418382860979466,540,Our sessions suggest you go to great lengths to keep people away from what's inside you.
3471,1,11,103,115,1.1130434782608696,0.03212584282891649,540,Okay. How about a small breath?
3474,0,10,79,89,1.1123595505617978,0.03366527782977937,540,normally my patients open on the couch.
3474,3,4,82,89,1.1123595505617978,0.04358255128025165,540,"Now cough three times and say ""fee""."
3476,1,9,88,98,1.1122448979591837,0.035180556970122914,540,I am concerned with your vitals...I think you need to lose a little weight.
3476,2,7,89,98,1.1122448979591837,0.038053449573630896,540,I think we can move past doctor/patient confidentiallly
3476,2,7,89,98,1.1122448979591837,0.038053449573630896,540,"Yes,there's definitely a significant tax liability."
3476,0,11,87,98,1.1122448979591837,0.03205118021233007,540,"""Ok Doc I feel unsafe too""."
3480,1,10,96,107,1.1121495327102804,0.033402011549440974,540,"I know you've repressed your memories, but this is ridiculous!"
3480,3,6,98,107,1.1121495327102804,0.038319262284904496,540,You're probably not the investing type.
3480,0,12,95,107,1.1121495327102804,0.030648958094751454,540,You have a severe case of Claustrophobia
3480,1,10,96,107,1.1121495327102804,0.033402011549440974,540,I know you said your heart was broken but this is a weird way to protect it.
3480,1,10,96,107,1.1121495327102804,0.033402011549440974,540,Oh yeah! there's money in there to pay your bill.
3485,5,3,108,116,1.1120689655172413,0.04018613313038098,540,"Sounds like your money rhythm is off. Take two quarters in the morning, then two in the evening."
3486,1,12,112,125,1.112,0.03051387838662184,540,You sound heartless!
3487,2,6,82,90,1.1111111111111112,0.04011358543486932,540,... and did your GP ever prescribe a laxative?
3487,2,8,98,108,1.1111111111111112,0.03562558005899987,540,"Another deep breath. Your Roth sounds fine, but your 401k sounds inflamed. Are you taking your anit-Trump meds regularly?"
3487,1,10,97,108,1.1111111111111112,0.03310757750141195,540,Tell me about your mother's maiden name.
3487,2,7,90,99,1.1111111111111112,0.03768416986205077,540,"Feeling empty is normal at times, but you are now in a safe place."
3487,4,5,108,117,1.1111111111111112,0.03795885936238593,540,My best patient ever!
3487,0,11,88,99,1.1111111111111112,0.03174603174603174,540,If you value your internals you'll have to cut back on the cracking.
3487,0,11,88,99,1.1111111111111112,0.03174603174603174,540,"Yes, I hear you. 30L-15R-4L. Right after the election."
3487,2,5,74,81,1.1111111111111112,0.04303314829119352,540,Do you have your blankie with you?
3487,1,8,81,90,1.1111111111111112,0.036870202688664894,540,Studying Safe Sex at the Kinsey Institute
3487,1,9,89,99,1.1111111111111112,0.03484183684747369,540,Sounds to me like your combination's been hacked.
3487,3,6,99,108,1.1111111111111112,0.037976995945814614,540,Let's talk about some keys to your health.
3487,2,8,98,108,1.1111111111111112,0.03562558005899987,540,"Okay, now say ahhh."
3487,3,7,107,117,1.1111111111111112,0.035965438795678005,540,I hear you but this isn't the safe place I was talking about.
3487,1,9,89,99,1.1111111111111112,0.03484183684747369,540,We just need to correct combination of medicines for your needs.
3487,1,7,73,81,1.1111111111111112,0.039283710065919304,540,PLEASE!! Let the Taxes go.
3487,2,9,106,117,1.1111111111111112,0.03385484561237766,540,"You only need two things in order to open up to others more easily: two complete turns to the R, then L to 21, R to 14, L to 72--and of course, someone to turn your latch."
3487,0,12,96,108,1.1111111111111112,0.030381596756651686,540,"I'd say open wide and say ""Ah"" but I don't have the key."
3487,1,9,89,99,1.1111111111111112,0.03484183684747369,540,You have an enlarged heart of gold.
3487,2,7,90,99,1.1111111111111112,0.03768416986205077,540,You're not getting enough roughage.
3487,2,7,90,99,1.1111111111111112,0.03768416986205077,540,Yes Doctor.. There is a Midget in here!
3487,2,6,82,90,1.1111111111111112,0.04011358543486932,540,If you still can take a deep breath.
3487,2,7,90,99,1.1111111111111112,0.03768416986205077,540,"It is a dangerous world. Seems you've taken safety to a whole new level,"
3487,1,8,81,90,1.1111111111111112,0.036870202688664894,540,"Mr. Fargo...right to 17, and then what?"
3510,1,12,114,127,1.110236220472441,0.030057118595922142,540,Yup. I here it. Your tax-rate is increasing.
3510,2,10,115,127,1.110236220472441,0.03206890636180488,540,"Yeah, I'm kind of over magic realism too."
3512,0,13,105,118,1.1101694915254237,0.02894618860440565,540,A lifetime of cracks is starting to take its toll.
3513,0,12,97,109,1.110091743119266,0.030118831198153243,540,Now take in a deep breadth.
3513,2,8,99,109,1.110091743119266,0.035311943069701895,540,Your pulse is elevated. Am I getting too close?
3513,1,10,98,109,1.110091743119266,0.032818267139664126,540,"Dear, when I suggested ""role playing"" this isn't what I had in mind."
3513,3,6,100,109,1.110091743119266,0.037640775611899616,540,"No, Donald. This isn't the way to heal the child within!"
3513,2,8,99,109,1.110091743119266,0.035311943069701895,540,"I'm afraid you are correct, Mr. Steel, your therapy is down the yellow brick road."
3513,3,6,100,109,1.110091743119266,0.037640775611899616,540,Sounds like a few more hugs from your mom would have gotten you to open up.
3513,1,10,98,109,1.110091743119266,0.032818267139664126,540,"Oh my, I would strongly recommend a cashectomy."
3520,2,7,91,100,1.11,0.037321967966993566,540,"So, you do not feel safe anymore ... it is a unique case of identity crisis and persecution complex."
3520,1,9,90,100,1.11,0.03450955072018602,540,This may require surgery.
3520,1,9,90,100,1.11,0.03450955072018602,540,"Well, it's certainly the path less taken."
3520,1,9,90,100,1.11,0.03450955072018602,540,I always said he had a heart of gold!
3520,1,9,90,100,1.11,0.03450955072018602,540,Cause of debt: Leaky Valve Syndrome.
3520,2,7,91,100,1.11,0.037321967966993566,540,"Mmmm... incredible, a genuine heart of gold"
3520,1,9,90,100,1.11,0.03450955072018602,540,"That's one tired ticker, old timer. Plus, you're inchoate, insensate, and inert - not to mention loaded. You're the perfect patient!"
3520,3,5,92,100,1.11,0.03993681878855019,540,"You know, just in case."
3528,1,8,82,91,1.10989010989011,0.03648322226516845,540,I’m sure that “too big to fail” talk hurt. Tell me how you feel about it.
3528,3,4,84,91,1.10989010989011,0.04265473004544949,540,"Well, no limbs and no brain, but at least you have a heart..."
3528,1,8,82,91,1.10989010989011,0.03648322226516845,540,you seem a little hallow
3528,0,10,81,91,1.10989010989011,0.032967032967032975,540,And you're still experiencing feelings of detachment?
3528,1,8,82,91,1.10989010989011,0.03648322226516845,540,The front desk said you didn't have the funds for your Co-pay.
3528,1,8,82,91,1.10989010989011,0.03648322226516845,540,It seems getting payment from HMOs involves more red tape all the time.
3528,1,8,82,91,1.10989010989011,0.03648322226516845,540,"Your secrets are safe with me. I'm listening, but can't help but feel like you are locking me out of what is deep inside."
3535,3,7,109,119,1.1092436974789917,0.03538285519270036,540,I disagree but this is a safe space so it doesn't really matter.
3535,0,13,106,119,1.1092436974789917,0.02871683968851464,540,"I suppose yet another ""psychiatrist cartoon"" is the safe way to go..."
3537,2,8,100,110,1.1090909090909091,0.035003763756773935,540,looking for donalds tax returns like....
3537,3,6,101,110,1.1090909090909091,0.03731044288845776,540,I'm going to need you to quit storing cigarettes.
3537,1,10,99,110,1.1090909090909091,0.03253394851147357,540,I know your heart is racing but it is in the safe zone.
3537,2,8,100,110,1.1090909090909091,0.035003763756773935,540,"I'm kind of apprehensive, doctor. I don't feel safe anymore."
3537,2,8,100,110,1.1090909090909091,0.035003763756773935,540,"If it's not Hillaty's 30,000 deleted e-mails it's Donald Trump!s tax return. It's hard to tell with all the static."
3537,1,10,99,110,1.1090909090909091,0.03253394851147357,540,My prognosis is alarming.
3543,0,11,90,101,1.108910891089109,0.031152738064459954,540,You could stand to gain a little weight.
3543,1,9,91,101,1.108910891089109,0.034183517825014005,540,"Now, what kind of experiment did you say you were conducting?"
3543,1,9,91,101,1.108910891089109,0.034183517825014005,540,I've checked your accounts and your customers seem to have lost interest in banking here.
3543,1,9,91,101,1.108910891089109,0.034183517825014005,540,It's just a routine check-up; I always say: safety first...
3543,3,5,93,101,1.108910891089109,0.03955442446621422,540,professionally speaking..I think it's a pretty safe bet to say that unlocking your feelings....will lower your heart rate.
3543,1,9,91,101,1.108910891089109,0.034183517825014005,540,"Now don't worry, we are a Medicaid participant."
3543,0,11,90,101,1.108910891089109,0.031152738064459954,540,Okay. Now exhale...
3543,2,7,92,101,1.108910891089109,0.036966642975434595,540,"For some reason instead of a heart, I hear the rustling of money."
3543,0,11,90,101,1.108910891089109,0.031152738064459954,540,This is not a hold up. I said inhale and hold your breath.
3552,0,10,82,92,1.108695652173913,0.03262859720767456,540,I hear you but you've got to open up and let me in.
3552,0,10,82,92,1.108695652173913,0.03262859720767456,540,Better to hire a lawyer!
3552,0,10,82,92,1.108695652173913,0.03262859720767456,540,"I hate coming to the hospital. The last time the surgeon opened me up, he left something inside of me"
3552,1,8,83,92,1.108695652173913,0.03610425042817033,540,I can hear your heartbeat
3552,1,8,83,92,1.108695652173913,0.03610425042817033,540,"It's a combination of 2s, 4s, and definitely some hypertension."
3557,1,7,75,83,1.108433734939759,0.03837749683764797,540,Don't worry. You can talk about anything you want. You're safe here.
3558,1,11,108,120,1.1083333333333334,0.030851213681489343,540,Better out than in.
3558,0,13,107,120,1.1083333333333334,0.028491075150158016,540,"I'm sorry, sir, but the prognosis is correct, you suffer from terminal obsolesce."
3558,0,13,107,120,1.1083333333333334,0.028491075150158016,540,Fine. Keep it all locked up. But the copays are not getting any lower.
3561,2,8,101,111,1.1081081081081081,0.03470090136443011,540,The sperm seems healthy.
3561,0,12,99,111,1.1081081081081081,0.02960662473000899,540,Your safe and sound!
3561,2,8,101,111,1.1081081081081081,0.03470090136443011,540,"Do not worry, what breaks us makes us stronger."
3561,1,10,100,111,1.1081081081081081,0.03225449413188406,540,You've just got a mild case of the Lock Box Blues. Al Gore had it and now he's fine.
3565,1,9,92,102,1.107843137254902,0.0338635640722447,540,This is not what I meant by a safe place!
3565,2,7,93,102,1.107843137254902,0.03661800148069146,540,"Hold your breathe, I can't hear money talk"
3565,2,7,93,102,1.107843137254902,0.03661800148069146,540,"Your heartbeat sounds like the stock exchange ticker, Mr. Trump."
3565,2,7,93,102,1.107843137254902,0.03661800148069146,540,"Yes, I will keep your combination confidential but I still have to document it properly: 38 right - 17 left - 5 right."
3565,1,9,92,102,1.107843137254902,0.0338635640722447,540,Breathe out already!
3570,1,8,84,93,1.10752688172043,0.03573304215805771,540,"Don't be anxious, your in a safe place!"
3570,2,6,85,93,1.10752688172043,0.03886649447231017,540,"Yes, you're safe. You just had a bad dream."
3572,2,9,110,121,1.1074380165289257,0.03278121163778187,540,I'm afraid what you have is contagious.
3572,2,9,110,121,1.1074380165289257,0.03278121163778187,540,"OK, I'll marry you if you tell me the combination."
3574,3,6,103,112,1.1071428571428572,0.03666683380931001,540,"Your having played it ""safe"" for so long, you now have a resulting condition in which you will soon crack."
3574,2,8,102,112,1.1071428571428572,0.03440321991797277,540,If I click in on the combination I can finally pay off my student loans.
3574,2,8,102,112,1.1071428571428572,0.03440321991797277,540,"I think it's safe to say sir that your heart sounds completely ""locked up"""
3574,0,12,100,112,1.1071428571428572,0.029356962018813812,540,"Yes, a safe can have feelings, too."
3574,0,12,100,112,1.1071428571428572,0.029356962018813812,540,It's safe to say you are locked up.
3579,0,11,92,103,1.1067961165048543,0.030581088928331335,540,You have a heart of gold . . . with normal rate and rhythm.
3579,1,9,93,103,1.1067961165048543,0.03354952174237468,540,Abstinence is not the only safe method.
3579,3,5,95,103,1.1067961165048543,0.038811148235284094,540,And do you have insurance?
3579,2,7,94,103,1.1067961165048543,0.03627585723648214,540,You're saying you've felt this bloatedness since 4/15/1995?
3579,1,9,93,103,1.1067961165048543,0.03354952174237468,540,Do you feel safe in your home?
3579,0,11,92,103,1.1067961165048543,0.030581088928331335,540,If you open the door I will cough all you want.
3579,2,7,94,103,1.1067961165048543,0.03627585723648214,540,Actually Mr. Andrews its more simile than metaphor.
3579,1,9,93,103,1.1067961165048543,0.03354952174237468,540,Polly want a cracker?
3587,1,8,85,94,1.1063829787234043,0.03536936228202006,540,"It may take me a while, but I'll get it out."
3587,1,8,85,94,1.1063829787234043,0.03536936228202006,540,"Well, if I weighed as much as you and jumped up on the couch, I'd have a heart issue too."
3587,2,6,86,94,1.1063829787234043,0.03846780975883542,540,"You have an irregular heart beat,I'll need to refer you to a safe cracker."
3587,1,8,85,94,1.1063829787234043,0.03536936228202006,540,Brexit and breathe.
3587,0,10,84,94,1.1063829787234043,0.03197203760837918,540,No heartbeat. Phew.
3587,1,8,85,94,1.1063829787234043,0.03536936228202006,540,Why are your phobias locked up?
3587,0,10,84,94,1.1063829787234043,0.03197203760837918,540,"Your problems are not psychical, but psychological. Try to be more open."
3587,1,8,85,94,1.1063829787234043,0.03536936228202006,540,Hold It.
3587,1,8,85,94,1.1063829787234043,0.03536936228202006,540,Don't breathe too deeply.
3587,1,8,85,94,1.1063829787234043,0.03536936228202006,540,It's not only your temperature that's tumbling!
3597,2,8,103,113,1.1061946902654867,0.0341105880233427,540,Your clicks are too faint to crack!
3597,2,8,103,113,1.1061946902654867,0.0341105880233427,540,Your fantasies are safe with us.
3597,1,10,102,113,1.1061946902654867,0.03170968940880912,540,"Page the surgeon, this is an open and shut case."
3597,1,10,102,113,1.1061946902654867,0.03170968940880912,540,"Well, it seems you don't have health insurance. I assume you'll be paying out-of-body?"
3601,1,7,77,85,1.1058823529411765,0.03751201268570391,540,"Your heart sounds fine, I think it's anxiety...maybe you need to learn to let your feelings out."
3601,0,9,76,85,1.1058823529411765,0.033571402278047356,540,I was dismayed to find the medical program I was accepted to at Locksmith University was unaccredited.
3603,1,9,94,104,1.1057692307692308,0.03324122919906702,540,"Nurse, stat! Call the yegg immediately."
3603,2,7,95,104,1.1057692307692308,0.0359400308298562,540,Your warranty stipulates that you have an annual checkup.
3603,0,11,93,104,1.1057692307692308,0.03030301670261224,540,Your pin tumblers are falling nicely into line. I'll have you open in a jiffy.
3603,3,5,96,104,1.1057692307692308,0.03844986753471491,540,I have to say; you really aren't a stereotypical cracker.
3603,2,7,95,104,1.1057692307692308,0.0359400308298562,540,Maybe you've been playing it too safe.
3603,1,9,94,104,1.1057692307692308,0.03324122919906702,540,A bit of Nickel allergy isn't the end of the world.
3609,1,11,111,123,1.1056910569105691,0.0301336667012711,540,"I’m hearing, ‘iSafe is disabled. Try again in 1 minute.’"
3610,1,10,103,114,1.105263157894737,0.03144410480278553,540,That's weird - I don't hear anything. Do you belong to a millennial?
3610,3,8,122,133,1.105263157894737,0.03248491578149302,540,"It's safe to say, it's not your heart this time."
3610,1,8,86,95,1.105263157894737,0.035012984986988224,540,"I think your condition stems from a combination of factors, but with the proper treatment you'll be safe."
3610,2,6,87,95,1.105263157894737,0.038077201622920574,540,"I sense a slight pulse,Mr.Trump."
3610,0,12,102,114,1.105263157894737,0.028869990158009742,540,"Ticker good, Lungs clear, get your Flu shot and you're good for another year."
3610,0,12,102,114,1.105263157894737,0.028869990158009742,540,"Your liver isn't great, but you've got a heart of gold."
3610,3,4,88,95,1.105263157894737,0.04091255857516159,540,"I appreciate your understanding, Mr. Clipkins. We can't BOTH get ringworm."
3610,1,8,86,95,1.105263157894737,0.035012984986988224,540,"I know you're on pins and needles, but this clinic is a safe space."
3610,1,6,69,76,1.105263157894737,0.04008301634665216,540,"When he said his name was Peter Parker, I didn't think he meant that Peter Parker."
3610,4,4,106,114,1.105263157894737,0.038137880279631456,540,The vault seeks psychotherapy after an armed bank robbery.
3610,0,10,85,95,1.105263157894737,0.03165351405398112,540,We'll test your reflexes next.
3610,2,6,87,95,1.105263157894737,0.038077201622920574,540,Hm ... is there a history of heart problems in your factory?
3610,2,6,87,95,1.105263157894737,0.038077201622920574,540,Mary couldn't decide between her job as a Doctor and her passion of being a safecracker
3623,1,9,95,105,1.1047619047619048,0.03293853061738659,540,It seems you have something repressed
3623,1,9,95,105,1.1047619047619048,0.03293853061738659,540,"""Oil can , oil can "" ?"
3623,1,9,95,105,1.1047619047619048,0.03293853061738659,540,The empty feeling you have inside should change with a new President and economy.
3623,0,11,94,105,1.1047619047619048,0.030029928672614767,540,"As speculated, you have no heart."
3623,2,7,96,105,1.1047619047619048,0.035610349371814606,540,It will not open your mind or mend your heart
3623,1,9,95,105,1.1047619047619048,0.03293853061738659,540,Are you sure you don't want to come out and have a cookie?
3629,0,9,77,86,1.1046511627906976,0.03320157631219844,540,You can tell me anything. I put you health secrets in the vault.
3630,2,8,105,115,1.1043478260869566,0.033539969082926106,540,"Germophobia, sir! Did you hear that!?"
3631,2,6,88,96,1.1041666666666667,0.03769442774523756,540,Do you feel like you're under a lot of pressure at work?
3631,1,8,87,96,1.1041666666666667,0.034663693361021125,540,Don't be so nervous. Relax You're tumbling. You'll be safe with me.
3631,1,8,87,96,1.1041666666666667,0.034663693361021125,540,Do you feel safer in your safe-place?
3631,1,8,87,96,1.1041666666666667,0.034663693361021125,540,It's a more direct route to fiscal health. Cut out the middle man.
3631,1,8,87,96,1.1041666666666667,0.034663693361021125,540,"Well, your breathing does sound a bit hollow."
3631,1,8,87,96,1.1041666666666667,0.034663693361021125,540,I understand you’ve been feeling empty and worthless since Bernie lost the nomination.
3631,2,6,88,96,1.1041666666666667,0.03769442774523756,540,"Yes, I get it. A condom every time."
3638,1,11,113,125,1.104,0.029673492026255653,540,it's not safe to lead a sedentary life style!
3639,1,9,96,106,1.1037735849056605,0.03264127572638085,540,"Hello? Your heart is beating in perfect ""morse""!"
3639,3,5,98,106,1.1037735849056605,0.03774707829329233,540,Did you expect me to open up automatically? I expect my money's worth for this session.
3639,1,9,96,106,1.1037735849056605,0.03264127572638085,540,Your health records are safe.
3639,1,9,96,106,1.1037735849056605,0.03264127572638085,540,This is step one in my 'listening cure.'
3639,1,9,96,106,1.1037735849056605,0.03264127572638085,540,Oh no! Three clicks to the right means angina.
3639,2,7,97,106,1.1037735849056605,0.03528664620451737,540,You’ve got a heart of gold.
3645,2,5,80,87,1.103448275862069,0.04016300240929356,540,"The Trump taxes, and his secret plan to defeat ISIS are trying their best to break out."
3645,1,10,105,116,1.103448275862069,0.030926014010099357,540,"Well Tinman, the witch didn't totally lie. You do have a heart now...and you're safe here."
3645,1,10,105,116,1.103448275862069,0.030926014010099357,540,"Meds must not be working. Irregular heartbeat strong, obesity tipping the scales up still."
3645,2,8,106,116,1.103448275862069,0.033261740484137645,540,"Actually, I'm Bi...a health manager AND a wealth manager."
3645,2,5,80,87,1.103448275862069,0.04016300240929356,540,You have engorged too many subprime toxic mortgages0
3645,2,5,80,87,1.103448275862069,0.04016300240929356,540,"I have unlocked the mystery, you are safe."
3645,0,9,78,87,1.103448275862069,0.032839767809852885,540,I'm going to help you open up so that we can have frank discussions.
3652,2,6,89,97,1.1030927835051547,0.03731925537624309,540,The ticker is still going strong but you should play it safe
3652,1,8,88,97,1.1030927835051547,0.03432127896123399,540,"If we decipher your code, we will unlock the full potential of our ability to treat you."
3652,0,10,87,97,1.1030927835051547,0.031035037574206954,540,"No worries. Yes, you love holding money but you have a bigger heart than Donald Trump."
3652,1,8,88,97,1.1030927835051547,0.03432127896123399,540,"Calm down. You'll be safe here. Good thing you yelled when they tried to break it, and you scared them off."
3652,2,6,89,97,1.1030927835051547,0.03731925537624309,540,When was the last time you felt cracked open?
3652,2,6,89,97,1.1030927835051547,0.03731925537624309,540,Now open wide and say: Aaaaaaah
3658,3,5,99,107,1.102803738317757,0.03740521304360735,540,"If you don't want to deal with your anxiety issues, I suggest you retire or find another job."
3658,0,11,96,107,1.102803738317757,0.029498181860449973,540,"You're no Tin Man. You have a vibrant, healthy organ."
3658,2,7,98,107,1.102803738317757,0.03496876062405552,540,"I found the combination! It's the click, click, clicking of your heart."
3658,4,3,100,107,1.102803738317757,0.03969238851584534,540,Why did you never tell me you were once Al Gore's lock-box?
3658,1,9,97,107,1.102803738317757,0.032349319565136724,540,Why do always think it is a combination of diseases?
3658,1,9,97,107,1.102803738317757,0.032349319565136724,540,We may just have to open you up again and drain some more fluids.
3658,3,5,99,107,1.102803738317757,0.03740521304360735,540,I can't hear your heart second sound.
3658,2,7,98,107,1.102803738317757,0.03496876062405552,540,"Unfortunately, this safe cannot be cracked. On a positive note, its chances of developing anemia are essentially nil."
3658,2,7,98,107,1.102803738317757,0.03496876062405552,540,"Hey, you've got to hide your love away."
3667,0,12,105,117,1.1025641025641026,0.028168934256541104,540,"Look, I can help you with the mechanics, but you'll have to consult Dr. Frung for your insecurity issues."
3668,1,7,80,88,1.1022727272727273,0.03628436369735344,540,"Five clicks to the left, two to the right, seven to the left, one to the right.... No oil needed this year, Mr. Steel. You're good to go!"
3668,0,9,79,88,1.1022727272727273,0.0324857203870887,540,"our office motto is""we treat the patients without the profit in mind"""
3668,1,7,80,88,1.1022727272727273,0.03628436369735344,540,Next week you'll open up and we'll what's inside of you.
3668,0,9,79,88,1.1022727272727273,0.0324857203870887,540,"One of us, Senor Wences, is being very defensive..."
3668,1,7,80,88,1.1022727272727273,0.03628436369735344,540,I know! Yanks out of it and THE CUBS won 103 games this year. Go figure.
3668,1,7,80,88,1.1022727272727273,0.03628436369735344,540,The economy is not safe.
3674,2,6,90,98,1.1020408163265305,0.036951460869878,540,You are safe here. Lets bring down your heart rate.
3674,1,8,89,98,1.1020408163265305,0.033985541406505795,540,"What troubling secrets have you been holding in all these years? Ah, Donald Trump's taxes!"
3674,1,8,89,98,1.1020408163265305,0.033985541406505795,540,"Ah! I see you are clogged with tax returns!"""
3677,3,5,100,108,1.1018518518518519,0.03706947350832802,540,Wait for it...
3677,1,9,98,108,1.1018518518518519,0.032062522251504355,540,Don't worry. You should see the kinds of patients the other residents are treating right now.
3677,1,9,98,108,1.1018518518518519,0.032062522251504355,540,"I'm very happy to say that you qualify for our ""No cure, no fee"" policy."
3677,2,7,99,108,1.1018518518518519,0.034656537617835145,540,Another Viagra overdose...
3677,2,7,99,108,1.1018518518518519,0.034656537617835145,540,Is there money in here sir ?
3677,1,9,98,108,1.1018518518518519,0.032062522251504355,540,Is there any reason you'd like to tell me that you do not feel safe at home?
3677,2,7,99,108,1.1018518518518519,0.034656537617835145,540,The problem is ....yo've been keeping things locked inside too long . We;'ll work together and you'll be able to open up.
3677,2,7,99,108,1.1018518518518519,0.034656537617835145,540,If I were you I would rethink that because i'm the one with the thumbs
3685,1,10,107,118,1.1016949152542372,0.030424659927313576,540,Take a deep breath and push hard!
3685,1,10,107,118,1.1016949152542372,0.030424659927313576,540,"It may not be strep, but I'd rather prescribe you an antibiotic, just to play it safe."
3687,2,5,82,89,1.101123595505618,0.039289345386959953,540,Your wife called. She said you have been having a hard time opening up.
3688,1,8,90,99,1.101010101010101,0.03365628799333507,540,His physical strength and stamina are extraordinary
3688,0,10,89,99,1.101010101010101,0.030440148787487714,540,I can hear Donald Trump's heart...it's very faint and very small.
3688,0,10,89,99,1.101010101010101,0.030440148787487714,540,"Next session, and then we hit the jackpot."
3688,2,6,91,99,1.101010101010101,0.03659082924417306,540,This would go a lot faster if you would stop murmuring.
3688,1,8,90,99,1.101010101010101,0.03365628799333507,540,"I can't find a thing wrong with you...or right, for that matter."
3693,3,5,101,109,1.1009174311926606,0.03673969682148849,540,"I'm not really a doctor, I just play one in cartoons. Why do you ask?"
3693,1,9,99,109,1.1009174311926606,0.03178074876273171,540,"""Don't blame me I didn't put his kidney in the safe."
3695,1,10,108,119,1.1008403361344539,0.03018000873737951,540,I think the problem is an overused Tumblr.
3695,2,8,109,119,1.1008403361344539,0.03245401024042414,540,I believe I can help you with your germaphobia .
3695,2,8,109,119,1.1008403361344539,0.03245401024042414,540,"I'll need a second opinion from the specialist, Dr. Willie Sutton."
3698,1,8,91,100,1.1,0.03333333333333333,540,"In my opinion, you have a heart made of steel NOT stone."
3698,0,12,108,120,1.1,0.027500954910846354,540,Tell me your combination. It will improve your health and my wealth.
3698,0,10,90,100,1.1,0.03015113445777636,540,You sound rather chesty today.
3698,0,9,81,90,1.1,0.031799936400190784,540,Take two time capsuls and call me after midnight
3698,1,9,100,110,1.1,0.03150386872730591,540,Yes you are on the couch and not the exam table but we still need your numbers before we can help you.
3698,0,9,81,90,1.1,0.031799936400190784,540,It's painless and won't even break the bank.
3698,1,7,82,90,1.1,0.03550948950905247,540,"Twenty-five? Seven? Fourteen? No comprende, senor."
3698,0,11,99,110,1.1,0.028734788556634548,540,I believe some exploratory surgery is in order.
3698,0,12,108,120,1.1,0.027500954910846354,540,"So sorry, I am unable to make you come out of the box"
3698,2,5,83,90,1.1,0.03886658893356652,540,Breath in. Keep holding.
3698,2,6,92,100,1.1,0.03623715376697393,540,It seems you're barely breathing and have no heart.
3698,2,6,92,100,1.1,0.03623715376697393,540,I'm afraid your problem won't be solved with drugs
3698,1,9,100,110,1.1,0.03150386872730591,540,It sounds empty
3698,1,6,73,80,1.1,0.03815358702051022,540,You need to unlock your heart.
3698,1,9,100,110,1.1,0.03150386872730591,540,Seems as though your heart is in the right place. Are you considering donating to charities without your owners approval?
3698,2,7,101,110,1.1,0.034048486253872585,540,Don't worry just let it out. No need to lock it up.
3698,0,11,99,110,1.1,0.028734788556634548,540,"no, your biological clock does not sound like a time bomb"
3698,0,10,90,100,1.1,0.03015113445777636,540,It sounds cracked
3698,1,7,82,90,1.1,0.03550948950905247,540,"Oh, I'm too late, its tumblers have gone silent."
3717,4,3,104,111,1.0990990990990992,0.03829912647103992,540,Gesundheit!
3717,1,9,101,111,1.0990990990990992,0.03123175622734365,540,"Okay, you do sound like the Blues Brothers. Yes, both of them. Now will you come out?"
3719,1,8,92,101,1.099009900990099,0.033016499010956574,540,Can't you remember the combination? It's becoming difficult to examine you.
3719,2,6,93,101,1.099009900990099,0.03589023556513239,540,"Well, I think it's safe to say that you haven't been doing anything taxing for quite a few years."
3719,0,10,91,101,1.099009900990099,0.0298675309485116,540,My response is you shouldn't watch movies about Houdini and Dr. Freud.
3719,1,8,92,101,1.099009900990099,0.033016499010956574,540,You've been hacked. Someone in Russia is holding your combination for ransom.
3719,2,6,93,101,1.099009900990099,0.03589023556513239,540,Your love of square dance music should remain locked away...
3719,0,10,91,101,1.099009900990099,0.0298675309485116,540,"Don't be alarmed, but your time clock needs a new pacemaker ASAP ."
3719,2,6,93,101,1.099009900990099,0.03589023556513239,540,Your feminine touch makes me feel safe
3726,0,9,82,91,1.098901098901099,0.031467738600607385,540,"I know my business name is 'Dr. Locksmith,' but I don't think you need a psychiatrist."
3726,2,5,84,91,1.098901098901099,0.03845281603519623,540,Your heart is safe enough for sex
3726,1,7,83,91,1.098901098901099,0.03513429687408587,540,"Thanks to the Wall Street-backed health insurance companies, and the US spending more on healthcare than any other democracy, this is the way many doctors now determine whether or not they'll take on new patients."
3726,1,7,83,91,1.098901098901099,0.03513429687408587,540,"It's a little unusual in psychiatry, but with patients as heavily defended as you..."
3730,0,8,73,81,1.0987654320987654,0.03335618786692912,540,"I completely assure you that after ten years of combination therapy, your secrets are safe with me"
3731,2,8,112,122,1.098360655737705,0.0316844882644848,540,Unlocking your secrets requires evaluating how you click.
3732,1,9,102,112,1.0982142857142858,0.030964289610915668,540,"Mr. John Doe, I promise we do observe privacy rules here."
3732,0,11,101,112,1.0982142857142858,0.028247337400779903,540,"what was the combination again, mr. darwin?"
3732,1,9,102,112,1.0982142857142858,0.030964289610915668,540,You have the heart of a fifteen-year-old...Republican.
3732,1,9,102,112,1.0982142857142858,0.030964289610915668,540,"'Money ta;lks?'"" Don't believe it."
3732,1,9,102,112,1.0982142857142858,0.030964289610915668,540,"I am not your psychiatrist, but your tumbler has a click."
3737,1,8,93,102,1.0980392156862746,0.032705613260176805,540,"Don't worry sir, I'd say you're ""safe"" from disease."
3737,0,10,92,102,1.0980392156862746,0.029589188531613242,540,How do I know how much is inside ? It`s the first time I`ve been to a shrink.
3737,1,8,93,102,1.0980392156862746,0.032705613260176805,540,"Your heart rate is normal, but I also need to take your temperature."
3740,2,5,85,92,1.0978260869565217,0.038047743942136635,540,It would be healthier to simply mute the sound during post-debate discussions.
3740,1,7,84,92,1.0978260869565217,0.03476692790349797,540,No doubt your movie career exposed you to many dangerous chemicals.
3742,1,10,112,123,1.0975609756097562,0.029239401085097542,540,"Breathe out ... turn your tumblers and cough for me. Good. You're all bottled up, Mr. Schlage ... you need to open up more ..."
3742,2,4,76,82,1.0975609756097562,0.04109959590271843,540,I think surgery might be the best option.
3744,1,9,103,113,1.0973451327433628,0.030701351313731726,540,I have lost most of my patience.
3744,0,11,102,113,1.0973451327433628,0.028009733301017116,540,"Unless you open up, we'll never recover your safe word."
3746,1,8,94,103,1.0970873786407767,0.03240051065888945,540,"""Are you saying 'money talks' ""?"
3746,1,8,94,103,1.0970873786407767,0.03240051065888945,540,"I know, I feel a little insecure myself sometimes. The world is not always a safe place."
3746,2,6,95,103,1.0970873786407767,0.03521591259723893,540,Paging Doctor Yegg.
3746,1,8,94,103,1.0970873786407767,0.03240051065888945,540,"We all get twisted, try to ignore it..."
3746,1,8,94,103,1.0970873786407767,0.03240051065888945,540,You've got the mumps.
3746,3,4,96,103,1.0970873786407767,0.037822320250824555,540,You're quite lucid and all of your vitals appear to be fine. I don't understand you're need to feel safe.
3746,1,8,94,103,1.0970873786407767,0.03240051065888945,540,"Mr. Jones, I went into medicine to do good. Clearly, I'm doing quite well."
3746,1,8,94,103,1.0970873786407767,0.03240051065888945,540,Don't bank on living much longer
3754,0,9,84,93,1.096774193548387,0.030823647932448676,540,Understandable you want to stay there for the next four years; but keeping your absentee ballot doesn't help right now
3754,1,7,85,93,1.096774193548387,0.03440714115645377,540,You seem to have a case of arteriosclerosis of your money flow.
3756,1,9,104,114,1.0964912280701755,0.030442827689649028,540,"Yes, I'm sure this was much easier at 5 yrs. old, when you decided to lock up your feelings."
3756,1,9,104,114,1.0964912280701755,0.030442827689649028,540,Now breathe out.
3756,3,5,106,114,1.0964912280701755,0.03517494204674149,540,"Danger? No, you're not in danger. . . ."
3759,2,6,96,104,1.0961538461538463,0.034888146161337175,540,"To Sharon's astonishment she heard music... We can dance if we want to, we can leave your friends behind Cause your friends don't dance and if they don't dance Well they're no friends of mine."
3759,2,6,96,104,1.0961538461538463,0.034888146161337175,540,"Well, if you hadn't be practicing safe sex, you wouldn't be pregnant!"
3759,0,10,94,104,1.0961538461538463,0.029047715018613904,540,"Next time, remember to read the Black Box warning."
3759,2,6,96,104,1.0961538461538463,0.034888146161337175,540,"You're not alone, you have a condition that's not that uncommon these days. I'm going to refer you to a locksmith in the area for you to see as soon as you can."
3759,1,8,95,104,1.0961538461538463,0.03210103183993805,540,Hmm. The Cumadin seems to be helping the deposits.
3759,1,8,95,104,1.0961538461538463,0.03210103183993805,540,Your copper deficiency has gotten worse. Seen a metallurgist recently?
3759,0,10,94,104,1.0961538461538463,0.029047715018613904,540,Don't count on getting better.
3766,0,9,85,94,1.0957446808510638,0.030511347605209665,540,Locking up your emotions doesn't keep me from hearing what is wrong.
3766,1,7,86,94,1.0957446808510638,0.034054704991984645,540,"A heart of gold, but with a murmur of vermeil."
3766,2,5,87,94,1.0957446808510638,0.03726262915437227,540,"Hillary, not all safes are safe."
3766,1,7,86,94,1.0957446808510638,0.034054704991984645,540,"Ok, now try to go to your safe place."
3766,1,7,86,94,1.0957446808510638,0.034054704991984645,540,The combination of your combination and money is a bad combination.
3766,1,7,86,94,1.0957446808510638,0.034054704991984645,540,"Someone, please, let me out!"
3772,1,9,105,115,1.0956521739130434,0.03018860884950203,540,Are you certain you don't eat a lot of rich foods?
3773,3,4,98,105,1.0952380952380953,0.03712124852793622,540,Who did you say your insurance provider was?
3773,1,8,96,105,1.0952380952380953,0.03180702321771782,540,Is it safe? I'm sure you've never heard that one before.
3773,1,6,77,84,1.0952380952380953,0.03640093409748079,540,"You're safe for now, but keep taking your medicine."
3773,1,8,96,105,1.0952380952380953,0.03180702321771782,540,How long has your cash been warm and soft?
3773,1,8,96,105,1.0952380952380953,0.03180702321771782,540,"You may feel empty, but I need to look into you to make sure"
3773,1,8,96,105,1.0952380952380953,0.03180702321771782,540,"If you want me to open up, shouldn't you ask me about my childhood?"
3773,0,10,95,105,1.0952380952380953,0.028784310706047096,540,Something about you makes me feel safe.
3780,2,7,107,116,1.0948275862068966,0.032345697075803606,540,Your nomination sounds like it has arrhythmia
3780,1,9,106,116,1.0948275862068966,0.029938588507783567,540,The root of all sickness is the LOVE of money!
3782,1,7,87,95,1.0947368421052632,0.03370939707864366,540,"Patience, Mr. Otis!"" I know you're gasping in there, but I'm just a student!"
3782,1,7,87,95,1.0947368421052632,0.03370939707864366,540,"Why is it that I can't call you the N-word, yet you can call me a Cracker?"
3782,1,7,87,95,1.0947368421052632,0.03370939707864366,540,Your insurance information.
3782,2,5,88,95,1.0947368421052632,0.03688207718037519,540,"Sorry, I don't mean to insult you, but I was hoping you could help me crack my case."
3786,0,7,67,74,1.0945945945945945,0.034252578598678016,540,It's global anemia. You definitely need an infusion from the blood money bank.
3787,2,8,117,127,1.094488188976378,0.030479792175330447,540,"Cough, cough, ..., I think you're safe."
3788,2,5,89,96,1.09375,0.03650920636117426,540,Hey guys I found Mr. Whiskers.
3788,2,5,89,96,1.09375,0.03650920636117426,540,I want to do some tests just to be... um... cautious.
3788,3,3,90,96,1.09375,0.03939822831977147,540,"It hurts to open up to what's been locked away, doctor."
3791,2,6,99,107,1.0934579439252337,0.03394039367420965,540,This won't hurt a bit.
3791,0,10,97,107,1.0934579439252337,0.02827151987866968,540,You poor soul. Those tax returns do look awful.
3791,1,8,98,107,1.0934579439252337,0.031234829589821243,540,"I think I've told you before,too much money can make you ill"
3791,0,10,97,107,1.0934579439252337,0.02827151987866968,540,I hear a murmur and suggest it is time to reset.
3791,1,8,98,107,1.0934579439252337,0.031234829589821243,540,Playing it safe will only lock up your heart.
3791,0,10,97,107,1.0934579439252337,0.02827151987866968,540,"Sir, of course, your plan covers everything but vascular ultrasound."
3791,1,8,98,107,1.0934579439252337,0.031234829589821243,540,"In case my Houdini genes are defective, try 48-26-19."
3798,0,8,78,86,1.0930232558139534,0.03150535522951525,540,"Cough please, and cough, and cough up the money."
3799,1,7,89,97,1.092783505154639,0.03303932048630483,540,"Well, Hippocrates didn't have malpractice costs to worry about."
3799,1,7,89,97,1.092783505154639,0.03303932048630483,540,But the DNC hacked you first?
3799,2,5,90,97,1.092783505154639,0.036143786886533726,540,Hmm....I'm afraid your iron lung is no longer safe.
3799,2,5,90,97,1.092783505154639,0.036143786886533726,540,Your cholesterol is high. Please stop eating so many yeggs.
3803,2,6,100,108,1.0925925925925926,0.0336357955503476,540,"You were feeling guilty about the robbery last week when the pain started? You probably need a psychiatrist, not a cardiologist."
3803,2,6,100,108,1.0925925925925926,0.0336357955503476,540,"Looks like you got a mostly deductible and out-of-network PPO in there, you lucky bastard."
3803,2,6,100,108,1.0925925925925926,0.0336357955503476,540,After I take your vital signs we can talk about how you might unlock your softer side.
3803,0,10,98,108,1.0925925925925926,0.028021888038609433,540,It's not one thing but a combination of health & safety related issues at work here.
3803,1,8,99,108,1.0925925925925926,0.03095636405937514,540,You are diagnosed with stiff heart syndrome. I recommend opening yourself up.
3803,1,8,99,108,1.0925925925925926,0.03095636405937514,540,"I can hear a breakthrough about to happen. Remember, you're still in a safe place."
3809,1,6,80,87,1.0919540229885059,0.03518836131447995,540,Getting you to open up would be much more difficult with a time lock.
3809,1,6,80,87,1.0919540229885059,0.03518836131447995,540,Dr. Oz said I 'd hear nothing; the Wizard said you have a heart.
3809,2,4,81,87,1.0919540229885059,0.03880114661141246,540,Please come out. I promise I'll keep you safe.
3809,0,8,79,87,1.0919540229885059,0.031159469919054366,540,And how long have you had this recurring nonproductive combination?
3809,2,4,81,87,1.0919540229885059,0.03880114661141246,540,I feel very SAFE in your hands doc.
3814,1,7,90,98,1.0918367346938775,0.03271414967358107,540,How did we wind up here?
3814,0,9,89,98,1.0918367346938775,0.02932272417666304,540,"Well, you did say you'd like to open up more."
3814,0,9,89,98,1.0918367346938775,0.02932272417666304,540,Open Sesame!
3814,2,5,91,98,1.0918367346938775,0.03578559800520693,540,Why emails and tax returns? Whose voices?
3814,1,7,90,98,1.0918367346938775,0.03271414967358107,540,"With weekly visits, I'm sure we can decipher the code and unlock whatever it is inside you that's making you inaccessible."
3814,0,9,89,98,1.0918367346938775,0.02932272417666304,540,Together we'll crack your safety issues.
3820,2,6,101,109,1.091743119266055,0.033336606372615346,540,"Don't worry, you're fine. I'm calling in a safe and vault specialist!"
3820,2,6,101,109,1.091743119266055,0.033336606372615346,540,I detect a heart murmur!
3822,0,11,109,120,1.0916666666666666,0.02645177773392142,540,Your heart's not into it.
3823,2,5,92,99,1.0909090909090908,0.03543442758386343,540,Donald you need to stop hiding your feelings inside your self and come out and express who you really are. Anyway we are running out of time I have other patients to see.
3823,1,7,91,99,1.0909090909090908,0.03239530204999084,540,Don't worry you're going to be all SAFE.
3823,0,8,80,88,1.0909090909090908,0.030821068346400457,540,Cash may be King..but being overworked can kill you!
3823,2,6,102,110,1.0909090909090908,0.033042683608111786,540,I can hear what you're thinking
3823,1,7,91,99,1.0909090909090908,0.03239530204999084,540,Give me a good set of tumblers over password protection any day.
3823,0,8,80,88,1.0909090909090908,0.030821068346400457,540,A vaccine would have been the safer choice.
3823,1,7,91,99,1.0909090909090908,0.03239530204999084,540,Lets see... your combination of your symptoms do not indicate the code we need to crack to find what is wrong with your insides
3823,1,7,91,99,1.0909090909090908,0.03239530204999084,540,I realize this is silly but the Edward Snowden incident has NSA spooked.
3823,2,5,92,99,1.0909090909090908,0.03543442758386343,540,I'd cut back on the cholesterol to be safe.
3823,2,6,102,110,1.0909090909090908,0.033042683608111786,540,Trust me. I feel your pain.
3823,0,11,110,121,1.0909090909090908,0.0262431940540739,540,I'm very sorry---was your portfolio diversified?
3823,1,6,81,88,1.0909090909090908,0.03480188606767164,540,"Pulse or impulse , glut or gelt ?"
3823,0,9,90,99,1.0909090909090908,0.029039843863633643,540,I think it's safe to say that I've cracked the case on why you've been feeling so robbed lately..
3823,1,7,91,99,1.0909090909090908,0.03239530204999084,540,With depth psychology it is important to open up.
3823,2,5,92,99,1.0909090909090908,0.03543442758386343,540,at least you have money to cover up your health
3823,0,10,100,110,1.0909090909090908,0.027535569673426488,540,"When you feel me squeeze, cough."
3823,1,6,81,88,1.0909090909090908,0.03480188606767164,540,I am not sure if this is the most effective way to protect yourself from a heart attack.
3823,1,7,91,99,1.0909090909090908,0.03239530204999084,540,"Disappointed? I know, we're all disappointed in the candidates."
3841,2,7,113,122,1.0901639344262295,0.030804808656623515,540,"I believe that you may have ""locked-in"" syndrome."
3842,2,6,103,111,1.09009009009009,0.03275388967792232,540,Unsafe sex is the likely cause of your present chest condition.
3842,2,6,103,111,1.09009009009009,0.03275388967792232,540,I'd say you're a safe heart beat from being cracked!!
3844,2,5,93,100,1.09,0.03509007169147893,540,you have a heart of steel but it's still my job to keep you safe.
3844,2,5,93,100,1.09,0.03509007169147893,540,I think you're suffering from a heavy heart.
3844,0,9,91,100,1.09,0.028762349126466132,540,"I know you are concerned about protecting your heart, but I think we should discuss other options."
3844,0,9,91,100,1.09,0.028762349126466132,540,"Doctor, open the id."
3844,2,5,93,100,1.09,0.03509007169147893,540,"I turn my right hand in, I turn my right hand out, then I give myself a shake, and turn myself about!"
3844,2,5,93,100,1.09,0.03509007169147893,540,"Marcus, like I told you last time, you're eating the wrong greens."
3844,0,9,91,100,1.09,0.028762349126466132,540,It's not a safe place Mr. McGillackudy.
3844,1,7,92,100,1.09,0.03208259542638234,540,"*tick tick, tick tick* Could you breathe a little deeper for me? *cha-ching, cha-ching*"
3844,2,5,93,100,1.09,0.03509007169147893,540,You can't keep putting yourself in these unsafe working conditions.
3844,1,7,92,100,1.09,0.03208259542638234,540,If you can't remember the combination we will have to blow it open.
3854,1,6,82,89,1.0898876404494382,0.034423789781366426,540,Soon enough I feel you'll open up. But you do need to feel safe first.
3854,2,4,83,89,1.0898876404494382,0.03795207395946741,540,"So, your telling me there's a chance?"
3856,0,10,102,112,1.0892857142857142,0.027065781646351265,540,"I'm sorry but the problem is locked up, I can't seem to get it."
3856,1,8,103,112,1.0892857142857142,0.029890327816923083,540,Ready to let me in?
3856,2,6,104,112,1.0892857142857142,0.03247009174422343,540,Save your money. Your crack habit isn't any safer than the safe cracker you've been spending time with.
3856,1,8,103,112,1.0892857142857142,0.029890327816923083,540,"Hey Doc, if you don't accept Medicare, skip it."
3860,0,9,92,101,1.0891089108910892,0.028490088257303276,540,I'm afraid it's regressed.
3860,0,9,92,101,1.0891089108910892,0.028490088257303276,540,In a case like this I'm willing to waive my fees.
3860,0,9,92,101,1.0891089108910892,0.028490088257303276,540,I'm afraid you'll have to go back for another round of QE.
3860,2,5,94,101,1.0891089108910892,0.034752334207493546,540,I'll tell you what's inside after Obamacare starts picking up my coverage.
3860,2,5,94,101,1.0891089108910892,0.034752334207493546,540,You need to turn your radio down.
3860,2,5,94,101,1.0891089108910892,0.034752334207493546,540,I'm sense a real weakness in your interest rate.
3866,1,6,83,90,1.0888888888888888,0.03405380352021444,540,I think you need to see a gastroenterologist.
3867,1,5,73,79,1.0886075949367089,0.036876916682468,540,Okay. Now turn your head and cough.
3868,1,8,104,113,1.0884955752212389,0.02963516604230352,540,"Mr. Rivera, I'm sure there's something in this safe."
3868,2,6,105,113,1.0884955752212389,0.032191161508245844,540,Diagnosis: High Blood pressure withAnxiety! Prescription: exercise and Xanax.
3870,2,5,95,102,1.088235294117647,0.03442102645217136,540,Let me see if you are truly heartless.
3870,0,9,93,102,1.088235294117647,0.028222915166426037,540,So you say a man with blonde hair named Donald.... what was it again? attacked you?
3870,1,7,94,102,1.088235294117647,0.03147491066319619,540,"Yes, Jerry, everything you tell me will be kept in the vault."
3870,3,3,96,102,1.088235294117647,0.03713413689297195,540,Something tells me this is the beginning of a beautiful friendship.
3870,0,9,93,102,1.088235294117647,0.028222915166426037,540,How's your circulation?
3870,2,5,95,102,1.088235294117647,0.03442102645217136,540,"Safe sex can leave me empty, too, but a crank with armor will never harm her."
3870,0,9,93,102,1.088235294117647,0.028222915166426037,540,"Right to lub dub, left past lub dub to ...."
3870,1,7,94,102,1.088235294117647,0.03147491066319619,540,Open up and say EpiPen.
3870,1,7,94,102,1.088235294117647,0.03147491066319619,540,My medical training has cracked tougher attempts to secure the rising costs of health care.
3870,0,9,93,102,1.088235294117647,0.028222915166426037,540,Deep Breath
3880,1,6,84,91,1.0879120879120878,0.03369166970715581,540,I'm afraid it's your 1%...
3880,0,8,83,91,1.0879120879120878,0.029848423131814458,540,"You'll have to give me the combination if you want your pacemaker battery repaced, Mr. Chaney."
3882,1,8,105,114,1.087719298245614,0.029384313829045588,540,A heart of gold but alas secured from the trials of love.
3882,2,6,106,114,1.087719298245614,0.03191697501845719,540,Ugh! You're always crying poor!
3884,0,7,73,80,1.0875,0.031791199721728586,540,I think it's safe to say you have no heart.
3885,2,5,96,103,1.087378640776699,0.03409596683771112,540,I'm going to order an EKG. Just to be you.
3885,1,7,95,103,1.087378640776699,0.03117960143264719,540,I guess you keep your heart well protected from others
3885,0,9,94,103,1.087378640776699,0.027960689125970634,540,"In another dozen sessions or so, we may really begin to unlock some secrets."
3885,1,7,95,103,1.087378640776699,0.03117960143264719,540,If I can unlock your deep dark secrets I will be rich!!
3885,2,5,96,103,1.087378640776699,0.03409596683771112,540,"It's safe to say, Mr. Johnson, you're crackers."
3885,0,9,94,103,1.087378640776699,0.027960689125970634,540,"Sorry, but your heart is in the right place!"
3891,0,11,115,126,1.0873015873015872,0.025247577334264856,540,No secrets now
3892,1,6,85,92,1.0869565217391304,0.03333714153170442,540,"Good news. Now, I'm sure we can get it off of you."
3892,1,8,106,115,1.0869565217391304,0.029137663185509245,540,Have ever you been told you're cold-hearted?
3892,1,8,106,115,1.0869565217391304,0.029137663185509245,540,Sounds like a healthy balance.
3895,1,7,96,104,1.0865384615384615,0.03088977042533612,540,Relax and exhale.
3895,0,9,95,104,1.0865384615384615,0.02770327452746085,540,"Relax, Mr. Trump -- November 9 will be here before you know it."
3895,0,9,95,104,1.0865384615384615,0.02770327452746085,540,"Take a deep breath.......I said, take a deep breath........please take a deep breath."
3898,0,7,74,81,1.0864197530864197,0.031414841111109815,540,Your secrets are safe with me until I can make big bucks for spilling them!
3898,1,5,75,81,1.0864197530864197,0.03599353021509445,540,I don't think Xanax will do it this time
3900,0,10,106,116,1.0862068965517242,0.026172549100593842,540,Is it your heart or your tumblers I'm hearing?
3901,0,8,85,93,1.086021505376344,0.02923328321807103,540,"“Could you holler when you hear the click?""'"
3902,2,5,98,105,1.0857142857142856,0.0334638991811172,540,"Sir, I really can't hear anything if you keep raving about crackers."
3902,0,9,96,105,1.0857142857142856,0.02745054065230065,540,G'vault! No heartbeat!
3902,0,9,96,105,1.0857142857142856,0.02745054065230065,540,"I understand that doctors make you feel unsafe, but..."
3902,1,7,97,105,1.0857142857142856,0.030605266952826823,540,This is not what is meant by putting problems 'out of sight and out of mind'.
3902,2,5,98,105,1.0857142857142856,0.0334638991811172,540,"Oh my, your heart sounds are so distant"
3902,0,9,96,105,1.0857142857142856,0.02745054065230065,540,"Don't worry,we'll find the combination to your heart."
3902,0,9,96,105,1.0857142857142856,0.02745054065230065,540,"Come on, the combination must be in an early memory!!"
3909,3,4,110,117,1.0854700854700854,0.033405425075860126,540,"Hillary's 33,000 emails covering yoga routines and Chelsea's wedding plans may be in here."
3910,1,5,76,82,1.0853658536585367,0.035567492543107565,540,I'm afraid you have AIDS.
3910,1,5,76,82,1.0853658536585367,0.035567492543107565,540,I hear some fluid cash in your main compartment.
3910,2,3,77,82,1.0853658536585367,0.039574747605718795,540,"It seems your only problem is you are too closed off. I would recommend opening up, in a few days you should start to feel more content and everyone around you will probably feel richer."
3913,0,8,86,94,1.0851063829787233,0.028935093578151216,540,"With 10 of you inside there wanting a check-up, you're just going to have to be a little more patient."
3913,0,8,86,94,1.0851063829787233,0.028935093578151216,540,You are a couch potato. A little Jung will make you safe.
3913,1,6,87,94,1.0851063829787233,0.0326499653871415,540,"Roger says he wasn't calling YOU a vulnerable, insecure bitch. He was just putting her engagement ring back. Now... left 25... right 37... left 18...."
3913,0,8,86,94,1.0851063829787233,0.028935093578151216,540,Money does talk. It says 'follow me.'
3913,0,8,86,94,1.0851063829787233,0.028935093578151216,540,I can't read my own combination.
3913,2,4,88,94,1.0851063829787233,0.03598334113429031,540,"So, let's start with an icebreaker."
3913,0,8,86,94,1.0851063829787233,0.028935093578151216,540,"I want to try you on Zoloft first, see if that helps you relax and open up"
3920,0,9,97,106,1.0849056603773586,0.027202361454431733,540,"now, now Mr Pilkington. Have you been eating my interns again?"
3920,2,5,99,106,1.0849056603773586,0.03315656054737697,540,You're safe1
3920,0,9,97,106,1.0849056603773586,0.027202361454431733,540,You’re heartless.
3920,1,7,98,106,1.0849056603773586,0.030325945789286015,540,Looks like your combination is 120 ... 80 ...
3920,1,7,98,106,1.0849056603773586,0.030325945789286015,540,... And so now I have a panic attack any time I see a millenial.
3920,1,7,98,106,1.0849056603773586,0.030325945789286015,540,Any yegg allergy?
3920,2,5,99,106,1.0849056603773586,0.03315656054737697,540,Now aren't you relieved you can afford a concierge doctor?
3927,0,11,119,130,1.0846153846153845,0.024503697126800623,540,"I'm sorry but I think your problem is psychological, not medical."
3928,1,5,77,83,1.0843373493975903,0.03515140534892228,540,Diagnosis is a heart of gold
3928,1,5,77,83,1.0843373493975903,0.03515140534892228,540,"When you're crackers, you come to the safe cracker."
3930,1,6,88,95,1.0842105263157895,0.03231687280010614,540,"Doc, you're a good yegg."
3930,1,6,88,95,1.0842105263157895,0.03231687280010614,540,"Zika? No, you're safe."
3930,0,8,87,95,1.0842105263157895,0.02864290665845136,540,I don't find any reason why you should no longer feel safe…
3930,1,6,88,95,1.0842105263157895,0.03231687280010614,540,Your health is totally safe.
3930,2,4,89,95,1.0842105263157895,0.03561382362667231,540,"Trust me, if we just make it feel comfortable it'll open right up."
3935,0,9,98,107,1.0841121495327102,0.02695861535441561,540,You're doing fine. Just don't let anyone get to you.
3935,1,7,99,107,1.0841121495327102,0.030051666926852676,540,One last question Doc; will the cost of fixing my ticker break the bank?
3935,2,5,100,107,1.0841121495327102,0.032854808298598374,540,Affordable Health Care Act...time of death...11/8/16.
3938,1,8,110,119,1.084033613445378,0.028191038356332146,540,your heart sounds weak we may have to remove the blockage
3939,0,9,99,108,1.0833333333333333,0.026719185044249912,540,I am detecting a safe space.
3939,1,5,78,84,1.0833333333333333,0.0347449246876021,540,"Alright, now let me hold your crank shaft and you cough."
3939,1,6,89,96,1.0833333333333333,0.03199049566457976,540,YOUR TUMBLERS ARE STRONG AND IN SYNC.AVOID RUST AND YOU WILL HAVE A LONG LIFE.
3939,2,4,90,96,1.0833333333333333,0.035251809293701954,540,"Are you hurting inside? Please tell me the password to your heart. Don't worry, I am not here to steal but to heal."
3939,0,8,88,96,1.0833333333333333,0.028356543640780014,540,I'm afraid your Hemochromatosis is getting worse.
3939,0,8,88,96,1.0833333333333333,0.028356543640780014,540,"There's no need to be embarrassed, anything we discuss is a matter of doctor-patient confidentiality. Now, tell me about your crack."
3939,1,7,100,108,1.0833333333333333,0.02978229534399722,540,Would a medication change would help you remember the combination?
3939,0,8,88,96,1.0833333333333333,0.028356543640780014,540,"Relax, deep breaths..."
3939,1,6,89,96,1.0833333333333333,0.03199049566457976,540,"Oh no, I hear a very erratic tick in your timer!"
3939,0,8,88,96,1.0833333333333333,0.028356543640780014,540,"Yes, you are perfectly safe for your removal procedure."
3939,1,8,111,120,1.0833333333333333,0.027963895623643823,540,"For the last time, you ARE made of money and this visit will be on YOUR dimes!"
3950,0,9,100,109,1.0825688073394495,0.026483957302276408,540,It takes time to unlock your inner vault voice.
3950,1,7,101,109,1.0825688073394495,0.02951770078607596,540,I'm still looking for the Banker's Heart.
3950,0,9,100,109,1.0825688073394495,0.026483957302276408,540,"Well, if you do have Alzheimer's, it's going to be very difficult recovering your combination code."
3950,1,7,101,109,1.0825688073394495,0.02951770078607596,540,"Sorry kitty, I need you hear if you are dead or alive."
3954,1,6,90,97,1.0824742268041236,0.03167063331815595,540,"Unfortunately, this chair can only hold 2000 pounds."
3954,0,8,89,97,1.0824742268041236,0.028075832711972844,540,Avoid butter and yeggs.
3954,2,4,91,97,1.0824742268041236,0.03489707218486238,540,"""It's crazy"", what people keep locked up in their hearts."
3957,1,8,113,122,1.0819672131147542,0.027520395398836644,540,My guess is that it's viral so I don't recommend antibiotics.
3958,1,7,102,110,1.0818181818181818,0.029257757557340232,540,Hm. Sounds like the worst case of zikaphobia I've ever heard.
3958,1,7,102,110,1.0818181818181818,0.029257757557340232,540,"Yeh, this is med school L1 - R0 - L1"
3958,2,5,103,110,1.0818181818181818,0.031981589214373426,540,"Prognosis is indeterminate. Daisy has no heart beat but is purring. ""Get me tuna. Don't open the box."""
3958,1,7,102,110,1.0818181818181818,0.029257757557340232,540,"""If you don't have Medicare, I hope you have enough to pay your bill""."
3958,1,7,102,110,1.0818181818181818,0.029257757557340232,540,"The bad news is, it is your tumblers. The good news is, with a little medication and rest everything will be all right."
3963,2,4,92,98,1.0816326530612246,0.034549395319879404,540,I won't be opening you up until I know what's going on in there
3963,0,8,90,98,1.0816326530612246,0.02780060872570408,540,I don't hear a thing. Maybe it all really did sink to the bottom.
3965,1,8,114,123,1.08130081300813,0.027303868910679735,540,"Actually, we both suffer from Confidentiality Agreement."
3966,1,7,103,111,1.0810810810810811,0.029002344323711324,540,Be SAFE!!!!
3967,1,6,92,99,1.0808080808080809,0.031049689453607518,540,"Transparency? Yes, there is a lot of concern about it this year."
3967,1,6,92,99,1.0808080808080809,0.031049689453607518,540,I can hear you Sneezy. Come out so I can treat you.
3967,1,6,92,99,1.0808080808080809,0.031049689453607518,540,"Come on now Mr Trump! a colonoscopy isn't so bad, don't lock yourself away like your taxes. Bridgebody.squarespace.com"
3967,0,8,91,99,1.0808080808080809,0.027530712883605927,540,It's safe to say the combination of iron and carbon has made it hard for me to crack open your illness.
3971,1,8,115,124,1.0806451612903225,0.027090716543423828,540,"I am a little concerned with your recent rapid weight gain"" ""Ya doc it's all these negative interest rates"
3972,0,7,80,87,1.0804597701149425,0.029330909862272565,540,Don't forget... we charge by the hour until we obtain your payment.
3972,1,5,81,87,1.0804597701149425,0.033579911847869605,540,"""Breath in, breath out"".. I told you, I forgot my combination code.."
3974,1,7,104,112,1.0803571428571428,0.028751343925678245,540,"The code is 6-6-6, so it must be Trump’s tax returns. Can’t wait to see what the analysis reveals."
3975,1,6,93,100,1.08,0.030748244591432296,540,"So, tell me, for how long have you been having flutters?"
3975,2,4,94,100,1.08,0.03387439663632029,540,Now just take a deep breath breath and exhale normally.
3975,1,6,93,100,1.08,0.030748244591432296,540,"I would like to unlock your heart, but, I can't find one!"
3975,0,8,92,100,1.08,0.027265992434429072,540,"This is not whet people mean by ""safe space."""
3975,0,8,92,100,1.08,0.027265992434429072,540,It's safe to say you have too much junk in the trunk.
3975,1,6,93,100,1.08,0.030748244591432296,540,Just relax. I was advised to check the health of my I.R.A. account.
3975,1,6,93,100,1.08,0.030748244591432296,540,"Deep breath. Hmm, you sound a little congested."
3975,1,6,93,100,1.08,0.030748244591432296,540,"Henry, I can hear you. You can come out now."
3983,0,9,104,113,1.079646017699115,0.025582941017507042,540,The daily lattes are really wearing down your ticker.
3983,2,5,106,113,1.079646017699115,0.031153531050193705,540,I recommend not invading the trust for at least 5 more years.
3983,1,7,105,113,1.079646017699115,0.028504643200719312,540,I can't hear a heartbeat.
3983,1,7,105,113,1.079646017699115,0.028504643200719312,540,You're blocking.
3987,0,7,81,88,1.0795454545454546,0.02901010034307146,540,You're complicated... I can't tell if it's fib or flutter
3987,1,5,82,88,1.0795454545454546,0.03320871785794785,540,I'm afraid I'm not able to detect what it will take to open you up.
3987,1,5,82,88,1.0795454545454546,0.03320871785794785,540,"I feel for you, there is too much in there"
3987,0,7,81,88,1.0795454545454546,0.02901010034307146,540,"""What was that Mr. Smith? You'll come out when?"
3991,2,4,95,101,1.0792079207920793,0.03354668187346023,540,Finding a soft spot for manipulation involves detecting the slightest whooshing of a heartbeat.
3991,0,8,93,101,1.0792079207920793,0.027006300390071,540,Nice coat. My gastro wears a ski mask.
3991,1,6,94,101,1.0792079207920793,0.03045258712718752,540,I hear a severe tumbler malfunction we call tumbleritis!
3991,1,6,94,101,1.0792079207920793,0.03045258712718752,540,You've got to learn to let go.
3991,1,6,94,101,1.0792079207920793,0.03045258712718752,540,Paul vaulting again? I'm going to have to prescribe a suppository for your repository.
3991,0,8,93,101,1.0792079207920793,0.027006300390071,540,You really need to watch what you put inside your body.
3997,2,3,84,89,1.0786516853932584,0.036526674251151636,540,Increased copays are causing doctors to go to extremes before seeing new patients.
3997,0,7,82,89,1.0786516853932584,0.02869621407125669,540,We just need to find a safe combination of medicines.
3999,2,4,96,102,1.0784313725490196,0.03322524070696413,540,Just checking the safe for a beat and making sure it has living presidents at the end of my examination.
3999,0,8,94,102,1.0784313725490196,0.026751495257385263,540,You're heart's desires are safe here.
3999,2,4,96,102,1.0784313725490196,0.03322524070696413,540,"As I suspected, it sounds like you have a HIPAA breach due to a raging case of unencrypted patient data combined with chronic unauthorized disclosure, creating a secondary infection of vulnerability to IT hacking incidents."
3999,1,6,95,102,1.0784313725490196,0.03016255226718731,540,What I am hearing from you is that we will only achieve a breakthrough if you will let yourself open up a little.
3999,1,6,95,102,1.0784313725490196,0.03016255226718731,540,Did you recently switch laundry detergents?
3999,0,8,94,102,1.0784313725490196,0.026751495257385263,540,"Ah, I don't think you could afford another robbery attack, so play it safe and retire."
4005,0,9,106,115,1.0782608695652174,0.02515497681219461,540,"Well, just don't pay any attention to those kids who say you're cracked."
4005,1,7,107,115,1.0782608695652174,0.028023707101644646,540,"Well, Mr. Capone's vault, the x-rays came back with nothing."
4005,1,7,107,115,1.0782608695652174,0.028023707101644646,540,"If you are really sorry, clap your paws together three times."
4008,1,8,119,128,1.078125,0.026270321623998942,540,Your heartbeat is strongest when Trump is up in the polls.
4009,2,3,85,90,1.0777777777777777,0.036129112962265536,540,How long has it been since your last wazoo-oscopy?
4009,0,7,83,90,1.0777777777777777,0.028389029979298108,540,"For the last time, please try to ease up on the screaming!"
4011,0,8,95,103,1.0776699029126213,0.02650144078476277,540,"""hmm, I suspect a ulcer if you don't stop worrying about feeling safe all the time""."
4011,0,8,95,103,1.0776699029126213,0.02650144078476277,540,I don't intend an invasive procedure
4011,0,8,95,103,1.0776699029126213,0.02650144078476277,540,Sounds like your starting to crack a cold
4011,1,6,96,103,1.0776699029126213,0.029877981403833992,540,The drugs are getting stronger every year.
4015,1,7,108,116,1.0775862068965518,0.02778926391163417,540,Let's make it rain
4016,3,4,122,129,1.0775193798449612,0.03036519305424884,540,My brother has a rent-stabilized safe deposit box on 19th St. Perhaps you could go in together on a Dumpster?
4017,2,4,98,104,1.0769230769230769,0.03260047286888297,540,I can hear the beat. But ...they say money and heart don't go together...'
4017,2,4,98,104,1.0769230769230769,0.03260047286888297,540,You never did pay your anesthesiologist Mr. Whipple.
4017,1,5,85,91,1.0769230769230769,0.032142726693744045,540,I hope you paid your deductible
4017,0,8,96,104,1.0769230769230769,0.02625600572254959,540,I'm detecting a hint of cynicism and a slight case of cliche.
4017,2,5,110,117,1.0769230769230769,0.030113857411010452,540,Are you sure this is HIPAA compliant?
4017,0,8,96,104,1.0769230769230769,0.02625600572254959,540,It helps me know when you are about to unlock and open up.
4017,1,7,109,117,1.0769230769230769,0.02755870446597473,540,Don't worry! It may take a while for you to express your innermost emotions.
4017,0,5,60,65,1.0769230769230769,0.033308669376324554,540,It's safe to say I have a PhD in unlocking insurance payments.
4017,1,6,97,104,1.0769230769230769,0.029598721828630804,540,Knock three times on the ceiling if you want me. Twice on the pipe if the answer is 'no'.
4026,1,6,98,105,1.0761904761904761,0.029324626460989652,540,Turn and caught while I grab your nuggets.
4026,0,8,97,105,1.0761904761904761,0.026015063596431805,540,"You're perfectly normal, other than white-coat syndrome."
4026,0,8,97,105,1.0761904761904761,0.026015063596431805,540,It sounds like pins and needles.
4026,1,6,98,105,1.0761904761904761,0.029324626460989652,540,I think its time for you to place your holdings in a safe bank
4026,1,6,98,105,1.0761904761904761,0.029324626460989652,540,Let's work on breaking through your body armor.
4026,1,6,98,105,1.0761904761904761,0.029324626460989652,540,"Oh come on, Mr. Stumpf! You know what the word ""feelings"" means."
4026,0,8,97,105,1.0761904761904761,0.026015063596431805,540,Therapist says feelin' empty in this case may be a physical thing
4026,2,4,99,105,1.0761904761904761,0.03229680944345366,540,"This is your free annual Medicare physical, so I can't address any complaints."
4026,2,4,99,105,1.0761904761904761,0.03229680944345366,540,"You're on the mend, and definitely not sorry."
4026,0,8,97,105,1.0761904761904761,0.026015063596431805,540,No. I don't have theft insurance. Why do you ask?
4026,0,8,97,105,1.0761904761904761,0.026015063596431805,540,I am trying to unlock your inner secrets to find out why you feel you are trapped in a box
4026,1,6,98,105,1.0761904761904761,0.029324626460989652,540,"Uh, I really, really do respect your privacy but it's kind of hard to treat you if I can't see you."
4038,1,5,86,92,1.076086956521739,0.03180242267428119,540,"The worst case scenario is that I will not be able to unlock you. No need to worry. In the interim we will check you for overdose of cash, jewels, or stock certificates."
4038,0,7,85,92,1.076086956521739,0.02779392999764994,540,It sounds as though you're having investment envy.
4038,1,5,86,92,1.076086956521739,0.03180242267428119,540,You'll need a combination of treatment and medication to get to a safe place.
4038,0,7,85,92,1.076086956521739,0.02779392999764994,540,"I know you’re in there somewhere. So come on out, come on, don’t be afraid."
4042,0,6,73,79,1.0759493670886076,0.02999595287390335,540,Your heart belongs to Donald Trump?!
4042,1,4,74,79,1.0759493670886076,0.034990386303048154,540,I'm not hearing any diamonds. Would you now go to 37?
4044,0,9,110,119,1.0756302521008403,0.024340507680318108,540,"Sir, change your password, immediately; or else…"
4045,0,8,98,106,1.0754716981132075,0.025778492492980108,540,Hardly worth the reimbursement.
4045,0,8,98,106,1.0754716981132075,0.025778492492980108,540,You have an acute case of hemochromatosis.
4045,0,8,98,106,1.0754716981132075,0.025778492492980108,540,"If you don't tell your Dr. what your magic numbers are, I will rip your beating heart out."
4045,1,6,99,106,1.0754716981132075,0.029055553591831505,540,"Ok Jerry, now what exactly did Elaine tell you about George and Kramer?"
4045,0,8,98,106,1.0754716981132075,0.025778492492980108,540,You are the first person where I had to unlock more than your heart.
4050,0,7,86,93,1.075268817204301,0.02750561649383918,540,I'm afraid to say but you have incurable 'Locked in syndrome '.
4050,0,7,86,93,1.075268817204301,0.02750561649383918,540,"Sorry, I'm just a first-year resident, so I can't crack you open myself; but the supervising M.D. should be here any minute."
4050,0,7,86,93,1.075268817204301,0.02750561649383918,540,Free consultation for overweights
4050,1,5,87,93,1.075268817204301,0.031469239415701566,540,Do you have a lot of grease in your diet?
4054,1,4,75,80,1.075,0.03456327897009421,540,I don't think you are safe.........
4055,0,8,99,107,1.074766355140187,0.025546174856603016,540,"Yes, I do hear the voices saying, 'Fill me with more and more money.' Obviously, you are correct in choosing to run for Congress."
4055,0,8,99,107,1.074766355140187,0.025546174856603016,540,I sense a heart of gold within you...
4055,2,4,101,107,1.074766355140187,0.03170612774077673,540,Im afraid I'm going to have to do surgery to see what is wrong.
4058,2,3,89,94,1.074468085106383,0.03462173176941414,540,"25, 42, and... fall allergies."
4058,1,5,88,94,1.074468085106383,0.031142956046401403,540,You can opun up to me... steel yourself... dial in your feelings... this is a safe place.
4058,1,5,88,94,1.074468085106383,0.031142956046401403,540,I'd like to see a surgeon do this.
4058,1,5,88,94,1.074468085106383,0.031142956046401403,540,"Well you do present a diagnostic enigma, don't you?"
4062,1,6,101,108,1.0740740740740742,0.028531933927964475,540,The Trump campaign has released a photo from the candidate's recent cardiovascular exam
4062,0,8,100,108,1.0740740740740742,0.025317997297209745,540,I'd avoid heavy stretching
4062,1,6,101,108,1.0740740740740742,0.028531933927964475,540,"So, you have forgotten your password?"
4062,1,4,76,81,1.0740740740740742,0.03414646095293662,540,"Hi, my name is Dorothy. I used to be friends with your father the Tin Man before I went to Metallical School."
4066,0,9,113,122,1.0737704918032787,0.023763366198363604,540,"You're safe now, Mr. Fenton."
4067,0,7,88,95,1.0736842105263158,0.026946528542342727,540,Your personal health details are safe with me...sealed in a vault. Your opponent will never know of them.
4067,1,5,89,95,1.0736842105263158,0.030823360722295908,540,Don't hear anything—cold cash.
4067,1,5,89,95,1.0736842105263158,0.030823360722295908,540,"I hear two heartbeats, so obviously you didn't practice safe sex."
4070,0,8,101,109,1.073394495412844,0.025093850407933077,540,"Once more, which lives matter?"
4070,0,8,101,109,1.073394495412844,0.025093850407933077,540,I'm here to help you unload what's been weighing you down. Rest assured it will be safe with me.
4072,0,6,76,82,1.0731707317073171,0.028935171414719005,540,I voted against cancellation fees.
4072,2,2,78,82,1.0731707317073171,0.037940379403794036,540,Inhale... Exhale... Open up your chest... Deep breath...
4072,1,7,115,123,1.0731707317073171,0.02625176626850195,540,It's good that you came at the drop of a dime.
4075,0,7,89,96,1.0729166666666667,0.026675402900107063,540,Money speaks.
4075,0,7,89,96,1.0729166666666667,0.026675402900107063,540,Under your current health plan excessive greed is not covered.
4077,1,6,103,110,1.0727272727272728,0.02802682769670462,540,"Sorry, you're still more than a heartbeat away from the Presidency."
4077,1,6,103,110,1.0727272727272728,0.02802682769670462,540,Your parentèle controls really did a number on you
4079,2,5,117,124,1.0725806451612903,0.028452036323225297,540,Lift up your shirt so I can listen to your heart
4080,0,7,90,97,1.0721649484536082,0.02640966692257628,540,"I don't know, I just don't feel safe anymore doc... - You really need to open up more often"
4080,0,7,90,97,1.0721649484536082,0.02640966692257628,540,"Now, turn your head and cough."
4080,1,5,91,97,1.0721649484536082,0.0302034292633109,540,Does the fact that I'm paying my own bill affect how the hospital sees me?
4080,1,5,91,97,1.0721649484536082,0.0302034292633109,540,"Come on, open up– I know you’ve got some gold in there for me."
4080,0,7,90,97,1.0721649484536082,0.02640966692257628,540,I'm afraid the Fed's going to cut off my life support!
4085,0,8,103,111,1.072072072072072,0.02465722990032265,540,Are you there God? It's me.
4085,0,8,103,111,1.072072072072072,0.02465722990032265,540,I will keep you in a safe place; my next appointment is in 10 minutes.
4087,1,7,117,125,1.072,0.025843199642109637,540,"What caused you to be angry and bitter today? I will treat your broken heart, so now open up to me."
4088,0,6,78,84,1.0714285714285714,0.028268619114727778,540,Today's combination is something to eat.
4088,1,6,105,112,1.0714285714285714,0.027539271462716404,540,You are keeping to much inside. It's a cancer.
4088,1,6,105,112,1.0714285714285714,0.027539271462716404,540,Code green!
4088,1,5,92,98,1.0714285714285714,0.029902710610083878,540,Shouldn't you use anesthesia if you're going to open me up?
4088,0,8,104,112,1.0714285714285714,0.02444455587287331,540,Yeah sure. I can recommend you this very good proctologist friend of mine.
4088,0,7,91,98,1.0714285714285714,0.02614916186239279,540,It's hard to hear from out here. You can come out -- you're in a safe zone.
4088,0,7,91,98,1.0714285714285714,0.02614916186239279,540,I think its heart is no longer functioning.
4088,1,5,92,98,1.0714285714285714,0.029902710610083878,540,I prefer to skip the insurance paperwork.
4088,1,5,92,98,1.0714285714285714,0.029902710610083878,540,"Mr. Lee, I know you don't want your prostate exam, but I'm very gentle."
4088,1,5,92,98,1.0714285714285714,0.029902710610083878,540,I think it's time we discuss stress.
4098,0,8,105,113,1.0707964601769913,0.02423551139403392,540,"Mr. Pence, you are a heart beat from the President"
4099,2,3,94,99,1.0707070707070707,0.0329054956738568,540,Try again. I didn't quite get that.
4099,0,7,92,99,1.0707070707070707,0.02589373512976387,540,"Of course I am Veterinarian not a Doctor; but I think I can get it open for you,"
4099,0,7,92,99,1.0707070707070707,0.02589373512976387,540,"HOUSTON, WE HAVE A PROBLEM"
4102,0,6,79,85,1.0705882352941176,0.027946704450951078,540,"Nope! Not a time bomb, you've got a heart if gold."
4103,3,3,122,128,1.0703125,0.029728913302898573,540,"""OMyGod! I'm hearing, TRUMP TRUMP TRUMP along side of TICK TICK TICK""!"
4104,2,4,108,114,1.0701754385964912,0.029798521925766992,540,"Come on out Mr. Philpot, there is no one else here to see your ugly face"
4104,0,8,106,114,1.0701754385964912,0.02403000455077891,540,"Mr. Hodges agrees to your terms; let him out, and you get safety."
4106,0,7,93,100,1.07,0.025643239997624287,540,"Left 31, Right 18, Left 9 -- okay open up!"
4106,0,7,93,100,1.07,0.025643239997624287,540,"Sorry doc, I'm a heavy breather."
4106,1,5,94,100,1.07,0.029318866956210297,540,Your secret is safe with me. Have you been taking the blood pressure medicine?
4106,1,5,94,100,1.07,0.029318866956210297,540,"Lets just see what's going on with that heart of gold. As you said, ""Better safe than sorry."""
4106,1,5,94,100,1.07,0.029318866956210297,540,It's a safe bet this is locked deeply indies you.
4106,0,7,93,100,1.07,0.025643239997624287,540,Stay away from political campaign money. There are only a few good clicks left in you.
4106,1,5,94,100,1.07,0.029318866956210297,540,Please caugh!
4106,0,7,93,100,1.07,0.025643239997624287,540,It appears the nest egg has expired.
4114,2,4,109,115,1.0695652173913044,0.029544570346930272,540,Mr. William Devane?
4115,0,7,94,101,1.0693069306930694,0.025397535323526052,540,"I'd like you to keep taking them for another week, just to be safe."
4115,0,7,94,101,1.0693069306930694,0.025397535323526052,540,"Sorry, your insurance doesn’t cover the good Xanax."
4115,0,7,94,101,1.0693069306930694,0.025397535323526052,540,I feel like you're resisting my attempts to get to past your defensive nature.
4115,1,5,95,101,1.0693069306930694,0.029035402571515205,540,This operation is not very safe.
4119,0,6,81,87,1.0689655172413792,0.027324338472174546,540,Your feelings of entitlement have isolated your lock tumblers.
4119,1,6,109,116,1.0689655172413792,0.026613277820985957,540,"""Sorry, going down there isn't covered by your Annual."" '"
4119,1,6,109,116,1.0689655172413792,0.026613277820985957,540,I'm sure we can crack the code to figure out what your ailments are
4119,1,6,109,116,1.0689655172413792,0.026613277820985957,540,"At least it sounds like your cough is better, Mr. Cruthers"
4123,2,3,97,102,1.0686274509803921,0.03195501327699658,540,I think you need a wheel pack transplant.
4123,0,7,95,102,1.0686274509803921,0.025156485287162588,540,"A vegetarian diet is fine, but you need to make sure to get enough iron."
4123,1,5,96,102,1.0686274509803921,0.028757361018843988,540,I should have brought the EKG.
4123,0,7,95,102,1.0686274509803921,0.025156485287162588,540,I've seen this locked-in syndrome before. Now breathe in and or through your mouth.
4123,0,7,95,102,1.0686274509803921,0.025156485287162588,540,I assure you. Obamacare is quite androgynous.
4128,0,8,109,117,1.0683760683760684,0.023433835993969022,540,"I agree that a panic attack could be natural and not psychosomatic, given your line of work."
4128,1,6,110,117,1.0683760683760684,0.026391416894891634,540,Are you paying by monthly salary or yearly?
4130,0,6,82,88,1.0681818181818181,0.02702341637863115,540,"You can't keep your feelings about the election to yourself , Mr. Undecided."
4131,0,7,96,103,1.0679611650485437,0.024919959142514478,540,"Mr. Smith, your diet isn't quite the winning combination."
4131,1,5,97,103,1.0679611650485437,0.02848458833762835,540,It's not what you think it is Mr. Trump.
4131,1,5,97,103,1.0679611650485437,0.02848458833762835,540,You should exercise regularly and have more lettuce.
4131,2,3,98,103,1.0679611650485437,0.031650263535454415,540,It is not necessary to have a Safe Cracker to expose Donald Trump's despicable character.
4131,1,5,97,103,1.0679611650485437,0.02848458833762835,540,I'm afraid you will need two valves repaired.
4136,1,6,111,118,1.0677966101694916,0.02617322020845467,540,"So it's not about you, it's about me?"
4137,0,6,83,89,1.0674157303370786,0.0267290380145649,540,Ooh. Cold on my ears.
4137,0,6,83,89,1.0674157303370786,0.0267290380145649,540,I know! I can only be paid if solve this problem.
4137,0,6,83,89,1.0674157303370786,0.0267290380145649,540,There's your heart of gold
4137,1,4,84,89,1.0674157303370786,0.031141677669920615,540,I'm sure it's a time bomb—who would want to hurt you?
4141,1,5,98,104,1.0673076923076923,0.02821693633378369,540,You sound pretty congested.
4141,0,7,97,104,1.0673076923076923,0.024687830983678844,540,Are you feeling safe in there?
4141,0,7,97,104,1.0673076923076923,0.024687830983678844,540,I think you might need to see Dr. Freud for these kind of symptoms.
4144,1,4,85,90,1.0666666666666667,0.030802824262100497,540,"It's a monument, he just loves bagels."
4144,1,4,85,90,1.0666666666666667,0.030802824262100497,540,Didn't I warn you about safe sleep?
4144,0,6,84,90,1.0666666666666667,0.026440992651270086,540,"Don't worry, I can SAFE you."
4144,0,6,84,90,1.0666666666666667,0.026440992651270086,540,Knock three times on the ceiling if you want out.
4148,0,7,99,106,1.0660377358490567,0.024236287884273826,540,My husband who is also a Doctor taught me how to do this.
4148,0,7,99,106,1.0660377358490567,0.024236287884273826,540,"Safe to say, Seinfeld knows your situation."
4150,1,4,86,91,1.065934065934066,0.030471259110747873,540,"I know we discussed this last time, but you really need to get serious about trimming the fat if you want to be able to compete in this economy."
4150,0,6,85,91,1.065934065934066,0.026159078492830955,540,I know that heart of gold is in there somewhere!
4150,1,4,86,91,1.065934065934066,0.030471259110747873,540,"You are not sick, just chic."
4150,1,4,86,91,1.065934065934066,0.030471259110747873,540,Your right and left ventricles sound good but I'm concerned about the one back to the right again.
4150,2,2,87,91,1.065934065934066,0.03424467660811793,540,..99 bottles of beer on the wall.. 99 bottles of beer..
4150,1,4,86,91,1.065934065934066,0.030471259110747873,540,Your Medicare eligible? There's nothing inside!
4150,0,6,85,91,1.065934065934066,0.026159078492830955,540,But I can;t help you if you stay in your safety zone
4157,2,4,116,122,1.0655737704918034,0.027881202584008512,540,"9. . .8. . .7. . .sss. . .[sigh.] I promise you, Mr. Smith, when I open my eyes, you will not have turned into a combination safe with the cure for my frigidity inside."
4158,0,7,100,107,1.0654205607476634,0.02401664339953488,540,The level of cholesterol in your blood has risen to an unsafe level.
4158,0,7,100,107,1.0654205607476634,0.02401664339953488,540,"Hardening of the arteries, not surprisingly, which no stent can remedy."
4160,1,4,87,92,1.065217391304348,0.030146749794849395,540,"You 'hear a slight click?'...'increased chance of internal exposure?' Doc', speak in terms I can understand! How much will I lose?"
4161,2,4,117,123,1.065040650406504,0.027658735525258344,540,"After it's failed pole-vaulting accident the doctor advises her patient then even though a good combination of activities is ideal in life, sometimes self-preservation is key."
4162,0,7,101,108,1.0648148148148149,0.023800937426629188,540,It's hard to make ends meet these days with only one job.
4162,0,7,101,108,1.0648148148148149,0.023800937426629188,540,We'll get back to womb trauma next time. Now you really must go.
4162,0,7,101,108,1.0648148148148149,0.023800937426629188,540,Insurance prior authorizations are such a pain in the ass.
4162,1,5,102,108,1.0648148148148149,0.02719475848237172,540,It looks like you have pneumonia. I'm a bad doctor.
4162,1,5,102,108,1.0648148148148149,0.02719475848237172,540,Possibly a bit of upper-bracketial congestion.
4162,1,5,102,108,1.0648148148148149,0.02719475848237172,540,Better save that. We'll need it for the autopsy!
4168,1,4,88,93,1.064516129032258,0.02982907366236422,540,"Well, technically, Trump's office visit payment was made on time ..."
4168,1,4,88,93,1.064516129032258,0.02982907366236422,540,I don't like the sound of your tumbler. I am going to call in Dr. Yegg for a second opinion.
4170,0,7,102,109,1.0642201834862386,0.02358906516902373,540,"If dogs are man's best friend, you must be my ex girlfriend."
4170,1,5,103,109,1.0642201834862386,0.02695067087951537,540,Calmly...calmly. No need to get excited...We have a very reasonable co-pay...
4170,1,5,103,109,1.0642201834862386,0.02695067087951537,540,Believe this is a case of residual toxic loans.
4173,1,4,89,94,1.0638297872340425,0.0295180173228277,540,Don't worry--I have the key to your heart.
4173,0,6,88,94,1.0638297872340425,0.02534822966728812,540,Crackin
4175,0,7,103,110,1.0636363636363637,0.023380925507988964,540,"Diagnosis:Pneumonia. But, sturdy and durable."
4175,1,5,104,110,1.0636363636363637,0.026710921904774393,540,Unlock your inner demons.
4175,0,7,103,110,1.0636363636363637,0.023380925507988964,540,I'm also a board-certified Lawn Doctor.
4175,1,5,104,110,1.0636363636363637,0.026710921904774393,540,Your secret's safe with me Sig.
4179,0,5,74,79,1.0632911392405062,0.027569346349343597,540,Disgruntled storyboard artist reveals The Hurt Locker was originally conceived as an animated feature.
4180,1,4,90,95,1.063157894736842,0.029213376171221134,540,"With this economy, you're not getting enough nourishment."
4180,0,6,89,95,1.063157894736842,0.025088985264210828,540,"Oh dear, there's just something obvious about emptiness, even when you try to convince yourself otherwise."
4182,0,7,104,111,1.063063063063063,0.023176420843012604,540,Just to be safe we'll check you for arrhythmia.
4182,0,7,104,111,1.063063063063063,0.023176420843012604,540,Oh! Your feelings are so locked in.
4184,0,8,119,127,1.062992125984252,0.021643599084607144,540,"Relax, I don't see a problem with extra billing."
4185,0,6,90,96,1.0625,0.02483498169496957,540,Did you hear about the doctor who was arrested for moonlighting?
4185,0,6,90,96,1.0625,0.02483498169496957,540,You're saying 'comfort zone' and I'm hearing insecure.
4185,0,6,90,96,1.0625,0.02483498169496957,540,Your problem is that you have no heart.
4185,2,3,107,112,1.0625,0.029148275135450867,540,"I understand that you are tired of weighing a ton but I predict that once we get to 10-24-16, you will deliver a healthy bundle of cash."
4185,1,4,91,96,1.0625,0.028914953940885134,540,You don't need more closure. I've got your number. You think you're in a safe place
4185,1,4,91,96,1.0625,0.028914953940885134,540,"Hey Doc, it's my job ..."" ""Keeping everything locked up is no way to live. It's just not safe."
4185,1,4,91,96,1.0625,0.028914953940885134,540,"Okay, calm down, I'll get you out. One more time, 33 Bernie clicks to the left, 25 Clinton clicks to the right, and how many FUBAR clicks to the right?"
4185,1,4,91,96,1.0625,0.028914953940885134,540,Now just breathe normally.
4185,2,2,92,96,1.0625,0.03248650192029828,540,"Honestly, It looks like you have 'Geraldo Rivera', nothing to worry about, nothing there!"
4185,1,4,91,96,1.0625,0.028914953940885134,540,"As dead as your presidency, Mr. Gore."
4185,0,7,105,112,1.0625,0.02297545694043149,540,"Billy! Billy, listen to me! You have to give this up. ""Safe...the final frontier"" is just NOT a good idea for a TV show."
4196,0,7,106,113,1.0619469026548674,0.02277794278979425,540,Try again. You have the wrong combination.
4197,1,4,92,97,1.0618556701030928,0.028622562283432445,540,"I hear what you, but I need you to open up more."
4197,0,6,91,97,1.0618556701030928,0.024586061892189325,540,Am I getting warmer?
4197,2,2,93,97,1.0618556701030928,0.032156301155004986,540,A combination of spit and polish and you'll be fine!
4197,1,4,92,97,1.0618556701030928,0.028622562283432445,540,"Yes, you do have a heart of gold and I can help you unlock it."
4197,2,2,93,97,1.0618556701030928,0.032156301155004986,540,It's safe to say you have cancer.
4202,1,5,108,114,1.0614035087719298,0.02579308021553167,540,Just click a little deeper and think of happier thoughts.
4202,0,7,107,114,1.0614035087719298,0.02258379046749838,540,"Well, no, we'll have to get rid of the a-fib first, before we can go in and get it. I'm sure it's growing, though."
4204,1,5,109,115,1.0608695652173914,0.025573383503554075,540,It's safe to say - you have a serious problem here.
4204,0,7,108,115,1.0608695652173914,0.022392915007277005,540,I see you've never been heart broken. Excellent!
4204,0,7,108,115,1.0608695652173914,0.022392915007277005,540,Yes ... the heartbeat of a perfectly robust Powerball winner! Just go easy on the little purple pills ...
4207,0,6,93,99,1.0606060606060606,0.0241028760295672,540,"I keep getting blamed, but it's not me. It's them."
4207,1,4,94,99,1.0606060606060606,0.028055154538562173,540,"As your O.M.G, I cannot hear a heartbeat. You are no longer safe in my care!"
4207,0,6,93,99,1.0606060606060606,0.0241028760295672,540,"Did you get your flu vaccine?"" ""No, my insurance didn't cover it."
4207,0,6,93,99,1.0606060606060606,0.0241028760295672,540,It's safe to say your doing a terrific job protecting your heart.
4207,1,4,94,99,1.0606060606060606,0.028055154538562173,540,New and improved provider reimbursement under Obamacare.
4207,0,6,93,99,1.0606060606060606,0.0241028760295672,540,I was worried you might not get this whole shrink ray thing.
4213,0,7,109,116,1.0603448275862069,0.02220523427713811,540,"Sam, I can hardly hear anything.. Told you to stop analyzing the Trump business ...."
4213,0,7,109,116,1.0603448275862069,0.02220523427713811,540,You are headed for a safe cracking.
4213,0,7,109,116,1.0603448275862069,0.02220523427713811,540,"Lub Dub Kaching, Lub Dub Kaching."
4216,0,5,78,83,1.0602409638554218,0.02627527589820373,540,I don't like the way your passport sounds. I'm going to call the airport to get your contents scanned.
4217,0,6,94,100,1.06,0.0238683256575942,540,"Doc, where am I going to find gluten free junk bonds?"
4217,0,6,94,100,1.06,0.0238683256575942,540,"A locked heart chakra, you say?"
4217,0,6,94,100,1.06,0.0238683256575942,540,The rare financial banker checking his finances
4217,0,6,94,100,1.06,0.0238683256575942,540,Ready for your pre-election check-up?
4221,0,7,110,117,1.0598290598290598,0.022020668862385094,540,Is telling him that he has heart disease the combination?
4222,0,5,79,84,1.0595238095238095,0.025970494292140555,540,Take a deep breath... same thing worked on my husband.
4223,0,6,95,101,1.0594059405940595,0.023638289873887774,540,Just to be safe we better unlock the psyche.
4223,0,6,95,101,1.0594059405940595,0.023638289873887774,540,"No, Mr. Daniels. Now, of course, I don't hear the murmur."
4223,0,6,95,101,1.0594059405940595,0.023638289873887774,540,Mrs. Clinton? Mr. Trump? Anybody there?
4223,1,4,96,101,1.0594059405940595,0.02750979007811843,540,I'm afraid I have bad news--your money pressure is way too high. I recommend a money-ectomy.
4223,0,6,95,101,1.0594059405940595,0.023638289873887774,540,Perhaps you might be a little paranoid schizophrenia.
4228,0,7,112,119,1.0588235294117647,0.02166057924466644,540,Just relax. I want you to open up and stick out your tongue.
4228,2,2,98,102,1.0588235294117647,0.030601075512358165,540,You will re-cover you are a very strong BOX
4228,0,6,96,102,1.0588235294117647,0.023412639769646793,540,Stethoscope trauma you reckon Doc?
4231,0,6,97,103,1.058252427184466,0.023191251289830905,540,Quinoa is more hands on than spelt.
4231,0,6,97,103,1.058252427184466,0.023191251289830905,540,I didn't think your secrets were this deep.
4231,1,4,98,103,1.058252427184466,0.026985209754375555,540,"Of course, Sidney...but if you really want to be alive...."
4231,0,6,97,103,1.058252427184466,0.023191251289830905,540,Your coming down with a case of the Stumpf. No wonder you're not feeling so secure!
4235,0,7,114,121,1.0578512396694215,0.02131206108797954,540,Your problem is that you have no soul.
4236,0,6,98,104,1.0576923076923077,0.0229740050072309,540,"My parents told me to be a valuable part of society, but enough is enough, I don't need a shrink, call the Mob."
4236,0,6,98,104,1.0576923076923077,0.0229740050072309,540,...and one more deep breath.
4236,1,4,99,104,1.0576923076923077,0.026730346115573952,540,Part of my internship/residency requirement! And success pays the tuition.
4236,0,6,98,104,1.0576923076923077,0.0229740050072309,540,I'd suggest a safe combination of real numbers.
4236,0,6,98,104,1.0576923076923077,0.0229740050072309,540,I hear nothing; perhaps under the floorboards.
4236,0,6,98,104,1.0576923076923077,0.0229740050072309,540,"I know he said he left his heart in San Francisco, but this is ridiculous."
4236,1,4,99,104,1.0576923076923077,0.026730346115573952,540,Calm down and breathe deeply?
4243,1,3,83,87,1.0574712643678161,0.02995283577189294,540,Take a thorough spin.
4244,1,5,116,122,1.0573770491803278,0.02413432897272973,540,"Breath in, breath out. Feel yourself becoming smaller."
4245,1,4,100,105,1.0571428571428572,0.026480248457037097,540,"Money never sleeps, but Wall Street people do, son."
4245,0,6,99,105,1.0571428571428572,0.02276078590901976,540,"Sorry to report that you've been hacked and your identity compromised. You are no longer the devious, narcissistic, deplorable excuse for a man. Instead, you are now a sweet, sensitive, loving and charming human being. That will be $5,000 please."
4245,0,6,99,105,1.0571428571428572,0.02276078590901976,540,I see you're going through the change of life.
4245,0,6,99,105,1.0571428571428572,0.02276078590901976,540,I suspect your symptoms are not physical. Might I recommend a good counselor?
4245,0,6,99,105,1.0571428571428572,0.02276078590901976,540,"And how long have you had this ""safe feeling"" about your health?"
4250,0,5,83,88,1.0568181818181819,0.024818855464885405,540,"Unfortunately your insides are hollow. I've only seen this once before, in someone I can only reveal as the current GOP presidential candidate."
4250,0,5,83,88,1.0568181818181819,0.024818855464885405,540,"Exhale, relax. In no time, we will whisk you to a safe space."
4250,1,3,84,88,1.0568181818181819,0.02961770764999516,540,"Trust me, I'm a doctor. I'm not a Hollywood trope."
4253,1,4,101,106,1.0566037735849056,0.026234784420898372,540,"Do I detect a ""broken open"" heart?"
4254,1,3,85,89,1.0561797752808988,0.029289991744514136,540,Should I call the coroner or the morgue?
4254,1,3,85,89,1.0561797752808988,0.029289991744514136,540,Trickle down is bedwetting.
4256,0,6,101,107,1.0560747663551402,0.022345990086729082,540,Maybe Major League Baseball turned you down because all your calls were safe.
4256,0,6,101,107,1.0560747663551402,0.022345990086729082,540,I'm afraid we'll have to crowdsource the results.
4256,0,6,101,107,1.0560747663551402,0.022345990086729082,540,Nothing is safe during the sick wconomy.
4259,1,3,86,90,1.0555555555555556,0.02896944496966529,540,tick tick tick to your soul
4259,0,6,102,108,1.0555555555555556,0.022144203647078017,540,It grieves me to tell you that you have but one final click left in our capitalistic world...
4259,0,5,85,90,1.0555555555555556,0.024280462345539,540,I still recommend losing some weight. You just haven't shown the activity level to be a Sumo.
4259,1,3,86,90,1.0555555555555556,0.02896944496966529,540,Looks like pneumonia. Have you been to any rallies lately?
4259,0,6,102,108,1.0555555555555556,0.022144203647078017,540,"For the hundredth time, I haven't seen Marathon Man."
4259,0,5,85,90,1.0555555555555556,0.024280462345539,540,Try a more balanced diet . . . your acid test ratio is too low.
4259,0,5,85,90,1.0555555555555556,0.024280462345539,540,Hold on Jack in the box. I hear your heartbeat
4266,0,6,103,109,1.055045871559633,0.021946024609185516,540,"Take a deep breath, then exhale."
4267,0,5,86,91,1.054945054945055,0.024019921334439576,540,Think about spending a little more time with your family.
4268,1,4,105,110,1.0545454545454545,0.025296782642673453,540,MY ? BEATS 4 U!!
4268,0,6,104,110,1.0545454545454545,0.02175135721461623,540,I'm finding it difficult to decipher your feelings.
4268,0,6,104,110,1.0545454545454545,0.02175135721461623,540,"But Truth, you must come out even if big media is threatening to you."
4271,0,5,87,92,1.0543478260869565,0.02376490622713203,540,I have good news and bad news. The bad news is you have gold fever. The good news is you're chock full of gold!
4271,1,3,88,92,1.0543478260869565,0.028348938449680054,540,"Don't worry, this one's free."
4271,0,5,87,92,1.0543478260869565,0.02376490622713203,540,"You know, I've heard a lot of hearts beat in my day, but never one so quiet that it sounded like an empty chamber."
4271,0,5,87,92,1.0543478260869565,0.02376490622713203,540,Sounds good! Doing better than being sorry!
4275,0,6,105,111,1.054054054054054,0.021560109059931505,540,"If this doesn't work, we'll try hypnotherapy."
4275,0,6,105,111,1.054054054054054,0.021560109059931505,540,"Change your diet, if you want to be safe."
4275,0,6,105,111,1.054054054054054,0.021560109059931505,540,"Alcohol, drugs - it's a deadly combination, and your addiction is something that you simply must crack."
4278,0,5,88,93,1.053763440860215,0.02351524327248115,540,I am sorry to tell you this but your heart is only made of tin.
4278,0,5,88,93,1.053763440860215,0.02351524327248115,540,This isn't Kansas and there is no Wizard of Oz who works here sorry to say.
4278,0,5,88,93,1.053763440860215,0.02351524327248115,540,"Pickles, in 10s and 20s."
4278,0,5,88,93,1.053763440860215,0.02351524327248115,540,sure its weak but not as weak as the signal from the Fed
4278,0,5,88,93,1.053763440860215,0.02351524327248115,540,This is so cold that it could be a door to Narnia.
4283,1,3,90,94,1.053191489361702,0.027754443713926897,540,"This is the captain speaking. Abandon ship, your valuables are safe with me."
4284,1,4,108,113,1.0530973451327434,0.02463612549924788,540,Relax. No inside job going on. This time either.
4285,0,5,90,95,1.0526315789473684,0.023031314447036,540,"I know you are stressed by your responsibility, so I will help you this time, but you must remember in the future."
4285,0,5,90,95,1.0526315789473684,0.023031314447036,540,Don't worry. I'll have you out in a beat.
4285,0,5,90,95,1.0526315789473684,0.023031314447036,540,Is it safe to be here?
4285,0,5,90,95,1.0526315789473684,0.023031314447036,540,Better cancel trip to Monaco for this season.
4285,1,4,109,114,1.0526315789473684,0.024423504473014248,540,"Well Mr Carney, your ticker's working perfectly fine, the capacity of your coffer to recover after our sustained inflation exercises is good...but you might want to gain a few pounds if the the larger exports will each need reposistioning!"
4285,1,4,109,114,1.0526315789473684,0.024423504473014248,540,I'm going to referral you to a chiropractor. I believe he'll be able to crack out the kinks.
4291,1,3,92,96,1.0520833333333333,0.02718435948454175,540,"Not every form of retention poses a serious long-term threat but I'm afraid if we continue experiencing symptoms of discomfort, a quick in-and-out is the only real option."
4291,0,5,91,96,1.0520833333333333,0.02279673562093397,540,You are going to have to unlock your heart before anyone can hear it.
4291,0,5,91,96,1.0520833333333333,0.02279673562093397,540,I'm getting a rousing confirmation that safe dwelling is good for mental health.
4291,0,5,91,96,1.0520833333333333,0.02279673562093397,540,"Breathe in, breathe out."
4295,0,6,110,116,1.0517241379310345,0.02065213990098335,540,"your pulse does not sound very ""safe"""
4295,1,4,111,116,1.0517241379310345,0.02400907994844967,540,"""Agora""? I suppose because the ancient Greeks had marketplaces but didn't have locking safes."
4297,0,5,92,97,1.0515463917525774,0.022566882365229714,540,"Yes, you have found an air pocket"
4297,0,5,92,97,1.0515463917525774,0.022566882365229714,540,You've been devouring far too many loopholes.
4297,1,3,93,97,1.0515463917525774,0.0269080064662643,540,"I play the lotto everyday, I think I know what I'm doing Jeffery."
4297,1,3,93,97,1.0515463917525774,0.0269080064662643,540,I don't detect a crack problem
4297,0,5,92,97,1.0515463917525774,0.022566882365229714,540,"It's not like you, all this unsafe behavior..."
4297,1,3,93,97,1.0515463917525774,0.0269080064662643,540,It's been 5 years with no repeal and its heartbeat is very faint; it's time to give Obamacare a chance to breathe.
4303,0,6,111,117,1.0512820512820513,0.020479637174006114,540,"I think its SAFE to say, you've been CRACKING too many pills!"
4303,0,4,74,78,1.0512820512820513,0.025136562726294533,540,Unlock those feelings. Your secret is safe with me.
4303,0,6,111,117,1.0512820512820513,0.020479637174006114,540,"I will listen as your voucher, safe."
4306,1,3,94,98,1.0510204081632653,0.026637213210524497,540,You're only as sick as your secrets.
4306,0,5,93,98,1.0510204081632653,0.022341613457808624,540,There's only a little scratch.
4306,1,3,94,98,1.0510204081632653,0.026637213210524497,540,I can’t get anything out of you your secrets are just to locked away
4306,0,5,93,98,1.0510204081632653,0.022341613457808624,540,Come out and have something to eat. There are no bullies here to steal your lunch money.
4306,1,3,94,98,1.0510204081632653,0.026637213210524497,540,"Money talks: ""You say you're feeling claustrophobic?"""
4311,0,5,94,99,1.0505050505050506,0.022120793242072008,540,"Left 37, right 14, left 7, right 22, left..."
4311,0,5,94,99,1.0505050505050506,0.022120793242072008,540,"OMG -Code blue, code blue. This safe is no longer safe. Get a crash cart STAT. I want an EKG, a CBC but no LOL."
4311,0,5,94,99,1.0505050505050506,0.022120793242072008,540,And what is your everyday diet? I think your eating to much money and it's stressing you out.
4314,1,2,77,80,1.05,0.03029391884499827,540,You need an emergency Benjamin-ectomy-I hope.
4314,1,4,115,120,1.05,0.02322101820064118,540,"Aha, a woman of color with her ear to the pulse of the economy!"
4314,0,5,95,100,1.05,0.02190429135575903,540,"Doc, I thought it was a healthy way to keep my feelings safe."
4314,0,5,95,100,1.05,0.02190429135575903,540,"I may be blind, but it is Safe to say you may need a withdraw from the Blood Bank."
4318,0,6,115,121,1.0495867768595042,0.01981748563352364,540,I'm hearing 1...3...9...interesting. I thought Mark was born in February of '40.
4319,0,5,96,101,1.0495049504950495,0.021691982475452135,540,Locked up crazy
4319,0,5,96,101,1.0495049504950495,0.021691982475452135,540,Sounds like a bad case of greed: I'd prescribe a third party
4319,0,5,96,101,1.0495049504950495,0.021691982475452135,540,"As a committed vegetarian, I want to get a taste of your pulse."
4319,1,3,97,101,1.0495049504950495,0.025856564073664552,540,We haven't yet cracked the case.
4323,0,4,77,81,1.0493827160493827,0.024223971444874794,540,You're all buttoned up.
4324,0,5,97,102,1.0490196078431373,0.021483746075718797,540,I think you have been ingesting too much lead.
4324,1,3,98,102,1.0490196078431373,0.025606413380457306,540,I found my broken heart...
4324,0,5,97,102,1.0490196078431373,0.021483746075718797,540,"Still stuck on ""Goodnight Irene"" and ""Bye Bye Blackbird""? You obviously feel safe with that, but you'll have to give me a better Tumblr combination before I can release you."
4327,0,4,78,82,1.048780487804878,0.023934311290861397,540,"Yes, there is a creepy clown outside looking for your safe space."
4328,0,5,98,103,1.0485436893203883,0.021279466201922555,540,My diagnosis: Iatrophibia.
4328,0,5,98,103,1.0485436893203883,0.021279466201922555,540,"If you really are a shape-shifter, I suggest you shift your shape now while I can still hear breath sounds."
4328,0,5,98,103,1.0485436893203883,0.021279466201922555,540,"We will get to the bottom of what's inside you that's bothering you, but first need to make sure your heart is healthy enough."
4328,0,5,98,103,1.0485436893203883,0.021279466201922555,540,"It's thready, weak, and irregular. Oh, I get it! Hillary is inside! Bill locked her up again!"
4328,1,3,99,103,1.0485436893203883,0.025361054610136515,540,"Sir, the hospital has a zero-tolerance policy against racial pejoratives."
4333,0,6,118,124,1.0483870967741935,0.019348281081601804,540,"Dr Smith, Can you unlock myself from fear"
4334,1,3,100,104,1.0480769230769231,0.025120351432044052,540,Your ticker needs a hand.
4334,1,3,100,104,1.0480769230769231,0.025120351432044052,540,"Advanced arteriosclerosis, Mr. Roselli. I warned you about all the mortadella and prosciutto."
4336,0,5,100,105,1.0476190476190477,0.0208823337930245,540,You're the only one who lets me check their breathing--everyone else just wants to talk.
4336,1,2,81,84,1.0476190476190477,0.028866330437393648,540,He swears by those new Nike ground shoes.
4336,0,5,100,105,1.0476190476190477,0.0208823337930245,540,"'Cracking the Code,' Bioethics 101"
4339,0,5,101,106,1.0471698113207548,0.0206892703318409,540,"Your Id and Ego sound fine, but your Super Ego sounds constricted, and tight as a...well, a locked safe."
4340,0,5,102,107,1.0467289719626167,0.020499741172303885,540,Why do they think I went to medschool?
4341,0,4,82,86,1.0465116279069768,0.022841730741167496,540,"Yes, it is possible to have too much fiber."
4342,0,5,103,108,1.0462962962962963,0.020313650225214416,540,"At this condition, you're not safe"
4343,0,4,83,87,1.0459770114942528,0.02258398432011167,540,"Yes, for you 40bps is perfectly safe"
4344,1,3,105,109,1.0458715596330275,0.02398224333540997,540,"I RECOMMEND VASELINE INSTEAD OF MACHINE OIL."" I RECOMMEND USING VASELINE INSTEAD OF MACHINE OIL."""
4344,0,5,104,109,1.0458715596330275,0.020130904850286947,540,I hear the crackles of a tight code and broken heart.
4344,1,3,105,109,1.0458715596330275,0.02398224333540997,540,"In the Psychiatry of Things, you are unable to connect with the pulse. Your tumblers have ceased to be blue."
4347,0,5,105,110,1.0454545454545454,0.01995141570292857,540,They say you're the best magician specialist in town.
4347,0,5,105,110,1.0454545454545454,0.01995141570292857,540,It really is the craziest thing in the world.
4347,0,5,105,110,1.0454545454545454,0.01995141570292857,540,"The only way you will open up , is if people turn your dials ."
4347,0,5,105,110,1.0454545454545454,0.01995141570292857,540,"Sir, please stop Yellen, I promise it won't hurt."
4347,1,2,85,88,1.0454545454545454,0.027567201584687385,540,Your heart beats in Morse code.
4352,1,4,128,133,1.0451127819548873,0.020982534736555546,540,have a heart and let me open this thing
4353,1,3,107,111,1.045045045045045,0.023555352022601204,540,T'S THE EVIL EXCRETION FROM THE MONEY !
4353,1,3,107,111,1.045045045045045,0.023555352022601204,540,He's right - this cartoon IS sideways.
4353,0,5,106,111,1.045045045045045,0.019775096589106683,540,"Do you think I'm going to make it, doc?"" ""Well.. a locked artery only means one thing, you're definitely not safe from a stroke."
4356,0,4,85,89,1.0449438202247192,0.02208554475019371,540,"Despite your safe environment, your blood pressure is high.."
4357,0,5,107,112,1.0446428571428572,0.019601864327811826,540,Good news. Sounds like everything is in the safe zone for you.
4357,1,3,108,112,1.0446428571428572,0.023347553319375942,540,You're husband left his first four wives out of the will and has deemed you responsible for all of the safe's contents. Once I get it open we will be able to see which one of the 27 grandchildren managed to lock themselves inside before he passed.
4359,0,4,86,90,1.0444444444444445,0.021844479878251593,540,So I see that your coming back from retirement to work for the N.S.A.?
4359,0,4,86,90,1.0444444444444445,0.021844479878251593,540,The patient is out of control
4361,0,5,108,113,1.0442477876106195,0.01943163862065665,540,The balloon payment is working well.
4361,1,3,109,113,1.0442477876106195,0.023143387659952993,540,I'm rethinking how much I want this merit badge.
4361,1,3,109,113,1.0442477876106195,0.023143387659952993,540,They call you a safe but right now you're not really safe.
4364,0,4,87,91,1.043956043956044,0.021608617148355498,540,"Madame Secretary and the Donald, when the accusations stop....."
4365,0,5,109,114,1.043859649122807,0.019264341928182754,540,The only thing I'm picking up is out-cold cash
4366,0,5,110,115,1.0434782608695652,0.019099899352477363,540,Your combination lock is too regular for safe health
4366,1,3,111,115,1.0434782608695652,0.022745581033938995,540,"Unfortunately, there's a nationwide epidemic of anemia going on..."
4368,1,3,112,116,1.043103448275862,0.022551760816809447,540,"I kept yelling, ""Kim, put it in the safe, put it in the safe!!!"" Doc, I feel invisible. I can't take it anymore!!!!"
4369,1,2,90,93,1.043010752688172,0.026098934716194122,540,Where do you think he got those hiking boots?
4369,1,2,90,93,1.043010752688172,0.026098934716194122,540,I know how you feel. Poor Kim!
4371,0,5,112,117,1.0427350427350428,0.018779289504360728,540,Yes sir...the tweet machine seems to think it's ready to click send!
4372,1,1,69,71,1.0422535211267605,0.03131343280074131,540,It's almost impossible to get through to you. You're so hidden and locked up...
4373,1,2,92,95,1.0421052631578946,0.025554497782741797,540,Its safe to say everything sounds good! Its safe to say everything sounds good!
4373,1,2,92,95,1.0421052631578946,0.025554497782741797,540,Sounds like you're still going to need supplemental insurance.
4375,0,5,114,119,1.0420168067226891,0.01846925862614142,540,shortness of breath for sure... any allergies to SSRI's?
4376,0,4,92,96,1.0416666666666667,0.020501747179860065,540,A SAFE'S secrets are SAFEST on my couch!
4376,0,4,92,96,1.0416666666666667,0.020501747179860065,540,"As far as your heart is concerned, it is on the wrong side,but you are safe."
4378,0,5,116,121,1.0413223140495869,0.018169291953543974,540,"Removal is impossible, so I'll just increase the dosage of your constipation medicine."
4379,1,2,94,97,1.041237113402062,0.02503230633046987,540,"just checking you're safe , seen many like you locked up"
4379,0,4,93,97,1.041237113402062,0.020293834726834565,540,"It's safe to say, He's gone."
4379,0,4,93,97,1.041237113402062,0.020293834726834565,540,"If only I had listened to my friends at the New Yorker, I wouldn't be having so much trouble blowing this box."
4382,0,4,94,98,1.0408163265306123,0.02009009450213533,540,We are looking for the money’s heartbeat and to measure the money.
4383,0,4,95,99,1.0404040404040404,0.01989040223966842,540,It is really scary doc; all this responsibility has my heart racing.
4384,0,4,96,100,1.04,0.019694638556693247,540,"Say ""uncle""!"
4384,0,4,96,100,1.04,0.019694638556693247,540,They said that aging Government Bond was a bad idea
4384,0,3,72,75,1.04,0.022779791898059957,540,"On a scale of 1 to 10, how bad is the pain?"
4384,0,4,96,100,1.04,0.019694638556693247,540,"I can not hear anything, you are safe."
4388,0,4,97,101,1.0396039603960396,0.019502688716427928,540,"Come on, let go, get happy, gonna release those tumblers away."
4388,1,2,98,101,1.0396039603960396,0.024049421389091327,540,women doctors are dumb
4388,1,2,98,101,1.0396039603960396,0.024049421389091327,540,It talks!!!
4391,0,4,98,102,1.0392156862745099,0.019314442404360956,540,I'm glad you came in and I can hear way you feel unsafe.
4392,0,4,99,103,1.0388349514563107,0.019129793517354894,540,I know it is difficult to harbor such inner secrets.
4392,0,4,99,103,1.0388349514563107,0.019129793517354894,540,Malpractice!
4392,0,4,99,103,1.0388349514563107,0.019129793517354894,540,I no longer hear a safe heart beat--your secrets are gone!
4392,0,4,99,103,1.0388349514563107,0.019129793517354894,540,"So you don't trust yourself, otherwise unsafe."
4392,0,4,99,103,1.0388349514563107,0.019129793517354894,540,"(into to Pink Floyd's ""Money"")"
4397,0,4,100,104,1.0384615384615385,0.01894863996469793,540,"Doctor, where did you put the key to the Tardis?"
4398,0,4,101,105,1.0380952380952382,0.018770883480320816,540,Your heartbeat indicates you have a safety problem.
4398,1,2,102,105,1.0380952380952382,0.0231407919004939,540,"Wait, you are telling me that you have Donald Trump's presidential temperament!"
4398,1,2,102,105,1.0380952380952382,0.0231407919004939,540,Bonnie to Clyde; Bonnie to Clyde; Do you read me?
4401,0,4,102,106,1.0377358490566038,0.018596429445455906,540,"As much as I try, only you can up."
4401,0,4,102,106,1.0377358490566038,0.018596429445455906,540,You need to release what you've been holding in for so long before you explode.
4403,0,3,77,80,1.0375,0.021374819563973062,540,I'm afraid our 211 response time is almost up.
4404,1,2,104,107,1.0373831775700935,0.022711742534674655,540,"Unlock your anxieties, open up, eat your greens. Trust my combination and you'll feel safe again."
4405,0,4,104,108,1.037037037037037,0.01825706748942968,540,"If you do choose the bariatric surgery option to solve the weight problem, there may be technical challenges as well as unusual complications."
4405,0,3,78,81,1.037037037037037,0.0211143597240581,540,You're just like all the others. You're treating me like an object.
4407,1,2,106,109,1.036697247706422,0.022298310758641558,540,"Robert, are you having contractions?"
4407,1,2,106,109,1.036697247706422,0.022298310758641558,540,"The therapist wanted to be sure that her three sub-conscious roles on the victim triangle - Persecutor, Rescuer and Victim, were being listened to before seeing her next client. Mr Karpman was known for bringing dramatic issues to his sessions."
4407,0,4,105,109,1.036697247706422,0.018091987104280182,540,gimme that money bitch
4410,0,3,81,84,1.0357142857142858,0.020369708052572492,540,So is the anything you want to tell me A-vault?
4411,1,2,111,114,1.0350877192982457,0.02132770662606682,540,I finally found a way to put my financial issues to rest!!
4412,0,4,112,116,1.0344827586206897,0.017015005648109267,540,Knock 3 times on the ceiling if you want me
4413,0,3,85,88,1.0340909090909092,0.019454845748129147,540,Now I know why Charles spent so much time practicing his moon walk.
4414,0,3,86,89,1.0337078651685394,0.019238823495237367,540,Didn't I tell you the Deluxe with The Clapper would be the most fun!
4415,0,3,87,90,1.0333333333333334,0.01902754426349146,540,I am checking to find out if banknote investments are secure.
4415,0,4,116,120,1.0333333333333334,0.016455241616498074,540,"And, I can categorically state that Mr. Trump has the healthiest conscience of any presidential candidate in history!"
4415,0,4,116,120,1.0333333333333334,0.016455241616498074,540,Moonlighting psychiatrist
4415,0,3,87,90,1.0333333333333334,0.01902754426349146,540,"7-24-16. Hm, Your heartbeat jumped after 24."
4415,0,3,87,90,1.0333333333333334,0.01902754426349146,540,You do seem to be wheezing a bit.
4420,0,3,88,91,1.032967032967033,0.018820853595113755,540,Sorry Ms. K....Mr. West gave strict orders that you are not to interrupt another one of his shows.
4421,0,4,118,122,1.0327868852459017,0.01618894260983636,540,I think you're sick. Your heart's not beating.
4422,0,3,89,92,1.0326086956521738,0.018618603664560845,540,You will need to be accustomed to that your insurance will not pay the full price of your medical costs.
4422,0,3,89,92,1.0326086956521738,0.018618603664560845,540,It's the pay as I crack your code program.
4424,0,4,120,124,1.032258064516129,0.015931122526606292,540,The tick you have misses a we bit.
4425,0,3,91,94,1.0319148936170213,0.01822686578570966,540,"Doctor, is this inflation rate normal?"
4426,0,3,92,95,1.0315789473684212,0.018037112288197883,540,"So, sorry, I can't be sure if it's human or mechanical ticking!"
4427,0,3,93,96,1.03125,0.017851267830546233,540,"Cough the money louder, LOUDER."
4428,0,3,94,97,1.0309278350515463,0.017669212887631548,540,Forgot your numbers - send it to be by heart beats.
4428,0,3,94,97,1.0309278350515463,0.017669212887631548,540,You've not been taking your Xanax.
4428,0,3,94,97,1.0309278350515463,0.017669212887631548,540,I knew John was on edge but this is ridiculous
4431,0,3,95,98,1.030612244897959,0.017490832756567442,540,"well, I still don't hear a heartbeat, maybe some back next week."
4431,1,1,96,98,1.030612244897959,0.02272273456789517,540,"Doc, a special diagnostic app is needed on your stethoscope for a patient like me."
4431,0,3,95,98,1.030612244897959,0.017490832756567442,540,I hear a heartbeat. The patient is safe.
4434,0,3,99,102,1.0294117647058822,0.016811921984695454,540,Breathe deeply for me... very good
4435,0,3,101,104,1.0288461538461537,0.016491849488691337,540,"No, I am not related to Jimmy Valentine Mr. Steele. and yes I am not a cracker as your owner Mr. Trump has pointed out."
4436,0,3,102,105,1.0285714285714285,0.01633633928276758,540,"We're not sure what happens next, but Kanye requested this session."
4437,0,3,103,106,1.028301886792453,0.01618373374908687,540,My therapist told me I the best way to deal with my fears is to face them.
4437,0,3,103,106,1.028301886792453,0.01618373374908687,540,All prostitutes took money.
4439,0,3,104,107,1.02803738317757,0.0160339522788493,540,"You need to do more exercises, how about strengthening workouts?"
4440,0,3,105,108,1.0277777777777777,0.015886917217854884,540,I'm still looking for the gold vein!
4441,0,3,107,110,1.0272727272727273,0.01560078968238724,540,"Don't worry, Sterling is still not par with dollar!"
4441,0,3,107,110,1.0272727272727273,0.01560078968238724,540,These days HIV isn't the death sentence it once was.
4443,1,1,109,111,1.027027027027027,0.02007136921884807,540,Your session is over FOREVER!
4444,0,3,110,113,1.0265486725663717,0.015190410670920237,540,"Look it, we've got to call it off- I can only be your doctor Cough, please."
4445,0,3,112,115,1.0260869565217392,0.014928610004851354,540,"Well it could be that some internals are out of alignment, I cannot see your joints. It could be HIPAA. Hmmm, you are going to be a tough one to crack -- let me start old school with this stethoscope before I get another opinion from Dr. Blowtorch."
4446,0,3,113,116,1.0258620689655173,0.014801064108144106,540,Everything looks normal. Now open your mouth and say 'Ahhh'
4447,0,3,114,117,1.0256410256410255,0.014675678755700992,540,"I know, I know, mr Fort Knox......, but, Mr trump is the president."
4448,0,3,115,118,1.0254237288135593,0.014552399522167074,540,Are the the meanings of R and W also reversed.
4449,0,2,79,81,1.0246913580246915,0.017349962126611367,540,Home visits can be quite productive.
4450,1,0,82,83,1.0240963855421688,0.024096385542168693,540,Have you been doing your exercises?
4451,0,2,84,86,1.0232558139534884,0.01634732612453039,540,"..........nine, ten............why did you stop the deep breathing exercise?"
4452,0,2,85,87,1.0229885057471264,0.01616054423971325,540,"How'd you get in there? Didn't you know ""Safe-ty is no accident?"""
4453,0,2,89,91,1.021978021978022,0.01545422938441684,540,You've wrapped that dick up!
4454,0,2,91,93,1.021505376344086,0.015123727087070405,540,T
4454,0,2,91,93,1.021505376344086,0.015123727087070405,540,ERADICATE! ERADICATE!!!  Is that all you Yanks can say whenever someone mentions Obamacare?
4454,0,2,91,93,1.021505376344086,0.015123727087070405,540,Al Gore went too far this time.
4457,0,2,92,94,1.0212765957446808,0.01496372036217601,540,I hate hiking with M.C. Escher.
4457,0,2,92,94,1.0212765957446808,0.01496372036217601,540,469! I should have known that would be the key to unlocking these tax returns.
4459,0,2,94,96,1.0208333333333333,0.01465365251955096,540,Did you pick up smoking again? It's going to really add up.
4460,0,2,95,97,1.0206185567010309,0.014503387470905613,540,ERADICATE! ERADICATE!!! Is that all you Yanks can say whenever anyone mentions universal health reform?
4460,0,2,95,97,1.0206185567010309,0.014503387470905613,540,We're gonna need to do a much bigger biopsy.
4462,0,2,96,98,1.0204081632653061,0.014356172614544043,540,"Charley has found a great new use for ""Air Jordan's""!"
4462,0,2,96,98,1.0204081632653061,0.014356172614544043,540,You won free speech and now you want Obamacare?
4462,0,2,96,98,1.0204081632653061,0.014356172614544043,540,Gary's colon doctor was surprised to see Gary fell into something rather than onto it this time.
4465,0,2,98,100,1.02,0.014070529413628947,540,The lock-maker might have to install some electric if you're not safe enough.
4466,0,2,100,102,1.0196078431372548,0.013796030288829229,540,Your thoughts are scrambled. Calm Down and Think Straight.
4467,0,2,101,103,1.0194174757281553,0.013662757940984675,540,"No insurance you say? Erm, OK. I guess your health is in your safe with me."
4468,0,2,102,104,1.0192307692307692,0.013532035612611728,540,"If I can crack the right diagnostic code, I can resect all your insurance premium and you lose weight!"
4469,1,0,105,106,1.0188679245283019,0.01886792452830189,540,Too incongruous for the Fresh Air Fund to keep money in here.
4470,0,2,133,135,1.0148148148148148,0.010436494549594388,540,"If I was a younger man I'de ask you out on a date."" ""Shush, I'm trying to listen."" ""If I was handsome like a movie star, maybe then?"" ""It's only what's inside you that counts."" Said the Doc sympathetically. ""Gold Digger."" ""You're imposable."
4471,0,1,89,90,1.011111111111111,0.011173358719233181,540,"Meanwhile, the other members of the eccentric heist crew were strategizing how best to tell Dr. DiCypher she's leaning too heavily on her gimmick."
4472,0,1,90,91,1.010989010989011,0.011049892402196598,540,"Your deteriorating insides seem ""unsafe,"" and therefore, an immediate reconstruction operation is necessary."
4473,0,1,101,102,1.0098039215686274,0.009852336290568345,540,Your heart rate is a tad for someone of your weight.
4474,0,1,115,116,1.0086206896551724,0.008658089785895598,540,I need a doctors note for missing class.
4475,0,1,130,131,1.0076335877862594,0.007662891493956463,540,Maybe I can get the safe open if I listen to it.
