rank,funny,somewhat_funny,unfunny,count,score,precision,contest,caption
1,69,151,82,302,1.9569536423841059,0.040681365006483165,544,"Given Mr Tell's declining accuracy with his bow and arrow, we're lucky the guys don't use Apples."
2,60,142,80,282,1.929078014184397,0.04181913151028726,544,"Where exactly is Bethlehem, NY? Hmmm. Off the top of my head … 42°36'N 73°50'W in Albany County."
3,74,81,98,253,1.9051383399209487,0.05159531027508156,544,I liked it better when they were just little voices inside our heads.
4,41,40,81,162,1.7530864197530864,0.06556586483316872,544,I liked it better when the voices were inside my head.
5,39,29,81,149,1.7181208053691275,0.07003441466526977,544,It wouldn't be so bad if their printers weren't in our pants.
6,47,12,89,148,1.7162162162162162,0.07552022223121585,544,Are you thinking what I'm thinking?
7,44,7,87,138,1.6884057971014492,0.07886903192865957,544,Have your person contact my person.
8,26,37,69,132,1.6742424242424243,0.06843835871062329,544,I live in constant fear he will hit ctrl+alt+del
8,24,41,67,132,1.6742424242424243,0.06672696681999027,544,Don't you miss the days when we thought about sex?
10,41,5,84,130,1.6692307692307693,0.08127521326217697,544,Have your guy call my guy.
10,38,11,81,130,1.6692307692307693,0.07904352305965213,544,Are you thinking what I'm thinking?
12,39,8,82,129,1.6666666666666667,0.08037380369506869,544,Are you thinking what I'm thinking?
12,30,26,73,129,1.6666666666666667,0.0732791378316071,544,Does your guy wear pants?
12,36,14,79,129,1.6666666666666667,0.07808057522450883,544,Are you thinking what I’m thinking?
12,38,10,81,129,1.6666666666666667,0.07961673372731191,544,I'll have my person contact your person.
16,35,15,78,128,1.6640625,0.07786311914875253,544,I'll have my people call your people
17,34,14,77,125,1.656,0.07878431152161885,544,Are you thinking what I'm thinking?
17,21,40,64,125,1.656,0.06730191963901755,544,"Remember when the only things on our minds were sex, drugs, and rock and roll?"
19,34,12,78,124,1.6451612903225807,0.07949614177711885,544,Funny...I was just thinking the same thing...
20,35,9,79,123,1.6422764227642277,0.08092007342718914,544,I'll have my guy call your guy.
20,35,9,79,123,1.6422764227642277,0.08092007342718914,544,"Hey, Are you thinking what I'm thinking?"
20,31,17,75,123,1.6422764227642277,0.07755603263552403,544,Are you thinking what I'm thinking?
23,33,11,77,121,1.6363636363636365,0.08046010937788942,544,Are you thinking what I'm thinking?
23,31,15,75,121,1.6363636363636365,0.0787295821622217,544,Are you thinking what I'm thinking?
23,30,17,74,121,1.6363636363636365,0.0778498944161523,544,Are you thinking what I'm thinking?
23,32,13,76,121,1.6363636363636365,0.07959954870644666,544,Are you thinking what I'm thinking?
23,33,11,77,121,1.6363636363636365,0.08046010937788942,544,Are you thinking what I'm thinking?
23,35,7,79,121,1.6363636363636365,0.08215419219227854,544,I'll have my people email your people
23,33,11,77,121,1.6363636363636365,0.08046010937788942,544,Are you thinking what I'm thinking?
23,35,7,79,121,1.6363636363636365,0.08215419219227854,544,Are you thinking what I'm thinking?
31,32,12,76,120,1.6333333333333333,0.08020748071502887,544,I'll have my guy call your guy.
31,33,10,77,120,1.6333333333333333,0.08107586561400804,544,I'll have my people call your people.
33,26,23,70,119,1.6302521008403361,0.07535279622889879,544,The New Yorker must be testing its new Caption Selection system
34,34,5,78,117,1.623931623931624,0.08386347350195146,544,Are you thinking what I'm thinking?
34,34,5,78,117,1.623931623931624,0.08386347350195146,544,I'll have my guy call your guy.
36,31,10,75,116,1.6206896551724137,0.08182254211322226,544,Are you thinking what I'm thinking?
36,30,12,74,116,1.6206896551724137,0.08090119504920043,544,My people will talk to your people
38,31,9,75,115,1.617391304347826,0.08247007519190817,544,Are you thinking what I'm thinking?
38,28,15,72,115,1.617391304347826,0.07964701751019199,544,Have your people call my people.
38,32,7,76,115,1.617391304347826,0.083389859116416,544,Are you thinking what I'm thinking you're thinking I'm thinking?
38,29,13,73,115,1.617391304347826,0.08059902418494623,544,"""Have your man call my man""."
42,22,26,66,114,1.6140350877192982,0.07424909707442731,544,"I can’t get work off my mind, either."
43,22,27,67,116,1.6120689655172413,0.07323285623956087,544,I work under Jerry in Accounting. You?
44,31,6,75,112,1.6071428571428572,0.08447462632711288,544,Have your guy call my guy.
44,32,4,76,112,1.6071428571428572,0.0854215292182276,544,Have your people call my people.
44,30,8,74,112,1.6071428571428572,0.08351698828519974,544,Have your people call my people.
47,29,9,73,111,1.6036036036036037,0.08321870505660862,544,Have your little person contact my little person.
48,29,9,74,112,1.5982142857142858,0.08264823411938109,544,I'll have my guy call your guy
49,22,21,66,109,1.5963302752293578,0.07724361431385375,544,Are you thinking what I'm thinking?
49,19,27,63,109,1.5963302752293578,0.07387077877175023,544,Accounting says we have too much overhead
51,17,30,61,108,1.5925925925925926,0.07210074899553907,544,We have way too much overhead.
51,28,8,72,108,1.5925925925925926,0.08427509084853035,544,Are you thinking what I'm thinking?
51,18,28,62,108,1.5925925925925926,0.07329112000949323,544,I should have asked more questions when they offered me a 'Department Head.'
54,11,41,55,107,1.588785046728972,0.06499090590322013,544,"You know, before email and internet, all we had were little balloons floating in the air with words inside them"
54,28,7,72,107,1.588785046728972,0.08497955922137332,544,Are you thinking what I'm thinking?
54,18,27,62,107,1.588785046728972,0.07387941562375352,544,when I turn around check if he's playing solitaire again
57,28,8,73,109,1.5871559633027523,0.083675149301656,544,Are you thinking what I'm thinking?
58,29,4,73,106,1.5849056603773586,0.0867377459524997,544,Are you thinking what I'm thinking?
58,28,6,72,106,1.5849056603773586,0.08569563614095653,544,Are you thinking what I'm thinking?
60,22,20,68,110,1.5818181818181818,0.07682374591828445,544,I hate working under the new guy.
61,26,9,70,105,1.5809523809523809,0.08427774635875096,544,Have your person contact my person
61,28,5,72,105,1.5809523809523809,0.08642360150798119,544,"My thoughts, exactly"
61,24,13,68,105,1.5809523809523809,0.08207580742831345,544,Are you thinking what I'm thinking?
64,27,6,71,104,1.5769230769230769,0.0860860717096702,544,I'll have my guy call your guy.
64,26,8,70,104,1.5769230769230769,0.08499473657242765,544,Are you thinking what I'm thinking?
66,24,11,68,103,1.5728155339805825,0.08347344978194286,544,Are you thinking what I'm thinking?
66,23,13,67,103,1.5728155339805825,0.08232526592364565,544,Are you thinking what I'm thinking?
66,27,5,71,103,1.5728155339805825,0.08682694884537417,544,I'll have my people talk to your people.
66,22,15,66,103,1.5728155339805825,0.08116084031292069,544,Have your guy call my guy and we'll set something up.
66,24,11,68,103,1.5728155339805825,0.08347344978194286,544,Are you thinkin' what I'm thinkin'?
66,23,13,67,103,1.5728155339805825,0.08232526592364565,544,Have your guy call my guy.
72,26,6,70,102,1.5686274509803921,0.08646490700836933,544,Are you thinking what I'm thinking?
72,17,24,61,102,1.5686274509803921,0.07568980510664468,544,Don't you hate those guys in the head office?
72,26,6,70,102,1.5686274509803921,0.08646490700836933,544,Are you thinking what I'm thinking?
72,26,6,70,102,1.5686274509803921,0.08646490700836933,544,Are you thinking what I'm thinking?
72,26,6,70,102,1.5686274509803921,0.08646490700836933,544,Are you thinking what I'm thinking?
72,22,14,66,102,1.5686274509803921,0.08185127916475315,544,I'll have my guy call your guy.
72,24,10,68,102,1.5686274509803921,0.08418970259144615,544,Are you thinking what I'm thinking?
72,25,8,69,102,1.5686274509803921,0.08533488784313867,544,"""Are you thinking what I'm thinking?"
80,23,11,67,101,1.5643564356435644,0.08374388298530891,544,Are you thinking what I'm thinking?
80,28,1,72,101,1.5643564356435644,0.08946025345011104,544,Are you thinking what I'm thinking?
80,27,3,71,101,1.5643564356435644,0.08834657404437313,544,Are you thinking what I'm thinking?
83,24,8,68,100,1.56,0.08565847148632606,544,Are you thinking what I'm thinking?
83,25,6,69,100,1.56,0.0868296835154542,544,Have your man call my man.
85,26,3,70,99,1.5555555555555556,0.08876511687867071,544,My people will contact your people!
85,24,7,68,99,1.5555555555555556,0.08641157241893142,544,Have your people call my people
87,25,5,70,100,1.55,0.08689364217539193,544,Are you thinking what I'm thinking?
87,25,5,70,100,1.55,0.08689364217539193,544,Have your people call my people.
89,11,31,55,97,1.5463917525773196,0.07031565207780208,544,I miss the good old days when they drew balloons over our heads.
89,23,7,67,97,1.5463917525773196,0.08672721899585722,544,I'll have my people call your people.
89,23,7,67,97,1.5463917525773196,0.08672721899585722,544,My guy will text your guy.
89,20,13,64,97,1.5463917525773196,0.08292937126162335,544,You thinking what I'm thinking?
89,22,9,66,97,1.5463917525773196,0.08548002036998455,544,My people will talk to your people.
94,22,10,67,99,1.5454545454545454,0.08405405990886405,544,I'll have my people call your people.
95,15,22,59,96,1.5416666666666667,0.0768295371441074,544,Our overhead is killing us.
96,25,3,70,98,1.5408163265306123,0.08843065365812988,544,Have your people call my people.
97,20,11,64,95,1.5368421052631578,0.08440626746787697,544,Are you thinking what I’m thinking?
97,23,5,67,95,1.5368421052631578,0.08829671842746611,544,Are you thinking what I'm thinking?
97,20,11,64,95,1.5368421052631578,0.08440626746787697,544,I'll have my person call your person...
97,19,13,63,95,1.5368421052631578,0.08306897027245072,544,Have your person call my person.
97,17,17,61,95,1.5368421052631578,0.08032761350032962,544,"What are the figures, off the top of your head?"
97,14,23,58,95,1.5368421052631578,0.07603047411043738,544,Remember when we wanted to be department heads?
103,23,4,67,94,1.5319148936170213,0.08910204019320878,544,Are you thinking what I'm thinking?
103,14,22,58,94,1.5319148936170213,0.07668212420079179,544,"Yeah, I'm really tired of being micro-managed, too!"
105,23,5,68,96,1.53125,0.08755089372032744,544,Have your people call my people.
106,17,15,61,93,1.5268817204301075,0.08175179634751419,544,The voice in my head just gave two week's notice.
106,19,11,63,93,1.5268817204301075,0.08456278370204359,544,Are you thinking what I'm thinking?
106,22,5,66,93,1.5268817204301075,0.08861222635465363,544,Have your people call my people.
106,22,5,66,93,1.5268817204301075,0.08861222635465363,544,Are you thinking what I'm thinking?
110,23,4,68,95,1.5263157894736843,0.08833675926623832,544,Are you thinking what I'm thinking?
111,8,32,52,92,1.5217391304347827,0.06821430787415096,544,I hate when he uses the stapler.
112,13,23,58,94,1.5212765957446808,0.07521603660756261,544,"Is it just me, or is it odd the little men at desks on our heads don't have little men at desks on their heads?"
113,19,8,63,90,1.511111111111111,0.08690035397919259,544,Are you thinking what I'm thinking?
113,20,6,64,90,1.511111111111111,0.08832530448204694,544,Are you thinking what I'm thinking?
113,20,6,64,90,1.511111111111111,0.08832530448204694,544,Have your person contact my person.
113,19,8,63,90,1.511111111111111,0.08690035397919259,544,I'll have my guy call your guy.
117,8,29,52,89,1.5056179775280898,0.06988169542059264,544,"Life was much simpler when the only thing you got over your head when you got an idea, was a light bulb."
117,20,5,64,89,1.5056179775280898,0.08915044999221597,544,I'll have my guy call your guy.
117,20,5,64,89,1.5056179775280898,0.08915044999221597,544,I'll have my hat call your hat.
117,16,13,60,89,1.5056179775280898,0.08322470951683696,544,How much memory do you have?
117,17,11,61,89,1.5056179775280898,0.08474499919803569,544,Have your person call my person.
117,20,5,64,89,1.5056179775280898,0.08915044999221597,544,Have your people call my people.
117,18,9,62,89,1.5056179775280898,0.08623849200901094,544,Are you thinking what I'm thinking?
117,19,7,63,89,1.5056179775280898,0.08770655687519276,544,My person will contact your person.
125,19,6,63,88,1.5,0.08852677897456387,544,I'll have my people call your people.
125,18,8,62,88,1.5,0.08703882797784893,544,I'll have my people call your people.
125,18,8,62,88,1.5,0.08703882797784893,544,Are you thinking what I'm thinking?
125,14,16,58,88,1.5,0.08081352297940449,544,"Off the top of my head,I'm guessing you're thinking what I'm thinking."
125,21,2,65,88,1.5,0.09143006417649889,544,"He just said, 'I'll have my people call your people.'"
125,13,18,57,88,1.5,0.07918075824648958,544,I'm sensing a hostile comb-over.
125,20,4,64,88,1.5,0.08999013065589467,544,Are you thinking what I'm thinking?
125,16,12,60,88,1.5,0.08398387664337814,544,"""Are you thinking what I'm thinking?"
125,20,4,64,88,1.5,0.08999013065589467,544,"Uh, are you thinking what I'm thinking?"
125,10,24,54,88,1.5,0.07406681724583486,544,I'll need to check with the man upstairs.
135,19,5,63,87,1.4942528735632183,0.08936133728603175,544,Are you thinking what I'm thinking?
135,20,3,64,87,1.4942528735632183,0.09084468508344264,544,Have your guy call my guy.
135,18,7,62,87,1.4942528735632183,0.08785294756117175,544,I'll have my people speak to your people
135,18,7,62,87,1.4942528735632183,0.08785294756117175,544,Have your person call my person...
135,18,7,62,87,1.4942528735632183,0.08785294756117175,544,Are you thinking what I'm thinking?
135,17,9,61,87,1.4942528735632183,0.08631820311396697,544,Are you thinking what I'm thinking?
135,17,9,61,87,1.4942528735632183,0.08631820311396697,544,Are you thinking what I'm thinking?
135,19,5,63,87,1.4942528735632183,0.08936133728603175,544,Are you thinking what I'm thinking?
143,17,9,62,88,1.4886363636363635,0.0855163158548237,544,My guy will contact your guy.
144,19,4,64,87,1.4827586206896552,0.08934414414738566,544,Are you thinking what I’m thinking?
145,10,21,54,85,1.4823529411764707,0.0759842323055954,544,This overhead is killing me.
146,14,13,59,86,1.4767441860465116,0.082250733053497,544,I can’t get my mind off of work either.
147,11,18,55,84,1.4761904761904763,0.07849010899859392,544,"Funny, I was just thinking about the same thing."
147,17,6,61,84,1.4761904761904763,0.08877988289291862,544,Are you thinking what I'm thinking?
149,16,7,60,83,1.4698795180722892,0.0879741456783934,544,Are you thinking what I'm thinking?
150,16,7,61,84,1.4642857142857142,0.08710033479998033,544,I'll have my person talk to your person
151,11,16,55,82,1.4634146341463414,0.07988836299720148,544,Now I know why the job description said level-headed
151,12,14,56,82,1.4634146341463414,0.08175123647153579,544,Are you thinking what I'm thinking?
153,15,7,59,81,1.4567901234567902,0.08792775990404643,544,Are you thinking what I'm thinking?
153,9,19,53,81,1.4567901234567902,0.07667750067582918,544,We really need to start leaving work at the office.
153,10,17,54,81,1.4567901234567902,0.07866435714604439,544,"I see you've been outsourced, too."
153,11,15,55,81,1.4567901234567902,0.08060225220494194,544,I'm getting really tired of this micro-management.
153,16,5,60,81,1.4567901234567902,0.08966567312551821,544,Are you thinking what I'm thinking?
153,16,5,60,81,1.4567901234567902,0.08966567312551821,544,Are you thinking what I'm thinking?
159,15,7,60,82,1.451219512195122,0.0870273209936662,544,Have your boy text my boy.
159,7,23,52,82,1.451219512195122,0.07186683255380011,544,Do you ever get this feeling there's like this whole other level of reality that we're just totally unaware of?
161,9,18,53,80,1.45,0.07733700704208724,544,"So are we of 4 minds, then?"
161,14,8,58,80,1.45,0.08696718426648357,544,Are you thinking what I'm thinking?
161,10,16,54,80,1.45,0.07935658986139954,544,'I really prefer the lightbulb.'
161,13,10,57,80,1.45,0.08512834688303289,544,Are you thinking what I'm thinking?
161,11,14,55,80,1.45,0.08132603550298584,544,Does yours wear shoes? Mine likes the feeling of hair between his toes.
161,7,22,51,80,1.45,0.07313071356019156,544,I told you having two Department Heads was a bad idea.
161,13,10,57,80,1.45,0.08512834688303289,544,My thoughts exactly!
168,12,12,57,81,1.4444444444444444,0.08240220541217404,544,"I like to support Small Business, but if he microwaves fish one more time, he's gone."
169,8,19,52,79,1.4430379746835442,0.07589525281947244,544,I'm Gonna Wash That Man Right Out Of My Hair.
170,14,6,58,78,1.435897435897436,0.08863065198212798,544,"Well, it all depends on what you mean by, ""Are you thinking what I'm thinking?"""
170,12,10,56,78,1.435897435897436,0.0847902813108697,544,When I signed up for the new LinkedIn I didn't realize what a headache it would be...
170,9,16,53,78,1.435897435897436,0.07867903663476963,544,How do we ditch them for lunch?
170,13,8,57,78,1.435897435897436,0.08673172509397443,544,Are you thinking what I'm thinking?
170,12,10,56,78,1.435897435897436,0.0847902813108697,544,I can't seem to get work off my mind.
175,9,16,54,79,1.4303797468354431,0.0778724402069414,544,We're a lot alike. I always have work on my mind and you have a head for business.
175,9,16,54,79,1.4303797468354431,0.0778724402069414,544,It's a little tight. Do you have something in a conference table?
177,14,5,58,77,1.4285714285714286,0.08948201251325062,544,Are you thinking what I'm thinking?
177,14,5,58,77,1.4285714285714286,0.08948201251325062,544,Have your people call my people
177,13,7,57,77,1.4285714285714286,0.08755151091650734,544,Are you thinking what I'm thinking!?
177,13,7,57,77,1.4285714285714286,0.08755151091650734,544,Are you thinking what I'm thinking?
177,14,5,58,77,1.4285714285714286,0.08948201251325062,544,My people should be talking to your people.
177,12,9,56,77,1.4285714285714286,0.08557747112473627,544,Are you thinking what I'm thinking?
183,11,10,55,76,1.4210526315789473,0.08432010414524851,544,I think I'm getting carpal temple syndrome.
183,7,18,51,76,1.4210526315789473,0.07554052681267011,544,This latest Office upgrade is nothing but headaches.
183,14,4,58,76,1.4210526315789473,0.0903466188742718,544,I'll have my guy call your guy.
183,14,4,58,76,1.4210526315789473,0.0903466188742718,544,My guy will be in touch with your guy
183,14,4,58,76,1.4210526315789473,0.0903466188742718,544,Are you thinking what I'm thinking?
183,10,12,54,76,1.4210526315789473,0.08221315448322793,544,Uneasy lies the head that wears the desk.
183,12,8,56,76,1.4210526315789473,0.08637567456204329,544,What do you say we grab a beer and get work off our minds...
183,14,4,58,76,1.4210526315789473,0.0903466188742718,544,Are you thinking what I'm thinking!?
191,13,5,56,74,1.4189189189189189,0.0902642399225493,544,Are you thinking what I'm thinking?
191,14,3,57,74,1.4189189189189189,0.09229228708695607,544,Have your guy call my guy.
191,8,15,51,74,1.4189189189189189,0.07935027897914199,544,This job demands a level head.
191,12,7,55,74,1.4189189189189189,0.08818956719391453,544,Are you thinking what I'm thinking?
191,14,3,57,74,1.4189189189189189,0.09229228708695607,544,Are you thinking what I'm thinking?
191,13,5,56,74,1.4189189189189189,0.0902642399225493,544,Are you thinking what I'm thinking?
191,8,15,51,74,1.4189189189189189,0.07935027897914199,544,"He's been giving ""unfunny"" ratings to captions for the last 8 hours."
198,13,5,57,75,1.4133333333333333,0.0892275829637986,544,Have your people call my people.
199,5,20,48,73,1.4109589041095891,0.07255821270351921,544,Tell me again why you think this will be more popular than the Apple Watch.
199,9,12,52,73,1.4109589041095891,0.08238181987519963,544,Is that your natural desk color? Or do you varnish it?
199,6,18,49,73,1.4109589041095891,0.07513462407262254,544,I still think a simple light bulb gets the idea across.
199,13,4,56,73,1.4109589041095891,0.09115280720400516,544,"I'll have my guy email your guy, and we'll do lunch."
199,13,4,56,73,1.4109589041095891,0.09115280720400516,544,Are you thinking what I'm thinking?
199,5,20,48,73,1.4109589041095891,0.07255821270351921,544,Have you always supported small businesses?
199,11,8,54,73,1.4109589041095891,0.0868780711892258,544,Are you thinking what I'm thinking?
206,5,19,48,72,1.4027777777777777,0.07310389369363225,544,Remember the old days when I had Georgia on my mind?
206,9,11,52,72,1.4027777777777777,0.08312114352008726,544,"I loved the Apple iwatch and Google Glass, but I'm not so sure how I feel about the new Microsoft Office."
206,13,3,56,72,1.4027777777777777,0.09205471050958773,544,Shh... They can hear what we're thinking!
206,13,3,56,72,1.4027777777777777,0.09205471050958773,544,"Have your people call my people, and we'll do lunch."
206,4,21,47,72,1.4027777777777777,0.07037714804139637,544,"What do you THINK?"" ""I don't know - how do you FEEL?"
211,9,10,52,71,1.3943661971830985,0.08386746572190157,544,It may take a full body cavity search to locate upper management.
211,12,4,55,71,1.3943661971830985,0.09077992766784364,544,Have your guy get in touch with my guy.
211,7,14,50,71,1.3943661971830985,0.07892352521758818,544,My boss has been on me all day.
211,3,22,46,71,1.3943661971830985,0.06796517406058164,544,"The doctor asked me too if I heard little voices in my head too, I said no just typing."
211,10,8,53,71,1.3943661971830985,0.08623320876284185,544,I'll have my guy call your guy.
211,6,16,49,71,1.3943661971830985,0.07633156847497467,544,I think it best to double check that with the head office. Don't you?
211,8,12,51,71,1.3943661971830985,0.08143302352051535,544,I see you have a head for business too.
211,8,12,51,71,1.3943661971830985,0.08143302352051535,544,I hope they're not planning a merger.
211,7,14,50,71,1.3943661971830985,0.07892352521758818,544,You can't get your mind off work either?
211,4,20,47,71,1.3943661971830985,0.07086380861911594,544,Downsizing went alright but these overheads are a nightmare.
211,11,6,54,71,1.3943661971830985,0.08853575989653782,544,Have your guy call my guy.
211,7,14,50,71,1.3943661971830985,0.07892352521758818,544,Last week I was only up to my neck in work
211,12,4,55,71,1.3943661971830985,0.09077992766784364,544,I'll have my people contact your people.
211,8,12,51,71,1.3943661971830985,0.08143302352051535,544,We’re working hard but the overhead is killing us.
211,5,18,48,71,1.3943661971830985,0.07364844776998507,544,"Well, at least no one is going to ask about our comb overs anymore"
211,8,12,51,71,1.3943661971830985,0.08143302352051535,544,Do you have trouble balancing your workload?
211,5,18,48,71,1.3943661971830985,0.07364844776998507,544,Should we have requested a brain chip instead of a desktop?
211,6,16,49,71,1.3943661971830985,0.07633156847497467,544,This micromanaging is really getting out of control.
211,7,14,50,71,1.3943661971830985,0.07892352521758818,544,"On the plus side, his restaurant picks are better than Siri's."
211,6,16,49,71,1.3943661971830985,0.07633156847497467,544,"And they said we'd never carry computers in our pockets, either."
211,11,6,54,71,1.3943661971830985,0.08853575989653782,544,This micromanagement is getting ridiculous.
211,6,16,49,71,1.3943661971830985,0.07633156847497467,544,I can't believe you wore the same mid-level bureaucrat as me today!
233,10,7,53,70,1.3857142857142857,0.08703264931467809,544,Have your little people email my little people.
233,12,3,55,70,1.3857142857142857,0.09166700276887108,544,I thought your people were supposed to contact my people.
233,9,9,52,70,1.3857142857142857,0.08462034844990593,544,All we need now is a Small Business Loan.
233,10,7,53,70,1.3857142857142857,0.08703264931467809,544,I'll have my people call your people.
233,1,25,44,70,1.3857142857142857,0.06203203988422092,544,"Mine? Well, once he'd mapped pi to 950,000 decimal places, he moved along to vacation porn."
233,12,3,55,70,1.3857142857142857,0.09166700276887108,544,Have your man talk to my man.
233,12,3,55,70,1.3857142857142857,0.09166700276887108,544,Are you thinking what I'm thinking?
233,8,11,51,70,1.3857142857142857,0.08213723088122253,544,Nice to see somebody else around here with a head for business.
233,5,17,48,70,1.3857142857142857,0.07419089345728716,544,You and I appear to be the only ones carrying the workload around here.
233,9,9,52,70,1.3857142857142857,0.08462034844990593,544,Let's do lunch. Have your computer guy call my computer guy.
233,7,13,50,70,1.3857142857142857,0.07957666757214087,544,"""Ha ha, watch what happens when I hit ""Ctrl + C""!"
233,6,15,49,70,1.3857142857142857,0.07693092581620721,544,I see that you and I have a similar head for business.
233,5,17,48,70,1.3857142857142857,0.07419089345728716,544,It's tough balancing work.
233,11,5,54,70,1.3857142857142857,0.08937986754118613,544,Are you thinking what I'm thinking?
233,12,3,55,70,1.3857142857142857,0.09166700276887108,544,You thinking the same thing I'm thinking?
233,8,11,51,70,1.3857142857142857,0.08213723088122253,544,"It's not dandruff, he just had a powdered sugar doughnut."
233,11,5,54,70,1.3857142857142857,0.08937986754118613,544,I'll get my people to call your people.
250,12,2,55,69,1.3768115942028984,0.09256561294830518,544,I'll have my people call your people.
250,11,4,54,69,1.3768115942028984,0.09023378104119267,544,Are you thinking what I'm thinking?
250,12,2,55,69,1.3768115942028984,0.09256561294830518,544,Are you thinking what I'm thinking?
250,7,12,50,69,1.3768115942028984,0.08023157360396053,544,Well at least we don't operate jackhammers for a living.
250,3,20,46,69,1.3768115942028984,0.06879008333288725,544,"I don't believe in God, but I'm pretty sure there is a man upstairs."
250,11,4,54,69,1.3768115942028984,0.09023378104119267,544,Are you thinking what I'm thinking?
250,12,2,55,69,1.3768115942028984,0.09256561294830518,544,Work is always on my brain.
250,2,22,45,69,1.3768115942028984,0.06561873288505372,544,Checkmate!
250,6,14,49,69,1.3768115942028984,0.07752965847636759,544,I'm beginning to regret outsourcing myself.
250,7,12,50,69,1.3768115942028984,0.08023157360396053,544,Foil hats would have prevented this.
250,9,8,52,69,1.3768115942028984,0.08537927337462424,544,Are you thinking what I'm thinking?
250,9,8,52,69,1.3768115942028984,0.08537927337462424,544,"Penny for your thoughts. But don't tell me, email me."
250,12,2,55,69,1.3768115942028984,0.09256561294830518,544,Are you thinking what I'm thinking?
250,3,20,46,69,1.3768115942028984,0.06879008333288725,544,"I worked HR at Wrigley Chewing Gum. There they taught me, ""Two heads are better than one."""
250,12,2,55,69,1.3768115942028984,0.09256561294830518,544,You're thinking what I'm thinking?
250,6,14,49,69,1.3768115942028984,0.07752965847636759,544,Lunch sounds great. Have your guy contact my guy.
250,10,6,53,69,1.3768115942028984,0.08784006933902297,544,I'm virtually out of my mind.
250,8,10,51,69,1.3768115942028984,0.0828454154583902,544,Have your person call my person. We'll do lunch.
250,9,8,52,69,1.3768115942028984,0.08537927337462424,544,"I don't know about you, but I miss Siri."
250,11,4,54,69,1.3768115942028984,0.09023378104119267,544,Are you thinking what I'm thinking?
250,7,12,50,69,1.3768115942028984,0.08023157360396053,544,"Yes, as a matter of fact, I do take the office home at night"
250,11,4,54,69,1.3768115942028984,0.09023378104119267,544,Are you thinking what I'm thinking?
250,7,12,50,69,1.3768115942028984,0.08023157360396053,544,I can't get work off my mind...you?
250,6,14,49,69,1.3768115942028984,0.07752965847636759,544,Aren't you tired of being micro-managed?
250,13,0,56,69,1.3768115942028984,0.09484012948114837,544,Are you thinkin' what I'm thinkin'?
250,12,2,55,69,1.3768115942028984,0.09256561294830518,544,Are you thinking what I'm thinking?
250,9,8,52,69,1.3768115942028984,0.08537927337462424,544,Are you thinking what I think you're thinking?
250,9,8,52,69,1.3768115942028984,0.08537927337462424,544,Have your guy call my guy.
250,10,6,53,69,1.3768115942028984,0.08784006933902297,544,At least yours wears pants.
250,6,14,49,69,1.3768115942028984,0.07752965847636759,544,I always seem to have work on my mind these days.
250,11,4,54,69,1.3768115942028984,0.09023378104119267,544,I'll Have My People Contact Your People
250,6,14,49,69,1.3768115942028984,0.07752965847636759,544,What system software does your Super Ego use?
250,12,2,55,69,1.3768115942028984,0.09256561294830518,544,Tell your guy to talk to my guy.
250,5,16,48,69,1.3768115942028984,0.07473011764982479,544,This wasn't what I thought they meant when I was told I was assigned to the head office.
250,11,4,54,69,1.3768115942028984,0.09023378104119267,544,Are you thinking what I'm thinking?
250,11,4,54,69,1.3768115942028984,0.09023378104119267,544,Have your guy call my guy!
286,11,3,54,68,1.3676470588235294,0.09109713617782203,544,I'll have my guy contact your guy!
286,8,9,51,68,1.3676470588235294,0.0835568281559177,544,"The iHat isn't so bad, once you accept that you'll never have sex again."
286,6,13,49,68,1.3676470588235294,0.0781266945795663,544,"Hey, does your guy spend all day on porn, too?"
286,6,13,49,68,1.3676470588235294,0.0781266945795663,544,I hate micromanagers.
286,10,5,53,68,1.3676470588235294,0.08865498664500654,544,I'll have your hacker call my hacker.
286,7,11,50,68,1.3676470588235294,0.08088734121420482,544,Mine hates it when I forget to duck.
286,8,9,51,68,1.3676470588235294,0.0835568281559177,544,"So, you can't get your job off your mind either."
286,8,9,51,68,1.3676470588235294,0.0835568281559177,544,"Yeah, it's hard to balance work AND a girlfriend."
286,12,1,55,68,1.3676470588235294,0.09347550364975316,544,Are you thinking what I'm thinking?
286,10,5,53,68,1.3676470588235294,0.08865498664500654,544,Mine keeps asking for a raise
286,7,11,50,68,1.3676470588235294,0.08088734121420482,544,I hate being micromanaged.
286,10,5,53,68,1.3676470588235294,0.08865498664500654,544,Sure. Have your people talk with my people.
298,6,13,50,69,1.3623188405797102,0.07717026075112264,544,Ever get the sense you're not in charge?
298,9,7,53,69,1.3623188405797102,0.08505305122635451,544,Have your guy call my guy.
298,6,13,50,69,1.3623188405797102,0.07717026075112264,544,I'm OK as long as he doesn't have Mexican for lunch.
298,5,15,49,69,1.3623188405797102,0.07435718986682269,544,That's exactly what i have been thinking
302,6,12,49,67,1.3582089552238805,0.07872081250670442,544,I miss my thinking cap.
302,11,2,54,67,1.3582089552238805,0.09196948675285539,544,Are you thinking what I'm thinking?
302,8,8,51,67,1.3582089552238805,0.08427060217218625,544,Looks like the downsizing didn't reduce overhead.
302,7,10,50,67,1.3582089552238805,0.08154293566023545,544,"If we put our heads together, we can have a conference table."
302,5,14,48,67,1.3582089552238805,0.07579368237090822,544,"So, you’ve got a micromanager too?"
307,8,7,51,66,1.3484848484848484,0.08498573647614985,544,Have your people call my people.
307,9,5,52,66,1.3484848484848484,0.08768566513743312,544,Are you thinking what I'm thinking?
307,10,3,53,66,1.3484848484848484,0.09030490760083042,544,Have your people call my people.
310,6,10,48,64,1.34375,0.08097480869293328,544,Well one of us needs to go home and change hats
310,9,4,51,64,1.34375,0.08969400693999784,544,I feel we've reached a meeting of the minds here.
310,8,6,50,64,1.34375,0.086884884386875,544,"Some say he micromanages, but I can't imagine working for anyone else."
310,9,4,51,64,1.34375,0.08969400693999784,544,I'll have my people contact your people.
310,7,8,49,64,1.34375,0.08398185154477655,544,Those jerks at the hat store told me I had the only one.
310,7,8,49,64,1.34375,0.08398185154477655,544,"It’s weighing on me, too."
310,6,10,48,64,1.34375,0.08097480869293328,544,"'They're playing head games again."""
310,8,6,50,64,1.34375,0.086884884386875,544,Heavy is the head that wears Leon from Accounting.
310,8,6,50,64,1.34375,0.086884884386875,544,They worked hard to get a head.
310,4,14,46,64,1.34375,0.07459796344937072,544,"Yeah, I've been carrying my boss for way too long also."
310,4,14,46,64,1.34375,0.07459796344937072,544,"'Hey, don't blame me! The decision came from the top!"""
310,4,14,46,64,1.34375,0.07459796344937072,544,It's hard for me to keep a work-life balance. Especially when I tie my shoes.
310,7,8,49,64,1.34375,0.08398185154477655,544,Bad news: Boss says we need to cut overhead.
310,9,4,51,64,1.34375,0.08969400693999784,544,Are you thinking what I'm thinking?
310,8,6,50,64,1.34375,0.086884884386875,544,Are you thinking what I'm thinking?
310,3,16,45,64,1.34375,0.07119567686848623,544,It was more fun when we always had sex on our minds.
310,9,4,51,64,1.34375,0.08969400693999784,544,"I don't want to freak you out, but you've got a tiny bureaucrat on your head"
310,6,10,48,64,1.34375,0.08097480869293328,544,I can tell my guy is just playing solitaire.
310,3,16,45,64,1.34375,0.07119567686848623,544,"I liked ""Georgia"" better."
329,5,11,47,63,1.3333333333333333,0.07838618016696206,544,I liked Siri better.
329,9,3,51,63,1.3333333333333333,0.09051256444028409,544,I'll have my guy call your guy.
329,5,11,47,63,1.3333333333333333,0.07838618016696206,544,Bathroom breaks have been a challenge
329,7,7,49,63,1.3333333333333333,0.08466675133346033,544,"You say potato, I say potato."
329,6,9,48,63,1.3333333333333333,0.0815869230407957,544,I just clicked on 'Install Microsoft Office.'
329,4,13,46,63,1.3333333333333333,0.07504905376532171,544,Things have been tough since they banned thought bubbles.
329,1,19,43,63,1.3333333333333333,0.06400204809830924,544,The tap tap tapping in my head is driving me crazy.
329,6,9,48,63,1.3333333333333333,0.0815869230407957,544,"The management here is pretty much on top of things, although they sometimes split hairs."
329,8,5,50,63,1.3333333333333333,0.08763841367493648,544,Are you thinking what I'm thinking?
329,7,7,49,63,1.3333333333333333,0.08466675133346033,544,Are you thinking what I'm thinking?
329,3,15,45,63,1.3333333333333333,0.07155646512351531,544,Am I the only one feeling micromanaged?
329,9,3,51,63,1.3333333333333333,0.09051256444028409,544,Have your person call my person.
329,8,5,50,63,1.3333333333333333,0.08763841367493648,544,I'm having a hard time balancing work.
329,9,3,51,63,1.3333333333333333,0.09051256444028409,544,I'll have my guy call your guy.
329,5,11,47,63,1.3333333333333333,0.07838618016696206,544,Rainy days are the worst.
329,9,3,51,63,1.3333333333333333,0.09051256444028409,544,"""Are you thinking what I'm thinking?"
329,8,5,50,63,1.3333333333333333,0.08763841367493648,544,Are you thinking what I'm thinking?
329,4,13,46,63,1.3333333333333333,0.07504905376532171,544,I think I prefer the voices in my head.
329,4,13,46,63,1.3333333333333333,0.07504905376532171,544,"Off the top of my head, I'd say that desktops are not going extinct."
329,6,9,48,63,1.3333333333333333,0.0815869230407957,544,I really hate micromanagement... and my neck is killing me.
329,8,5,50,63,1.3333333333333333,0.08763841367493648,544,Have your person call my person.
329,4,13,46,63,1.3333333333333333,0.07504905376532171,544,What do you do to get work off your mind?
329,6,9,48,63,1.3333333333333333,0.0815869230407957,544,I'm under constant pressure from the head of my department.
329,7,7,49,63,1.3333333333333333,0.08466675133346033,544,I know what you're thinking.
329,4,13,46,63,1.3333333333333333,0.07504905376532171,544,What do you do for desk hair?
329,8,5,50,63,1.3333333333333333,0.08763841367493648,544,"Next time, I'm definitely taking the ankle monitor."
329,6,9,48,63,1.3333333333333333,0.0815869230407957,544,"Forget your heart, what's your head telling you."
329,5,11,47,63,1.3333333333333333,0.07838618016696206,544,I'll have my head office contact your head office.
329,9,3,51,63,1.3333333333333333,0.09051256444028409,544,I'll have my little guy call your little guy.
358,7,7,50,64,1.328125,0.08349593511396561,544,It's stressful working under a micromanager.
359,5,10,47,62,1.3225806451612903,0.07890777924097209,544,Sometimes I feel like the man is keeping me down....
359,6,8,48,62,1.3225806451612903,0.08219037872229688,544,Do you wish you'd got a laptop too?
359,3,14,45,62,1.3225806451612903,0.07189434028626156,544,It won't be so bad once they go wireless.
359,7,6,49,62,1.3225806451612903,0.08534681648595453,544,I'll have my guy talk to your guy .
359,6,8,48,62,1.3225806451612903,0.08219037872229688,544,I was thinking the same thing.
359,4,12,46,62,1.3225806451612903,0.07548256020412515,544,I could be worse. Imagine if we had asked for treadmill desks.
359,5,10,47,62,1.3225806451612903,0.07890777924097209,544,"'Frankly, I miss Siri.'"
359,8,4,50,62,1.3225806451612903,0.08839060930924623,544,"""You're micromanaged too?"
359,5,10,47,62,1.3225806451612903,0.07890777924097209,544,"Yea, was kinda thinking the same thing."
359,8,4,50,62,1.3225806451612903,0.08839060930924623,544,"Off the top of my head, I don't remember what they do here."
359,5,10,47,62,1.3225806451612903,0.07890777924097209,544,At the end of the day we've all got to answer to the guy upstairs.
359,6,8,48,62,1.3225806451612903,0.08219037872229688,544,What's mine doing?
359,6,8,48,62,1.3225806451612903,0.08219037872229688,544,Do we really need two head writers?
359,9,2,51,62,1.3225806451612903,0.09133302000827749,544,"Weird, I was thinking the same thing."
359,6,8,48,62,1.3225806451612903,0.08219037872229688,544,I just hate it when he takes his shoes off.
359,7,6,49,62,1.3225806451612903,0.08534681648595453,544,My guy will call your guy.
359,4,12,46,62,1.3225806451612903,0.07548256020412515,544,Running under a low hanging branch is the way I clear my head of work.
359,4,12,46,62,1.3225806451612903,0.07548256020412515,544,We can’t have two head writers.
359,4,12,46,62,1.3225806451612903,0.07548256020412515,544,The worst part is I can't even tell if he's really working.
359,4,12,46,62,1.3225806451612903,0.07548256020412515,544,I hate commercial surreal estate.
359,8,4,50,62,1.3225806451612903,0.08839060930924623,544,Are you thinking what I'm thinking?
359,7,6,49,62,1.3225806451612903,0.08534681648595453,544,The overhead is killing us.
359,6,8,48,62,1.3225806451612903,0.08219037872229688,544,Do you ever feel micromanaged?
359,5,10,47,62,1.3225806451612903,0.07890777924097209,544,"We're getting twice as much done, but the overhead is killer."
359,8,4,50,62,1.3225806451612903,0.08839060930924623,544,Have your little man call my little man to schedule that little meeting.
359,5,10,47,62,1.3225806451612903,0.07890777924097209,544,"If you're not the head of marketing, what ARE you the head of?"
359,6,8,48,62,1.3225806451612903,0.08219037872229688,544,These IRS audits are getting too personal.
359,4,12,46,62,1.3225806451612903,0.07548256020412515,544,"Yes, but mine isn't wearing any pants."
359,2,16,44,62,1.3225806451612903,0.06811736515327178,544,What do you do when you just can't get work off your mind?
359,7,6,49,62,1.3225806451612903,0.08534681648595453,544,I get a feeling we're like-minded.
359,5,10,47,62,1.3225806451612903,0.07890777924097209,544,"NO! The difference between us is: mine has done my income taxes, balanced my check book, and restructured my 401k, while your's has just sat there all day playing video solitaire."
390,4,12,47,63,1.3174603174603174,0.0744510438067211,544,Welcome to the head office.
390,7,6,50,63,1.3174603174603174,0.08413712756091785,544,Off the top of my head? Hang on. Lemme ask.
392,6,7,48,61,1.3114754098360655,0.08278282736362359,544,We support small business.
392,8,3,50,61,1.3114754098360655,0.08913973682471188,544,"Yes, that's how to get a head in business."
392,5,9,47,61,1.3114754098360655,0.07941377977960633,544,"Funny, I was just thinking the exact same thing."
392,4,11,46,61,1.3114754098360655,0.07589532483264116,544,I can't get out from under the office
392,7,5,49,61,1.3114754098360655,0.08602002437657874,544,Laptops would eliminate overhead.
392,4,11,46,61,1.3114754098360655,0.07589532483264116,544,It's all about balance.
392,5,9,47,61,1.3114754098360655,0.07941377977960633,544,"So this is what he meant by "" Desk Jockey"""
392,2,15,44,61,1.3114754098360655,0.0683169390165333,544,I'll tell you what's wrong with the company....too many head offices.
392,5,9,47,61,1.3114754098360655,0.07941377977960633,544,"Hair bnb is going to work man, I'm telling you."
392,4,11,46,61,1.3114754098360655,0.07589532483264116,544,"I know it's not exactly a home office, but I still think I'm entitled to a tax deduction"
392,5,9,47,61,1.3114754098360655,0.07941377977960633,544,Find the 10 things different.
392,1,17,43,61,1.3114754098360655,0.06419311543426628,544,I feel like William Tell’s son – with an Apple on my head!
392,7,5,49,61,1.3114754098360655,0.08602002437657874,544,Are you thinking what I'm thinking?
392,7,5,49,61,1.3114754098360655,0.08602002437657874,544,Mine wastes time on that cartoon caption contest.
392,5,9,47,61,1.3114754098360655,0.07941377977960633,544,I just don't know about these new Microsoft wearables...
392,4,11,46,61,1.3114754098360655,0.07589532483264116,544,"Seriously Dean, I think we're carrying way too much overhead."
392,5,9,47,61,1.3114754098360655,0.07941377977960633,544,I miss pencils behind the ears.
392,4,11,46,61,1.3114754098360655,0.07589532483264116,544,It's a new corporate policy to shrink overhead.
392,8,3,50,61,1.3114754098360655,0.08913973682471188,544,George Orwell never saw this coming ....
392,6,7,48,61,1.3114754098360655,0.08278282736362359,544,No way you came up with that off the top of your head.
412,6,7,49,62,1.3064516129032258,0.08159148631143069,544,My thoughts exactly.
412,5,9,48,62,1.3064516129032258,0.07828377806886798,544,"It's Friday afternoon, why don't they just go home?"
412,7,5,50,62,1.3064516129032258,0.08477022689766137,544,I want a head with a corner office.
415,9,0,51,60,1.3,0.09297347899594899,544,"Twins @ Work: ""Are you thinking what I'm thinking?"""
415,3,12,45,60,1.3,0.07248611789946811,544,"No matter how hard I work, the boss is always on top of me."
415,6,6,48,60,1.3,0.08336157713463008,544,Can we go back to the man buns?
415,5,8,47,60,1.3,0.07990106877232901,544,Is this their idea of thinking outside the box?
415,4,10,46,60,1.3,0.0762837403353298,544,It's all about striking the right balance.
415,4,10,46,60,1.3,0.0762837403353298,544,We need to cut our overhead.
415,4,10,46,60,1.3,0.0762837403353298,544,We really need to reduce our overhead.
415,5,8,47,60,1.3,0.07990106877232901,544,I hate being micromanaged.
415,4,10,46,60,1.3,0.0762837403353298,544,I understand we should seek medical attention if it lasts for more than four hours.
415,5,8,47,60,1.3,0.07990106877232901,544,The head office just won't leave me alone.
415,3,12,45,60,1.3,0.07248611789946811,544,Have your guy call my guy.
415,5,8,47,60,1.3,0.07990106877232901,544,Apparently they meant what they said about moving us to the head office.
415,5,8,47,60,1.3,0.07990106877232901,544,"I don't like to take my work home with me, but it's always on my mind"
415,2,14,44,60,1.3,0.06847821213147406,544,I found him through a headhunter.
415,4,10,46,60,1.3,0.0762837403353298,544,I find he's more thorough than the thinking cap.
415,5,8,47,60,1.3,0.07990106877232901,544,I'll put you in touch with my head accountant.
415,3,12,45,60,1.3,0.07248611789946811,544,"I just hope they don't hit alt, control, delete."
415,5,8,47,60,1.3,0.07990106877232901,544,I know you are but what am I?
415,5,8,47,60,1.3,0.07990106877232901,544,The boss says it reduces overhead.
415,5,8,47,60,1.3,0.07990106877232901,544,"Business is good, but the overhead is killing me."
415,3,12,45,60,1.3,0.07248611789946811,544,Working in the Head Office sounded so appealing
415,5,8,47,60,1.3,0.07990106877232901,544,Tax accountant nesting season is hard on all of us.
415,4,10,46,60,1.3,0.0762837403353298,544,Do you ever get the feeling we've been hacked?
415,6,6,48,60,1.3,0.08336157713463008,544,The office in my pants is far less efficient.
415,5,8,47,60,1.3,0.07990106877232901,544,We’ll never get management out of our hair.
415,4,10,46,60,1.3,0.0762837403353298,544,"Oh my God, I know...the foot tapping."
415,5,8,47,60,1.3,0.07990106877232901,544,Don't even ask where he parks his car.
415,8,2,50,60,1.3,0.08988379189374322,544,Are you thinking what I'm thinking?
415,4,10,46,60,1.3,0.0762837403353298,544,It sucks being an early adopter; the next gen version's gonna have a brim.
415,5,8,47,60,1.3,0.07990106877232901,544,"I preferred the iWatch, but this covers my bald spot."
415,7,4,49,60,1.3,0.086684048669783,544,Are you thinking what I'm thinking?
415,6,6,48,60,1.3,0.08336157713463008,544,My guy says your guy is an idiot.
415,5,8,47,60,1.3,0.07990106877232901,544,Am I the only one who likes it when he takes off his shoes and massages my scalp?
415,6,6,48,60,1.3,0.08336157713463008,544,We really need to cut our overhead.
415,7,4,49,60,1.3,0.086684048669783,544,My man will get back to your man.
415,6,6,48,60,1.3,0.08336157713463008,544,are they in over our heads?
415,7,4,49,60,1.3,0.086684048669783,544,"Either my phone is ringing, or I've got tinnitus."
415,7,4,49,60,1.3,0.086684048669783,544,Have your guy call my guy and we'll talk.
415,4,10,46,60,1.3,0.0762837403353298,544,I always have work on my mind.
415,6,6,48,60,1.3,0.08336157713463008,544,Are you thinking what I'm thinking?
415,5,8,47,60,1.3,0.07990106877232901,544,"Sometimes he telecommutes, but he prefers to work out of the head office."
415,3,12,45,60,1.3,0.07248611789946811,544,"'Click, click, click!"" All night long... 'Click, click, click!'"
415,6,6,48,60,1.3,0.08336157713463008,544,"Off the top of my head, I would say that we are both workaholics."
415,2,14,44,60,1.3,0.06847821213147406,544,Do I have a receding desk?
415,2,14,44,60,1.3,0.06847821213147406,544,"It's driving me crazy! The TV show theme to ""The Patty Duke Show"" keeps running in my mind over and over."
415,7,4,49,60,1.3,0.086684048669783,544,Are you thinking what I'm thinking?
415,6,6,48,60,1.3,0.08336157713463008,544,"I see you run a low-overhead business, too."
415,8,2,50,60,1.3,0.08988379189374322,544,Are you thinking what I'm thinking?
415,3,12,45,60,1.3,0.07248611789946811,544,Work is always on my mind too.
415,5,8,47,60,1.3,0.07990106877232901,544,This is not when I meant when I requested a move to head office.
415,6,6,48,60,1.3,0.08336157713463008,544,Russian hackers?
466,8,2,51,61,1.2950819672131149,0.0885347089946429,544,I think we can get this deal done. I'll have my guy call your guy.
466,4,10,47,61,1.2950819672131149,0.0751837904540555,544,"Lice are pretty awful, but marketing directors are worse."
466,4,10,47,61,1.2950819672131149,0.0751837904540555,544,I much preferred the Google glasses.
466,8,2,51,61,1.2950819672131149,0.0885347089946429,544,I'll have my person talk with your person.
470,5,7,47,59,1.2881355932203389,0.08036608035599811,544,I believe we have the same barber.
470,6,5,48,59,1.2881355932203389,0.08392353905627811,544,They're working on this cartoon caption.
470,5,7,47,59,1.2881355932203389,0.08036608035599811,544,I thought these implants would be more sophisticated.
470,4,9,46,59,1.2881355932203389,0.07664367772910466,544,Jump if you hate your boss.
470,8,1,50,59,1.2881355932203389,0.09062045839443995,544,Have your people call my people.
470,3,11,45,59,1.2881355932203389,0.07273100989192272,544,The micro-management is starting to get to me.
470,7,3,49,59,1.2881355932203389,0.08733621209827301,544,I have to let him go but don't want a bad case of desk head.
470,5,7,47,59,1.2881355932203389,0.08036608035599811,544,Have your homunculus text my homunculus.
470,5,7,47,59,1.2881355932203389,0.08036608035599811,544,My thoughts exactly!
470,5,7,47,59,1.2881355932203389,0.08036608035599811,544,They're plugged in where?
470,7,3,49,59,1.2881355932203389,0.08733621209827301,544,"Are you thinkin' what I'm thinkin""?"
470,5,7,47,59,1.2881355932203389,0.08036608035599811,544,I'll have my guy email your guy.
470,7,3,49,59,1.2881355932203389,0.08733621209827301,544,Are you thinking what I'm thinking?
470,3,11,45,59,1.2881355932203389,0.07273100989192272,544,Does your guy at least keep his shoes on?
470,7,3,49,59,1.2881355932203389,0.08733621209827301,544,Are you thinking what I'm thinking?
470,6,5,48,59,1.2881355932203389,0.08392353905627811,544,I'll have my guy call your guy.
486,2,13,45,60,1.2833333333333334,0.06761333513821251,544,He's not heavy he's my accountant.
487,4,8,45,57,1.280701754385965,0.07817781433825675,544,"They told me I was ""head office material"", too."
487,4,8,45,57,1.280701754385965,0.07817781433825675,544,"I know the government's gotta prevent terrorism and all, but sometimes I think they go just a little too... Oh! My mind just went blank."
487,5,6,46,57,1.280701754385965,0.08208737461234245,544,I can't get work off of my mind either!
487,5,6,46,57,1.280701754385965,0.08208737461234245,544,"Weird, mine's not wearing pants either."
487,3,10,44,57,1.280701754385965,0.0740621646906627,544,Don't you get tired of that phone ringing in your ears?
487,1,14,42,57,1.280701754385965,0.06505437269382161,544,Are you downloading what I'm downloading?
487,3,10,44,57,1.280701754385965,0.0740621646906627,544,"""I was thinking the exact same thing""."
487,4,8,45,57,1.280701754385965,0.07817781433825675,544,"Telecomuting is great, but getting tech support can be a headache."
487,4,8,45,57,1.280701754385965,0.07817781433825675,544,I retweeted myself.
487,4,8,45,57,1.280701754385965,0.07817781433825675,544,I like the way your mind works.
487,0,16,41,57,1.280701754385965,0.06004585739704731,544,Hello Bob. Let me introduce boB from the Alternate Universe Department.
487,4,8,45,57,1.280701754385965,0.07817781433825675,544,I remember when guardian angels simply sat on the shoulder.
487,5,6,46,57,1.280701754385965,0.08208737461234245,544,You are out of your mind.
487,4,8,45,57,1.280701754385965,0.07817781433825675,544,I don't know if this new Google Hat is going to catch on.
487,2,12,43,57,1.280701754385965,0.0697039297502425,544,I hate when they spill coffee.
487,2,12,43,57,1.280701754385965,0.0697039297502425,544,I also have a head for small business.
487,4,8,45,57,1.280701754385965,0.07817781433825675,544,I see you also bought the new smart hat
487,5,6,46,57,1.280701754385965,0.08208737461234245,544,I was really expecting Virtual Reality to be more fun
487,0,16,41,57,1.280701754385965,0.06004585739704731,544,"Who would have guessed your inner child is a middle-aged actuary, just like mine"
506,4,7,45,56,1.2678571428571428,0.07850498961961752,544,I can balance work but not play. How 'bout you?
506,2,11,43,56,1.2678571428571428,0.06974476393590386,544,"I was thinking about, but the little accountant on my head says it's best to wait until after November 8. If that orange monster wins, then the market will crash."
506,2,11,43,56,1.2678571428571428,0.06974476393590386,544,Can't get work off your mind?
506,5,5,46,56,1.2678571428571428,0.08253716765510495,544,Shh. Little Brother is watching.
506,3,9,44,56,1.2678571428571428,0.07425417662209718,544,Off the top of my head ...
506,2,11,43,56,1.2678571428571428,0.06974476393590386,544,The overhead is killing me.
506,4,7,45,56,1.2678571428571428,0.07850498961961752,544,"THE PROBLEM'S NOT OUR BALANCE, IT'S THE OVERHEAD"
506,3,9,44,56,1.2678571428571428,0.07425417662209718,544,"I can't wait until ""bring your homunculus to work"" day is over."
506,4,7,45,56,1.2678571428571428,0.07850498961961752,544,I hate waking up to a bad chair day.
506,2,11,43,56,1.2678571428571428,0.06974476393590386,544,I think now that I'd rather have that microchip implant.
506,6,3,47,56,1.2678571428571428,0.08638133301748446,544,I liked it better when the voices were inside my head.
506,4,7,45,56,1.2678571428571428,0.07850498961961752,544,I don't think the management realizes how much the downsizing weighs on us.
506,1,13,42,56,1.2678571428571428,0.06492288846873887,544,IT told me to try turning it off and on again
506,4,7,45,56,1.2678571428571428,0.07850498961961752,544,They've taken technical support to a whole new level.
506,3,9,44,56,1.2678571428571428,0.07425417662209718,544,"Yes, Lloyd, I think we balance our work pretty well."
506,4,7,45,56,1.2678571428571428,0.07850498961961752,544,"Well, this is embarrassing."
506,3,9,44,56,1.2678571428571428,0.07425417662209718,544,You have no idea the pressure I'm under.
506,3,9,44,56,1.2678571428571428,0.07425417662209718,544,It appears we both have some of Hillary's emails.
506,5,5,46,56,1.2678571428571428,0.08253716765510495,544,Hard work is the key to getting a head in life.
506,4,7,45,56,1.2678571428571428,0.07850498961961752,544,So what's it like having a left-handed brain?
506,5,5,46,56,1.2678571428571428,0.08253716765510495,544,"Yeah, but on weekends he's a lumberjack and I get irritable."
506,5,5,46,56,1.2678571428571428,0.08253716765510495,544,Looks like we’re both dressed for the job we want: head executive.
506,4,7,45,56,1.2678571428571428,0.07850498961961752,544,I hate micro-managers.
506,5,5,46,56,1.2678571428571428,0.08253716765510495,544,Just give me your ideas off the top of your head
506,6,3,47,56,1.2678571428571428,0.08638133301748446,544,Same with my hairdresser: 'Lose the cubicle.'
506,3,9,44,56,1.2678571428571428,0.07425417662209718,544,"I agree, desktops are old hat."
506,3,9,44,56,1.2678571428571428,0.07425417662209718,544,I see you're having issues with upper management as well.
506,2,11,43,56,1.2678571428571428,0.06974476393590386,544,"I don't know what to think, my internet is down."
506,5,5,46,56,1.2678571428571428,0.08253716765510495,544,I thought I was the only one who had a head for business.
506,1,13,42,56,1.2678571428571428,0.06492288846873887,544,I guess we both have work on our minds.
506,3,9,44,56,1.2678571428571428,0.07425417662209718,544,Work has become such a balancing act.
506,0,15,41,56,1.2678571428571428,0.05971290310957638,544,...and I say it's not normal to have two head offices.
506,3,9,44,56,1.2678571428571428,0.07425417662209718,544,How's your personal assistant working out?
506,3,9,44,56,1.2678571428571428,0.07425417662209718,544,There must be some mistake. I was promoted to head the department.
506,3,9,44,56,1.2678571428571428,0.07425417662209718,544,I hate golf-shoe Fridays.
506,4,7,45,56,1.2678571428571428,0.07850498961961752,544,Are you syncing what I'm syncing?
506,2,11,43,56,1.2678571428571428,0.06974476393590386,544,He's already monetized my conscience and outsourced my imagination. How's yours helping you?
506,3,9,44,56,1.2678571428571428,0.07425417662209718,544,I used to have a monkey on my back.
506,3,9,44,56,1.2678571428571428,0.07425417662209718,544,"Ah, yes! Speech bubbles. Those were the days."
506,2,11,43,56,1.2678571428571428,0.06974476393590386,544,Hold on. I'm waiting to hear from the man upstairs.
506,3,9,44,56,1.2678571428571428,0.07425417662209718,544,The micromanaging has gotten out of control.
506,3,9,44,56,1.2678571428571428,0.07425417662209718,544,It wouldn't be so bad if he didn't have smelly feet.
506,6,3,47,56,1.2678571428571428,0.08638133301748446,544,Mine spends too much time on Facebook.
506,6,3,47,56,1.2678571428571428,0.08638133301748446,544,Do you know what I'm thinking?
506,4,7,45,56,1.2678571428571428,0.07850498961961752,544,We should have gone with baseball caps.
506,5,5,46,56,1.2678571428571428,0.08253716765510495,544,I can see how your mind works.
506,2,11,43,56,1.2678571428571428,0.06974476393590386,544,The boss wants to see all the department heads.
506,5,5,46,56,1.2678571428571428,0.08253716765510495,544,"The job weighs heavy on the mind, but at least we have one."
506,5,5,46,56,1.2678571428571428,0.08253716765510495,544,The guys in the head office think we're beneath them.
506,3,9,44,56,1.2678571428571428,0.07425417662209718,544,I can't seem to get work off my mind either.
556,5,5,47,57,1.263157894736842,0.08121228945373259,544,2 Great Minds think alike
556,2,11,44,57,1.263157894736842,0.0686712218487231,544,It's 24/7 tech support.
558,5,4,46,55,1.2545454545454546,0.08295137441473863,544,How is your Ikea any different than mine?
558,3,8,44,55,1.2545454545454546,0.0743917278364524,544,"If it’s just you and me, I’m not sure what to do, but if we find other people then I think we have a solid class action suit against the shampoo company."
558,4,6,45,55,1.2545454545454546,0.0787878787878788,544,I've been meaning to ask—where's your guy plugging in?
558,5,4,46,55,1.2545454545454546,0.08295137441473863,544,I'm standing right here. Can't you talk to me rather than e-mailing?
558,3,8,44,55,1.2545454545454546,0.0743917278364524,544,Do you ever feel like you're losing Ctrl?
558,4,6,45,55,1.2545454545454546,0.0787878787878788,544,"He really wants one of those standing desks, but I think they look silly."
558,1,12,42,55,1.2545454545454546,0.06470956516382613,544,I preferred the little angel and devil guys on my shoulders.
558,2,10,43,55,1.2545454545454546,0.06971892495651474,544,My conscience is clean. Yours has a spot on his tie.
558,6,2,47,55,1.2545454545454546,0.0869156556133291,544,This is taking technical support to an extreme.
558,4,6,45,55,1.2545454545454546,0.0787878787878788,544,Did you also buy the protective fedora?
558,1,12,42,55,1.2545454545454546,0.06470956516382613,544,Do you get the feeling we're being hacked?
558,5,4,46,55,1.2545454545454546,0.08295137441473863,544,It's the overhead that causes the biggest headaches.
558,2,10,43,55,1.2545454545454546,0.06971892495651474,544,Let's not overthink this.
558,6,2,47,55,1.2545454545454546,0.0869156556133291,544,"Between the FBI and Wikileaks, I wish he'd stop writing so many emails."
558,4,6,45,55,1.2545454545454546,0.0787878787878788,544,Have your people contact my people.
558,3,8,44,55,1.2545454545454546,0.0743917278364524,544,Our overhead is killing us.
558,5,4,46,55,1.2545454545454546,0.08295137441473863,544,"Just our luck, the only two headhunters in the world who take their title literally."
558,1,12,42,55,1.2545454545454546,0.06470956516382613,544,I'm renting it out via HairBnB.
558,4,6,45,55,1.2545454545454546,0.0787878787878788,544,Don't you love the new iDesk?
558,3,8,44,55,1.2545454545454546,0.0743917278364524,544,"Do you feel the oppressive weight of management, or is it just me?"
558,2,10,43,55,1.2545454545454546,0.06971892495651474,544,"Hey, Mac, your file's open."
558,5,4,46,55,1.2545454545454546,0.08295137441473863,544,"When they said that they were desk jockeys, I honestly didn't know that we would be the horses."
558,4,6,45,55,1.2545454545454546,0.0787878787878788,544,"Job's gone to your head, too?"
558,1,12,42,55,1.2545454545454546,0.06470956516382613,544,There it is again. Tap tap tap...
558,2,10,43,55,1.2545454545454546,0.06971892495651474,544,Thanks for showing me how to better organize my ideas.
558,3,8,44,55,1.2545454545454546,0.0743917278364524,544,I like the connectivity but the hat-hair is horrible...
558,3,8,44,55,1.2545454545454546,0.0743917278364524,544,"Thank god, I thought I was the only one. Does your guy spill coffee too?"
558,5,4,46,55,1.2545454545454546,0.08295137441473863,544,I'd say we both have a head for business.
558,2,10,43,55,1.2545454545454546,0.06971892495651474,544,William said something about shooting Apples off our heads. I came up with this.
558,1,12,42,55,1.2545454545454546,0.06470956516382613,544,At least your guy doesn't tap his feet on your head all day long.
558,3,8,44,55,1.2545454545454546,0.0743917278364524,544,"Have the people on your head talk to my people, on my head."
558,2,10,43,55,1.2545454545454546,0.06971892495651474,544,I see you asked for the executive haircut too
558,3,8,44,55,1.2545454545454546,0.0743917278364524,544,For cold weather I add a cubicle.
558,4,6,45,55,1.2545454545454546,0.0787878787878788,544,You too?
558,3,8,44,55,1.2545454545454546,0.0743917278364524,544,Never let your left brain know what your right brain is doing.
558,4,6,45,55,1.2545454545454546,0.0787878787878788,544,I'll email you my thoughts on that.
558,3,8,44,55,1.2545454545454546,0.0743917278364524,544,"I told you, he's not in"
558,4,6,45,55,1.2545454545454546,0.0787878787878788,544,Off the top of my head I'd say you and I work well together.
558,2,10,43,55,1.2545454545454546,0.06971892495651474,544,It's not what I thought tech support was either.
558,4,6,45,55,1.2545454545454546,0.0787878787878788,544,I think we should go back to iPhones.
558,2,10,43,55,1.2545454545454546,0.06971892495651474,544,Is your little accountant thinking what my little accountant is thinking?
558,4,6,45,55,1.2545454545454546,0.0787878787878788,544,"Yeah, work is always on my mind too."
558,3,8,44,55,1.2545454545454546,0.0743917278364524,544,Your left brain seems to work the same way as my right brain.
558,4,6,45,55,1.2545454545454546,0.0787878787878788,544,I feel a lot more relaxed after 5 p.m. when I reclaim my headspace.
602,2,10,44,56,1.25,0.06861335298462105,544,I see you're right-brained.
602,3,8,45,56,1.25,0.07319250547113999,544,You know why we're losing money? Too much overhead.
602,2,10,44,56,1.25,0.06861335298462105,544,"At first, the home office seemed like a great idea."
602,2,10,44,56,1.25,0.06861335298462105,544,If we handle this right we can each take off every other day.
606,2,9,43,54,1.2407407407407407,0.06961602376844407,544,You're right. Desk jobs are not beneath us.
606,4,5,45,54,1.2407407407407407,0.07901907873711286,544,I am considering a lobotomy...
606,4,5,45,54,1.2407407407407407,0.07901907873711286,544,I was also told it was one of a kind.
606,5,3,46,54,1.2407407407407407,0.08332362704556721,544,"Call me old fashioned, but I'm still attached to my desktop computer."
606,4,5,45,54,1.2407407407407407,0.07901907873711286,544,I can't get him off my mind either!
606,3,7,44,54,1.2407407407407407,0.07446611836866017,544,Stand-under desks are the new stand-up desks.
606,1,11,42,54,1.2407407407407407,0.06440169831426679,544,"I agree. These guys are starting to get in my hair, too."
606,3,7,44,54,1.2407407407407407,0.07446611836866017,544,I've always had a good head for business.
606,3,7,44,54,1.2407407407407407,0.07446611836866017,544,I'll have my man upstairs send you an email.
606,4,5,45,54,1.2407407407407407,0.07901907873711286,544,I thought you said it wasn't contagious!
606,3,7,44,54,1.2407407407407407,0.07446611836866017,544,"I really thought this would help my career, but my guy's just playing Tetris."
606,3,7,44,54,1.2407407407407407,0.07446611836866017,544,Does yours weep softly every night?
606,3,7,44,54,1.2407407407407407,0.07446611836866017,544,"Clearly we're fraternal; I prefer the keyboard, you prefer the mouse, I have pens and pencils, you don't, and what is your right hand doing, by the way?"
606,3,7,44,54,1.2407407407407407,0.07446611836866017,544,I like using the Cloud better.
606,2,9,43,54,1.2407407407407407,0.06961602376844407,544,"We are, indeed, of like minds, but I will be needing my stapler back."
606,5,3,46,54,1.2407407407407407,0.08332362704556721,544,"I don't know, your person would have to talk to my person."
606,5,3,46,54,1.2407407407407407,0.08332362704556721,544,You want the quarterly sales figures off the top of my head?
606,3,7,44,54,1.2407407407407407,0.07446611836866017,544,I know what you're probably thinking.
606,1,11,42,54,1.2407407407407407,0.06440169831426679,544,I hope that's not a private server.
606,1,11,42,54,1.2407407407407407,0.06440169831426679,544,Thank goodness mine lives in the cloud on weekends.
606,3,7,44,54,1.2407407407407407,0.07446611836866017,544,"For me, it was an underutilized space."
606,2,9,43,54,1.2407407407407407,0.06961602376844407,544,This was not what I pictured when the boss mentioned outsourcing.
606,3,7,44,54,1.2407407407407407,0.07446611836866017,544,We always have work on our mind.
606,5,3,46,54,1.2407407407407407,0.08332362704556721,544,He hates it when I look at my feet.
606,3,7,44,54,1.2407407407407407,0.07446611836866017,544,"That’s funny, you were on my mind too"
606,3,7,44,54,1.2407407407407407,0.07446611836866017,544,The company tells me this helicopter bossing is just for us millenials
606,2,9,43,54,1.2407407407407407,0.06961602376844407,544,Power outages are the new snow days.
606,4,5,45,54,1.2407407407407407,0.07901907873711286,544,Maybe the red pill and the blue pill aren't that different after all.
606,3,7,44,54,1.2407407407407407,0.07446611836866017,544,You are so crazy I can hear the voices in your head
606,1,11,42,54,1.2407407407407407,0.06440169831426679,544,That's a good idea. Let me run it by the higher-ups.
606,4,5,45,54,1.2407407407407407,0.07901907873711286,544,"If you're thinking what I'm thinking, you're fired."
606,3,7,44,54,1.2407407407407407,0.07446611836866017,544,"Yet again, the working man bears the burden of corporate downsizing."
606,1,11,42,54,1.2407407407407407,0.06440169831426679,544,Did I unplug the coffee machine and when did I leave the office? The last thing I recall is leaving the laptop in the car. How many drinks did I have before bed? Good thing I am self employed.
606,2,9,43,54,1.2407407407407407,0.06961602376844407,544,"One day, we'll just have a chip in our heads."
606,5,3,46,54,1.2407407407407407,0.08332362704556721,544,I'll have my guy text your guy about that.
606,2,9,43,54,1.2407407407407407,0.06961602376844407,544,Let's get our top guys on this right away...
606,3,7,44,54,1.2407407407407407,0.07446611836866017,544,I see you have work on your mind as well.
606,6,1,47,54,1.2407407407407407,0.08741646780553144,544,I'll have my people e-mail your people.
606,2,9,43,54,1.2407407407407407,0.06961602376844407,544,We seem to think very much alike.
606,3,7,44,54,1.2407407407407407,0.07446611836866017,544,Brothers from another mother board.
606,6,1,47,54,1.2407407407407407,0.08741646780553144,544,Good for us; we each managed to get a head.
606,3,7,44,54,1.2407407407407407,0.07446611836866017,544,I feel like I'm being micromanaged from above.
606,3,7,44,54,1.2407407407407407,0.07446611836866017,544,"Yes, it was top of my mind, too."
606,2,9,43,54,1.2407407407407407,0.06961602376844407,544,"I'm sorry, but I'm going to have to inform my head office"
606,4,5,45,54,1.2407407407407407,0.07901907873711286,544,Told your boss to get off your back too eh!
606,3,7,44,54,1.2407407407407407,0.07446611836866017,544,I'll have my guy take a look and call your guy.
606,3,7,44,54,1.2407407407407407,0.07446611836866017,544,Of course I feel like we're being micro-managed.
606,4,5,45,54,1.2407407407407407,0.07901907873711286,544,"Roger, copy that."
606,4,5,45,54,1.2407407407407407,0.07901907873711286,544,I just can’t do this anymore. I guess I don’t really have a head for business.
606,2,9,43,54,1.2407407407407407,0.06961602376844407,544,"""What are the odds? All these years, and I had no idea we went to the same hair stylist""."
606,1,11,42,54,1.2407407407407407,0.06440169831426679,544,I really need to get an ergonomic set up. My neck and back are killing me.
606,4,5,45,54,1.2407407407407407,0.07901907873711286,544,A meeting? My people will call your people.
606,2,9,43,54,1.2407407407407407,0.06961602376844407,544,My mom always said I had a head for business.
606,4,5,45,54,1.2407407407407407,0.07901907873711286,544,You know I really don't understand those guys that are always trying to get a head in the office.
606,4,5,45,54,1.2407407407407407,0.07901907873711286,544,It's the plugs I find most uncomfortable.
606,3,7,44,54,1.2407407407407407,0.07446611836866017,544,Remember the good old days when executive functioning was handled by the prefrontal cortex?
606,4,5,45,54,1.2407407407407407,0.07901907873711286,544,Mother was right. We both have a head for accounting.
663,3,7,46,56,1.2321428571428572,0.0720347653647201,544,"Trust me, it's easier than being outsourced to Bombay."
664,4,4,45,53,1.2264150943396226,0.07918997309552243,544,Are you thinking what I'm thinking?
664,1,10,42,53,1.2264150943396226,0.06398424512382328,544,My boss is a real micro-manager.
664,2,8,43,53,1.2264150943396226,0.06942386498172073,544,We have to stop taking the office home with us.
664,3,6,44,53,1.2264150943396226,0.07446719031852134,544,I'm feeling mounting pressure to let them work from home.
664,6,0,47,53,1.2264150943396226,0.08787736141202092,544,"I thought this supposed to be an online audit, not a hairline audit."
664,4,4,45,53,1.2264150943396226,0.07918997309552243,544,"Be strong, dude. In just a few weeks, they'll be sugar plum fairies dancing on our heads."
664,4,4,45,53,1.2264150943396226,0.07918997309552243,544,My guy will get back to your guy.
664,4,4,45,53,1.2264150943396226,0.07918997309552243,544,I'll have my guy email your guy.
664,3,6,44,53,1.2264150943396226,0.07446719031852134,544,Let's do lunch. Have your people email my people.
664,3,6,44,53,1.2264150943396226,0.07446719031852134,544,"That's funny, because I think YOU've been micromanaging ME."
674,4,5,49,58,1.2241379310344827,0.0739643291680361,544,Answered an ad for a level-headed support person. And you?
675,1,10,43,54,1.2222222222222223,0.06292801266165045,544,My guess is they're writing science fiction novels.
675,4,4,46,54,1.2222222222222223,0.0778226884413861,544,Your left brain is the same as my right brain.
677,3,5,43,51,1.2156862745098038,0.07573807025814888,544,Do you ever feel like we're being used?
677,0,11,40,51,1.2156862745098038,0.058166262643887544,544,I'm just not processing things the way I used to.
677,1,9,41,51,1.2156862745098038,0.0645571671888405,544,I have to wash that man right out of my hair.
677,3,5,43,51,1.2156862745098038,0.07573807025814888,544,The boss said we weren't using our heads
677,3,5,43,51,1.2156862745098038,0.07573807025814888,544,How many differences can you spot?
677,2,7,42,51,1.2156862745098038,0.07037003311735827,544,I can't seem to get the job off my mind.
677,1,9,41,51,1.2156862745098038,0.0645571671888405,544,Favorite band? Talking Heads.
677,3,5,43,51,1.2156862745098038,0.07573807025814888,544,I hate these micromanagers.
677,3,5,43,51,1.2156862745098038,0.07573807025814888,544,My wife thinks I'd look better with a laptop.
677,0,11,40,51,1.2156862745098038,0.058166262643887544,544,"Copy your costume? No, mine has a pencil cup."
677,2,7,42,51,1.2156862745098038,0.07037003311735827,544,I'm voting in favor of Measure 95 to set mandatory heights for doorways.
677,4,3,44,51,1.2156862745098038,0.08075004032146667,544,No way! Where'd you find the left-handed edition?
677,1,9,41,51,1.2156862745098038,0.0645571671888405,544,No way you'll get a promotion without a pencil holder.
677,3,5,43,51,1.2156862745098038,0.07573807025814888,544,"Oh, he just crawls up my back. How does your guy get to work?"
677,2,7,42,51,1.2156862745098038,0.07037003311735827,544,I can't get the boss off my mind either.
677,2,7,42,51,1.2156862745098038,0.07037003311735827,544,It came with my M.B.A. And yours?
677,3,5,43,51,1.2156862745098038,0.07573807025814888,544,"These hats are weird, but they get the job done."
677,1,9,41,51,1.2156862745098038,0.0645571671888405,544,"Hard to leave it at the office, isn't it?"
677,4,3,44,51,1.2156862745098038,0.08075004032146667,544,I'll have my people contact your people.
677,3,5,43,51,1.2156862745098038,0.07573807025814888,544,It's a great office... Lots of head space.
677,2,7,42,51,1.2156862745098038,0.07037003311735827,544,Is it just me? Or do you hate your job too?
677,4,3,44,51,1.2156862745098038,0.08075004032146667,544,You should see the party in the back.
677,3,5,43,51,1.2156862745098038,0.07573807025814888,544,First time at Micromanagers Unite ?
677,3,5,43,51,1.2156862745098038,0.07573807025814888,544,I guess I wouldn't mind it so much if his chair didn't squeak all the time.
677,2,7,42,51,1.2156862745098038,0.07037003311735827,544,I love people who mind their own business.
677,4,3,44,51,1.2156862745098038,0.08075004032146667,544,This isn't working
677,3,5,43,51,1.2156862745098038,0.07573807025814888,544,My guy is always hassling me about being more level-headed.
677,2,7,42,51,1.2156862745098038,0.07037003311735827,544,"So, Tetris or Solitaire?"
677,2,7,42,51,1.2156862745098038,0.07037003311735827,544,I think they've taken micro-managing too far.
677,2,7,42,51,1.2156862745098038,0.07037003311735827,544,There's that strange tapping noise again.
677,3,5,43,51,1.2156862745098038,0.07573807025814888,544,"On Sundays, I'm a Cheesehead."
677,2,7,42,51,1.2156862745098038,0.07037003311735827,544,We've got to reduce our overhead.
677,2,7,42,51,1.2156862745098038,0.07037003311735827,544,"I didn't think the bank would foreclose on my toupee either, but here we are."
677,4,3,44,51,1.2156862745098038,0.08075004032146667,544,I'll have my guy call your guy.
677,2,7,42,51,1.2156862745098038,0.07037003311735827,544,You got a guy? I got a guy!
677,2,7,42,51,1.2156862745098038,0.07037003311735827,544,Next time I'm requesting a laptop.
713,2,7,43,52,1.2115384615384615,0.06912804512336526,544,When should we tell them their jobs have been outsourced to India?
714,3,4,43,50,1.2,0.07559289460184544,544,So this is what it's like to have eye contact.
714,1,8,41,50,1.2,0.06388765649999399,544,"Thank you, I think you have a head for business as well."
714,3,4,43,50,1.2,0.07559289460184544,544,"They really seem to be riding us more these days, don't you think?"
714,2,6,42,50,1.2,0.06998542122237651,544,"Personally, I prefer an Apple watch."
714,3,4,43,50,1.2,0.07559289460184544,544,I'm a piece of chewed gum stuck under a desk. What are you?
714,1,8,41,50,1.2,0.06388765649999399,544,I heard the next one will be thinner and have a bigger screen.
714,2,6,42,50,1.2,0.06998542122237651,544,"FBI reading your emails again, too?"
714,1,8,41,50,1.2,0.06388765649999399,544,How's your work-life balance?
714,2,6,42,50,1.2,0.06998542122237651,544,I can't get work off my mind
714,1,8,41,50,1.2,0.06388765649999399,544,I am typing it up as I speak.
714,2,6,42,50,1.2,0.06998542122237651,544,I know what you're thinking!
714,3,4,43,50,1.2,0.07559289460184544,544,"Relax, will you? We've got our head guys on this."
714,1,8,41,50,1.2,0.06388765649999399,544,Nice desktop!
714,2,6,42,50,1.2,0.06998542122237651,544,Micromanagers are bad. But parasitic ones are even worse.
714,2,6,42,50,1.2,0.06998542122237651,544,The peyote should have worn off by now...
714,4,2,44,50,1.2,0.08081220356417686,544,It's not his desk I mind; it's his sleeping quarters.
714,2,6,42,50,1.2,0.06998542122237651,544,I've been thinking about going back to my Palm Pilot.
714,2,6,42,50,1.2,0.06998542122237651,544,We need to work on our work-life separation.
714,3,4,43,50,1.2,0.07559289460184544,544,Thanks for the heads up.
714,0,10,40,50,1.2,0.05714285714285714,544,Harvey Wallbanger serves doppelgangers; his drinks will make you see two...sipped some on lunch break and now look in the mirror. Is that me as me or as you?
714,2,6,42,50,1.2,0.06998542122237651,544,I like to think they work for us.
714,2,6,42,50,1.2,0.06998542122237651,544,So when I told The Devil we deserved to be Office Heads...
714,1,8,41,50,1.2,0.06388765649999399,544,How do you always seem to know what I am thinking!
714,1,8,41,50,1.2,0.06388765649999399,544,Why? Where do you plug yours in?
714,2,6,42,50,1.2,0.06998542122237651,544,And you want me to believe it's a coincidence that we also had the same costume last year?
714,1,8,41,50,1.2,0.06388765649999399,544,And you are the head of which department?
714,2,6,42,50,1.2,0.06998542122237651,544,"My exwife used to say that you can take the accountant out of the office, but you can't take the office out of the accountant."
714,1,8,41,50,1.2,0.06388765649999399,544,"I’m not looking forward to the merger, are you?"
714,3,4,43,50,1.2,0.07559289460184544,544,It's good to meet someone else who's connected.
714,2,6,42,50,1.2,0.06998542122237651,544,It's like you can read my mind.
714,4,2,44,50,1.2,0.08081220356417686,544,"Mine says that under us, it's turtles all the way down."
714,3,4,43,50,1.2,0.07559289460184544,544,I see you have work on your mind too.
714,3,4,43,50,1.2,0.07559289460184544,544,I have my order in for Head Top 4 coming out in March.
714,2,6,42,50,1.2,0.06998542122237651,544,"I thought ""How To Get A Head in Business"" was a typo."
714,2,6,42,50,1.2,0.06998542122237651,544,It's not just a breakthrough in technology but it has done wonders for the unemployment rate.
714,2,6,42,50,1.2,0.06998542122237651,544,I guess I'm not the only one who takes his work home.
714,2,6,42,50,1.2,0.06998542122237651,544,Shrinking the company's overhead is never easy.
714,1,8,41,50,1.2,0.06388765649999399,544,Let's call it a double-header and declare victory.
714,1,8,41,50,1.2,0.06388765649999399,544,Dandruff comptroller...you?
714,1,8,41,50,1.2,0.06388765649999399,544,"On the bright side, no 'Bad Hair Days' and Wi-Fi is better."
714,1,8,41,50,1.2,0.06388765649999399,544,"So, how do you tie your shoes?"
714,3,4,43,50,1.2,0.07559289460184544,544,Have you ever felt like you're nothing but a rug in some executive's office?
714,2,6,42,50,1.2,0.06998542122237651,544,And then I wished for my manager to get off my back. You too?
714,2,6,42,50,1.2,0.06998542122237651,544,Four heads work better than two
714,3,4,43,50,1.2,0.07559289460184544,544,I can't stop taking my work home either.
714,2,6,42,50,1.2,0.06998542122237651,544,How's your work-life balance coming along?
714,0,10,40,50,1.2,0.05714285714285714,544,It's not fair - you always know what I'm thinking.
714,3,4,43,50,1.2,0.07559289460184544,544,I can't think of anything off the top of my head.
714,1,8,41,50,1.2,0.06388765649999399,544,I have reason to suspect that your people have been talking to my people.
714,3,4,43,50,1.2,0.07559289460184544,544,This is much better than when we rented to the tap dancings studio.
714,1,8,41,50,1.2,0.06388765649999399,544,He's clicking Send.
714,1,8,41,50,1.2,0.06388765649999399,544,I'm just not wired that way
714,2,6,42,50,1.2,0.06998542122237651,544,My guy will call your guy.
714,4,2,44,50,1.2,0.08081220356417686,544,I feel like the overhead regulatory committee has been getting out of control lately.
714,2,6,42,50,1.2,0.06998542122237651,544,The guy up top just handles my calendar. I have another little guy who manages pretty much everything else.
714,2,6,42,50,1.2,0.06998542122237651,544,Al Opecia? Funny. My guy's name is Dan Druff.
714,1,8,41,50,1.2,0.06388765649999399,544,I'm sick and tired of my own damn emails.
714,0,10,40,50,1.2,0.05714285714285714,544,Do you ever get the feeling that they're just using us for our bodies?
714,4,2,44,50,1.2,0.08081220356417686,544,Where'd they put your fax machine?
714,3,4,43,50,1.2,0.07559289460184544,544,Is yours watching pornography too?
714,1,8,41,50,1.2,0.06388765649999399,544,"If you ask me, this whole 'two heads are better than one' is a bunch of crap."
714,3,4,43,50,1.2,0.07559289460184544,544,I'll have my Head Sales Rep get in touch with your Head Sales Rep ASAP.
714,2,6,42,50,1.2,0.06998542122237651,544,You've got to tip your hat to the IP guys.
714,3,4,43,50,1.2,0.07559289460184544,544,I'll have my guy get in touch with your guy.
714,1,8,41,50,1.2,0.06388765649999399,544,Whenever I have a problem I ask the guy upstairs too
714,2,6,42,50,1.2,0.06998542122237651,544,Because I'm a Mac and you're a PC.
714,3,4,43,50,1.2,0.07559289460184544,544,"Someday, I'm gonna have his job..."
714,2,6,42,50,1.2,0.06998542122237651,544,"Good to see you, too, but I've gotta go. He just hit Control P again."
714,2,6,42,50,1.2,0.06998542122237651,544,This company was built by the little guys.
714,1,8,41,50,1.2,0.06388765649999399,544,At last: non talking heads.
714,3,4,43,50,1.2,0.07559289460184544,544,"I have a dream job, too."
714,1,8,41,50,1.2,0.06388765649999399,544,It's gratifying to know that I'm just as mediocre as the next guy.
714,1,8,41,50,1.2,0.06388765649999399,544,From one Department Head to another.
714,1,8,41,50,1.2,0.06388765649999399,544,"Let's face it, Glen, we both have a great head for business."
714,3,4,43,50,1.2,0.07559289460184544,544,I see you also have a head for business.
714,3,4,43,50,1.2,0.07559289460184544,544,I see you are being micromanaged too.
714,2,6,42,50,1.2,0.06998542122237651,544,Office heads need to support the staff.
714,4,2,44,50,1.2,0.08081220356417686,544,My posture is a lot better since the layoffs.
714,3,4,43,50,1.2,0.07559289460184544,544,"The micromanaging has gone a bit too far, no?"
714,2,6,42,50,1.2,0.06998542122237651,544,"Yeah, I sprung for the pencil-holder. It adds a soupçon of earthiness. Who cares if it increases the overhead?"
714,2,6,42,50,1.2,0.06998542122237651,544,We seem to be balancing our work lives quite well.
714,4,2,44,50,1.2,0.08081220356417686,544,I just can't get work off my mind.
714,1,8,41,50,1.2,0.06388765649999399,544,The pencils are suppose to introduce a hint of retro.
714,2,6,42,50,1.2,0.06998542122237651,544,When is our next coffee break? My head is killing me.
714,3,4,43,50,1.2,0.07559289460184544,544,Balancing the overhead is twice as hard these days.
714,1,8,41,50,1.2,0.06388765649999399,544,"Do you remember sending me that e-mail, off the top of your head?"
714,1,8,41,50,1.2,0.06388765649999399,544,"I think I have a virus."" ""Nah, it's all in your head."
801,2,6,43,51,1.196078431372549,0.06871143320758917,544,Eraser tag was more fun.
801,2,6,43,51,1.196078431372549,0.06871143320758917,544,I love that he hides my bald spot.
801,2,6,43,51,1.196078431372549,0.06871143320758917,544,$79.99 at Best Buy. Where did you get yours?
801,3,4,44,51,1.196078431372549,0.07419956050362551,544,I use mine strictly for remembering passwords.
801,3,4,44,51,1.196078431372549,0.07419956050362551,544,"No, there's nothing on your head. Why?"
801,3,4,44,51,1.196078431372549,0.07419956050362551,544,"Like my driverless car, it works great until it crashes."
801,1,8,42,51,1.196078431372549,0.06274509803921571,544,I'm saving for a lap top.
801,0,10,41,51,1.196078431372549,0.05614831789520141,544,I think corporate misunderstood our feedback about more work/life balance.
801,1,8,42,51,1.196078431372549,0.06274509803921571,544,It blocks harmful UV rays and finds me tax loopholes.
801,3,4,44,51,1.196078431372549,0.07419956050362551,544,Why don't you have a pencil cup?
811,1,7,41,49,1.183673469387755,0.06303997616615865,544,Great minds think alike!
811,2,5,42,49,1.183673469387755,0.069457747811776,544,"Hey Bob, is it me, or are there consultants everywhere now?"
811,3,3,43,49,1.183673469387755,0.07533072989915002,544,This office overhead is giving me a headache.
811,2,5,42,49,1.183673469387755,0.069457747811776,544,I too find it stressful to be a department head.
811,0,9,40,49,1.183673469387755,0.05589005688828228,544,"When I woke up this morning, you were on my mind."
811,1,7,41,49,1.183673469387755,0.06303997616615865,544,Let's stay connected
811,1,7,41,49,1.183673469387755,0.06303997616615865,544,"The micro-managing is bad enough, but he keeps kicking his desk."
811,3,3,43,49,1.183673469387755,0.07533072989915002,544,The overhead is killing me!
811,2,5,42,49,1.183673469387755,0.069457747811776,544,Don't mind them. They're from the head office.
811,1,7,41,49,1.183673469387755,0.06303997616615865,544,"It may be cutting edge, but I prefer my smartphone."
811,3,3,43,49,1.183673469387755,0.07533072989915002,544,I'm thinking about getting a new digital personal assistant.
811,3,3,43,49,1.183673469387755,0.07533072989915002,544,I have a problem with my executive function!
811,1,7,41,49,1.183673469387755,0.06303997616615865,544,Seriously? Those shoes with that monitor?
811,3,3,43,49,1.183673469387755,0.07533072989915002,544,The pencil holder is what I find really annoying.
811,1,7,41,49,1.183673469387755,0.06303997616615865,544,He's not heavy; he's my brother.
811,3,3,43,49,1.183673469387755,0.07533072989915002,544,Can you repeat that? My head's in the cloud.
811,2,5,42,49,1.183673469387755,0.069457747811776,544,But I still wear my emotions on my sleeve.
811,2,5,42,49,1.183673469387755,0.069457747811776,544,It seems a private server is nothing but a headache!
811,2,5,42,49,1.183673469387755,0.069457747811776,544,I hear the next round of downsizing will be even more drastic.
811,0,9,40,49,1.183673469387755,0.05589005688828228,544,"I've got a lot on my mind right now, have your guy call my guy."
811,3,3,43,49,1.183673469387755,0.07533072989915002,544,You should see the party in the back.
811,3,3,43,49,1.183673469387755,0.07533072989915002,544,Our personal assistants are on top of it!
811,4,1,44,49,1.183673469387755,0.08077783732678857,544,I never let my job go to my head. How 'bout you?
811,3,3,43,49,1.183673469387755,0.07533072989915002,544,I told you they would go over our head with this.
811,3,3,43,49,1.183673469387755,0.07533072989915002,544,Can't get these new office-wide memos off your mind either?
811,0,9,40,49,1.183673469387755,0.05589005688828228,544,We have more in common than you’d think.
811,4,1,44,49,1.183673469387755,0.08077783732678857,544,Are you thinking what I'm thinking?
811,1,7,41,49,1.183673469387755,0.06303997616615865,544,I just sense you're someone who can relate to what's been on my mind lately.
811,4,1,44,49,1.183673469387755,0.08077783732678857,544,Let's try to get the office off our minds.
811,2,5,42,49,1.183673469387755,0.069457747811776,544,You're out of your mind.
811,3,3,43,49,1.183673469387755,0.07533072989915002,544,"I keep asking him to do my taxes, but he spends all day surfing for porn."
811,2,5,42,49,1.183673469387755,0.069457747811776,544,Who needs a cubicle?
811,2,5,42,49,1.183673469387755,0.069457747811776,544,Who's on your mind?
811,2,5,42,49,1.183673469387755,0.069457747811776,544,I warned you about these auditors.
811,2,5,42,49,1.183673469387755,0.069457747811776,544,We have nothing in common....my little guy runs a top hedge fund and your's sells time shares in Vegas
811,2,5,42,49,1.183673469387755,0.069457747811776,544,"Like it or not, these micromanagers ARE the bosses of us."
811,3,3,43,49,1.183673469387755,0.07533072989915002,544,I should have listened to the man upstairs.
811,2,5,42,49,1.183673469387755,0.069457747811776,544,"I don't know, sometimes I miss the string and two cans."
811,3,3,43,49,1.183673469387755,0.07533072989915002,544,I'll have my people call your people.
811,1,7,41,49,1.183673469387755,0.06303997616615865,544,"If we lose power, mine has a backup pencil."
811,3,3,43,49,1.183673469387755,0.07533072989915002,544,I'm hoping to be promoted to the head office.
811,3,3,43,49,1.183673469387755,0.07533072989915002,544,I think I'll have my guy email your guy.
811,4,1,44,49,1.183673469387755,0.08077783732678857,544,"I agree, it's not so bad once you get used to it. Although, it does get irritating when he makes me get coffee for him."
811,3,3,43,49,1.183673469387755,0.07533072989915002,544,I see you got the memo.
811,2,5,42,49,1.183673469387755,0.069457747811776,544,"""You're not the only one who can come up with answers off the top of your head""."
811,2,5,42,49,1.183673469387755,0.069457747811776,544,"Don't know about you, but this new workload is giving me a migraine."
811,2,5,42,49,1.183673469387755,0.069457747811776,544,You look silly with that desk on your head.
811,3,3,43,49,1.183673469387755,0.07533072989915002,544,are you thinking what I'm thinking?
811,3,3,43,49,1.183673469387755,0.07533072989915002,544,"I see you went with the executive haircut, too."
811,2,5,42,49,1.183673469387755,0.069457747811776,544,"I don't know about you, but if I knew it wasn't a metaphor, I would have gone with monkey on my back rather than accountant on the brain."
811,1,7,41,49,1.183673469387755,0.06303997616615865,544,"I know what you're thinking....and yes, you may borrow one of my pencils."
811,1,7,41,49,1.183673469387755,0.06303997616615865,544,What's the Wi-Fi password again?
811,2,5,42,49,1.183673469387755,0.069457747811776,544,It's all about balance.
811,2,5,42,49,1.183673469387755,0.069457747811776,544,Working from home isn't what it used to be.
811,3,3,43,49,1.183673469387755,0.07533072989915002,544,Are you thinking what I'm thinking?
811,2,5,42,49,1.183673469387755,0.069457747811776,544,Are you thinking the same thing I am?
811,2,5,42,49,1.183673469387755,0.069457747811776,544,All I did was hiccup while logging on. How about you?
811,1,7,41,49,1.183673469387755,0.06303997616615865,544,If you don't upgrade it's the end of the relationship.
811,2,5,42,49,1.183673469387755,0.069457747811776,544,"When I applied for a 'desk job,' this wasn't quite what I had in mind."
811,0,9,40,49,1.183673469387755,0.05589005688828228,544,Do you think we micromanage them?
811,2,5,42,49,1.183673469387755,0.069457747811776,544,"He's just a temp, until I can find someone more permanent."
811,2,5,42,49,1.183673469387755,0.069457747811776,544,His name is Glenlivet. What's yours?
811,1,7,41,49,1.183673469387755,0.06303997616615865,544,The worst part for me is that when I comb my hair I have to unplug everything.
811,2,5,42,49,1.183673469387755,0.069457747811776,544,I'm sick of the little guys going over our heads to get things done.
811,1,7,41,49,1.183673469387755,0.06303997616615865,544,Still think an MBA was the right choice?
811,1,7,41,49,1.183673469387755,0.06303997616615865,544,We both have a head for business.
811,1,7,41,49,1.183673469387755,0.06303997616615865,544,Are you processing what I'm processing?
811,3,3,43,49,1.183673469387755,0.07533072989915002,544,I notice you have work on your mind also.
811,3,3,43,49,1.183673469387755,0.07533072989915002,544,If the FBI wants our emails they're going to have to go over our heads to get them!
811,3,3,43,49,1.183673469387755,0.07533072989915002,544,"My workload is every bit as staggering as yours, Carl!"
811,3,3,43,49,1.183673469387755,0.07533072989915002,544,Mind your own business!
811,2,5,42,49,1.183673469387755,0.069457747811776,544,Heavy is the head that wears the desk.
811,3,3,43,49,1.183673469387755,0.07533072989915002,544,Wasn't it so much better when the voices were inside our heads?
811,3,3,43,49,1.183673469387755,0.07533072989915002,544,I can never get work off my mind either.
811,1,7,41,49,1.183673469387755,0.06303997616615865,544,I think we're on the same page.
811,3,3,43,49,1.183673469387755,0.07533072989915002,544,Can you check to see if mine is playing solitaire again?
811,3,3,43,49,1.183673469387755,0.07533072989915002,544,"Troublingly, mine was eating beans for lunch."
811,1,7,41,49,1.183673469387755,0.06303997616615865,544,I say we just power down and grab a couple of beers?
811,1,7,41,49,1.183673469387755,0.06303997616615865,544,I see you got the OfficeCrew Cut too.
811,2,5,42,49,1.183673469387755,0.069457747811776,544,"Ironically, we didn't read the small print when the Lilliputians suggested we downsize."
811,2,5,42,49,1.183673469387755,0.069457747811776,544,I guess we'll be in the next edition of the Diagnostic and Statistical Manual of Mental Disorders.
811,1,7,41,49,1.183673469387755,0.06303997616615865,544,It's clear we share a similar head for business.
811,0,9,40,49,1.183673469387755,0.05589005688828228,544,Nothing comes to mind. Not off the top of my head at least.
811,2,5,42,49,1.183673469387755,0.069457747811776,544,Go ahead! Byte me!
811,0,9,40,49,1.183673469387755,0.05589005688828228,544,Our overhead is killing us.
811,2,5,42,49,1.183673469387755,0.069457747811776,544,"Don't mention it. They had a 'buy one, get one' special on desk tops."
811,1,7,41,49,1.183673469387755,0.06303997616615865,544,"Yeah, well what you gain in productivity with these guys, you lose in privacy."
811,4,1,44,49,1.183673469387755,0.08077783732678857,544,"Is your work always on your mind, too?"
811,4,1,44,49,1.183673469387755,0.08077783732678857,544,These hats looked better online.
811,2,5,42,49,1.183673469387755,0.069457747811776,544,Do you think he's on top of it?
811,0,9,40,49,1.183673469387755,0.05589005688828228,544,The only thing I don't like is how they run the power cords.
811,1,7,41,49,1.183673469387755,0.06303997616615865,544,Wireless? I'm thinking about outsourcing.
811,3,3,43,49,1.183673469387755,0.07533072989915002,544,Uneasy lies the head that wears a computer.
811,3,3,43,49,1.183673469387755,0.07533072989915002,544,I have no clue. It's all above my head.
811,1,7,41,49,1.183673469387755,0.06303997616615865,544,We may wish to reconsider using our private servers.
811,3,3,43,49,1.183673469387755,0.07533072989915002,544,Why do we always take our work home with us?
811,1,7,41,49,1.183673469387755,0.06303997616615865,544,A week after Aruba and it's like we never went on vacation.
811,2,5,42,49,1.183673469387755,0.069457747811776,544,I hear they are coming out with a laptop version next year.
811,1,7,41,49,1.183673469387755,0.06303997616615865,544,"It's great! He does taxes, pays your bills, balances your checkbook, just don't feed him after midnight."
811,1,7,41,49,1.183673469387755,0.06303997616615865,544,Don't upgrade. You'll just have to learn how he works all over again.
811,1,7,41,49,1.183673469387755,0.06303997616615865,544,Just looking myself up on the internet
811,2,5,42,49,1.183673469387755,0.069457747811776,544,"If you can't beat em, conjoin em."
811,2,5,42,49,1.183673469387755,0.069457747811776,544,Who cuts your hair?
811,3,3,43,49,1.183673469387755,0.07533072989915002,544,I actually miss Google Glass.
811,3,3,43,49,1.183673469387755,0.07533072989915002,544,Ever feel like you can't get work off your mind long enough to relax?
811,2,5,42,49,1.183673469387755,0.069457747811776,544,You still have a landline too?
811,3,3,43,49,1.183673469387755,0.07533072989915002,544,I think micromanagement is stifling my creativity.
811,1,7,41,49,1.183673469387755,0.06303997616615865,544,Call me if you manage to get out from under it.
811,1,7,41,49,1.183673469387755,0.06303997616615865,544,We should network.
811,3,3,43,49,1.183673469387755,0.07533072989915002,544,Is the short commute worth the trade-off?
811,2,5,42,49,1.183673469387755,0.069457747811776,544,"I kept asking, what the hell is hat-desking?"
811,4,1,44,49,1.183673469387755,0.08077783732678857,544,We're at the forehead of the open-office trend.
811,2,5,42,49,1.183673469387755,0.069457747811776,544,"You too, huh?"
811,2,5,42,49,1.183673469387755,0.069457747811776,544,Do I have to go over your head on this?
811,3,3,43,49,1.183673469387755,0.07533072989915002,544,At least we're not chained to our desks.
811,2,5,42,49,1.183673469387755,0.069457747811776,544,I can't get the office off my mind. How about you?
811,1,7,41,49,1.183673469387755,0.06303997616615865,544,We have to stop meeting like this.
811,2,5,42,49,1.183673469387755,0.069457747811776,544,I don't even think they know we're here sometimes.
811,2,5,42,49,1.183673469387755,0.069457747811776,544,I think my brain works differently than other people's.
811,2,5,42,49,1.183673469387755,0.069457747811776,544,Do you ever get the feeling we're being watched?
811,1,7,41,49,1.183673469387755,0.06303997616615865,544,Not what I imagined as a mobile office. You?
811,2,5,42,49,1.183673469387755,0.069457747811776,544,"I hear on the 2.0 version, each of them will get a head-desk too."
811,2,5,42,49,1.183673469387755,0.069457747811776,544,Mind your own business
811,1,7,41,49,1.183673469387755,0.06303997616615865,544,"I'm all for smaller government and surveillance, but this is not what I had in mind."
811,2,5,42,49,1.183673469387755,0.069457747811776,544,I see we're both bringing our work home.
811,2,5,42,49,1.183673469387755,0.069457747811776,544,After taking with you I am starting to understand how the whole Cloud thing works.
811,2,5,42,49,1.183673469387755,0.069457747811776,544,Wait a minute. Yours gets bathroom breaks?
811,3,3,43,49,1.183673469387755,0.07533072989915002,544,Great minds think alike.
811,4,1,44,49,1.183673469387755,0.08077783732678857,544,I see you're doing the hairbnb thing.
811,1,7,41,49,1.183673469387755,0.06303997616615865,544,"What do you mean, we're not compatible?"
941,1,7,42,50,1.18,0.061875450936307745,544,It would seem that we are of like minds.
941,2,5,43,50,1.18,0.06815348823929464,544,These new budget caps are just impossible.
941,2,5,43,50,1.18,0.06815348823929464,544,What makes you think we might have a virus?
941,2,5,43,50,1.18,0.06815348823929464,544,Let me give you a little 'heads up.'
941,3,3,44,50,1.18,0.07390009803644321,544,"Sometimes I get this terrible fear that technology is taking over civilization, but my wife says it's all in my head."
941,2,5,43,50,1.18,0.06815348823929464,544,I'm guessing we go to the same barber.
947,0,8,39,47,1.1702127659574468,0.055411578656325414,544,Race you to the Patent Office.
947,1,6,40,47,1.1702127659574468,0.0632100658866106,544,You've got work on your mind too?
947,1,6,40,47,1.1702127659574468,0.0632100658866106,544,This is what you get for working at head office.
947,1,6,40,47,1.1702127659574468,0.0632100658866106,544,"Our overhead costs are small, almost all of it management."
947,3,2,42,47,1.1702127659574468,0.07645685835683208,544,"Off the top of my head, I would say you're mistaken."
947,3,2,42,47,1.1702127659574468,0.07645685835683208,544,Two heads are better than one!
947,1,6,40,47,1.1702127659574468,0.0632100658866106,544,Don't let him rent space in your head.
947,1,6,40,47,1.1702127659574468,0.0632100658866106,544,I'm now replying to your instant message.
947,1,6,40,47,1.1702127659574468,0.0632100658866106,544,I hate being a desk jockey.
947,2,4,41,47,1.1702127659574468,0.07014685887189226,544,Have your people get back to my people.
947,1,6,40,47,1.1702127659574468,0.0632100658866106,544,We should talk sometime. Why don't you have your guy set it up with my guy?
947,2,4,41,47,1.1702127659574468,0.07014685887189226,544,This isn't the piece of mind I expected working for Samsung!
947,2,4,41,47,1.1702127659574468,0.07014685887189226,544,I always have work on my mind.
947,2,4,41,47,1.1702127659574468,0.07014685887189226,544,Dad always said we inherited his head for business.
947,2,4,41,47,1.1702127659574468,0.07014685887189226,544,"I don't know about your guy, but mine's giving me a headache."
947,1,6,40,47,1.1702127659574468,0.0632100658866106,544,"No, you're the Nerd."
947,1,6,40,47,1.1702127659574468,0.0632100658866106,544,"It's a new productivity tool, called HairBNB."
947,2,4,41,47,1.1702127659574468,0.07014685887189226,544,Great minds think alike.
947,3,2,42,47,1.1702127659574468,0.07645685835683208,544,Our virtual humans seems to be having trouble coming up with a caption off the top of their heads.
947,3,2,42,47,1.1702127659574468,0.07645685835683208,544,Have your people call my people.
947,1,6,40,47,1.1702127659574468,0.0632100658866106,544,I look it as an improvement over the angel on one shoulder and the devil on the other ...
947,1,6,40,47,1.1702127659574468,0.0632100658866106,544,My hard drive thinks your hard drive is cute
947,1,6,40,47,1.1702127659574468,0.0632100658866106,544,Bob is shocked to discover that his life is just as boring in the parallel universe.
947,3,2,42,47,1.1702127659574468,0.07645685835683208,544,"Yeah, I can't get this new job off my mind either."
947,2,4,41,47,1.1702127659574468,0.07014685887189226,544,"Wait, what do you mean we could have left hours ago?"
947,2,4,41,47,1.1702127659574468,0.07014685887189226,544,Where did you get the pencil holder accessory?
947,1,6,40,47,1.1702127659574468,0.0632100658866106,544,I just can't get work off my mind.
947,1,6,40,47,1.1702127659574468,0.0632100658866106,544,I have a keyboard-pounding headache.
947,3,2,42,47,1.1702127659574468,0.07645685835683208,544,I may be closer to the copier but you're closer to the coffee!
947,2,4,41,47,1.1702127659574468,0.07014685887189226,544,Tell me again why Google Glass failed but these guys are cool?
947,2,4,41,47,1.1702127659574468,0.07014685887189226,544,I've been thinking too much off the top of my head.
947,2,4,41,47,1.1702127659574468,0.07014685887189226,544,Doesn't this seem like an inefficient use of overhead?
947,3,2,42,47,1.1702127659574468,0.07645685835683208,544,Heading to the office?
947,2,4,41,47,1.1702127659574468,0.07014685887189226,544,Can't get work off of your mind either?
947,3,2,42,47,1.1702127659574468,0.07645685835683208,544,"I asked how many people he stepped on getting to the top, and he said just me."
947,0,8,39,47,1.1702127659574468,0.055411578656325414,544,"Before the internet, you could just give an answer off the top of your head."
947,1,6,40,47,1.1702127659574468,0.0632100658866106,544,"No, I was thinking exactly the opposite."
947,2,4,41,47,1.1702127659574468,0.07014685887189226,544,Is this cubism or existentialism?
947,2,4,41,47,1.1702127659574468,0.07014685887189226,544,My superego person will be getting in touch with your superego person.
947,2,4,41,47,1.1702127659574468,0.07014685887189226,544,Where's yours plugged in?
947,1,6,40,47,1.1702127659574468,0.0632100658866106,544,"OK, so who was secretary of agriculture in1927?"
947,2,4,41,47,1.1702127659574468,0.07014685887189226,544,Can you feel the trickle down effect yet?
947,1,6,40,47,1.1702127659574468,0.0632100658866106,544,"One moment, my agent is typing."
947,2,4,41,47,1.1702127659574468,0.07014685887189226,544,Any tips on work-life balance?
947,1,6,40,47,1.1702127659574468,0.0632100658866106,544,"Radio Shacks attempt at artificial intelligence...""Ask Herb"""
947,2,4,41,47,1.1702127659574468,0.07014685887189226,544,Face it - we've both had too much work on our minds lately.
947,0,8,39,47,1.1702127659574468,0.055411578656325414,544,"No, it's YOU who needs to force quit!"
947,0,8,39,47,1.1702127659574468,0.055411578656325414,544,"My love life hasn't been that great but , boy, my productivity has been off the charts."
947,2,4,41,47,1.1702127659574468,0.07014685887189226,544,You hear that clicking in your head too?!
947,3,2,42,47,1.1702127659574468,0.07645685835683208,544,The only part I don't like is the bureaucratic nightmares.
947,1,6,40,47,1.1702127659574468,0.0632100658866106,544,What happens when the Doublemint Twins stop chewing gum and get a job.
947,3,2,42,47,1.1702127659574468,0.07645685835683208,544,Don't you just hate it when your subordinate goes over your head?
947,2,4,41,47,1.1702127659574468,0.07014685887189226,544,I'm of two minds on this subject.
947,3,2,42,47,1.1702127659574468,0.07645685835683208,544,"Oh, oh, I think I'm going to sneeze."
947,4,0,43,47,1.1702127659574468,0.08228438837349525,544,"You find that you're taking your work home with you, too?"
947,1,6,40,47,1.1702127659574468,0.0632100658866106,544,Work was on my mind before it was cool.
947,2,4,41,47,1.1702127659574468,0.07014685887189226,544,Overhead's a real problem here.
947,2,4,41,47,1.1702127659574468,0.07014685887189226,544,It's desk work all the way down.
947,1,6,40,47,1.1702127659574468,0.0632100658866106,544,Ever have that dream where you're driving home and without thinking you open the sunroof?
947,1,6,40,47,1.1702127659574468,0.0632100658866106,544,Do you think he would have drawn apples if his name was 'Mac'?
947,2,4,41,47,1.1702127659574468,0.07014685887189226,544,It's like we're in a New Yorker cartoon.
947,2,4,41,47,1.1702127659574468,0.07014685887189226,544,I think miniaturization has gone too far.
947,2,4,41,47,1.1702127659574468,0.07014685887189226,544,Flat tops would have been better than desk tops.
947,2,4,41,47,1.1702127659574468,0.07014685887189226,544,It's clearer now but I miss the Angel and the Devil.
947,3,2,42,47,1.1702127659574468,0.07645685835683208,544,I knew he would find a way to hold his new job over our heads.
947,2,4,41,47,1.1702127659574468,0.07014685887189226,544,I pine for the old days when all I had were voices IN my head.
947,2,4,41,47,1.1702127659574468,0.07014685887189226,544,"On three, lets reboot"
947,1,6,40,47,1.1702127659574468,0.0632100658866106,544,You also installed an auto-correct?
947,1,6,40,47,1.1702127659574468,0.0632100658866106,544,I liked him better when he had a candy dish on his desk.
947,1,6,40,47,1.1702127659574468,0.0632100658866106,544,Have your people call my people.
947,3,2,42,47,1.1702127659574468,0.07645685835683208,544,I'll fire yours if you fire mine.
947,1,6,40,47,1.1702127659574468,0.0632100658866106,544,Are you streaming what I'm streaming?
947,1,6,40,47,1.1702127659574468,0.0632100658866106,544,"What do our wives mean ""leave work at the office""? We're Stepford husbands."
947,1,6,40,47,1.1702127659574468,0.0632100658866106,544,My new Thinking Cap just requested more sick leave.
947,1,6,40,47,1.1702127659574468,0.0632100658866106,544,You said you'd wear yours on Wednesdays and I'd have Tuesdays.
947,1,6,40,47,1.1702127659574468,0.0632100658866106,544,"Big brains, small overhead--how can we not succeed?"
947,0,8,39,47,1.1702127659574468,0.055411578656325414,544,You want to google together some time?
947,1,6,40,47,1.1702127659574468,0.0632100658866106,544,"There's only one guy at work above me, too."
947,2,4,41,47,1.1702127659574468,0.07014685887189226,544,I'm making a mental note.
947,3,2,42,47,1.1702127659574468,0.07645685835683208,544,"OK, so my people called your people. Now what?"
947,2,4,41,47,1.1702127659574468,0.07014685887189226,544,I didn't even know they made a left-handed mouse.
947,1,6,40,47,1.1702127659574468,0.0632100658866106,544,"I'm out of memory, how about you?"
947,3,2,42,47,1.1702127659574468,0.07645685835683208,544,And R&D calls this a virtual office.
947,2,4,41,47,1.1702127659574468,0.07014685887189226,544,It could be worse. Before he found a job he used to live in my basement.
947,2,4,41,47,1.1702127659574468,0.07014685887189226,544,Sometimes I hear voices!
947,2,4,41,47,1.1702127659574468,0.07014685887189226,544,I find the overhead is making it hard to balance.
947,2,4,41,47,1.1702127659574468,0.07014685887189226,544,Where are the pencils? Top desk drawer on the left.
947,3,2,42,47,1.1702127659574468,0.07645685835683208,544,Do you ever feel micromanaged?
947,2,4,41,47,1.1702127659574468,0.07014685887189226,544,I think we need to do something about our office overhead.
947,2,4,41,47,1.1702127659574468,0.07014685887189226,544,"Is this what they mean by ""desktop""?"
947,2,4,41,47,1.1702127659574468,0.07014685887189226,544,They couldn't get work off their minds.
947,2,4,41,47,1.1702127659574468,0.07014685887189226,544,I see you're using the latest version of Office too.
947,2,4,41,47,1.1702127659574468,0.07014685887189226,544,"When they said the new i-hat connects to the internet, I had something else in mind."
947,2,4,41,47,1.1702127659574468,0.07014685887189226,544,Was this what you expected when we were told to meet at the head office?
947,2,4,41,47,1.1702127659574468,0.07014685887189226,544,My work is weighing heavily on my mind.
947,3,2,42,47,1.1702127659574468,0.07645685835683208,544,I see that you also see the value of working in the cloud.
947,0,8,39,47,1.1702127659574468,0.055411578656325414,544,Work has just been more and more on my mind lately
947,3,2,42,47,1.1702127659574468,0.07645685835683208,544,Did you get the optional ear flaps?
947,0,8,39,47,1.1702127659574468,0.055411578656325414,544,These internal audits are getting a little...well...uncomfortable.
947,2,4,41,47,1.1702127659574468,0.07014685887189226,544,Maybe we shouldn't approach everything with our accountant hats on.
947,1,6,40,47,1.1702127659574468,0.0632100658866106,544,I've got more on my pate than you do.
947,2,4,41,47,1.1702127659574468,0.07014685887189226,544,The sad moment David and Nathan realized they both had Bob's job on their mind and it was no joke.
947,2,4,41,47,1.1702127659574468,0.07014685887189226,544,The little computer in the glasses thing I kind of liked. This just plain sucks.
947,2,4,41,47,1.1702127659574468,0.07014685887189226,544,Shush! Little Brother is listening!
947,2,4,41,47,1.1702127659574468,0.07014685887189226,544,I'm considering a cubicle.
947,3,2,42,47,1.1702127659574468,0.07645685835683208,544,"Matching 'do's', cool...heh, heh."
947,1,6,40,47,1.1702127659574468,0.0632100658866106,544,Is it just me or are the new micromanagers over the top?
947,0,8,39,47,1.1702127659574468,0.055411578656325414,544,Is this proof of an alternate universe?
947,3,2,42,47,1.1702127659574468,0.07645685835683208,544,I hear the new manager has a strange way of getting into your head!
947,3,2,42,47,1.1702127659574468,0.07645685835683208,544,Business at the front killed the party at the back
947,1,6,40,47,1.1702127659574468,0.0632100658866106,544,"He just put in a request for a cubical wall, it's been nice knowing you."
947,2,4,41,47,1.1702127659574468,0.07014685887189226,544,I am thinking of contracting with someone off-site.
947,1,6,40,47,1.1702127659574468,0.0632100658866106,544,It´s much better than the angel and devil I used to have.
947,1,6,40,47,1.1702127659574468,0.0632100658866106,544,My wife says I have work on the brain.
947,3,2,42,47,1.1702127659574468,0.07645685835683208,544,"Yeah, this latest update seems a bit intrusive"
947,2,4,41,47,1.1702127659574468,0.07014685887189226,544,You couldn't pay me to work a desk job.
947,2,4,41,47,1.1702127659574468,0.07014685887189226,544,These open plan desks are a real headache.
947,4,0,43,47,1.1702127659574468,0.08228438837349525,544,I just asked my guy to talk to your guy about the details...
947,1,6,40,47,1.1702127659574468,0.0632100658866106,544,"I like working at head office, don't you?"
947,2,4,41,47,1.1702127659574468,0.07014685887189226,544,"I see you're into micromanaging, too."
947,1,6,40,47,1.1702127659574468,0.0632100658866106,544,The wife's been complaining I bring work home with me. How about yours?
947,0,8,39,47,1.1702127659574468,0.055411578656325414,544,Can't get work off of your mind either?
947,2,4,41,47,1.1702127659574468,0.07014685887189226,544,"I see Head Office is working you overtime, too."
947,2,4,41,47,1.1702127659574468,0.07014685887189226,544,I wish Bob would stop farting.
947,2,4,41,47,1.1702127659574468,0.07014685887189226,544,Artificial intelligence will never be fashionable.
947,2,4,41,47,1.1702127659574468,0.07014685887189226,544,I'll have my guy email your guy and we'll do lunch sometime.
947,2,4,41,47,1.1702127659574468,0.07014685887189226,544,"I don't know about you, but I'm tired of bringing my work home with me!"
947,2,4,41,47,1.1702127659574468,0.07014685887189226,544,I see you also have an executive function disorder.
947,2,4,41,47,1.1702127659574468,0.07014685887189226,544,We need to cut down on the overhead.
947,2,4,41,47,1.1702127659574468,0.07014685887189226,544,"I'll answer, but first: what's your mother's maiden name?"
947,0,8,39,47,1.1702127659574468,0.055411578656325414,544,You know there once was a time when the New Yorker cartoons were actually funny.
947,1,6,40,47,1.1702127659574468,0.0632100658866106,544,"Besides my guy's having twenty-two more little black dots, let's see you find five more differences in our mental pictures ... and there better not be a gun in your guy's right hand!"
947,1,6,40,47,1.1702127659574468,0.0632100658866106,544,"Besides my guy’s desk having a bunch of little black dots, can you find five other differences in our mental images?"
947,1,6,40,47,1.1702127659574468,0.0632100658866106,544,Great idea! Have your guy call my guy.
947,3,2,42,47,1.1702127659574468,0.07645685835683208,544,So...I see we share the same head accountant.
947,1,6,40,47,1.1702127659574468,0.0632100658866106,544,Someone needs to say it: outsourcing works.
947,1,6,40,47,1.1702127659574468,0.0632100658866106,544,Did they tell you the same tale of how easy it is to get ahead in this firm?
947,1,6,40,47,1.1702127659574468,0.0632100658866106,544,I'll have the voices in my head call the voices in your head.
947,1,6,40,47,1.1702127659574468,0.0632100658866106,544,I opted for the pencil upgrade.
947,2,4,41,47,1.1702127659574468,0.07014685887189226,544,There's got to be an easier way to get ahead at the office.
947,2,4,41,47,1.1702127659574468,0.07014685887189226,544,Have your people email my people.
947,2,4,41,47,1.1702127659574468,0.07014685887189226,544,You thinking what I'm thing?
947,1,6,40,47,1.1702127659574468,0.0632100658866106,544,You mean you're from head office too?
947,2,4,41,47,1.1702127659574468,0.07014685887189226,544,You should see where we put the break room.
947,2,4,41,47,1.1702127659574468,0.07014685887189226,544,What was your takeaway from mindfulness training?
947,2,4,41,47,1.1702127659574468,0.07014685887189226,544,I don't wanna play anymore head games.
947,2,4,41,47,1.1702127659574468,0.07014685887189226,544,He makes the big decisions but the guys at the bottom do all the leg-work.
947,1,6,40,47,1.1702127659574468,0.0632100658866106,544,Work on the brain?
947,1,6,40,47,1.1702127659574468,0.0632100658866106,544,I need more outlets.
947,1,6,40,47,1.1702127659574468,0.0632100658866106,544,"They both said they wanted to get ""a head"" in this company, but I never dreamed they would be ours."
947,3,2,42,47,1.1702127659574468,0.07645685835683208,544,It's nice to get away from the office and have some FaceTime.
947,1,6,40,47,1.1702127659574468,0.0632100658866106,544,It's not easy finding a work/life balance.
947,2,4,41,47,1.1702127659574468,0.07014685887189226,544,It got so much better with wifi.
947,1,6,40,47,1.1702127659574468,0.0632100658866106,544,"If you're thinking what I'm thinking, then I'm thinking we're both in need of a vacation."
947,1,6,40,47,1.1702127659574468,0.0632100658866106,544,Still got work on the brain?
947,1,6,40,47,1.1702127659574468,0.0632100658866106,544,"OK, this time Apple has gone too far."
947,1,6,40,47,1.1702127659574468,0.0632100658866106,544,I guess sometimes even the little guys can work their way to the top.
947,1,6,40,47,1.1702127659574468,0.0632100658866106,544,Look at the bright side — we both have a good head for business.
947,1,6,40,47,1.1702127659574468,0.0632100658866106,544,We need to have a meeting of the minds.
1106,1,6,41,48,1.1666666666666667,0.061980703166484186,544,Is this what our wives meant by twin sets?
1106,1,6,41,48,1.1666666666666667,0.061980703166484186,544,So much better than standing at my desk.
1106,0,8,40,48,1.1666666666666667,0.05436067275445353,544,"Work is on my mind, too."
1106,2,4,42,48,1.1666666666666667,0.06876141641725292,544,The barefoot scalp massages don't make up for all of the porn he watches.
1106,1,6,41,48,1.1666666666666667,0.061980703166484186,544,This Mobile office isn't as seamless as I had hoped
1106,2,4,42,48,1.1666666666666667,0.06876141641725292,544,They keep assuring us that they're not on private servers.
1106,0,8,40,48,1.1666666666666667,0.05436067275445353,544,How do you deal with desk hair?
1106,2,4,42,48,1.1666666666666667,0.06876141641725292,544,"I used to have an angel on my shoulder, but the SEC got him."
1114,4,0,45,49,1.163265306122449,0.07904047645321259,544,"Hold on, I'm thinking."
1115,0,7,39,46,1.1521739130434783,0.05354479188959757,544,"Of course I believe in free will! Whadya think, there's some guy up there controlling me with a computer or something? think, there's some guy up there controlling me with a dumpster"
1115,2,3,41,46,1.1521739130434783,0.06927778784183837,544,I'm busy right now.
1115,0,7,39,46,1.1521739130434783,0.05354479188959757,544,"It's nice to have well-managed hair, but sometimes I think I'd just as soon go back to dandruff."
1115,1,5,40,46,1.1521739130434783,0.061913070618242964,544,Mine's a white collar hacker.
1115,1,5,40,46,1.1521739130434783,0.061913070618242964,544,This IBM hat is only slightly less functional than my Apple watch and Google glass.
1115,1,5,40,46,1.1521739130434783,0.061913070618242964,544,Copy me on that.
1115,2,3,41,46,1.1521739130434783,0.06927778784183837,544,Ever felt like you never left the office?
1115,1,5,40,46,1.1521739130434783,0.061913070618242964,544,I'm sending you an email. Wink when you get it.
1115,1,5,40,46,1.1521739130434783,0.061913070618242964,544,Don't you hate taking work home?
1115,1,5,40,46,1.1521739130434783,0.061913070618242964,544,Can I borrow a pencil?
1115,0,7,39,46,1.1521739130434783,0.05354479188959757,544,"He's not so bad, but the back office is a nightmare."
1115,2,3,41,46,1.1521739130434783,0.06927778784183837,544,We've got to do something to get work off our minds.
1115,0,7,39,46,1.1521739130434783,0.05354479188959757,544,"I don't mind my brain working overtime, it's the 1 a.m. coffee breaks that are killing me."
1115,1,5,40,46,1.1521739130434783,0.061913070618242964,544,"Oddly, when my guy uses a BOLD font, I feel energized and confident and like I can really dance."
1115,1,5,40,46,1.1521739130434783,0.061913070618242964,544,We should have asked for more information when they said we'd be the heads of the department.
1115,2,3,41,46,1.1521739130434783,0.06927778784183837,544,Remember when your conscience was just an angel on one shoulder and a devil on the other?
1115,2,3,41,46,1.1521739130434783,0.06927778784183837,544,HR takes overhead way too seriously.
1115,2,3,41,46,1.1521739130434783,0.06927778784183837,544,"So you've got a gliodesktoma, too?"
1115,1,5,40,46,1.1521739130434783,0.061913070618242964,544,"Oh, knock it off! You're not the only one with a lot on his mind."
1115,2,3,41,46,1.1521739130434783,0.06927778784183837,544,But the heart says yes.
1115,2,3,41,46,1.1521739130434783,0.06927778784183837,544,I think we gotta get a load off of our minds. You think?
1115,2,3,41,46,1.1521739130434783,0.06927778784183837,544,Wait. I'm still loading.
1115,2,3,41,46,1.1521739130434783,0.06927778784183837,544,"Yeah, I tried breathing and meditation techniques first, too, but nothing beats a personal neural re-wiring assistant!"
1115,1,5,40,46,1.1521739130434783,0.061913070618242964,544,"It beats the aluminum foil, but I still think I prefer the propeller beanie."
1115,1,5,40,46,1.1521739130434783,0.061913070618242964,544,I like the way your mind works.
1115,1,5,40,46,1.1521739130434783,0.061913070618242964,544,"They told me joining the head office would be a promotion, but it's really ruined my work-life balance."
1115,1,5,40,46,1.1521739130434783,0.061913070618242964,544,Don't you wish we could get the head office out of our hair?
1115,2,3,41,46,1.1521739130434783,0.06927778784183837,544,Hard to believe I miss the days when all he did was look over my shoulder.
1115,0,7,39,46,1.1521739130434783,0.05354479188959757,544,Are you having a mind auditing experience too?
1115,0,7,39,46,1.1521739130434783,0.05354479188959757,544,"We're government employees, Bob, doing nothing is classified top secret."
1115,1,5,40,46,1.1521739130434783,0.061913070618242964,544,"""Oh my god, I love your 1997 office desk themed hat!"" Jim said sincerely. Unable to hide his inner pain any longer, ""Me too, I love yours too.""responded Mike."
1115,1,5,40,46,1.1521739130434783,0.061913070618242964,544,Do you have trouble disconnecting from the grid?
1115,1,5,40,46,1.1521739130434783,0.061913070618242964,544,"If anyone asks, this relationship is strictly business."
1115,2,3,41,46,1.1521739130434783,0.06927778784183837,544,Office heads need to support the staff
1115,1,5,40,46,1.1521739130434783,0.061913070618242964,544,Micro-technology gives me a headache!
1115,1,5,40,46,1.1521739130434783,0.061913070618242964,544,"This is not how I expected to be given the results of the ""are you right-brained or left brained"" quiz."
1115,1,5,40,46,1.1521739130434783,0.061913070618242964,544,You have work on your mind too?
1115,1,5,40,46,1.1521739130434783,0.061913070618242964,544,"So, what's on your mind?"
1115,2,3,41,46,1.1521739130434783,0.06927778784183837,544,Your wife complains you always have the office on your mind? Mine too.
1115,1,5,40,46,1.1521739130434783,0.061913070618242964,544,I use a PC; you use a Mac. Let's call the whole thing off.
1115,1,5,40,46,1.1521739130434783,0.061913070618242964,544,When I said I needed more headcount...
1115,1,5,40,46,1.1521739130434783,0.061913070618242964,544,Maybe you'll change your mind once my guy sends your guy a delightful cat video.
1115,1,5,40,46,1.1521739130434783,0.061913070618242964,544,"So they outsourced your brain too, huh?"
1115,1,5,40,46,1.1521739130434783,0.061913070618242964,544,My conscience keeps downloading porn.
1115,1,5,40,46,1.1521739130434783,0.061913070618242964,544,Don't you think our head offices stay on top of us too much?
1115,1,5,40,46,1.1521739130434783,0.061913070618242964,544,Did your guy have tuna for lunch?
1115,1,5,40,46,1.1521739130434783,0.061913070618242964,544,"We shouldn't have picked a business fraternity , these desk beanies suck."
1115,1,5,40,46,1.1521739130434783,0.061913070618242964,544,But this sure feels better than when they tried mining.
1115,1,5,40,46,1.1521739130434783,0.061913070618242964,544,You look familiar
1115,2,3,41,46,1.1521739130434783,0.06927778784183837,544,Won't they ever go wireless?
1115,1,5,40,46,1.1521739130434783,0.061913070618242964,544,I don't really care for the mobile office.
1115,1,5,40,46,1.1521739130434783,0.061913070618242964,544,Nice hat.
1115,1,5,40,46,1.1521739130434783,0.061913070618242964,544,I can't seem to get work off my mind either.
1115,2,3,41,46,1.1521739130434783,0.06927778784183837,544,We've become Pair-a-Techs.
1115,2,3,41,46,1.1521739130434783,0.06927778784183837,544,Do you have a pencil I could borrow?
1115,1,5,40,46,1.1521739130434783,0.061913070618242964,544,We can't let these promotions go to our heads.
1115,0,7,39,46,1.1521739130434783,0.05354479188959757,544,"Top of my head, I don't see this working."
1115,3,1,42,46,1.1521739130434783,0.07593151824596947,544,"It's not you, it's me."
1115,1,5,40,46,1.1521739130434783,0.061913070618242964,544,Do you think our jobs got to our heads_
1115,0,7,39,46,1.1521739130434783,0.05354479188959757,544,"Dammit! The lady at Etsy said it was a 'one of a kind mens' fascinator!"""
1115,1,5,40,46,1.1521739130434783,0.061913070618242964,544,I'm glad to see that I'm not the only head case around here.
1115,1,5,40,46,1.1521739130434783,0.061913070618242964,544,We need to tackle small thinkers and overhead as the same problem.
1115,1,5,40,46,1.1521739130434783,0.061913070618242964,544,"iOS 47 is lighter, faster, and covers my bald spot."
1115,1,5,40,46,1.1521739130434783,0.061913070618242964,544,Suppose they merge in order to reduce their underhead?
1115,0,7,39,46,1.1521739130434783,0.05354479188959757,544,You run a headhunter business as well?
1115,2,3,41,46,1.1521739130434783,0.06927778784183837,544,Have your head call my head and let's do lunch.
1115,2,3,41,46,1.1521739130434783,0.06927778784183837,544,Can you hold my nerd while I run to the cafeteria?
1115,2,3,41,46,1.1521739130434783,0.06927778784183837,544,This is the last time I'm outsourcing to Lilliput!
1115,1,5,40,46,1.1521739130434783,0.061913070618242964,544,Never thought I'd miss the days when the micromanagement was completely transparent.
1115,2,3,41,46,1.1521739130434783,0.06927778784183837,544,Who would have thought our promotions would go to our heads.
1115,1,5,40,46,1.1521739130434783,0.061913070618242964,544,I think we have the best twin day costume.
1115,2,3,41,46,1.1521739130434783,0.06927778784183837,544,We should establish a LAN.
1115,3,1,42,46,1.1521739130434783,0.07593151824596947,544,Pssst. You've got a little dude and a desk on your head.
1115,3,1,42,46,1.1521739130434783,0.07593151824596947,544,"I also asked for a little off the top, not a little office on top."
1115,1,5,40,46,1.1521739130434783,0.061913070618242964,544,"I'm Aries, the RAM, how about you?"
1115,0,7,39,46,1.1521739130434783,0.05354479188959757,544,"I'm trying to disconnect from work at home, but it's hard."
1115,1,5,40,46,1.1521739130434783,0.061913070618242964,544,'Head Office' just doesn't have that ring to it anymore!
1115,2,3,41,46,1.1521739130434783,0.06927778784183837,544,What's on your mind?
1115,0,7,39,46,1.1521739130434783,0.05354479188959757,544,I disagree. I think the little guy sitting at a desk on top of my head is MORE of a workaholic than the little guy sitting at a desk on top of your head.
1115,1,5,40,46,1.1521739130434783,0.061913070618242964,544,Let's get our head guys on it ASAP
1115,1,5,40,46,1.1521739130434783,0.061913070618242964,544,I thought it said hedge fund manager.
1115,0,7,39,46,1.1521739130434783,0.05354479188959757,544,"It's fine, but I am not looking forward to 'Bring your child to work day.'"
1115,1,5,40,46,1.1521739130434783,0.061913070618242964,544,"After I googled Google vs Brain, I had to go with Google."
1115,1,5,40,46,1.1521739130434783,0.061913070618242964,544,He tried to negotiate for a credenza too...that's where I had to put my toe down.
1115,1,5,40,46,1.1521739130434783,0.061913070618242964,544,"Wait, did I just think that, or post it on Facebook?"
1115,2,3,41,46,1.1521739130434783,0.06927778784183837,544,I didn't know this is what management meant by downsizing.
1115,1,5,40,46,1.1521739130434783,0.061913070618242964,544,The boss says we have to reduce our overhead.
1115,2,3,41,46,1.1521739130434783,0.06927778784183837,544,Laptops are easier to use.
1115,1,5,40,46,1.1521739130434783,0.061913070618242964,544,"I know, Casual Friday can't come soon enough!"
1115,2,3,41,46,1.1521739130434783,0.06927778784183837,544,I thought they were supposed to be standing on our shoulders.
1115,3,1,42,46,1.1521739130434783,0.07593151824596947,544,"When you work hard, you move on ahead ."
1115,0,7,39,46,1.1521739130434783,0.05354479188959757,544,"Dont't forget, I'm Mergers and you're Acquisitions."
1115,2,3,41,46,1.1521739130434783,0.06927778784183837,544,When Sid told me I could work from home I didn't think it would be such a balancing act.
1115,1,5,40,46,1.1521739130434783,0.061913070618242964,544,I'm hoping to grow my small business into a mid-cap.
1115,2,3,41,46,1.1521739130434783,0.06927778784183837,544,They say wear the hat for the job you want.
1115,1,5,40,46,1.1521739130434783,0.061913070618242964,544,"Right off the top of my head, I don't think it's a wise idea to take work home with us."
1115,2,3,41,46,1.1521739130434783,0.06927778784183837,544,Very heady.
1115,2,3,41,46,1.1521739130434783,0.06927778784183837,544,"Your barber does desktops, too?"
1115,1,5,40,46,1.1521739130434783,0.061913070618242964,544,I find that double-sided tape helps on windy days
1115,2,3,41,46,1.1521739130434783,0.06927778784183837,544,I told you mentoring corporate accountants was going to be a real balancing act.
1115,2,3,41,46,1.1521739130434783,0.06927778784183837,544,I liked it better when we just carried smart phones...
1115,1,5,40,46,1.1521739130434783,0.061913070618242964,544,"I can't seem to get work off my mind, can you?"
1115,1,5,40,46,1.1521739130434783,0.061913070618242964,544,I've got the head office.
1115,1,5,40,46,1.1521739130434783,0.061913070618242964,544,I can't get business out of my head.
1115,0,7,39,46,1.1521739130434783,0.05354479188959757,544,I find that double-sided tape helps on windy days
1115,0,7,39,46,1.1521739130434783,0.05354479188959757,544,"Does yours just look at porn all day, too?"
1115,1,5,40,46,1.1521739130434783,0.061913070618242964,544,"Initially, outsourcing ideas was great, but it's become a headache."
1115,1,5,40,46,1.1521739130434783,0.061913070618242964,544,"I'm good with business, but I never had a head for computers"
1115,1,5,40,46,1.1521739130434783,0.061913070618242964,544,"Is yours transcribing your thoughts, too?"
1115,1,5,40,46,1.1521739130434783,0.061913070618242964,544,"Yeah, I can't get work off my mind either."
1115,2,3,41,46,1.1521739130434783,0.06927778784183837,544,"I've had the same IT guy on my mind , too."
1115,2,3,41,46,1.1521739130434783,0.06927778784183837,544,"The voices in my head are emails now, too!"
1115,1,5,40,46,1.1521739130434783,0.061913070618242964,544,Have you tried Head Office and Shoulders?
1115,2,3,41,46,1.1521739130434783,0.06927778784183837,544,I guess we both have a lot on our minds.
1115,0,7,39,46,1.1521739130434783,0.05354479188959757,544,Does yours tap his foot?
1115,1,5,40,46,1.1521739130434783,0.061913070618242964,544,Department Heads meet face to face.
1115,0,7,39,46,1.1521739130434783,0.05354479188959757,544,Have you been able to get your head around it?
1115,1,5,40,46,1.1521739130434783,0.061913070618242964,544,They're saying we are incompatible.
1115,0,7,39,46,1.1521739130434783,0.05354479188959757,544,"?""My guy keeps up on the election polls for me so I can live my damn life"""
1115,2,3,41,46,1.1521739130434783,0.06927778784183837,544,I see that we're both working to get ahead.
1115,2,3,41,46,1.1521739130434783,0.06927778784183837,544,Does using your desktop give you headaches?
1115,2,3,41,46,1.1521739130434783,0.06927778784183837,544,I see you can't get work off your mind either!
1115,3,1,42,46,1.1521739130434783,0.07593151824596947,544,"I think we took that ""How to Get Ahead in Business"" book too literally."
1115,1,5,40,46,1.1521739130434783,0.061913070618242964,544,It feels funny when he tries to spread his toes apart
1115,1,5,40,46,1.1521739130434783,0.061913070618242964,544,How many martinis does it take for yours to go away?
1115,1,5,40,46,1.1521739130434783,0.061913070618242964,544,"The workaholic in me, honors the workaholic in you............"
1115,1,5,40,46,1.1521739130434783,0.061913070618242964,544,The pressure to reduce overhead is giving me a headache.
1115,1,5,40,46,1.1521739130434783,0.061913070618242964,544,Don't you have a mind of your own?
1115,1,5,40,46,1.1521739130434783,0.061913070618242964,544,"If twins think alike, how come my brain is checking out QVC online while your is watching 'Debbie does Dallas?'"
1115,1,5,40,46,1.1521739130434783,0.061913070618242964,544,"When Jack took my goose, I had to resort to office space rentals. What's your story?"
1115,2,3,41,46,1.1521739130434783,0.06927778784183837,544,Remember when we used to actually speak to each other?
1115,1,5,40,46,1.1521739130434783,0.061913070618242964,544,"He asked for a promotion, but I told him he's already at the top."
1115,1,5,40,46,1.1521739130434783,0.061913070618242964,544,My headspace leases for $2200 per sq. inch!
1115,1,5,40,46,1.1521739130434783,0.061913070618242964,544,I told you we shouldn't have let the new jobs go to our heads.
1115,3,1,42,46,1.1521739130434783,0.07593151824596947,544,"$25 at Costco, what did yours cost?"
1115,1,5,40,46,1.1521739130434783,0.061913070618242964,544,So which head office do you work for?
1115,1,5,40,46,1.1521739130434783,0.061913070618242964,544,"If the doctor separates us, who gets custody of the little ones?"
1115,1,5,40,46,1.1521739130434783,0.061913070618242964,544,I have to stop taking my work home with me.
1115,1,5,40,46,1.1521739130434783,0.061913070618242964,544,Why don't we just FaceTime?
1115,2,3,41,46,1.1521739130434783,0.06927778784183837,544,I see your super ego shops at Ikea as well.
1115,1,5,40,46,1.1521739130434783,0.061913070618242964,544,Being micromanaged is growing on me.
1115,1,5,40,46,1.1521739130434783,0.061913070618242964,544,Just off the top of my head I'd say we're a lot alike.
1115,2,3,41,46,1.1521739130434783,0.06927778784183837,544,Copy that.
1115,2,3,41,46,1.1521739130434783,0.06927778784183837,544,I was about to share my thoughts but I've lost connection.
1115,3,1,42,46,1.1521739130434783,0.07593151824596947,544,I hear a banjo.
1115,0,7,39,46,1.1521739130434783,0.05354479188959757,544,Five o'clock can't come soon enough.
1115,2,3,41,46,1.1521739130434783,0.06927778784183837,544,The headaches really got better once I got a rug under the office chair.
1115,2,3,41,46,1.1521739130434783,0.06927778784183837,544,I'm thinking of getting an intern.
1115,1,5,40,46,1.1521739130434783,0.061913070618242964,544,My memory was perfect until he discovered the delete key.
1115,1,5,40,46,1.1521739130434783,0.061913070618242964,544,The bubble thoughts are not as heavy.
1115,0,7,39,46,1.1521739130434783,0.05354479188959757,544,This is hairassment.
1115,1,5,40,46,1.1521739130434783,0.061913070618242964,544,My next hire is a chiropractor.
1267,2,3,42,47,1.148936170212766,0.06786504677504616,544,Does your personal assistant take bathroom breaks too?
1267,1,5,41,47,1.148936170212766,0.06066790909183939,544,Still think getting matching desk sets was a good idea?
1267,1,5,41,47,1.148936170212766,0.06066790909183939,544,Who knew this is what they meant when they said there could be ‘minor staff reductions?’
1270,2,3,43,48,1.1458333333333333,0.06650856696625959,544,This company's brainstorming techniques have gotten a little out of hand.
1270,1,5,42,48,1.1458333333333333,0.059471544937141164,544,"Yeah, I know what you mean, but he sure comes in handy during tax season."
1272,1,4,40,45,1.1333333333333333,0.06030226891555274,544,"They laugh alike,they walk alike,at times they even talk alike. You could lose your mind..."
1272,1,4,40,45,1.1333333333333333,0.06030226891555274,544,I'm glad we picked heads.
1272,1,4,40,45,1.1333333333333333,0.06030226891555274,544,I'll have my people call your people...
1272,2,2,41,45,1.1333333333333333,0.06816498108607269,544,Mine is always playing online poker. How about yours?
1272,1,4,40,45,1.1333333333333333,0.06030226891555274,544,My executive functions are all a mess.
1272,1,4,40,45,1.1333333333333333,0.06030226891555274,544,Mine's starting to itch. Should I see a barber or call tech support?
1272,1,4,40,45,1.1333333333333333,0.06030226891555274,544,Don't let anyone tell you you've got nothing going on upstairs.
1272,2,2,41,45,1.1333333333333333,0.06816498108607269,544,Are you left-handed?
1272,1,4,40,45,1.1333333333333333,0.06030226891555274,544,Trust me dude. These hats will totally get us laid.
1272,2,2,41,45,1.1333333333333333,0.06816498108607269,544,Telecommuting was never like this.
1272,1,4,40,45,1.1333333333333333,0.06030226891555274,544,I can't seem to get this email thing off my mind either.
1272,1,4,40,45,1.1333333333333333,0.06030226891555274,544,What hath Bill Gates wrought?
1272,0,6,39,45,1.1333333333333333,0.05124707431905384,544,Look George - there's being held accountable and then there's this.
1272,1,4,40,45,1.1333333333333333,0.06030226891555274,544,I'm OK with being micro-managed. They wear neckties. We don't.
1272,0,6,39,45,1.1333333333333333,0.05124707431905384,544,"What a coincidence, I work in my company's head office too."
1272,2,2,41,45,1.1333333333333333,0.06816498108607269,544,"Dude, where's your pencil holder?"
1272,1,4,40,45,1.1333333333333333,0.06030226891555274,544,The virtual workplace loses something when management buys the headsets.
1272,1,4,40,45,1.1333333333333333,0.06030226891555274,544,My accountant's on top of it too.
1272,1,4,40,45,1.1333333333333333,0.06030226891555274,544,My guy's starting to get suspicious that he's a hat too.
1272,2,2,41,45,1.1333333333333333,0.06816498108607269,544,I can't get my mind off my work.
1272,1,4,40,45,1.1333333333333333,0.06030226891555274,544,I would say off the top of my head that I can agree with your position on that.
1272,0,6,39,45,1.1333333333333333,0.05124707431905384,544,"Reminds me of a song, ""You are always on my mind"""
1272,1,4,40,45,1.1333333333333333,0.06030226891555274,544,Can you find the ten differences?
1272,2,2,41,45,1.1333333333333333,0.06816498108607269,544,My doctor said it should go away on its own around 5pm.
1272,1,4,40,45,1.1333333333333333,0.06030226891555274,544,"Well, one of us has to change."
1272,1,4,40,45,1.1333333333333333,0.06030226891555274,544,I don't think that work-life balance seminar helped much.
1272,0,6,39,45,1.1333333333333333,0.05124707431905384,544,"Hey man, what's on your mind?"
1272,1,4,40,45,1.1333333333333333,0.06030226891555274,544,Let's join forces and split the overhead.
1272,0,6,39,45,1.1333333333333333,0.05124707431905384,544,Can't get work off your mind either?
1272,1,4,40,45,1.1333333333333333,0.06030226891555274,544,My therapist says it's not healthy to walk around with the office on my mind.
1272,1,4,40,45,1.1333333333333333,0.06030226891555274,544,I hear these guys would do anything to get ahead!
1272,1,4,40,45,1.1333333333333333,0.06030226891555274,544,Some vacation we're having.
1272,2,2,41,45,1.1333333333333333,0.06816498108607269,544,I see that your head lice have also hired a lawyer.
1272,1,4,40,45,1.1333333333333333,0.06030226891555274,544,Mine's using brain power.
1272,0,6,39,45,1.1333333333333333,0.05124707431905384,544,What's on your mind?
1272,2,2,41,45,1.1333333333333333,0.06816498108607269,544,"""Heading to work"" got a new meaning, I'm afraid."
1272,1,4,40,45,1.1333333333333333,0.06030226891555274,544,Have your guy give my guy a call.
1272,1,4,40,45,1.1333333333333333,0.06030226891555274,544,"I said we need to take care of a little business, not a little buisnessman."
1272,0,6,39,45,1.1333333333333333,0.05124707431905384,544,This telekinetic commuting is a real headache.
1272,1,4,40,45,1.1333333333333333,0.06030226891555274,544,"No, I don't notice anything unusual about you."
1272,1,4,40,45,1.1333333333333333,0.06030226891555274,544,Me? I heard YOU were the new department head!
1272,2,2,41,45,1.1333333333333333,0.06816498108607269,544,See you have a virtual headache also.
1272,2,2,41,45,1.1333333333333333,0.06816498108607269,544,How was your weekend?
1272,1,4,40,45,1.1333333333333333,0.06030226891555274,544,I didn't realize that working from home came with the whole set-up.
1272,0,6,39,45,1.1333333333333333,0.05124707431905384,544,What happens if they get treadmills?
1272,2,2,41,45,1.1333333333333333,0.06816498108607269,544,This shrinking cubicles trend it getting ridiculous.
1272,0,6,39,45,1.1333333333333333,0.05124707431905384,544,I think we both have a lot on our minds.
1272,1,4,40,45,1.1333333333333333,0.06030226891555274,544,We need to change our shampoo.
1272,1,4,40,45,1.1333333333333333,0.06030226891555274,544,Is your inner child a middle-aged bureaucrat like mine?
1272,0,6,39,45,1.1333333333333333,0.05124707431905384,544,They say great minds think alike.
1272,0,6,39,45,1.1333333333333333,0.05124707431905384,544,"Something's on your mind, Frank."
1272,1,4,40,45,1.1333333333333333,0.06030226891555274,544,My mother gave me up for adoption at birth. You?
1272,2,2,41,45,1.1333333333333333,0.06816498108607269,544,I want you to keep this under your hat.
1272,1,4,40,45,1.1333333333333333,0.06030226891555274,544,It's time we stop bringing our work home.
1272,2,2,41,45,1.1333333333333333,0.06816498108607269,544,In retrospect memorizing multiplication tables would have been useful.
1272,2,2,41,45,1.1333333333333333,0.06816498108607269,544,Did your wife divorce you because you always have work on your mind too?
1272,1,4,40,45,1.1333333333333333,0.06030226891555274,544,Did your brain just invite my brain to join LinkedIn?
1272,1,4,40,45,1.1333333333333333,0.06030226891555274,544,"Yeah, I'm trying one of those standing desks too."
1272,2,2,41,45,1.1333333333333333,0.06816498108607269,544,Golf? I'll have my person get a hold of your person.
1272,1,4,40,45,1.1333333333333333,0.06030226891555274,544,I like your hat!
1272,2,2,41,45,1.1333333333333333,0.06816498108607269,544,Maybe a nice vacation would help get work off of our minds.
1272,1,4,40,45,1.1333333333333333,0.06030226891555274,544,I see you are having trouble leaving work at the office as well.
1272,2,2,41,45,1.1333333333333333,0.06816498108607269,544,Have your guy call my guy and let's do lunch.
1272,1,4,40,45,1.1333333333333333,0.06030226891555274,544,I think we've been sucked into another inexplicable NEW YORKER cartoon.
1272,1,4,40,45,1.1333333333333333,0.06030226891555274,544,"""So this is what we get for having a head for figures?"
1272,1,4,40,45,1.1333333333333333,0.06030226891555274,544,You're right Bob. This new app really helps you get a head.
1272,2,2,41,45,1.1333333333333333,0.06816498108607269,544,"My friends say I'm left-brained, but I just don't see it."
1272,2,2,41,45,1.1333333333333333,0.06816498108607269,544,"He's way more useful than Siri, but how are we going to keep this under our hats?"
1272,1,4,40,45,1.1333333333333333,0.06030226891555274,544,I imagine one of us will end up like dad
1272,1,4,40,45,1.1333333333333333,0.06030226891555274,544,I hate desk jobs.
1272,2,2,41,45,1.1333333333333333,0.06816498108607269,544,"I see the FBI is auditing your esp mail, too."
1272,1,4,40,45,1.1333333333333333,0.06030226891555274,544,My dopelganger is more tech-savvy than yours!
1272,1,4,40,45,1.1333333333333333,0.06030226891555274,544,I can't get work off my mind.
1272,1,4,40,45,1.1333333333333333,0.06030226891555274,544,Got work on your mind? Me too
1272,1,4,40,45,1.1333333333333333,0.06030226891555274,544,Remember when we could balance work and life?
1272,1,4,40,45,1.1333333333333333,0.06030226891555274,544,This guy really needs to delete his internet history.
1272,1,4,40,45,1.1333333333333333,0.06030226891555274,544,"The digital era's version of, 'off the top of my head'"
1272,1,4,40,45,1.1333333333333333,0.06030226891555274,544,Yeah it's been on my mind a lot too.
1272,0,6,39,45,1.1333333333333333,0.05124707431905384,544,Staying on top of things is very important around here.
1272,1,4,40,45,1.1333333333333333,0.06030226891555274,544,How long have you headed up the department?
1272,0,6,39,45,1.1333333333333333,0.05124707431905384,544,"Not exactly the Matrix, but close enough."
1272,2,2,41,45,1.1333333333333333,0.06816498108607269,544,Is there something on your mind?
1272,1,4,40,45,1.1333333333333333,0.06030226891555274,544,Great minds think alike.
1272,0,6,39,45,1.1333333333333333,0.05124707431905384,544,These new Google hats just aren't as fashionable as the Google glasses.
1272,0,6,39,45,1.1333333333333333,0.05124707431905384,544,We might be related
1272,2,2,41,45,1.1333333333333333,0.06816498108607269,544,What's on your mind?
1272,0,6,39,45,1.1333333333333333,0.05124707431905384,544,Any idea why people are doing a double-tech when they see us?
1272,1,4,40,45,1.1333333333333333,0.06030226891555274,544,"The rent's not bad, but the overhead is killing us."
1272,1,4,40,45,1.1333333333333333,0.06030226891555274,544,Man Accidentally Clones Self While Randomly Pushing Copier Buttons During One Bad Paper Jam
1272,2,2,41,45,1.1333333333333333,0.06816498108607269,544,Nothing like a desktop hat to keep your head out of the Cloud.
1272,1,4,40,45,1.1333333333333333,0.06030226891555274,544,I thought of it first! No- I did
1272,0,6,39,45,1.1333333333333333,0.05124707431905384,544,Do you have a feeling that some employees are going over our heads?
1272,1,4,40,45,1.1333333333333333,0.06030226891555274,544,You need to get your mind off of work.
1272,3,0,42,45,1.1333333333333333,0.07521014330903551,544,I've been making him work longer hours ever since my Great Recession.
1272,2,2,41,45,1.1333333333333333,0.06816498108607269,544,This work-life balance isn't easy.
1272,1,4,40,45,1.1333333333333333,0.06030226891555274,544,"The work weighs heavy, doesn't it?"
1272,1,4,40,45,1.1333333333333333,0.06030226891555274,544,I'm not so sure about this open-office plan.
1272,0,6,39,45,1.1333333333333333,0.05124707431905384,544,"The good thing is, we don't have to speak to each other anymore."
1272,1,4,40,45,1.1333333333333333,0.06030226891555274,544,Work has been weighing heavy on my mind too.
1272,1,4,40,45,1.1333333333333333,0.06030226891555274,544,I think this job's gone to our heads.
1272,2,2,41,45,1.1333333333333333,0.06816498108607269,544,It's just like my old obsession with sex-- I now think about work 24 hours a day without ever getting any done.
1272,1,4,40,45,1.1333333333333333,0.06030226891555274,544,"I miss the old Blackberry, too."
1272,1,4,40,45,1.1333333333333333,0.06030226891555274,544,What's on your mind... as if I didn't know.
1272,2,2,41,45,1.1333333333333333,0.06816498108607269,544,What's on you mind?
1272,1,4,40,45,1.1333333333333333,0.06030226891555274,544,What does your inner accountant tell you?
1272,1,4,40,45,1.1333333333333333,0.06030226891555274,544,He's a CEO so he uses his golden parachute. How does yours get down?
1272,1,4,40,45,1.1333333333333333,0.06030226891555274,544,You've got work on your mind too?
1272,2,2,41,45,1.1333333333333333,0.06816498108607269,544,"The new work/life balance program? It's OK, except his chair squeaks."
1272,1,4,40,45,1.1333333333333333,0.06030226891555274,544,"It's nice, but I want earflaps."
1272,1,4,40,45,1.1333333333333333,0.06030226891555274,544,I took away his smoke breaks when he dumped on my head.
1272,0,6,39,45,1.1333333333333333,0.05124707431905384,544,Where are your outlets?
1272,1,4,40,45,1.1333333333333333,0.06030226891555274,544,Great minds google alike.
1272,0,6,39,45,1.1333333333333333,0.05124707431905384,544,Are you sure this is how downsizing is supposed to work?
1272,2,2,41,45,1.1333333333333333,0.06816498108607269,544,"Great minds think alike, Harold."
1272,0,6,39,45,1.1333333333333333,0.05124707431905384,544,"Sure we're saving a lot on office space, but it still feels like we've got too much overhead."
1272,0,6,39,45,1.1333333333333333,0.05124707431905384,544,Don't you hate it when he presses the 'shift' key?
1272,1,4,40,45,1.1333333333333333,0.06030226891555274,544,They've been sent here by Head Office.
1272,2,2,41,45,1.1333333333333333,0.06816498108607269,544,You think maybe we need a hobby?
1272,2,2,41,45,1.1333333333333333,0.06816498108607269,544,You think this is bad? Wait till your wife disables your pop-ups.
1272,1,4,40,45,1.1333333333333333,0.06030226891555274,544,A parallel world they do exist
1272,0,6,39,45,1.1333333333333333,0.05124707431905384,544,What's on your mind?
1272,1,4,40,45,1.1333333333333333,0.06030226891555274,544,I hate having to use a public server.
1272,1,4,40,45,1.1333333333333333,0.06030226891555274,544,I'll have my person call your person.
1272,1,4,40,45,1.1333333333333333,0.06030226891555274,544,Your Wi-Fi is down.
1272,0,6,39,45,1.1333333333333333,0.05124707431905384,544,Call me old fashioned -- I'm keeping my pencil cup.
1272,0,6,39,45,1.1333333333333333,0.05124707431905384,544,"I can't get work off my mind, how 'bout you?"
1272,1,4,40,45,1.1333333333333333,0.06030226891555274,544,I see your hard drive imbedded as well?
1272,0,6,39,45,1.1333333333333333,0.05124707431905384,544,I don't know. what do YOU think the sampling error is?
1272,1,4,40,45,1.1333333333333333,0.06030226891555274,544,Have your man text my man and we'll do lunch.
1272,2,2,41,45,1.1333333333333333,0.06816498108607269,544,IRS audits give me a headache too
1272,0,6,39,45,1.1333333333333333,0.05124707431905384,544,What do you mean you're not taking my face-to-face meeting?
1272,1,4,40,45,1.1333333333333333,0.06030226891555274,544,Same Halloween costume store?
1272,1,4,40,45,1.1333333333333333,0.06030226891555274,544,great minds think alike
1272,1,4,40,45,1.1333333333333333,0.06030226891555274,544,"Same, having trouble getting work off my mind."
1272,1,4,40,45,1.1333333333333333,0.06030226891555274,544,I don't like this latest trend in mini-computers.
1272,2,2,41,45,1.1333333333333333,0.06816498108607269,544,I always envisioned Big Brother being less bureaucratic.
1272,2,2,41,45,1.1333333333333333,0.06816498108607269,544,The wifi is down again. How an I supposed to know what you are thinking !
1272,2,2,41,45,1.1333333333333333,0.06816498108607269,544,So it's like this all the way down to sales?
1272,2,2,41,45,1.1333333333333333,0.06816498108607269,544,Work is always on my mind.
1272,1,4,40,45,1.1333333333333333,0.06030226891555274,544,How do YOU manage to stop thinking about work and relax?
1272,2,2,41,45,1.1333333333333333,0.06816498108607269,544,I just can't get you off my mind
1272,0,6,39,45,1.1333333333333333,0.05124707431905384,544,I see you also belong to the Stupid Hat of the Month Club.
1272,1,4,40,45,1.1333333333333333,0.06030226891555274,544,He worked his way up from my male room.
1272,1,4,40,45,1.1333333333333333,0.06030226891555274,544,Are you e-mailing what I'm e-mailing?
1272,1,4,40,45,1.1333333333333333,0.06030226891555274,544,Call the exterminator and say we still have them.
1272,2,2,41,45,1.1333333333333333,0.06816498108607269,544,Telepathic twins warming up before another day at the office.
1272,2,2,41,45,1.1333333333333333,0.06816498108607269,544,I am lovin’ my new government hat.
1272,1,4,40,45,1.1333333333333333,0.06030226891555274,544,We've got to get this audit off of our minds.
1272,1,4,40,45,1.1333333333333333,0.06030226891555274,544,"Like I said earlier, I just can't seem to take my mind off work."
1272,0,6,39,45,1.1333333333333333,0.05124707431905384,544,"Work is your happy place, too?"
1272,1,4,40,45,1.1333333333333333,0.06030226891555274,544,Gotta keep your head in the game
1423,1,4,41,46,1.1304347826086956,0.059047967499893814,544,This micromanagement has really gotten out of hand.
1423,0,6,40,46,1.1304347826086956,0.05020437123388051,544,I see you're also getting a head start on your taxes.
1423,1,4,41,46,1.1304347826086956,0.059047967499893814,544,I'm not sure I care for this new 'work at dome' initiative.
1423,1,4,41,46,1.1304347826086956,0.059047967499893814,544,I didn't sign up for this kind of outside-the-box thinking.
1423,2,2,42,46,1.1304347826086956,0.06672964888823965,544,I'm ignoring my little head
1423,1,4,41,46,1.1304347826086956,0.059047967499893814,544,This technology boom is getting out of hand...
1423,2,2,42,46,1.1304347826086956,0.06672964888823965,544,you must be an executive too?
1423,1,4,41,46,1.1304347826086956,0.059047967499893814,544,No pencil box? You are a wild man.
1423,0,6,40,46,1.1304347826086956,0.05020437123388051,544,I just hate being micromanaged.
1423,0,6,40,46,1.1304347826086956,0.05020437123388051,544,Not sure how I feel about the new mobile offices.
1423,2,2,42,46,1.1304347826086956,0.06672964888823965,544,"Yeah, work's been on my mind a lot lately too."
1423,0,6,40,46,1.1304347826086956,0.05020437123388051,544,"I don't know about you, but I'm rethinking my decision to choose the work-from-home option."
1423,1,4,41,46,1.1304347826086956,0.059047967499893814,544,"To be fair, he did say he would monitor the situation."
1423,1,4,41,46,1.1304347826086956,0.059047967499893814,544,I'll have my brain wire the instructions to your brain.
1423,0,6,40,46,1.1304347826086956,0.05020437123388051,544,I don't mind having work on the brain all the time as much as the incessant tapping.
1423,2,2,42,46,1.1304347826086956,0.06672964888823965,544,Taking my job home weighs on me.
1439,1,4,42,47,1.127659574468085,0.057844581686821384,544,"I tried dandruff shampoo, but it didn't work."
1439,0,6,41,47,1.127659574468085,0.04920290896196927,544,"Me too, every once an while I hear this clicking noise."
1441,1,3,39,43,1.1162790697674418,0.059615808787130756,544,I see we have the same barber.
1441,1,3,39,43,1.1162790697674418,0.059615808787130756,544,Sorry if I seem a little distant. My head is still back at the office.
1441,1,3,39,43,1.1162790697674418,0.059615808787130756,544,"No, you can't borrow a pencil."
1441,1,3,39,43,1.1162790697674418,0.059615808787130756,544,It's the best desktop I can come up with right off the top of my head.
1441,0,5,38,43,1.1162790697674418,0.04946336973228635,544,Did you get my email?
1441,1,3,39,43,1.1162790697674418,0.059615808787130756,544,"Hey, you, get off of my cloud."
1441,1,3,39,43,1.1162790697674418,0.059615808787130756,544,And I was sure no-one else would have the same costume this year.
1441,0,5,38,43,1.1162790697674418,0.04946336973228635,544,This hack and hide thing was a bad idea. Let's make a run for the Ecuadorean embassy and grab some ceviche.
1441,1,3,39,43,1.1162790697674418,0.059615808787130756,544,"Personally, I'd rather have the devil on my shoulder off the meds than the accountant on my head with the meds."
1441,0,5,38,43,1.1162790697674418,0.04946336973228635,544,The difference is in the details!
1441,1,3,39,43,1.1162790697674418,0.059615808787130756,544,I see you also have work on your mind.
1441,0,5,38,43,1.1162790697674418,0.04946336973228635,544,"Yeah, I'm also taking my work home with me all the time."
1441,2,1,40,43,1.1162790697674418,0.06827491757164275,544,I'm exhausted. He NEVER takes a lunch break!
1441,1,3,39,43,1.1162790697674418,0.059615808787130756,544,It just came to me off the top of my head.
1441,1,3,39,43,1.1162790697674418,0.059615808787130756,544,You're talking in a funny font.
1441,0,5,38,43,1.1162790697674418,0.04946336973228635,544,"No, it's not all in your head."
1441,0,5,38,43,1.1162790697674418,0.04946336973228635,544,Should we tip our hats?
1441,0,5,38,43,1.1162790697674418,0.04946336973228635,544,I prefer hot-desking
1441,2,1,40,43,1.1162790697674418,0.06827491757164275,544,Whenever I take my work home with me I get a migraine.
1441,1,3,39,43,1.1162790697674418,0.059615808787130756,544,"Yeah, I'm a desktop guy too."
1441,1,3,39,43,1.1162790697674418,0.059615808787130756,544,I think we both have work on our minds.
1441,1,3,39,43,1.1162790697674418,0.059615808787130756,544,We're taking our work home with us again!
1441,2,1,40,43,1.1162790697674418,0.06827491757164275,544,So this is how the mind works.
1441,1,3,39,43,1.1162790697674418,0.059615808787130756,544,They're working on the next big thing.
1441,1,3,39,43,1.1162790697674418,0.059615808787130756,544,Got work?
1441,1,3,39,43,1.1162790697674418,0.059615808787130756,544,You have to admit — it's a little clunkier than the Google Watch.
1441,1,3,39,43,1.1162790697674418,0.059615808787130756,544,I call him Charles Darwin.
1441,1,3,39,43,1.1162790697674418,0.059615808787130756,544,Why does everyone presume we are twins? We're nothing alike!
1441,1,3,39,43,1.1162790697674418,0.059615808787130756,544,"Love your mullet. Business up front, party in the back!"
1441,1,3,39,43,1.1162790697674418,0.059615808787130756,544,I miss bedhead.
1441,1,3,39,43,1.1162790697674418,0.059615808787130756,544,"I,too,have a head for business"
1441,0,5,38,43,1.1162790697674418,0.04946336973228635,544,Luckily he takes long lunches.
1441,1,3,39,43,1.1162790697674418,0.059615808787130756,544,"""I don't know about you, but I can't get work off my mind""."
1441,1,3,39,43,1.1162790697674418,0.059615808787130756,544,Workplace mind games.
1441,1,3,39,43,1.1162790697674418,0.059615808787130756,544,"I don't remember,either - let's Google it."
1441,1,3,39,43,1.1162790697674418,0.059615808787130756,544,Sounds great. Have your brain call my brain and set it up.
1441,2,1,40,43,1.1162790697674418,0.06827491757164275,544,"That phrase, 'giving critical support to higher-ups', in the job description was a bit misleading."
1441,1,3,39,43,1.1162790697674418,0.059615808787130756,544,I can't keep work off my mind either.
1441,2,1,40,43,1.1162790697674418,0.06827491757164275,544,What happened to your pencil cup?
1441,1,3,39,43,1.1162790697674418,0.059615808787130756,544,Wait! Wait! Let me guess! You rubbed a magic lamp? A genie appeared and granted your wish? But he thought you wished for a 10 inch desk - am I right?
1441,0,5,38,43,1.1162790697674418,0.04946336973228635,544,"It was bad enough bringing him to the cafeteria, but now he wants to go outside."
1441,0,5,38,43,1.1162790697674418,0.04946336973228635,544,You've got work on the brain too?
1441,1,3,39,43,1.1162790697674418,0.059615808787130756,544,Its vintage John Malcovich.
1441,2,1,40,43,1.1162790697674418,0.06827491757164275,544,I can't get my work off my mind.
1441,2,1,40,43,1.1162790697674418,0.06827491757164275,544,"Well, off the top of my head, so to speak...."
1441,1,3,39,43,1.1162790697674418,0.059615808787130756,544,Funny. I was just thinking that.
1441,1,3,39,43,1.1162790697674418,0.059615808787130756,544,"I have no problem with renting to the Lilliputians, but shouldn't we have checked the exchange rate?"
1441,2,1,40,43,1.1162790697674418,0.06827491757164275,544,Please cc your wife on my greeting.
1441,1,3,39,43,1.1162790697674418,0.059615808787130756,544,It's a no-brainer.
1441,0,5,38,43,1.1162790697674418,0.04946336973228635,544,I understand. Demands of the office can weigh on the mind.
1441,1,3,39,43,1.1162790697674418,0.059615808787130756,544,"Clearly, you have a head for business too."
1441,1,3,39,43,1.1162790697674418,0.059615808787130756,544,Is it a mirror?
1441,0,5,38,43,1.1162790697674418,0.04946336973228635,544,"""Just off the top of my head, I suspect we've run out of cubicles""."
1441,0,5,38,43,1.1162790697674418,0.04946336973228635,544,Managing the cloud is a full time job.
1441,0,5,38,43,1.1162790697674418,0.04946336973228635,544,Are you syncing what I'm syncing?
1441,1,3,39,43,1.1162790697674418,0.059615808787130756,544,He says he wants to FaceTime.
1441,1,3,39,43,1.1162790697674418,0.059615808787130756,544,Please review my attachment
1441,0,5,38,43,1.1162790697674418,0.04946336973228635,544,"I dunno, what's on your mind? OR Things are better since the little voice inside my head connected to the Internet."
1441,0,5,38,43,1.1162790697674418,0.04946336973228635,544,I still prefer this to Hairbnb.
1441,1,3,39,43,1.1162790697674418,0.059615808787130756,544,Are you getting paid for overtime?
1441,1,3,39,43,1.1162790697674418,0.059615808787130756,544,"If we put our heads together, we can fire one of the guys."
1441,1,3,39,43,1.1162790697674418,0.059615808787130756,544,They said I'll be off desk duty next week. How about you?
1441,0,5,38,43,1.1162790697674418,0.04946336973228635,544,It's the new approach to downsizing staff.
1441,1,3,39,43,1.1162790697674418,0.059615808787130756,544,Mine's from Phil's One-of-a-Kind Haberdashery. Yours?
1441,1,3,39,43,1.1162790697674418,0.059615808787130756,544,Only a right-brained person could create a caption for this cartoon.
1441,1,3,39,43,1.1162790697674418,0.059615808787130756,544,"Split shifts really work, don't they?"
1441,2,1,40,43,1.1162790697674418,0.06827491757164275,544,I think our need to communicate has gone too far.
1441,1,3,39,43,1.1162790697674418,0.059615808787130756,544,I hate these internal auditors.
1441,0,5,38,43,1.1162790697674418,0.04946336973228635,544,Cloud computing is just a little too far away for me
1510,1,3,40,44,1.1136363636363635,0.05830506897872825,544,"So, that's how I became head of the company."
1510,1,3,40,44,1.1136363636363635,0.05830506897872825,544,"We've got a good system going, one kick is a technical glitch, and two kicks is to visit the little boy's room."
1510,0,5,39,44,1.1136363636363635,0.048398332783092544,544,Advil won't help
1510,1,3,40,44,1.1136363636363635,0.05830506897872825,544,Black nine to red ten.
1510,1,3,40,44,1.1136363636363635,0.05830506897872825,544,How is your google office hat working out?
1510,2,1,41,44,1.1136363636363635,0.06675749786387705,544,Mom still likes me best.
1510,2,1,41,44,1.1136363636363635,0.06675749786387705,544,Anyone can listen to the voices from inside...
1510,0,5,39,44,1.1136363636363635,0.048398332783092544,544,I just send him an email when my scalp gets itchy.
1510,0,5,39,44,1.1136363636363635,0.048398332783092544,544,"We're the heads of the company, that's why I put the desks here."
1510,1,3,40,44,1.1136363636363635,0.05830506897872825,544,This is my first Hairbnb guest.
1510,1,3,40,44,1.1136363636363635,0.05830506897872825,544,"I bought the basic package to delegate routine daily decisions, and bought the override option for major commitments."
1510,0,5,39,44,1.1136363636363635,0.048398332783092544,544,Do you really think two heads are better than one?
1510,0,5,39,44,1.1136363636363635,0.048398332783092544,544,Let me guess. You want me to lend you a pencil.
1510,1,3,40,44,1.1136363636363635,0.05830506897872825,544,I'm done with self-help books after this one.
1510,2,1,41,44,1.1136363636363635,0.06675749786387705,544,I had a scary dream that I was always thinking of work--you too?
1510,1,3,40,44,1.1136363636363635,0.05830506897872825,544,He stole our idea for Facebook so let's keep this one top secret.
1510,2,1,41,44,1.1136363636363635,0.06675749786387705,544,My department head is contacting yours as we speak.
1510,2,1,41,44,1.1136363636363635,0.06675749786387705,544,"""Is that all you think about is work?"". ""Looks whose talking""."
1510,1,3,40,44,1.1136363636363635,0.05830506897872825,544,It's not as bad as the conference room.
1510,1,3,40,44,1.1136363636363635,0.05830506897872825,544,Only successful leaders use pencil holders.
1510,1,3,40,44,1.1136363636363635,0.05830506897872825,544,"Off the top of my head, or can I get back to you?"
1510,0,5,39,44,1.1136363636363635,0.048398332783092544,544,"If you change your vote, DON'T bring it up at Thanksgiving!"
1510,0,5,39,44,1.1136363636363635,0.048398332783092544,544,"You and I see eye to eye, but our analytic sides are just not connecting."
1510,1,3,40,44,1.1136363636363635,0.05830506897872825,544,His secretary? You don't want to know.
1510,0,5,39,44,1.1136363636363635,0.048398332783092544,544,"Yeah, I'd take a 'helicopter mom' over these 'hovering dads' any day!!"
1510,2,1,41,44,1.1136363636363635,0.06675749786387705,544,I can't believe you wore the same fascinator as me. You BITCH.
1510,1,3,40,44,1.1136363636363635,0.05830506897872825,544,Don't say that. You've got every bit the head for business that I've got.
1510,1,3,40,44,1.1136363636363635,0.05830506897872825,544,"The whole ""head office"" concept is not as impressive as it sounds."
1510,2,1,41,44,1.1136363636363635,0.06675749786387705,544,Stop repeat voting your New Yorker Caption Contest entry on work time!!
1510,1,3,40,44,1.1136363636363635,0.05830506897872825,544,I just loved it when we communicated orally.
1510,1,3,40,44,1.1136363636363635,0.05830506897872825,544,You need to have a level head on your shoulders these days to achieve a good work-life balance.
1510,1,3,40,44,1.1136363636363635,0.05830506897872825,544,Have your people talk with my people.
1510,1,3,40,44,1.1136363636363635,0.05830506897872825,544,I also feel that I take my work home with me.
1510,0,5,39,44,1.1136363636363635,0.048398332783092544,544,Out of Office just doesn't work.
1510,1,3,40,44,1.1136363636363635,0.05830506897872825,544,It wouldn't be so bad if the tiny invoices weren't so hard to read.
1510,0,5,39,44,1.1136363636363635,0.048398332783092544,544,Mike and Dave are the heads of our finance department.
1510,1,3,40,44,1.1136363636363635,0.05830506897872825,544,"Sorry, I don't have control of my schedule."
1510,0,5,39,44,1.1136363636363635,0.048398332783092544,544,Why are you badmouthing me on Facebook?
1510,1,3,40,44,1.1136363636363635,0.05830506897872825,544,It's hard to leave your work at the office when your office is in cyber space
1510,0,5,39,44,1.1136363636363635,0.048398332783092544,544,It's our tragedy to be managed by the little men on top.
1510,1,3,40,44,1.1136363636363635,0.05830506897872825,544,Are you happy with the way our overhead is being managed?
1510,1,3,40,44,1.1136363636363635,0.05830506897872825,544,Probably separated at birth.
1510,1,3,40,44,1.1136363636363635,0.05830506897872825,544,I don't think a standing desk will make a difference.
1510,0,5,39,44,1.1136363636363635,0.048398332783092544,544,recently it seems like the collective unconscious has become automated
1510,1,3,40,44,1.1136363636363635,0.05830506897872825,544,DON'T HIT DELETE.
1510,1,3,40,44,1.1136363636363635,0.05830506897872825,544,This wasn't quite my image of us getting new desk tops.
1510,1,3,40,44,1.1136363636363635,0.05830506897872825,544,Have you been using my shampoo?
1510,1,3,40,44,1.1136363636363635,0.05830506897872825,544,My alter ego is smarter than your alter ego . . .
1510,0,5,39,44,1.1136363636363635,0.048398332783092544,544,Mind your own business.
1510,0,5,39,44,1.1136363636363635,0.048398332783092544,544,"I'd have mine exorcised, but he's getting too much done...."
1510,0,5,39,44,1.1136363636363635,0.048398332783092544,544,I told you this would happen when you work at home.
1510,1,3,40,44,1.1136363636363635,0.05830506897872825,544,It's called a corporate double header
1510,0,5,39,44,1.1136363636363635,0.048398332783092544,544,I could've sworn I just had a thought of my own.
1510,2,1,41,44,1.1136363636363635,0.06675749786387705,544,My doppelgänger can outwork your doppelgänger!
1510,2,1,41,44,1.1136363636363635,0.06675749786387705,544,I've got work on my mind.
1510,2,1,41,44,1.1136363636363635,0.06675749786387705,544,I can't seem to get away from work these days.
1510,1,3,40,44,1.1136363636363635,0.05830506897872825,544,I'm also the owner of a small business man.
1510,1,3,40,44,1.1136363636363635,0.05830506897872825,544,This isn't what I thought they meant by Head Office employees.
1510,1,3,40,44,1.1136363636363635,0.05830506897872825,544,I'm thinking of transitioning to wireless
1510,1,3,40,44,1.1136363636363635,0.05830506897872825,544,"So, I'll get my people to talk to your people.."
1510,1,3,40,44,1.1136363636363635,0.05830506897872825,544,Be glad you're not a cruise ship captain.
1510,1,3,40,44,1.1136363636363635,0.05830506897872825,544,Control. Delete.
1510,0,5,39,44,1.1136363636363635,0.048398332783092544,544,Great mimes think alike.
1510,2,1,41,44,1.1136363636363635,0.06675749786387705,544,They call it crown-sizing.
1510,1,3,40,44,1.1136363636363635,0.05830506897872825,544,These new desks are real head-scratchers!
1510,2,1,41,44,1.1136363636363635,0.06675749786387705,544,I have no idea what this means.
1510,2,1,41,44,1.1136363636363635,0.06675749786387705,544,I see you also work under a micromanager.
1510,2,1,41,44,1.1136363636363635,0.06675749786387705,544,"No, my desk is not messy. You have OCD."
1510,1,3,40,44,1.1136363636363635,0.05830506897872825,544,I think we relate because each of us has a head for business.
1510,0,5,39,44,1.1136363636363635,0.048398332783092544,544,"I felt the cheese wedge wasn't sending the right message to perspective employers, you?"
1510,1,3,40,44,1.1136363636363635,0.05830506897872825,544,Don't mind me.
1510,1,3,40,44,1.1136363636363635,0.05830506897872825,544,I'm not sure how I feel about the new managerial oversight program.
1510,1,3,40,44,1.1136363636363635,0.05830506897872825,544,No; you're the puppet.
1510,0,5,39,44,1.1136363636363635,0.048398332783092544,544,1011100101110110010000100111100100001111010001111.
1510,0,5,39,44,1.1136363636363635,0.048398332783092544,544,"All I know is if I try to wear a hat, I get sued."
1510,0,5,39,44,1.1136363636363635,0.048398332783092544,544,"I've combed my records, but didn't find anything."
1510,0,5,39,44,1.1136363636363635,0.048398332783092544,544,How did we go from Casual Fridays to Ironic Saturdays?
1510,1,3,40,44,1.1136363636363635,0.05830506897872825,544,"I don't care what Mom told you, we are not identical twins."
1510,1,3,40,44,1.1136363636363635,0.05830506897872825,544,His new operating system gives me a headache.
1510,1,3,40,44,1.1136363636363635,0.05830506897872825,544,Did you get my e-mail?
1510,1,3,40,44,1.1136363636363635,0.05830506897872825,544,Great! Have your social media guy give my social media guy a call sometime.
1510,0,5,39,44,1.1136363636363635,0.048398332783092544,544,What's on your mind?
1510,1,3,40,44,1.1136363636363635,0.05830506897872825,544,Enough with these mind games.
1510,1,3,40,44,1.1136363636363635,0.05830506897872825,544,That was just off the top of head.
1510,0,5,39,44,1.1136363636363635,0.048398332783092544,544,Feels like I'm getting the boot.
1510,0,5,39,44,1.1136363636363635,0.048398332783092544,544,"Sorry, his head is in the clouds sometimes"
1510,0,5,39,44,1.1136363636363635,0.048398332783092544,544,Are you here for the headhunting conference?
1510,1,3,40,44,1.1136363636363635,0.05830506897872825,544,"Yeah, this is where I saw myself in five years, too."
1510,0,5,39,44,1.1136363636363635,0.048398332783092544,544,I'm having mine removed on Tuesday
1510,2,1,41,44,1.1136363636363635,0.06675749786387705,544,We gotta keep the overhead under control.
1510,0,5,39,44,1.1136363636363635,0.048398332783092544,544,Let me know if your guy needs to borrow a pen.
1510,1,3,40,44,1.1136363636363635,0.05830506897872825,544,"It’s not detachable, but look on the bright side: no more bad hair days."
1510,1,3,40,44,1.1136363636363635,0.05830506897872825,544,This whole job-sharing thing gives me a headache.
1510,1,3,40,44,1.1136363636363635,0.05830506897872825,544,Thy never acknowledge support staff.
1510,2,1,41,44,1.1136363636363635,0.06675749786387705,544,"Two hackers from the Kremlin trying to make sense of the Electoral College: ""In Russia it is much simpler."""
1510,0,5,39,44,1.1136363636363635,0.048398332783092544,544,These first-generation Google Glass prototypes are going to be worth a fortune some day- just you wait.
1510,2,1,41,44,1.1136363636363635,0.06675749786387705,544,It's a heady job.
1510,0,5,39,44,1.1136363636363635,0.048398332783092544,544,I hear the newest model comes with its own 401K.
1510,2,1,41,44,1.1136363636363635,0.06675749786387705,544,"It's part of the new ""Open Office"" concept."
1510,2,1,41,44,1.1136363636363635,0.06675749786387705,544,Google Desk has doomed the water cooler break.
1510,2,1,41,44,1.1136363636363635,0.06675749786387705,544,I can't believe they hired our brains so they could play solitaire.
1510,1,3,40,44,1.1136363636363635,0.05830506897872825,544,You look like you have something on your mind.
1510,1,3,40,44,1.1136363636363635,0.05830506897872825,544,P.C. Vey is one messed up dude.
1510,0,5,39,44,1.1136363636363635,0.048398332783092544,544,Wanna swap Mr. Right Brain for Mr. Left Brain?
1510,1,3,40,44,1.1136363636363635,0.05830506897872825,544,Are you clicking what I'm clicking?
1510,1,3,40,44,1.1136363636363635,0.05830506897872825,544,It beats working in a cubicle.
1510,1,3,40,44,1.1136363636363635,0.05830506897872825,544,Two great minds with a single dull thought.
1510,2,1,41,44,1.1136363636363635,0.06675749786387705,544,Let's keep calm and get them to reboot.
1510,1,3,40,44,1.1136363636363635,0.05830506897872825,544,The company's really taking this skills inventory seriously.
1510,2,1,41,44,1.1136363636363635,0.06675749786387705,544,"Besides my guy's having twenty-two more little black dots, can you find five other differences in our mental images?"
1510,1,3,40,44,1.1136363636363635,0.05830506897872825,544,Are you left-brained or right-brained?
1510,1,3,40,44,1.1136363636363635,0.05830506897872825,544,"No, YOU have a head for business."
1510,1,3,40,44,1.1136363636363635,0.05830506897872825,544,HEY P.C. VEY . WHAT THE HELL ARE YOU THINKING ! ?
1510,1,3,40,44,1.1136363636363635,0.05830506897872825,544,"""Won't ever complain about earworms again, will we?'"
1510,1,3,40,44,1.1136363636363635,0.05830506897872825,544,Seems like our heads are in the same place.
1510,1,3,40,44,1.1136363636363635,0.05830506897872825,544,"Well, I'm a left brain and you're a right brain, for starters."
1510,1,3,40,44,1.1136363636363635,0.05830506897872825,544,left brain - right brain executive functions smack down
1510,1,3,40,44,1.1136363636363635,0.05830506897872825,544,"Let's face it, Frank, this workload is heady stuff."
1510,0,5,39,44,1.1136363636363635,0.048398332783092544,544,Two heads don't seem to be any better than one at solving our diversity problem.
1510,0,5,39,44,1.1136363636363635,0.048398332783092544,544,It'll be so much easier once they finally move to standing desks.
1510,1,3,40,44,1.1136363636363635,0.05830506897872825,544,I'm sorry my guy stole your guy's pencil holder.
1510,2,1,41,44,1.1136363636363635,0.06675749786387705,544,Not too long ago having your head in the cloud was a bad thing.
1510,1,3,40,44,1.1136363636363635,0.05830506897872825,544,We're never going to get through all these emails are we?
1510,1,3,40,44,1.1136363636363635,0.05830506897872825,544,There goes that strange tapping noise again.
1510,1,3,40,44,1.1136363636363635,0.05830506897872825,544,Off the top of my head I think this is pretty weird
1510,2,1,41,44,1.1136363636363635,0.06675749786387705,544,Do we name them?
1510,1,3,40,44,1.1136363636363635,0.05830506897872825,544,They'll never say we don't have much upstairs anymore!
1510,2,1,41,44,1.1136363636363635,0.06675749786387705,544,Did you see that cool new New Yorker cartoon caption contest?
1510,2,1,41,44,1.1136363636363635,0.06675749786387705,544,Exactly. Getting a smartphone was the dumbest thing I ever did.
1510,1,3,40,44,1.1136363636363635,0.05830506897872825,544,I feel we're getting ahead of ourselves here.
1510,0,5,39,44,1.1136363636363635,0.048398332783092544,544,"I had no idea this is what they meant by ""work/life balance."""
1510,0,5,39,44,1.1136363636363635,0.048398332783092544,544,Great minds think alike.
1510,1,3,40,44,1.1136363636363635,0.05830506897872825,544,I think we're on the same page.
1510,1,3,40,44,1.1136363636363635,0.05830506897872825,544,"Just a sec, I'm still loading."
1510,0,5,39,44,1.1136363636363635,0.048398332783092544,544,My guy won't work weekends unless I offer stock options.
1510,1,3,40,44,1.1136363636363635,0.05830506897872825,544,I always have work on my mind.
1510,1,3,40,44,1.1136363636363635,0.05830506897872825,544,Need a pencil?
1510,1,3,40,44,1.1136363636363635,0.05830506897872825,544,Glad to meet a fellow appreciator of skeumorphic design.
1510,1,3,40,44,1.1136363636363635,0.05830506897872825,544,Headtops are the wave of the future.
1510,1,3,40,44,1.1136363636363635,0.05830506897872825,544,Now mine wants a standing desk.
1510,0,5,39,44,1.1136363636363635,0.048398332783092544,544,"Yikes, I did not anticipate actual human interaction. Let me Google how to do this."
1510,0,5,39,44,1.1136363636363635,0.048398332783092544,544,I wouldn't mind so much if he wasn't just spending all day on Facebook!
1510,1,3,40,44,1.1136363636363635,0.05830506897872825,544,"Just rinse, lather and reboot."
1510,2,1,41,44,1.1136363636363635,0.06675749786387705,544,"I feel I'm being manipulated..., Me too."
1510,1,3,40,44,1.1136363636363635,0.05830506897872825,544,I can't seem to get work off my mind either.
1510,0,5,39,44,1.1136363636363635,0.048398332783092544,544,You wouldn't by any chance be adopted?
1510,0,5,39,44,1.1136363636363635,0.048398332783092544,544,We need to quit playing these head games.
1510,1,3,40,44,1.1136363636363635,0.05830506897872825,544,Forget about Google Glass and the Apple Watch. Executive Hat has it all!
1510,0,5,39,44,1.1136363636363635,0.048398332783092544,544,I think I know what's on your mind.
1510,1,3,40,44,1.1136363636363635,0.05830506897872825,544,Tetris all day long.
1510,1,3,40,44,1.1136363636363635,0.05830506897872825,544,Let me check with my head office and get back to you.
1510,0,5,39,44,1.1136363636363635,0.048398332783092544,544,"Buzzfeed wants us for their ""Can you spot the differences?"" quiz."
1510,1,3,40,44,1.1136363636363635,0.05830506897872825,544,"Well, my guy has pencils, so I win!"
1510,2,1,41,44,1.1136363636363635,0.06675749786387705,544,To get ahead you need a desk job!
1510,1,3,40,44,1.1136363636363635,0.05830506897872825,544,The corporate consciousness in me honors the corporate consciousness in you.
1510,2,1,41,44,1.1136363636363635,0.06675749786387705,544,My brain’s been hacked!
1510,1,3,40,44,1.1136363636363635,0.05830506897872825,544,"So, what's on your mind?"
1510,1,3,40,44,1.1136363636363635,0.05830506897872825,544,"Well, ONE of us is going to have to change!"
1510,1,3,40,44,1.1136363636363635,0.05830506897872825,544,"Tell me, Greg, where do you see yourself in ten years?"
1510,0,5,39,44,1.1136363636363635,0.048398332783092544,544,Not quite the 'desk set' I had in mind.
1510,1,3,40,44,1.1136363636363635,0.05830506897872825,544,I just got the new one with mood control.
1510,1,3,40,44,1.1136363636363635,0.05830506897872825,544,"Since he started texting, I can't hear myself think."
1510,0,5,39,44,1.1136363636363635,0.048398332783092544,544,See if you can guess what I'm leaking.
1510,1,3,40,44,1.1136363636363635,0.05830506897872825,544,This way I can limit my conversations to 140 characters.
1510,0,5,39,44,1.1136363636363635,0.048398332783092544,544,I told you not to let the work go to your head
1510,1,3,40,44,1.1136363636363635,0.05830506897872825,544,"Huh, same barber"
1510,2,1,41,44,1.1136363636363635,0.06675749786387705,544,This mobility thing isn't what it's cracked up to be.
1510,2,1,41,44,1.1136363636363635,0.06675749786387705,544,It's nice to meet someone else who has a good head for business.
1510,1,3,40,44,1.1136363636363635,0.05830506897872825,544,Read my quips.
1510,0,5,39,44,1.1136363636363635,0.048398332783092544,544,Do you PC what I PC?
1510,1,3,40,44,1.1136363636363635,0.05830506897872825,544,This heavy workload's a pain in the neck.
1510,0,5,39,44,1.1136363636363635,0.048398332783092544,544,Really? Something's been weighing on my mind too.
1510,0,5,39,44,1.1136363636363635,0.048398332783092544,544,Where do you think they plug in their cords?
1510,1,3,40,44,1.1136363636363635,0.05830506897872825,544,We're downsizing.
1510,1,3,40,44,1.1136363636363635,0.05830506897872825,544,Let's put our office heads together on this.
1510,1,3,40,44,1.1136363636363635,0.05830506897872825,544,So... it has come to this.
1510,1,3,40,44,1.1136363636363635,0.05830506897872825,544,Why didn't God think of this?
1510,1,3,40,44,1.1136363636363635,0.05830506897872825,544,"No, YOU'RE the one who's got it backwards."
1510,0,5,39,44,1.1136363636363635,0.048398332783092544,544,I used to be a left brain person
1510,2,1,41,44,1.1136363636363635,0.06675749786387705,544,You convinced me to try the whole standing desk thing.
1510,0,5,39,44,1.1136363636363635,0.048398332783092544,544,Great minds think alike.
1510,0,5,39,44,1.1136363636363635,0.048398332783092544,544,Your fly is open
1510,1,3,40,44,1.1136363636363635,0.05830506897872825,544,If we lose this contract it's all on your head.
1510,0,5,39,44,1.1136363636363635,0.048398332783092544,544,We're in over our heads.
1510,1,3,40,44,1.1136363636363635,0.05830506897872825,544,"Now I get the air quotes when they asked us if we were ready for ""head"" office."
1510,1,3,40,44,1.1136363636363635,0.05830506897872825,544,This micro managing has got to end soon.
1510,1,3,40,44,1.1136363636363635,0.05830506897872825,544,What's on your mind's mind?
1510,2,1,41,44,1.1136363636363635,0.06675749786387705,544,I imagine you're also having a hard time wrapping your head around this.
1510,0,5,39,44,1.1136363636363635,0.048398332783092544,544,I'm thinking of switching to a fedora.
1510,0,5,39,44,1.1136363636363635,0.048398332783092544,544,Can you send me the dial-in for our meeting of the minds?
1510,1,3,40,44,1.1136363636363635,0.05830506897872825,544,So how many hats do you wear?
1510,0,5,39,44,1.1136363636363635,0.048398332783092544,544,Two heads are better than one head. What's that supposed to mean?
1510,1,3,40,44,1.1136363636363635,0.05830506897872825,544,I like that it covers my bald spot.
1510,0,5,39,44,1.1136363636363635,0.048398332783092544,544,His work is over my head.
1510,1,3,40,44,1.1136363636363635,0.05830506897872825,544,I see you can't get work off your mind either.
1510,1,3,40,44,1.1136363636363635,0.05830506897872825,544,Do you think we are letting our work get on top of us?
1510,2,1,41,44,1.1136363636363635,0.06675749786387705,544,None of the other planets had ANY hats.
1510,0,5,39,44,1.1136363636363635,0.048398332783092544,544,"So, we do overhead cost projection the same way."
1510,0,5,39,44,1.1136363636363635,0.048398332783092544,544,How the outsourcing going for you?
1510,0,5,39,44,1.1136363636363635,0.048398332783092544,544,I feel like I'm suddenly free to be the accountant I've always wanted to be.
1510,1,3,40,44,1.1136363636363635,0.05830506897872825,544,I can tell your office overhead is too high too.
1510,1,3,40,44,1.1136363636363635,0.05830506897872825,544,So much for thinking outside the box.
1510,2,1,41,44,1.1136363636363635,0.06675749786387705,544,What does he do without pencils?
1510,0,5,39,44,1.1136363636363635,0.048398332783092544,544,I'm calling it Work-Life Balance.
1510,1,3,40,44,1.1136363636363635,0.05830506897872825,544,Get a life.
1510,0,5,39,44,1.1136363636363635,0.048398332783092544,544,Do you hear a tapping sound?
1510,0,5,39,44,1.1136363636363635,0.048398332783092544,544,There's a reason these hats are on sale.
1510,1,3,40,44,1.1136363636363635,0.05830506897872825,544,You think we have it bad? My friend Stanley is Hillary Clinton's server.
1510,0,5,39,44,1.1136363636363635,0.048398332783092544,544,"Hang on, I'm working remotely."
1510,1,3,40,44,1.1136363636363635,0.05830506897872825,544,"No, thank God, my guy is NOT a foot jiggler."
1510,2,1,41,44,1.1136363636363635,0.06675749786387705,544,We should put our heads together. We will save money on rent.
1510,1,3,40,44,1.1136363636363635,0.05830506897872825,544,Remember when smartphones were our only personal assistants?
1510,1,3,40,44,1.1136363636363635,0.05830506897872825,544,Looks like we both have a lot on our mind...
1510,1,3,40,44,1.1136363636363635,0.05830506897872825,544,He's been video chatting with Dorothy in my pocket.
1510,1,3,40,44,1.1136363636363635,0.05830506897872825,544,I'm sure glad I don't have your job!
1510,1,3,40,44,1.1136363636363635,0.05830506897872825,544,Your problem is bed head. Pull up the covers and keep dreaming.
1510,2,1,41,44,1.1136363636363635,0.06675749786387705,544,"Administrators from the Twin Cities, ""love you Bro""."
1510,1,3,40,44,1.1136363636363635,0.05830506897872825,544,Look at it this way-- we're helping them get ahead.
1510,1,3,40,44,1.1136363636363635,0.05830506897872825,544,I'll have my people talk with your people.
1510,1,3,40,44,1.1136363636363635,0.05830506897872825,544,"He flattens my hair, but it's worth having a fact-checker at all times."
1510,0,5,39,44,1.1136363636363635,0.048398332783092544,544,They say version 2.0 is going to be slimmer and better looking.
1731,1,3,41,45,1.1111111111111112,0.057050590894718936,544,I forgive you. We both have a lot on our minds.
1731,2,1,42,45,1.1111111111111112,0.06530597929391763,544,It doesn't seem like we're really connecting.
1731,2,1,42,45,1.1111111111111112,0.06530597929391763,544,I think I can account for our headaches.
1731,1,3,41,45,1.1111111111111112,0.057050590894718936,544,"I don't know about you, but I can't get this clicking noise out of my head."""
1731,0,5,40,45,1.1111111111111112,0.047377936967913425,544,Surprisingly I don't regret downloading the newest Microsoft Office Suite. Showering on the other hand has been and uncomfortable subject for both of us.
1731,0,5,40,45,1.1111111111111112,0.047377936967913425,544,I don't know. I think they kind of suit us.
1731,0,5,40,45,1.1111111111111112,0.047377936967913425,544,"It's sales, Wayne, not brain surgery."
1731,1,3,41,45,1.1111111111111112,0.057050590894718936,544,All they seem to talk about is getting a head.
1731,2,1,42,45,1.1111111111111112,0.06530597929391763,544,I need to upgrade my i Clone App.
1731,0,5,40,45,1.1111111111111112,0.047377936967913425,544,"Please don't be insulted, but did you realize you have a tiny man sitting at a desk on top of your head?"
1731,0,5,40,45,1.1111111111111112,0.047377936967913425,544,I think we're on the same page.
1731,1,3,41,45,1.1111111111111112,0.057050590894718936,544,The company's taken downsizing too far.
1743,0,4,38,42,1.0952380952380953,0.045843796413450766,544,They told me this job will be above my head.
1743,1,2,39,42,1.0952380952380953,0.057123496526633864,544,You feel like your bringing your work home with you
1743,1,2,39,42,1.0952380952380953,0.057123496526633864,544,I think we're both totally over our heads at work right now.
1743,2,0,40,42,1.0952380952380953,0.06651717102567413,544,I used to think I was the only one in this office who had a conscience.
1743,1,2,39,42,1.0952380952380953,0.057123496526633864,544,At least they're male advisors Gulliver. Those 4 inch stilettos hurt like hell.
1743,1,2,39,42,1.0952380952380953,0.057123496526633864,544,Your mind-desk isn't as cluttered as mine. Maybe it's all the kale?
1743,1,2,39,42,1.0952380952380953,0.057123496526633864,544,I'll check with my somebody and see if he concurs.
1743,1,2,39,42,1.0952380952380953,0.057123496526633864,544,"""I've come to join you at head office""."
1743,0,4,38,42,1.0952380952380953,0.045843796413450766,544,I long for the Reagan era when everyone thought it was super sexy to have a head for business.
1743,0,4,38,42,1.0952380952380953,0.045843796413450766,544,Where did he say he was installing the modem?!?
1743,1,2,39,42,1.0952380952380953,0.057123496526633864,544,"Lunch? Fine, have your person call my person."
1743,1,2,39,42,1.0952380952380953,0.057123496526633864,544,its funny you said that. he has been on my mind since i left the office.
1743,2,0,40,42,1.0952380952380953,0.06651717102567413,544,It's too much for senior management: they're in over our heads.
1743,1,2,39,42,1.0952380952380953,0.057123496526633864,544,"I can't seem to get work off of mind, either."
1743,0,4,38,42,1.0952380952380953,0.045843796413450766,544,"Next time buy from Party City, not Office Depot."
1743,1,2,39,42,1.0952380952380953,0.057123496526633864,544,It looks like we're both working on Executive Function.
1743,0,4,38,42,1.0952380952380953,0.045843796413450766,544,"If you don't like being micromanaged, maybe this isn't the job for you."
1743,1,2,39,42,1.0952380952380953,0.057123496526633864,544,Tax time--what a pain in the neck.
1743,0,4,38,42,1.0952380952380953,0.045843796413450766,544,Care to share any thoughts on managing your overhead?
1743,0,4,38,42,1.0952380952380953,0.045843796413450766,544,Damn these micromanagers.
1743,1,2,39,42,1.0952380952380953,0.057123496526633864,544,Lunch next week? Have your hat call my hat.
1743,2,0,40,42,1.0952380952380953,0.06651717102567413,544,I was so hoping that Google Hats wouldn't become a thing.
1743,1,2,39,42,1.0952380952380953,0.057123496526633864,544,Forehead break in five?
1743,2,0,40,42,1.0952380952380953,0.06651717102567413,544,I thought these virtual reality lenses were to show our secret fantasies.
1743,1,2,39,42,1.0952380952380953,0.057123496526633864,544,"If Comey finds this one, it'll be our heads!"
1743,0,4,38,42,1.0952380952380953,0.045843796413450766,544,Microsoft promised to be sleeker on the upgrade
1743,0,4,38,42,1.0952380952380953,0.045843796413450766,544,"I would have gone for the whole cubicle, but this is more manageable."
1743,1,2,39,42,1.0952380952380953,0.057123496526633864,544,And to think that I was excited when HQ said we were getting the latest in wearables.
1743,1,2,39,42,1.0952380952380953,0.057123496526633864,544,"My guy keeps looking at porn sites, which is very distracting."
1743,0,4,38,42,1.0952380952380953,0.045843796413450766,544,"..,the told me it was one of a kind..."
1743,0,4,38,42,1.0952380952380953,0.045843796413450766,544,"So, the boss asked you if you were 'level headed' too I see."
1743,1,2,39,42,1.0952380952380953,0.057123496526633864,544,We stash all our undocumented workers in the subconscious.
1743,1,2,39,42,1.0952380952380953,0.057123496526633864,544,I'm still not used to this headware upgrade.
1743,1,2,39,42,1.0952380952380953,0.057123496526633864,544,I see you too are over your head with this e-mail thing!
1743,1,2,39,42,1.0952380952380953,0.057123496526633864,544,I don't know about you but I'm getting tired of carrying the guys from the head office.
1743,1,2,39,42,1.0952380952380953,0.057123496526633864,544,"No thanks, I also got a guy for that."
1743,2,0,40,42,1.0952380952380953,0.06651717102567413,544,Google watch was more stylish than Google hat.
1743,0,4,38,42,1.0952380952380953,0.045843796413450766,544,I like who I am so much more online than live
1743,0,4,38,42,1.0952380952380953,0.045843796413450766,544,Just having a lawyer on retainer wasn't good enough.
1743,0,4,38,42,1.0952380952380953,0.045843796413450766,544,Not much happening at headquarters today
1743,0,4,38,42,1.0952380952380953,0.045843796413450766,544,I'm sensing you need to borrow a pencil.
1743,0,4,38,42,1.0952380952380953,0.045843796413450766,544,I just can't get work off my mind. How about you?
1743,0,4,38,42,1.0952380952380953,0.045843796413450766,544,"Work has become such a balancing act for me, how about you?"
1743,1,2,39,42,1.0952380952380953,0.057123496526633864,544,I don't know why people make such a big deal over identical twins.
1743,0,4,38,42,1.0952380952380953,0.045843796413450766,544,I've changed my mind - we go for the 'buy one - get one free' burrito special
1743,0,4,38,42,1.0952380952380953,0.045843796413450766,544,I know a work-a-holic when I see one.
1743,0,4,38,42,1.0952380952380953,0.045843796413450766,544,Two can play that game...
1743,1,2,39,42,1.0952380952380953,0.057123496526633864,544,My Destroyer takes out your battleship. Your move now.
1743,1,2,39,42,1.0952380952380953,0.057123496526633864,544,"It's not just inside our heads, right?"
1743,1,2,39,42,1.0952380952380953,0.057123496526633864,544,"That's funny; I've got work on my mind, too."
1743,2,0,40,42,1.0952380952380953,0.06651717102567413,544,"For security purposes, Barry wants me to tell you to tell Hank not to email him any more."
1743,1,2,39,42,1.0952380952380953,0.057123496526633864,544,Work's on my mind... you?
1743,1,2,39,42,1.0952380952380953,0.057123496526633864,544,I've put in a ticket.
1743,0,4,38,42,1.0952380952380953,0.045843796413450766,544,Looks we both used that Great Clicks salon coupon
1743,1,2,39,42,1.0952380952380953,0.057123496526633864,544,"I knew your slogan, 'Don't leave home without it.' , would come back to bite us in the ass."
1743,1,2,39,42,1.0952380952380953,0.057123496526633864,544,Enough with the damn emails.
1743,1,2,39,42,1.0952380952380953,0.057123496526633864,544,Have you ever had the urge to drop off the grid?
1743,1,2,39,42,1.0952380952380953,0.057123496526633864,544,What ever happened to cublicles?
1743,1,2,39,42,1.0952380952380953,0.057123496526633864,544,"I, too, find our lack of nostrils distressing."
1743,0,4,38,42,1.0952380952380953,0.045843796413450766,544,The newest version doesn't require hairclips.
1743,0,4,38,42,1.0952380952380953,0.045843796413450766,544,I find their micromanagement highly overrated.
1743,0,4,38,42,1.0952380952380953,0.045843796413450766,544,So... this is evolution?
1743,1,2,39,42,1.0952380952380953,0.057123496526633864,544,I'd love to know how they managed to get ahead in this business.
1743,1,2,39,42,1.0952380952380953,0.057123496526633864,544,How else are they going to get a head?
1743,0,4,38,42,1.0952380952380953,0.045843796413450766,544,I just asked for a little off the top too!
1743,0,4,38,42,1.0952380952380953,0.045843796413450766,544,I miss my inner-child
1743,0,4,38,42,1.0952380952380953,0.045843796413450766,544,It beats having to be in a cubical all day.
1743,0,4,38,42,1.0952380952380953,0.045843796413450766,544,Either you have a head for work or you have work in your head
1743,0,4,38,42,1.0952380952380953,0.045843796413450766,544,I told you we shouldn't have went to that doctor in Mexico for a baldness cure.
1743,1,2,39,42,1.0952380952380953,0.057123496526633864,544,Do you ever get the feeling that we are not in control any more?
1743,0,4,38,42,1.0952380952380953,0.045843796413450766,544,After the Great Beanstock collapse Jack started his own head office.
1743,0,4,38,42,1.0952380952380953,0.045843796413450766,544,I'm ahead of you.
1743,0,4,38,42,1.0952380952380953,0.045843796413450766,544,I've had it up to here with the head guy. I'm gonna tell him that I'm no longer bending over for nobody.
1743,1,2,39,42,1.0952380952380953,0.057123496526633864,544,We need a new haircut. The desktop is so passé
1743,2,0,40,42,1.0952380952380953,0.06651717102567413,544,Management is really riding us.
1743,0,4,38,42,1.0952380952380953,0.045843796413450766,544,They say the government drones could be listening to our every word.
1743,1,2,39,42,1.0952380952380953,0.057123496526633864,544,"What did YOU think he meant when he said ""Hair Plugs?"""
1743,0,4,38,42,1.0952380952380953,0.045843796413450766,544,"It was buy one, get one free."
1743,0,4,38,42,1.0952380952380953,0.045843796413450766,544,I've been looking for someone just like me!
1743,1,2,39,42,1.0952380952380953,0.057123496526633864,544,We're gonna give those African American church ladies some competition.
1743,1,2,39,42,1.0952380952380953,0.057123496526633864,544,My best thoughts are off the top of my head.
1743,1,2,39,42,1.0952380952380953,0.057123496526633864,544,"Oh, so you can't get work out of your head either?"
1743,1,2,39,42,1.0952380952380953,0.057123496526633864,544,My executive function can beat up your executive function.
1743,1,2,39,42,1.0952380952380953,0.057123496526633864,544,I needed the extra memory option. How about you?
1743,0,4,38,42,1.0952380952380953,0.045843796413450766,544,"I am the head of a Giant corporation, what's your excuse?"
1743,1,2,39,42,1.0952380952380953,0.057123496526633864,544,Yes I often take my work home with me and you?
1743,0,4,38,42,1.0952380952380953,0.045843796413450766,544,I have good work/life balance until he gets up to use the bathroom.
1743,0,4,38,42,1.0952380952380953,0.045843796413450766,544,I'm so tired of bringing the office home with me.
1743,1,2,39,42,1.0952380952380953,0.057123496526633864,544,"I see you've got work on the brain, too!"
1743,1,2,39,42,1.0952380952380953,0.057123496526633864,544,"'Copycat!"""
1743,1,2,39,42,1.0952380952380953,0.057123496526633864,544,This wearables thing may have gotten out of hand.
1743,1,2,39,42,1.0952380952380953,0.057123496526633864,544,He is afraid that I may have to take a haircut.
1743,1,2,39,42,1.0952380952380953,0.057123496526633864,544,I can see both of us are elsewhere right now...
1743,1,2,39,42,1.0952380952380953,0.057123496526633864,544,Darn. I always thought mine was bigger than yours.
1743,2,0,40,42,1.0952380952380953,0.06651717102567413,544,They are a bit heavier but the battery life is excellent
1743,1,2,39,42,1.0952380952380953,0.057123496526633864,544,I can't get anything done since he found Pokemons in my cerebellum.
1743,1,2,39,42,1.0952380952380953,0.057123496526633864,544,That was the doctor calling. It's worse than lice--we've got funeral and burial expenses insurance salesmen.
1743,1,2,39,42,1.0952380952380953,0.057123496526633864,544,"I can't seem to get work out of my head, either."
1743,1,2,39,42,1.0952380952380953,0.057123496526633864,544,My business decisions are also weighing heavily on my min
1743,1,2,39,42,1.0952380952380953,0.057123496526633864,544,Sometimes it seems my life is too complicated.
1743,1,2,39,42,1.0952380952380953,0.057123496526633864,544,Mine's a Herman Miller’s Airia Hyperdesk
1743,0,4,38,42,1.0952380952380953,0.045843796413450766,544,Do you think we are being to literal about increasing our executive functioning?
1743,0,4,38,42,1.0952380952380953,0.045843796413450766,544,Looks like you can't get work off your mind either.
1743,1,2,39,42,1.0952380952380953,0.057123496526633864,544,I know what you mean. Being an accountant can really weigh on you.
1743,2,0,40,42,1.0952380952380953,0.06651717102567413,544,Don't even think about it.
1743,1,2,39,42,1.0952380952380953,0.057123496526633864,544,"""I'm a firm believer in mental stimulation and cerebral balance."
1743,0,4,38,42,1.0952380952380953,0.045843796413450766,544,Is this what they call Work-Life Balance?
1743,1,2,39,42,1.0952380952380953,0.057123496526633864,544,"Can we talk, the server is down?"
1743,0,4,38,42,1.0952380952380953,0.045843796413450766,544,I've focused him on filtering out my classified thoughts.
1743,0,4,38,42,1.0952380952380953,0.045843796413450766,544,"My little businessman's name is Fred Spanky, and he ruins the lives of elderly widows."
1743,1,2,39,42,1.0952380952380953,0.057123496526633864,544,That's the last time I take your advice about keeping something top of mind.
1743,0,4,38,42,1.0952380952380953,0.045843796413450766,544,I get the feeling I'm in over my head.
1743,1,2,39,42,1.0952380952380953,0.057123496526633864,544,"There, do you hear a clicking noise?"
1743,1,2,39,42,1.0952380952380953,0.057123496526633864,544,"my guy is on it right now so, I'll have him send it to your guy just as soon as I get through thinking that through."
1743,1,2,39,42,1.0952380952380953,0.057123496526633864,544,It's a good thing we have a head for business
1743,0,4,38,42,1.0952380952380953,0.045843796413450766,544,I told my barber I want my haircut short on the sides with a desk on top.
1743,0,4,38,42,1.0952380952380953,0.045843796413450766,544,Why won't you friend me?
1743,1,2,39,42,1.0952380952380953,0.057123496526633864,544,So it turns out 'Head of the Company' isn't quite the promotion I expected.
1743,1,2,39,42,1.0952380952380953,0.057123496526633864,544,Your head office is ignoring my head office.
1743,1,2,39,42,1.0952380952380953,0.057123496526633864,544,Did you hear back from the head office?
1743,0,4,38,42,1.0952380952380953,0.045843796413450766,544,He wants a standing desk.
1743,0,4,38,42,1.0952380952380953,0.045843796413450766,544,"I hate these open plan offices, too."
1743,1,2,39,42,1.0952380952380953,0.057123496526633864,544,United we stand - Divided we disconnect.
1743,1,2,39,42,1.0952380952380953,0.057123496526633864,544,My little man on a little computer can beat your man on a little computer up.
1743,1,2,39,42,1.0952380952380953,0.057123496526633864,544,Desk duty's a real headache.
1743,1,2,39,42,1.0952380952380953,0.057123496526633864,544,Ever wonder why we're such good company men?
1743,1,2,39,42,1.0952380952380953,0.057123496526633864,544,Do you need a pencil?
1743,2,0,40,42,1.0952380952380953,0.06651717102567413,544,"Have your people call my people, and we’ll do lunch."
1743,1,2,39,42,1.0952380952380953,0.057123496526633864,544,I feel like I'm in over my head.
1743,1,2,39,42,1.0952380952380953,0.057123496526633864,544,My brainchild can outwork your brainchild!
1743,1,2,39,42,1.0952380952380953,0.057123496526633864,544,I find he's far more productive when I've had coffee.
1743,0,4,38,42,1.0952380952380953,0.045843796413450766,544,I can't get work off my mind either. It's time for a vacation.
1743,1,2,39,42,1.0952380952380953,0.057123496526633864,544,I'm starting to get a little tired of us being Siamese twins.
1743,0,4,38,42,1.0952380952380953,0.045843796413450766,544,The voice on my head told me to do it.
1743,1,2,39,42,1.0952380952380953,0.057123496526633864,544,"In tech age, you can't ever get away from the office."
1743,0,4,38,42,1.0952380952380953,0.045843796413450766,544,These personal fact checkers are great.
1743,1,2,39,42,1.0952380952380953,0.057123496526633864,544,"The worst part is, he's still using AOL."
1743,0,4,38,42,1.0952380952380953,0.045843796413450766,544,I can’t get work off my mind.
1743,0,4,38,42,1.0952380952380953,0.045843796413450766,544,I think we're over thinking this.
1743,2,0,40,42,1.0952380952380953,0.06651717102567413,544,"Man, is this company ever going to go with business casual?"
1743,0,4,38,42,1.0952380952380953,0.045843796413450766,544,I'm not sure this is an upgrade.
1743,0,4,38,42,1.0952380952380953,0.045843796413450766,544,"The only way we can be sure of differentiating ourselves from each other is to retweet our hashtags at predetermined alternate scandalized moments, preliminary to any agreed upon pre-hacking."
1743,1,2,39,42,1.0952380952380953,0.057123496526633864,544,"Doc said it was a two for one, combination electronic haircut and non-invasive brain surgery"
1743,0,4,38,42,1.0952380952380953,0.045843796413450766,544,"So, we've finally been outsourced, huh?"
1743,1,2,39,42,1.0952380952380953,0.057123496526633864,544,These next-stage wearables are starting to get cumbersome.
1743,0,4,38,42,1.0952380952380953,0.045843796413450766,544,Can I borrow a pen?
1743,1,2,39,42,1.0952380952380953,0.057123496526633864,544,I'll have my person contact your person.
1743,1,2,39,42,1.0952380952380953,0.057123496526633864,544,"These head-top computers are just fine, but I don't like my avatar."
1743,1,2,39,42,1.0952380952380953,0.057123496526633864,544,All shoulder angels fired
1743,1,2,39,42,1.0952380952380953,0.057123496526633864,544,My head is a mess.
1743,0,4,38,42,1.0952380952380953,0.045843796413450766,544,"My new employee? Pain in the neck, really."
1743,1,2,39,42,1.0952380952380953,0.057123496526633864,544,"Yep, I'll have to check with my hacker first."
1743,2,0,40,42,1.0952380952380953,0.06651717102567413,544,"I am relevant, I am relevant..."
1743,0,4,38,42,1.0952380952380953,0.045843796413450766,544,"They say it's from staring at the screen too long, but I'm beginning to think they don't know what it is!"
1743,0,4,38,42,1.0952380952380953,0.045843796413450766,544,I think we've both got the same thing on our minds.
1743,1,2,39,42,1.0952380952380953,0.057123496526633864,544,Let's have a one-on-one about the increase in overhead.
1743,0,4,38,42,1.0952380952380953,0.045843796413450766,544,Mine's a Mac person.
1743,0,4,38,42,1.0952380952380953,0.045843796413450766,544,Have you heard anything from the head office?
1743,1,2,39,42,1.0952380952380953,0.057123496526633864,544,It irks me that everyone always assumes we're identical twins.
1743,0,4,38,42,1.0952380952380953,0.045843796413450766,544,I don't understand; my wife complains that all I ever think about is work.
1743,1,2,39,42,1.0952380952380953,0.057123496526633864,544,The voices in my head have started e-mailing me instead.
1743,1,2,39,42,1.0952380952380953,0.057123496526633864,544,We should finish our meeting soon. I just received an instant message to take an urgent bathroom break.
1743,1,2,39,42,1.0952380952380953,0.057123496526633864,544,"Yes, I'm an office-bearer, too."
1743,1,2,39,42,1.0952380952380953,0.057123496526633864,544,Mine is actually smarter than Siri.
1743,0,4,38,42,1.0952380952380953,0.045843796413450766,544,I find it gives 'off the top of my head' answers more credibility. You?
1743,0,4,38,42,1.0952380952380953,0.045843796413450766,544,I get the sense that work weighs heavily on your mind.
1743,1,2,39,42,1.0952380952380953,0.057123496526633864,544,Do you ever feel like you can't get work off your mind?
1743,0,4,38,42,1.0952380952380953,0.045843796413450766,544,I see we use the same barber.
1743,0,4,38,42,1.0952380952380953,0.045843796413450766,544,It sure is a head-scratcher.
1743,1,2,39,42,1.0952380952380953,0.057123496526633864,544,Once we've finished inputting their programming we become obsolete.
1743,2,0,40,42,1.0952380952380953,0.06651717102567413,544,There's just got to be a better way.
1743,0,4,38,42,1.0952380952380953,0.045843796413450766,544,What's on your mind?
1743,1,2,39,42,1.0952380952380953,0.057123496526633864,544,I always wait for the little man in the desk on top of me to write me a memo when confronted with difficult decisions.
1743,0,4,38,42,1.0952380952380953,0.045843796413450766,544,Imagine what would happen them if we sneeze.
1743,1,2,39,42,1.0952380952380953,0.057123496526633864,544,Have the little man in the suit and tie sitting at the small desk on top of your head call the little man in the suit and tie sitting at the small desk on top of my head to schedule an appointment.
1743,0,4,38,42,1.0952380952380953,0.045843796413450766,544,The Lewinsky brothers always wondered what it would be like to be above the desk.
1743,0,4,38,42,1.0952380952380953,0.045843796413450766,544,My shrink says that I need to learn to leave work at work.
1743,1,2,39,42,1.0952380952380953,0.057123496526633864,544,I'd be happier with the bod for sin.
1743,1,2,39,42,1.0952380952380953,0.057123496526633864,544,"Why yes, I probably do think about work more than I should...why do you ask?"
1743,1,2,39,42,1.0952380952380953,0.057123496526633864,544,The only problem with these is you can't think outside the box.
1743,2,0,40,42,1.0952380952380953,0.06651717102567413,544,"I was a philosophy major, so what the hell."
1743,1,2,39,42,1.0952380952380953,0.057123496526633864,544,When you're on vacation with your family but you see a friend from work.
1743,0,4,38,42,1.0952380952380953,0.045843796413450766,544,It's called virtual reality!
1743,0,4,38,42,1.0952380952380953,0.045843796413450766,544,We've got a heads-up on cyber security.
1743,0,4,38,42,1.0952380952380953,0.045843796413450766,544,"The 2017 models will come in your choice of age, gender, race, and ethnicity."
1743,0,4,38,42,1.0952380952380953,0.045843796413450766,544,I wish management would get out of our hair.
1743,0,4,38,42,1.0952380952380953,0.045843796413450766,544,My work is weighing on me. How about you?
1743,0,4,38,42,1.0952380952380953,0.045843796413450766,544,When out of the office Phil and Fred had trouble taking off their work hats.
1743,1,2,39,42,1.0952380952380953,0.057123496526633864,544,The new Apple Virtual office is a little cumbersome.
1743,1,2,39,42,1.0952380952380953,0.057123496526633864,544,"""I can't get the song out of my head either...work work work work""."
1743,2,0,40,42,1.0952380952380953,0.06651717102567413,544,"Sorry, but I only ""Sorry, but I can't take a chance on the Russians hacking my emails. Do you ever phone?"
1743,0,4,38,42,1.0952380952380953,0.045843796413450766,544,"I was just thinking, could I borrow a pencil?"
1743,1,2,39,42,1.0952380952380953,0.057123496526633864,544,Just because we're twins doesn't mean we have to dress alike.
1743,1,2,39,42,1.0952380952380953,0.057123496526633864,544,I see you read the latest book on How to Get A-head!
1743,1,2,39,42,1.0952380952380953,0.057123496526633864,544,We're going to need a bigger newspaper.
1743,0,4,38,42,1.0952380952380953,0.045843796413450766,544,"With a good connection, we'll work."
1743,1,2,39,42,1.0952380952380953,0.057123496526633864,544,Now he keeps bugging me about getting a faster brain.
1743,1,2,39,42,1.0952380952380953,0.057123496526633864,544,I see you are also an early adopter of the Google Brain.
1743,1,2,39,42,1.0952380952380953,0.057123496526633864,544,Bob and Tom quickly learn the future of wearable technology will not be in the form of micro-management hats.
1743,0,4,38,42,1.0952380952380953,0.045843796413450766,544,"I'm telling you, these are gonna fall off as soon as we start our backswing."
1743,0,4,38,42,1.0952380952380953,0.045843796413450766,544,And feng shui to you.
1743,1,2,39,42,1.0952380952380953,0.057123496526633864,544,Are you sure this is what it means to dress for the job you want?
1743,0,4,38,42,1.0952380952380953,0.045843796413450766,544,Does this upgrade increase thinking speed or just memory?
1743,0,4,38,42,1.0952380952380953,0.045843796413450766,544,"It's tax season, so I've had a lot on my mind, too."
1743,1,2,39,42,1.0952380952380953,0.057123496526633864,544,Don't you just hate it when you have to bring work home
1743,2,0,40,42,1.0952380952380953,0.06651717102567413,544,Maybe we adopted these brain enhancement implants too early.
1743,2,0,40,42,1.0952380952380953,0.06651717102567413,544,The micromanaging around here has really gotten out of control.
1743,0,4,38,42,1.0952380952380953,0.045843796413450766,544,"Darn, meant to delete not copy."
1743,1,2,39,42,1.0952380952380953,0.057123496526633864,544,It's nice to meet someone else with an overdeveloped executive function.
1743,0,4,38,42,1.0952380952380953,0.045843796413450766,544,"I don't know about you, but I'm tired of having business constantly on my mind!"
1743,0,4,38,42,1.0952380952380953,0.045843796413450766,544,My desk is bigger than yours.
1743,1,2,39,42,1.0952380952380953,0.057123496526633864,544,Still don't believe in evolution?
1743,1,2,39,42,1.0952380952380953,0.057123496526633864,544,"If we keep wearing these labor union protest hats to make grandiose Grecian parallels, forget Atlas, we'll be jobless."
1743,0,4,38,42,1.0952380952380953,0.045843796413450766,544,I have mixed feelings about this latest round of downsizing.
1743,1,2,39,42,1.0952380952380953,0.057123496526633864,544,Off the top the top of my head . .. I'd say you have a little work on your mind.
1743,1,2,39,42,1.0952380952380953,0.057123496526633864,544,I'm not wearing anything under my laptop.
1743,1,2,39,42,1.0952380952380953,0.057123496526633864,544,He's Tweedledee.
1743,0,4,38,42,1.0952380952380953,0.045843796413450766,544,We both have a lot on our minds.
1743,0,4,38,42,1.0952380952380953,0.045843796413450766,544,"It's been tough, but I've learned never to question the man upstairs."
1743,0,4,38,42,1.0952380952380953,0.045843796413450766,544,He asked for a treadmill desk but it's not covered in the warranty
1743,0,4,38,42,1.0952380952380953,0.045843796413450766,544,The lawyers won't let us brainstorm off the top of our heads.
1743,0,4,38,42,1.0952380952380953,0.045843796413450766,544,It's turtles all the way down.
1743,1,2,39,42,1.0952380952380953,0.057123496526633864,544,I don't understand why having a head for business isn't a more attractive quality.
1743,0,4,38,42,1.0952380952380953,0.045843796413450766,544,I still remember how the keys pounded before they went electronic.
1743,1,2,39,42,1.0952380952380953,0.057123496526633864,544,My man wants to speak to your man. Is that okay?
1743,1,2,39,42,1.0952380952380953,0.057123496526633864,544,The head office is good for micromanagement and that's about it.
1743,1,2,39,42,1.0952380952380953,0.057123496526633864,544,I have the same thing on my mind.
1743,2,0,40,42,1.0952380952380953,0.06651717102567413,544,"I don't get it, my wife keeps complaining about my bring the office home."
1743,1,2,39,42,1.0952380952380953,0.057123496526633864,544,A home office isn't as appealing as it sounded.
1743,2,0,40,42,1.0952380952380953,0.06651717102567413,544,"Since installing a porn filter, his productivity has gone way up."
1743,1,2,39,42,1.0952380952380953,0.057123496526633864,544,"How about some more double print, Gene?"
1743,0,4,38,42,1.0952380952380953,0.045843796413450766,544,All I think about is work.
1743,1,2,39,42,1.0952380952380953,0.057123496526633864,544,A zip drive for your thoughts?
1743,1,2,39,42,1.0952380952380953,0.057123496526633864,544,I keep thinking it's Wednesday.
1743,0,4,38,42,1.0952380952380953,0.045843796413450766,544,"Thankfully, my community service is almost over."
1743,1,2,39,42,1.0952380952380953,0.057123496526633864,544,Work is crushing me.
1743,1,2,39,42,1.0952380952380953,0.057123496526633864,544,"I don't know about you, but all the problems at work, have been on my mind, lately."
1743,0,4,38,42,1.0952380952380953,0.045843796413450766,544,"In the end, our similarities are greater than our differences."
1743,0,4,38,42,1.0952380952380953,0.045843796413450766,544,The brain's executive functions are at their peak at our age.
1743,1,2,39,42,1.0952380952380953,0.057123496526633864,544,Byte me!
1743,2,0,40,42,1.0952380952380953,0.06651717102567413,544,You gave how much to the campaign?
1743,1,2,39,42,1.0952380952380953,0.057123496526633864,544,Heavy is the head that wears the crown of drones.
1743,0,4,38,42,1.0952380952380953,0.045843796413450766,544,What's up?
1743,1,2,39,42,1.0952380952380953,0.057123496526633864,544,Do you get a tingling sensation down there when he opens a new private window?
1743,1,2,39,42,1.0952380952380953,0.057123496526633864,544,"Still, there's no accounting for some of my thoughts."
1743,0,4,38,42,1.0952380952380953,0.045843796413450766,544,Do you like solitaire?
1743,1,2,39,42,1.0952380952380953,0.057123496526633864,544,I didn't expect this when I was told I was being promoted to head office.
1743,1,2,39,42,1.0952380952380953,0.057123496526633864,544,We compete at the highest level
1743,0,4,38,42,1.0952380952380953,0.045843796413450766,544,I think our brains are working harder than we are...
1743,0,4,38,42,1.0952380952380953,0.045843796413450766,544,Who would have ever guessed that the basis of mental telepathy would be discovered in our lifetime.
1743,0,4,38,42,1.0952380952380953,0.045843796413450766,544,I'm also a workaholic who desperately needed help.
1743,0,4,38,42,1.0952380952380953,0.045843796413450766,544,"Phil, have you erased me...?"
1743,1,2,39,42,1.0952380952380953,0.057123496526633864,544,I was out of my head yesterday. Any messages?
1743,0,4,38,42,1.0952380952380953,0.045843796413450766,544,"When he said that we'd do a little brainstorming, I didn't realize that this is what he had in mind!"
1743,0,4,38,42,1.0952380952380953,0.045843796413450766,544,I think we may have a virus as your thoughts are coming in a tad slow?
1743,1,2,39,42,1.0952380952380953,0.057123496526633864,544,My poor brother thinks his job is better than mine.
1743,0,4,38,42,1.0952380952380953,0.045843796413450766,544,They've banned this in France.
1743,2,0,40,42,1.0952380952380953,0.06651717102567413,544,We need someone with a big head and a conference room.
1743,0,4,38,42,1.0952380952380953,0.045843796413450766,544,My on-board fact checker indicates that you actually do have gum you could share.
1743,1,2,39,42,1.0952380952380953,0.057123496526633864,544,Two heads are better than one
1743,0,4,38,42,1.0952380952380953,0.045843796413450766,544,I had this dream... Left and Right working together...
1743,0,4,38,42,1.0952380952380953,0.045843796413450766,544,I'll have to have my guy DM your guy on that.
1743,0,4,38,42,1.0952380952380953,0.045843796413450766,544,It's cool that we were able to get twins.
1743,0,4,38,42,1.0952380952380953,0.045843796413450766,544,"Psst... don't look up, but I think someone is watching us."
1743,1,2,39,42,1.0952380952380953,0.057123496526633864,544,"I don't mind that work gets in my head, but it sure is messing up my part."
1743,0,4,38,42,1.0952380952380953,0.045843796413450766,544,They figured out how to get a head in business.
1743,2,0,40,42,1.0952380952380953,0.06651717102567413,544,"yes, glad you're appathetic"
1743,1,2,39,42,1.0952380952380953,0.057123496526633864,544,Politically correct. Our talking heads come with instant fact checking.
1743,1,2,39,42,1.0952380952380953,0.057123496526633864,544,People are going to think we called each other this morning.
1743,2,0,40,42,1.0952380952380953,0.06651717102567413,544,My work load is heavier than your work load.
1743,1,2,39,42,1.0952380952380953,0.057123496526633864,544,"Lately, I can't seem to get work off of my mind."
1743,1,2,39,42,1.0952380952380953,0.057123496526633864,544,"I'll tell you what your guy is writing, and then you tell me mine."
1743,1,2,39,42,1.0952380952380953,0.057123496526633864,544,"Like you, I owe my success to all the little people."
1743,0,4,38,42,1.0952380952380953,0.045843796413450766,544,Does yours take his shoes off?
1743,1,2,39,42,1.0952380952380953,0.057123496526633864,544,"I understand the Red Hat Club, but this Office Hat Club is a bit of a stretch"
1743,1,2,39,42,1.0952380952380953,0.057123496526633864,544,Do you ever wonder what the phone and computer are plugged into?
1743,1,2,39,42,1.0952380952380953,0.057123496526633864,544,Must we also use the same barber?
1743,1,2,39,42,1.0952380952380953,0.057123496526633864,544,I see work is weighing on your mind too.
1743,0,4,38,42,1.0952380952380953,0.045843796413450766,544,"Yeah, my twelve inch pianist is *also* an accountant."
1743,2,0,40,42,1.0952380952380953,0.06651717102567413,544,Uu
1743,0,4,38,42,1.0952380952380953,0.045843796413450766,544,The difference between us? I make this look good.
1743,0,4,38,42,1.0952380952380953,0.045843796413450766,544,I see you can't disconnect from work either...
1743,0,4,38,42,1.0952380952380953,0.045843796413450766,544,It's a doubleheader!
1743,0,4,38,42,1.0952380952380953,0.045843796413450766,544,"I didn't catch his name on his first day, and now it's too late for me to ask."
1743,1,2,39,42,1.0952380952380953,0.057123496526633864,544,I'll have my assistant snail mail your assistant.
1743,1,2,39,42,1.0952380952380953,0.057123496526633864,544,"Maybe it works for them, but I'm not loving this whole Feng Shui thing."
1743,1,2,39,42,1.0952380952380953,0.057123496526633864,544,The Hat Sisters of Wall Street.
1743,0,4,38,42,1.0952380952380953,0.045843796413450766,544,I thought you only had a laptop.
1743,0,4,38,42,1.0952380952380953,0.045843796413450766,544,I think that genie misunderstood my wish
1743,1,2,39,42,1.0952380952380953,0.057123496526633864,544,"Standing on the shoulders of giants? Eh, close enough."
1743,0,4,38,42,1.0952380952380953,0.045843796413450766,544,I listed it was quaint with only mild dandruff.
1743,0,4,38,42,1.0952380952380953,0.045843796413450766,544,Do you think they'll start cutting overheads?
1743,0,4,38,42,1.0952380952380953,0.045843796413450766,544,"So I said, ""How do you think you spell eggs-x-yu-tiv rez-ooo-may?"
1743,1,2,39,42,1.0952380952380953,0.057123496526633864,544,Do you ever have the feeling that you're just a character in a video game?
1743,0,4,38,42,1.0952380952380953,0.045843796413450766,544,I thought virtual reality would be more exciting.
1743,1,2,39,42,1.0952380952380953,0.057123496526633864,544,"At my last job, 'Upper Management' had their own offices."
1743,0,4,38,42,1.0952380952380953,0.045843796413450766,544,I'll have the voices in my head contact the voices in your head.
1743,1,2,39,42,1.0952380952380953,0.057123496526633864,544,My day trader is faster than your day trader.
1743,0,4,38,42,1.0952380952380953,0.045843796413450766,544,Come Wednesday we might be needing these.
1743,1,2,39,42,1.0952380952380953,0.057123496526633864,544,this censorship is mind numbing!
1743,1,2,39,42,1.0952380952380953,0.057123496526633864,544,"Whatever you do, don't check his browser history."
1743,0,4,38,42,1.0952380952380953,0.045843796413450766,544,It's the ultimate balancing act.
1743,0,4,38,42,1.0952380952380953,0.045843796413450766,544,It sure looks like we've got a lot on our minds.
1743,0,4,38,42,1.0952380952380953,0.045843796413450766,544,I'll have my department head contact your department head.
1743,0,4,38,42,1.0952380952380953,0.045843796413450766,544,No doubt we were separated at birth.
1743,2,0,40,42,1.0952380952380953,0.06651717102567413,544,"Bad as it gets, just remember how lucky we are to be knowledge workers and not just some manual grunts."
1743,1,2,39,42,1.0952380952380953,0.057123496526633864,544,1st World Problems.
1743,1,2,39,42,1.0952380952380953,0.057123496526633864,544,What's the voice telling you to do now?
1743,0,4,38,42,1.0952380952380953,0.045843796413450766,544,I think we have a lot in common
1743,2,0,40,42,1.0952380952380953,0.06651717102567413,544,"Who invented ""fantasy office""?"
1743,2,0,40,42,1.0952380952380953,0.06651717102567413,544,So you're finding it hard to get away from your desk job too?
1743,2,0,40,42,1.0952380952380953,0.06651717102567413,544,My boss has been on top of me these days too.
1743,0,4,38,42,1.0952380952380953,0.045843796413450766,544,My lack of right brain creativity makes us a good match.
1743,1,2,39,42,1.0952380952380953,0.057123496526633864,544,I've been considering just shaving my head.
1743,1,2,39,42,1.0952380952380953,0.057123496526633864,544,Are you groupthinking what I'm groupthinking?
1743,0,4,38,42,1.0952380952380953,0.045843796413450766,544,Let's not vote. We'd just cancel each others choice.
1743,0,4,38,42,1.0952380952380953,0.045843796413450766,544,We really need to cut our overhead.
1743,2,0,40,42,1.0952380952380953,0.06651717102567413,544,Wow! What are the chances? We both have the same Halloween costume.
1743,0,4,38,42,1.0952380952380953,0.045843796413450766,544,I think the office budget cut is really getting to me.
1743,1,2,39,42,1.0952380952380953,0.057123496526633864,544,Is my tie too skinny?
1743,0,4,38,42,1.0952380952380953,0.045843796413450766,544,I've been trying to organize my self talk. How about you?
1743,0,4,38,42,1.0952380952380953,0.045843796413450766,544,I hope this conversation finds you well
1743,1,2,39,42,1.0952380952380953,0.057123496526633864,544,I see we are attracting more like-minded people.
1743,1,2,39,42,1.0952380952380953,0.057123496526633864,544,"I could believe you just came up with the same idea last Halloween, but..."
1743,0,4,38,42,1.0952380952380953,0.045843796413450766,544,My God! It's like you're reading my mind!
1743,0,4,38,42,1.0952380952380953,0.045843796413450766,544,I hate these executive-level Halloween costume parties.
1743,1,2,39,42,1.0952380952380953,0.057123496526633864,544,"They told me it was a small company, top tier medical and... was I open to working off the top of my head."
1743,1,2,39,42,1.0952380952380953,0.057123496526633864,544,I like the way you think.
1743,1,2,39,42,1.0952380952380953,0.057123496526633864,544,"Well, they're better than the college students we had living up there before."
1743,1,2,39,42,1.0952380952380953,0.057123496526633864,544,Does yours just watch Netflix all day too?
2073,1,2,40,43,1.0930232558139534,0.055823181223160837,544,Are you sure you ate the whole brownie dude?
2073,1,2,40,43,1.0930232558139534,0.055823181223160837,544,I didn't really change my mind -- voting for Trump was an executive decision made after I was hacked by the Russians.
2073,1,2,40,43,1.0930232558139534,0.055823181223160837,544,No . . . the cloud is different
2073,0,4,39,43,1.0930232558139534,0.04481972612369448,544,I hate these SBA audits.
2073,1,2,40,43,1.0930232558139534,0.055823181223160837,544,"Right off the top of my head, I can't think of anything."
2073,1,2,40,43,1.0930232558139534,0.055823181223160837,544,See what I'm Saying?
2073,1,2,40,43,1.0930232558139534,0.055823181223160837,544,Siri was bright but I couldn't stand her voice.
2073,1,2,40,43,1.0930232558139534,0.055823181223160837,544,"Is this is some good marijuana, or what?"
2073,1,2,40,43,1.0930232558139534,0.055823181223160837,544,Mom always liked your little man best.
2073,1,2,40,43,1.0930232558139534,0.055823181223160837,544,Do you ever feel the government is monitoring our every thought?
2073,1,2,40,43,1.0930232558139534,0.055823181223160837,544,No way creative and intuitive is better than organized and systematic.
2073,1,2,40,43,1.0930232558139534,0.055823181223160837,544,It’s hard to talk when the wifi goes down.
2073,1,2,40,43,1.0930232558139534,0.055823181223160837,544,One of us is going to have to quit.
2073,1,2,40,43,1.0930232558139534,0.055823181223160837,544,"If they decide to cut staff, we're in trouble."
2073,1,2,40,43,1.0930232558139534,0.055823181223160837,544,I expected Google's 'Personal Assistant Hat' would be more streamlined.
2073,1,2,40,43,1.0930232558139534,0.055823181223160837,544,"He'll send you an email, and we'll set up a time for lunch."
2073,1,2,40,43,1.0930232558139534,0.055823181223160837,544,My id keeps telling me that my ego's working overtime.
2073,1,2,40,43,1.0930232558139534,0.055823181223160837,544,Can I borrow a pencil?
2073,0,4,39,43,1.0930232558139534,0.04481972612369448,544,I used to have a flattop.
2073,1,2,40,43,1.0930232558139534,0.055823181223160837,544,I should've gotten the app instead.
2073,0,4,39,43,1.0930232558139534,0.04481972612369448,544,I just can't seem to wrap my brain around it.
2073,0,4,39,43,1.0930232558139534,0.04481972612369448,544,My right hand doesn't know what your right hand is doing.
2073,1,2,40,43,1.0930232558139534,0.055823181223160837,544,We should demand raises. We have been carrying this company long enough.
2073,1,2,40,43,1.0930232558139534,0.055823181223160837,544,The evolutionary consequence of multi-tasking.
2073,1,2,40,43,1.0930232558139534,0.055823181223160837,544,If we wear bowlers it will be too dark to keep working at our desks after we leave.
2073,1,2,40,43,1.0930232558139534,0.055823181223160837,544,What makes you think we're self-centered?
2073,0,4,39,43,1.0930232558139534,0.04481972612369448,544,A bitcoin for your thoughts.
2073,0,4,39,43,1.0930232558139534,0.04481972612369448,544,Computer says No.
2073,0,4,39,43,1.0930232558139534,0.04481972612369448,544,"Don’t let others slow you down, get involved and you can see the powerfulness of it all."
2073,0,4,39,43,1.0930232558139534,0.04481972612369448,544,I prefer the virtual desktop version on Microsoft Office.
2073,1,2,40,43,1.0930232558139534,0.055823181223160837,544,How do you get rid of that little email going on and on in your head?
2073,1,2,40,43,1.0930232558139534,0.055823181223160837,544,"Okay, let's keep our best guys on top of it."
2073,1,2,40,43,1.0930232558139534,0.055823181223160837,544,My guy just ordered a bigger desk on Amazon. How about yours?
2073,0,4,39,43,1.0930232558139534,0.04481972612369448,544,"No, I didn't take your pencil holder."
2073,0,4,39,43,1.0930232558139534,0.04481972612369448,544,"Do you have that ""9 to 5"" song stuck in your head, too?"
2073,0,4,39,43,1.0930232558139534,0.04481972612369448,544,I'm thinking about growing a Mullet.
2073,0,4,39,43,1.0930232558139534,0.04481972612369448,544,"You know your guy looks ridiculous in that suit, right?"
2073,0,4,39,43,1.0930232558139534,0.04481972612369448,544,Wait. I thought I was the head office.
2073,0,4,39,43,1.0930232558139534,0.04481972612369448,544,A bitcoin for your thoughts.
2073,1,2,40,43,1.0930232558139534,0.055823181223160837,544,"Out of 650,000 a couple appear to be pertinent."""
2073,1,2,40,43,1.0930232558139534,0.055823181223160837,544,"I see you've got work on your mind, too."
2073,1,2,40,43,1.0930232558139534,0.055823181223160837,544,"The standing desks were innovative, but these have gone too far."
2073,1,2,40,43,1.0930232558139534,0.055823181223160837,544,You too sublet your head?
2073,1,2,40,43,1.0930232558139534,0.055823181223160837,544,"In his efforts to stop the negative voices in his head, Howard resorts to email. ""Howard, you are a worthless piece of shit...you aren't worth the air this message is written on."""
2073,1,2,40,43,1.0930232558139534,0.055823181223160837,544,"So, I've got email on the brain, huh? Look who's talking!"
2073,1,2,40,43,1.0930232558139534,0.055823181223160837,544,I'll have my guy email your guy.
2073,1,2,40,43,1.0930232558139534,0.055823181223160837,544,Talk about micromanaging....sheesh.
2120,1,2,41,44,1.0909090909090908,0.054580679253385125,544,But is this billable?
2120,0,4,40,44,1.0909090909090908,0.04384025656094653,544,Matter Over Mind
2120,1,2,41,44,1.0909090909090908,0.054580679253385125,544,I hope my bathroom break isn't considered a wikileak.
2120,1,2,41,44,1.0909090909090908,0.054580679253385125,544,This way we don't forget to file our taxes.
2124,1,2,42,45,1.0888888888888888,0.05339222337940409,544,So we give up a few freedoms to remain safe.
2125,0,3,38,41,1.0731707317073171,0.04117547077105886,544,They say the voices in your head speak louder than words.
2125,0,3,38,41,1.0731707317073171,0.04117547077105886,544,I call mine Little Deloitte.
2125,1,1,39,41,1.0731707317073171,0.05399010639311867,544,"They're Googling ""folie a deux""."
2125,0,3,38,41,1.0731707317073171,0.04117547077105886,544,Did you get my email?
2125,1,1,39,41,1.0731707317073171,0.05399010639311867,544,"You need to ask yourself... ""Have I been hacked?"""
2125,1,1,39,41,1.0731707317073171,0.05399010639311867,544,"You're right, it can be a real balancing act."
2125,0,3,38,41,1.0731707317073171,0.04117547077105886,544,Do you ever get the feeling you shouldn't believe most of what you're thinking?
2125,0,3,38,41,1.0731707317073171,0.04117547077105886,544,"It's 'The Twin Paradox', not 'The Twin Pair-o-desks' so let's take a ride to the dock store."
2125,1,1,39,41,1.0731707317073171,0.05399010639311867,544,Hold on. I'm receiving a message from Putin.
2125,1,1,39,41,1.0731707317073171,0.05399010639311867,544,"It's amazing, it's as if you can read my email."
2125,1,1,39,41,1.0731707317073171,0.05399010639311867,544,we're in over our heads.
2125,1,1,39,41,1.0731707317073171,0.05399010639311867,544,"I'm sure we'll be successful, we both have a good head for business!"
2125,1,1,39,41,1.0731707317073171,0.05399010639311867,544,"""Crazy Hat Day"" could not get any crazier!"
2125,1,1,39,41,1.0731707317073171,0.05399010639311867,544,I see you take your job with you on vacation too.
2125,0,3,38,41,1.0731707317073171,0.04117547077105886,544,This is definitely not what I thought they meant by achieving a 'work-life balance.'
2125,1,1,39,41,1.0731707317073171,0.05399010639311867,544,The worst part is I can't wear my favorite hat.
2125,1,1,39,41,1.0731707317073171,0.05399010639311867,544,Let's power down and then we can talk with our mouths.
2125,1,1,39,41,1.0731707317073171,0.05399010639311867,544,This polling thing has started to invade our privacy.
2125,0,3,38,41,1.0731707317073171,0.04117547077105886,544,Your space or mine.
2125,1,1,39,41,1.0731707317073171,0.05399010639311867,544,My private server is sending you an immunity app.
2125,0,3,38,41,1.0731707317073171,0.04117547077105886,544,Oh I don't take my work home. My work takes me home.
2125,0,3,38,41,1.0731707317073171,0.04117547077105886,544,Can we take off our client hats for a minute?
2125,0,3,38,41,1.0731707317073171,0.04117547077105886,544,Is THIS what is meant when someone gets ahead in the world?
2125,0,3,38,41,1.0731707317073171,0.04117547077105886,544,Mine has more GB than yours.
2125,0,3,38,41,1.0731707317073171,0.04117547077105886,544,When does yours usually clock out?
2125,0,3,38,41,1.0731707317073171,0.04117547077105886,544,I hate it when my boss is standing over me. Why can't he mind his own business?
2125,1,1,39,41,1.0731707317073171,0.05399010639311867,544,"I'm Atlas. What's your name, fucker?"
2125,1,1,39,41,1.0731707317073171,0.05399010639311867,544,"OK, now clear your mind and relax..."
2125,1,1,39,41,1.0731707317073171,0.05399010639311867,544,GET A LIFE OF YOUR OWN!
2125,1,1,39,41,1.0731707317073171,0.05399010639311867,544,"Correct, you're the personification of youth's unfulfilled promise. My turn. Am I American?"
2125,1,1,39,41,1.0731707317073171,0.05399010639311867,544,This job is really getting on top of me.
2125,1,1,39,41,1.0731707317073171,0.05399010639311867,544,Two parallel processors are better than one.
2125,1,1,39,41,1.0731707317073171,0.05399010639311867,544,I wish he'd roll off my head.
2125,0,3,38,41,1.0731707317073171,0.04117547077105886,544,Do you know you have a little man sitting at a little desk on top of your head?
2125,1,1,39,41,1.0731707317073171,0.05399010639311867,544,Do you think we're giving way too much of ourselves to our jobs?
2125,0,3,38,41,1.0731707317073171,0.04117547077105886,544,I had a different vision of what working at the Head Office would mean.
2125,0,3,38,41,1.0731707317073171,0.04117547077105886,544,"Hold on, I need to update my Adobe software."
2125,0,3,38,41,1.0731707317073171,0.04117547077105886,544,"I know how you think and I see what you see,... bro."
2125,1,1,39,41,1.0731707317073171,0.05399010639311867,544,"I've killed before, and I'll kill again! The tiny man on my head SAW. IT. ALL."
2125,0,3,38,41,1.0731707317073171,0.04117547077105886,544,I think I was just hacked.
2125,1,1,39,41,1.0731707317073171,0.05399010639311867,544,I wish our jobs would move to Mexico!
2125,1,1,39,41,1.0731707317073171,0.05399010639311867,544,We'll go together and tell him we need to get this off our minds.
2125,1,1,39,41,1.0731707317073171,0.05399010639311867,544,So you thought it was Boring Hat Day too?
2125,0,3,38,41,1.0731707317073171,0.04117547077105886,544,great minds think alike
2125,0,3,38,41,1.0731707317073171,0.04117547077105886,544,My doctor said take 2 aspirins and call him in the morning. What about yours?
2125,1,1,39,41,1.0731707317073171,0.05399010639311867,544,My human speaks french.
2125,0,3,38,41,1.0731707317073171,0.04117547077105886,544,We never talk anymore.
2125,0,3,38,41,1.0731707317073171,0.04117547077105886,544,"""we've got to stop letting work mess with our heads.:"
2125,0,3,38,41,1.0731707317073171,0.04117547077105886,544,"Sure it would save money if we outsourced to India, but I just don't know."
2125,0,3,38,41,1.0731707317073171,0.04117547077105886,544,I'm a head in the game.
2125,1,1,39,41,1.0731707317073171,0.05399010639311867,544,24/7 connectivity sucks!
2125,1,1,39,41,1.0731707317073171,0.05399010639311867,544,I don't like these new work hats.
2125,0,3,38,41,1.0731707317073171,0.04117547077105886,544,Are you trying out that new online dating site as well?
2125,1,1,39,41,1.0731707317073171,0.05399010639311867,544,"""Dr Livingstone,I presume?.."
2125,0,3,38,41,1.0731707317073171,0.04117547077105886,544,"Okay, just look busy for the next 30 years."
2125,1,1,39,41,1.0731707317073171,0.05399010639311867,544,I agree...It would be redundant and inefficient to have two head offices.
2125,1,1,39,41,1.0731707317073171,0.05399010639311867,544,We have to get work off our minds.
2125,1,1,39,41,1.0731707317073171,0.05399010639311867,544,It's the darned ringing in my ears that I'm having trouble getting used to.
2125,0,3,38,41,1.0731707317073171,0.04117547077105886,544,"Lately, it's like he has no idea what I'm thinking."
2125,0,3,38,41,1.0731707317073171,0.04117547077105886,544,I think it's harder to get ahead these days.
2125,1,1,39,41,1.0731707317073171,0.05399010639311867,544,I have so much on my mind that I can't get anything done. I guess it's true that the only way a two-man committee works is when one is dead.
2125,1,1,39,41,1.0731707317073171,0.05399010639311867,544,"My apologies, but I think I have your micromanager."
2125,1,1,39,41,1.0731707317073171,0.05399010639311867,544,At least our Apples are very PC.
2125,0,3,38,41,1.0731707317073171,0.04117547077105886,544,You ever get the feeling someone's controlling us?
2125,1,1,39,41,1.0731707317073171,0.05399010639311867,544,Glad I'm not the only one here with a head for business.
2125,1,1,39,41,1.0731707317073171,0.05399010639311867,544,"Can't wait to go wireless! I can't sit down since the connection of this thing redefines ""outlet""."
2125,0,3,38,41,1.0731707317073171,0.04117547077105886,544,"The new i-hacker hat, nice."
2125,0,3,38,41,1.0731707317073171,0.04117547077105886,544,"As I get older, more of my memory is in a cloud."
2125,0,3,38,41,1.0731707317073171,0.04117547077105886,544,We're literally under the thumbs of the head office!
2125,1,1,39,41,1.0731707317073171,0.05399010639311867,544,Corporate's micromanagement is really beginning to weigh me down.
2125,1,1,39,41,1.0731707317073171,0.05399010639311867,544,I was going to leave the factory sticker and merchandise tag on mine.
2125,1,1,39,41,1.0731707317073171,0.05399010639311867,544,This new mind remote is great!
2125,0,3,38,41,1.0731707317073171,0.04117547077105886,544,My head office gives me pain.
2125,0,3,38,41,1.0731707317073171,0.04117547077105886,544,I have a lot on my mind too!
2125,0,3,38,41,1.0731707317073171,0.04117547077105886,544,And I used to think Siri was annoying....
2125,0,3,38,41,1.0731707317073171,0.04117547077105886,544,I seem to have work on my mind too.
2125,0,3,38,41,1.0731707317073171,0.04117547077105886,544,Don't you think this is better than texting?
2125,1,1,39,41,1.0731707317073171,0.05399010639311867,544,"How long are they going to be here for? I've got a date later, and I really need them gone. She already thinks I'm unstable..."
2125,0,3,38,41,1.0731707317073171,0.04117547077105886,544,I am out of the office right now and only infrequently checking my messages.
2125,1,1,39,41,1.0731707317073171,0.05399010639311867,544,"Every since I went to Trumps new hotel, I've been getting these strange compulsions."
2125,0,3,38,41,1.0731707317073171,0.04117547077105886,544,"""Mines now demanding a stand-up desk""."
2125,1,1,39,41,1.0731707317073171,0.05399010639311867,544,Still downloading.
2125,0,3,38,41,1.0731707317073171,0.04117547077105886,544,Next year's model has a scalp massage function.
2125,1,1,39,41,1.0731707317073171,0.05399010639311867,544,I can't wait to get home so I can browse without supervision.
2125,0,3,38,41,1.0731707317073171,0.04117547077105886,544,They'd rather have their meeting tête-à-tête.
2125,0,3,38,41,1.0731707317073171,0.04117547077105886,544,Constantly having work on my mind has given me even less excuses for being unemployed.
2125,0,3,38,41,1.0731707317073171,0.04117547077105886,544,I can't sleep with the constant tapping in my head.
2125,1,1,39,41,1.0731707317073171,0.05399010639311867,544,Sometimes I wish I could just turn off my inner associate manager of sales.
2125,1,1,39,41,1.0731707317073171,0.05399010639311867,544,We did agree to a mutual 'head's up' on any new development.
2125,1,1,39,41,1.0731707317073171,0.05399010639311867,544,I just sent you my thoughts via ESP-mail.
2125,0,3,38,41,1.0731707317073171,0.04117547077105886,544,I can count at least ten differences between your idea and mine.
2125,0,3,38,41,1.0731707317073171,0.04117547077105886,544,It's hard to support a micro-manager!
2125,1,1,39,41,1.0731707317073171,0.05399010639311867,544,I'll have my guy contact your guy then.
2125,0,3,38,41,1.0731707317073171,0.04117547077105886,544,What happened to your pencils?
2125,0,3,38,41,1.0731707317073171,0.04117547077105886,544,"Well then, I'm holding you accountable also!"
2125,0,3,38,41,1.0731707317073171,0.04117547077105886,544,I didn't want to pay for Bluetooth either.
2125,0,3,38,41,1.0731707317073171,0.04117547077105886,544,"For some reason, I have this sudden urge to do conference calls."
2125,1,1,39,41,1.0731707317073171,0.05399010639311867,544,We must have the same hair stylist.
2125,0,3,38,41,1.0731707317073171,0.04117547077105886,544,I agree. This could catch on where cubicles are scarce.
2125,1,1,39,41,1.0731707317073171,0.05399010639311867,544,I'll have my people talk to your people.
2125,1,1,39,41,1.0731707317073171,0.05399010639311867,544,I'm thinking of getting the stand-up version.
2125,1,1,39,41,1.0731707317073171,0.05399010639311867,544,Sounds good to me but I'll need the approval of my head office.
2125,1,1,39,41,1.0731707317073171,0.05399010639311867,544,Okay--we have business in the front. Now what's your idea for party in the back?
2125,0,3,38,41,1.0731707317073171,0.04117547077105886,544,"Your brain in ""instant messaging"" mode, and your brain in ""think before speaking"" mode."
2125,1,1,39,41,1.0731707317073171,0.05399010639311867,544,It hides my bald spot. What about you?
2125,0,3,38,41,1.0731707317073171,0.04117547077105886,544,You always said you wanted to be in head office.
2125,1,1,39,41,1.0731707317073171,0.05399010639311867,544,You know where the cord outlets are right?
2125,1,1,39,41,1.0731707317073171,0.05399010639311867,544,TECHNOLOGY MAGICAL THINKING IN THE WORLD TODAY
2125,1,1,39,41,1.0731707317073171,0.05399010639311867,544,Work on the brain? Yeah me too!
2125,0,3,38,41,1.0731707317073171,0.04117547077105886,544,We never talk anymore.
2125,1,1,39,41,1.0731707317073171,0.05399010639311867,544,We both know compartmentalization is new age hogwash.
2125,0,3,38,41,1.0731707317073171,0.04117547077105886,544,It cuts down on overhead.
2125,0,3,38,41,1.0731707317073171,0.04117547077105886,544,Mine searches Yahoo for answers so I often have to Google it myself.
2125,1,1,39,41,1.0731707317073171,0.05399010639311867,544,"Off the top of my head, I'd say a key goal for next year would be achieving a better life/work balance."
2125,0,3,38,41,1.0731707317073171,0.04117547077105886,544,"Dude, you got a smart desk too?"
2125,0,3,38,41,1.0731707317073171,0.04117547077105886,544,The company says we are head cases
2125,1,1,39,41,1.0731707317073171,0.05399010639311867,544,"With this little overhead, how can we not succeed?"
2125,0,3,38,41,1.0731707317073171,0.04117547077105886,544,This startup is beginning to feel very corporate.
2125,1,1,39,41,1.0731707317073171,0.05399010639311867,544,Who does your hair?
2125,0,3,38,41,1.0731707317073171,0.04117547077105886,544,I'm not sure what I think of these new standing desks.
2125,1,1,39,41,1.0731707317073171,0.05399010639311867,544,My inner fact checker says Who's on first.
2125,1,1,39,41,1.0731707317073171,0.05399010639311867,544,Who's a blockhead?
2125,1,1,39,41,1.0731707317073171,0.05399010639311867,544,Business up front but no more party in the back.
2125,1,1,39,41,1.0731707317073171,0.05399010639311867,544,This office assistant app could use an update.
2125,0,3,38,41,1.0731707317073171,0.04117547077105886,544,Me neither. I never miss the old 9 to 5.
2125,1,1,39,41,1.0731707317073171,0.05399010639311867,544,Heavy on my mind.
2125,0,3,38,41,1.0731707317073171,0.04117547077105886,544,"Am I reading your mind, or did you just send me an email?"
2125,0,3,38,41,1.0731707317073171,0.04117547077105886,544,You too? I've also got a lot of that e-mail stuff on my mind.
2125,1,1,39,41,1.0731707317073171,0.05399010639311867,544,My office overhead leaves me speechless.
2125,1,1,39,41,1.0731707317073171,0.05399010639311867,544,Let's due lunch. I'll have my assistant contact yours to set it up.
2125,0,3,38,41,1.0731707317073171,0.04117547077105886,544,Heavy is the head that wears the desk.
2125,0,3,38,41,1.0731707317073171,0.04117547077105886,544,"Yeah, I have a tele-commute head leash, too. Fools my boss most of the time."
2125,1,1,39,41,1.0731707317073171,0.05399010639311867,544,"Dressing alike used to be fun, but now it's just weird."
2125,0,3,38,41,1.0731707317073171,0.04117547077105886,544,There's something on your head.
2125,0,3,38,41,1.0731707317073171,0.04117547077105886,544,Have your help desk call my help desk and maybe we can work these glitches out.
2125,0,3,38,41,1.0731707317073171,0.04117547077105886,544,What do yo do when you catch yours looking at porn?
2125,0,3,38,41,1.0731707317073171,0.04117547077105886,544,Could I borrow a pencil?
2125,0,3,38,41,1.0731707317073171,0.04117547077105886,544,"It was all in my head, until outsourcing."
2125,0,3,38,41,1.0731707317073171,0.04117547077105886,544,This is not the upward mobility I had in mind.
2125,1,1,39,41,1.0731707317073171,0.05399010639311867,544,Your work is just a mirror of mine.
2125,1,1,39,41,1.0731707317073171,0.05399010639311867,544,It's much easier if you get him to turn off the notifications.
2125,1,1,39,41,1.0731707317073171,0.05399010639311867,544,Micromanagement is a pain in the neck.
2125,0,3,38,41,1.0731707317073171,0.04117547077105886,544,"I didn't mind him at first, but now he's started to micro-manage everything."
2125,0,3,38,41,1.0731707317073171,0.04117547077105886,544,"You mean work is always on your mind, too?"
2125,0,3,38,41,1.0731707317073171,0.04117547077105886,544,I can't think of anything off the top of my head.
2125,0,3,38,41,1.0731707317073171,0.04117547077105886,544,Are you trying to steal my patent application?
2125,1,1,39,41,1.0731707317073171,0.05399010639311867,544,At the end of the day when you understand the big picture it's a no brainer.
2125,0,3,38,41,1.0731707317073171,0.04117547077105886,544,"You've got work on your mind, too?"
2125,1,1,39,41,1.0731707317073171,0.05399010639311867,544,I won't say anything until this audit is a thing of the past
2125,0,3,38,41,1.0731707317073171,0.04117547077105886,544,I know how you feel-bringing my work home hastened the death of my marriage too -
2125,0,3,38,41,1.0731707317073171,0.04117547077105886,544,"Well, I've never been micro-managed quite like this before."
2125,0,3,38,41,1.0731707317073171,0.04117547077105886,544,And then she had the gall to say we lack diversity!
2125,1,1,39,41,1.0731707317073171,0.05399010639311867,544,My wife wears a glass-top desk
2125,1,1,39,41,1.0731707317073171,0.05399010639311867,544,OMG... Twinsies!
2125,1,1,39,41,1.0731707317073171,0.05399010639311867,544,The Russians can read my mind.
2125,1,1,39,41,1.0731707317073171,0.05399010639311867,544,Shhh. The upper managers are listening.
2125,0,3,38,41,1.0731707317073171,0.04117547077105886,544,Discount Double Check! Can you find the differences in these two pictures?
2125,0,3,38,41,1.0731707317073171,0.04117547077105886,544,"Well, I finally think I've got a head of technology."
2125,1,1,39,41,1.0731707317073171,0.05399010639311867,544,There's something on my mind. I thought you'd understand.
2125,1,1,39,41,1.0731707317073171,0.05399010639311867,544,"Just off the top of my head, I'd say our systems seem compatible."
2125,1,1,39,41,1.0731707317073171,0.05399010639311867,544,"It seemed like a good idea at the time, but what happens if there are layoffs?"
2125,1,1,39,41,1.0731707317073171,0.05399010639311867,544,Is it just me or is there a man sitting at a desk on your head?
2125,0,3,38,41,1.0731707317073171,0.04117547077105886,544,"Yeah, it's nice, but the overhead's outrageous."
2125,1,1,39,41,1.0731707317073171,0.05399010639311867,544,I'll my people call your people.
2125,1,1,39,41,1.0731707317073171,0.05399010639311867,544,Our CEO always loved you best.
2125,0,3,38,41,1.0731707317073171,0.04117547077105886,544,How's your office overhead?
2125,0,3,38,41,1.0731707317073171,0.04117547077105886,544,Or we could form a band?
2125,1,1,39,41,1.0731707317073171,0.05399010639311867,544,"Yes, I'm aware it's just another sign of the shrinking economy."
2125,0,3,38,41,1.0731707317073171,0.04117547077105886,544,"Oy Vey, are we boring or what?"
2125,0,3,38,41,1.0731707317073171,0.04117547077105886,544,Listen Ying!!
2125,0,3,38,41,1.0731707317073171,0.04117547077105886,544,That desk job has been doing my head in lately
2125,0,3,38,41,1.0731707317073171,0.04117547077105886,544,"When I tried to explain our plan, Atlas shrugged."
2125,1,1,39,41,1.0731707317073171,0.05399010639311867,544,How can we tell which is the private server?
2125,0,3,38,41,1.0731707317073171,0.04117547077105886,544,"Ever feel like your brain is just a businessman sitting at a buffering computer?"" ""All the time!"
2125,1,1,39,41,1.0731707317073171,0.05399010639311867,544,It's been much harder on me with his new adjustable standing desk.
2125,1,1,39,41,1.0731707317073171,0.05399010639311867,544,Are you thinking what I'm thinking?? You're missing something.
2125,0,3,38,41,1.0731707317073171,0.04117547077105886,544,Glad we think alike.
2125,1,1,39,41,1.0731707317073171,0.05399010639311867,544,"""What happened to 'A Little Dab'll Do Ya'?"
2125,0,3,38,41,1.0731707317073171,0.04117547077105886,544,I really like the way you think.
2125,0,3,38,41,1.0731707317073171,0.04117547077105886,544,"I've got Bob, that hunk in accounting on my mind ....just like you."
2125,0,3,38,41,1.0731707317073171,0.04117547077105886,544,Relax. It's all on your head.
2125,1,1,39,41,1.0731707317073171,0.05399010639311867,544,"Off the top of my head, I couldn't tell you about his work quality"
2125,1,1,39,41,1.0731707317073171,0.05399010639311867,544,My alter ego can beat up your alter ego.
2125,0,3,38,41,1.0731707317073171,0.04117547077105886,544,Mine's named Gulliver.
2125,1,1,39,41,1.0731707317073171,0.05399010639311867,544,Bet I know what you're thinking?
2125,0,3,38,41,1.0731707317073171,0.04117547077105886,544,He is rational but the guy at my heart is all over the place.
2125,0,3,38,41,1.0731707317073171,0.04117547077105886,544,Penny for his thoughts.
2125,0,3,38,41,1.0731707317073171,0.04117547077105886,544,I sense a delete about to happen.
2125,0,3,38,41,1.0731707317073171,0.04117547077105886,544,Twin studies reveal genetic tendency to have office work on the brain.
2125,1,1,39,41,1.0731707317073171,0.05399010639311867,544,Mom says we think so much alike we must be related !
2125,1,1,39,41,1.0731707317073171,0.05399010639311867,544,"Yes, I get tired of taking my work home with me as well. It's like I can never unplug myself from it!"
2125,0,3,38,41,1.0731707317073171,0.04117547077105886,544,"Did you get the""Don't Be A Desk-Head Clone"" email?"
2125,1,1,39,41,1.0731707317073171,0.05399010639311867,544,This new method gives us a chance to nap when needed.
2125,1,1,39,41,1.0731707317073171,0.05399010639311867,544,What I got from just off the top of your head totally disagrees with what your saying.
2125,0,3,38,41,1.0731707317073171,0.04117547077105886,544,I'm tired of some wisenheimer always asking where my private server is.
2125,0,3,38,41,1.0731707317073171,0.04117547077105886,544,Are you Googling what I'm Googling?
2125,0,3,38,41,1.0731707317073171,0.04117547077105886,544,"Yeah, the mouse is faster than typing your ideas, but typing makes you THINK more."
2125,0,3,38,41,1.0731707317073171,0.04117547077105886,544,Human resources told me some time at head office would be good for my career.
2125,0,3,38,41,1.0731707317073171,0.04117547077105886,544,We're looking forward to the wireless upgrade.
2125,0,3,38,41,1.0731707317073171,0.04117547077105886,544,Right Brain vs Left Brain = no decided winner.
2125,0,3,38,41,1.0731707317073171,0.04117547077105886,544,Nice hat!
2125,1,1,39,41,1.0731707317073171,0.05399010639311867,544,I'll have my people call your people.
2125,0,3,38,41,1.0731707317073171,0.04117547077105886,544,Let's see someone hack this e-mail?
2125,0,3,38,41,1.0731707317073171,0.04117547077105886,544,I'm sorry but I no longer do conversations by speaking. I know you understand.
2125,0,3,38,41,1.0731707317073171,0.04117547077105886,544,It's really nice meeting someone who thinks just like me. Takes a load off my mind.
2125,1,1,39,41,1.0731707317073171,0.05399010639311867,544,Are you thinking the same thing I am?!
2125,1,1,39,41,1.0731707317073171,0.05399010639311867,544,I'm not sure if my brain is frozen or not responding.
2125,1,1,39,41,1.0731707317073171,0.05399010639311867,544,It proves that I'm a harder worker than you.
2125,0,3,38,41,1.0731707317073171,0.04117547077105886,544,"Since beginning work here, for some reason I just can't shake the urge to take work home with me."
2125,0,3,38,41,1.0731707317073171,0.04117547077105886,544,I think things first took a bad turn with the iPhone 9.
2125,0,3,38,41,1.0731707317073171,0.04117547077105886,544,It was more comfortable when our boss was just in our heads.
2125,0,3,38,41,1.0731707317073171,0.04117547077105886,544,Business has been picking up lately but our overhead is still killing us.
2125,1,1,39,41,1.0731707317073171,0.05399010639311867,544,I see your brain is on cranking out work again.
2125,0,3,38,41,1.0731707317073171,0.04117547077105886,544,Satan is real.
2125,1,1,39,41,1.0731707317073171,0.05399010639311867,544,Who's the meme here?
2125,1,1,39,41,1.0731707317073171,0.05399010639311867,544,We can compete or we can put our heads together.
2125,0,3,38,41,1.0731707317073171,0.04117547077105886,544,They can tell if you voted for him when you said you were with her.
2125,1,1,39,41,1.0731707317073171,0.05399010639311867,544,"oh shit, put it there my brother"
2125,1,1,39,41,1.0731707317073171,0.05399010639311867,544,This gives a whole new meaning to the expression 'head desk'.
2125,0,3,38,41,1.0731707317073171,0.04117547077105886,544,Can't think-too much pressure!
2125,0,3,38,41,1.0731707317073171,0.04117547077105886,544,I feel like our bosses always looking over us.
2125,1,1,39,41,1.0731707317073171,0.05399010639311867,544,I'll have my people call your people
2125,0,3,38,41,1.0731707317073171,0.04117547077105886,544,"Except for the hats, I think The Washington Lobbyists is a better name than Redskins."
2125,1,1,39,41,1.0731707317073171,0.05399010639311867,544,"I've heard of standing desks, but this is getting out of hand."
2125,0,3,38,41,1.0731707317073171,0.04117547077105886,544,"I don't really mind, but he won't let me wear my hat."
2125,0,3,38,41,1.0731707317073171,0.04117547077105886,544,They say this layout encourages idea sharing.
2125,1,1,39,41,1.0731707317073171,0.05399010639311867,544,We need to reduce our overhead.
2125,0,3,38,41,1.0731707317073171,0.04117547077105886,544,LOL; UR<; IM>
2125,1,1,39,41,1.0731707317073171,0.05399010639311867,544,I think they call it corporate downsizing.
2125,1,1,39,41,1.0731707317073171,0.05399010639311867,544,"Well, our head financial adviser recommends to let him take care of the small stuff and we should concentrate on the larger investment possibilities."
2125,0,3,38,41,1.0731707317073171,0.04117547077105886,544,"Instead of telling you, how about I send you a mental email?"
2125,0,3,38,41,1.0731707317073171,0.04117547077105886,544,"Work, work, work... It's always on my mind, too."
2125,0,3,38,41,1.0731707317073171,0.04117547077105886,544,My subconscious is really beginning to piss me off.
2125,1,1,39,41,1.0731707317073171,0.05399010639311867,544,It's amazing how different we are!
2125,0,3,38,41,1.0731707317073171,0.04117547077105886,544,"My wife says I need to cut the cord, but mother says I have to keep him."
2125,1,1,39,41,1.0731707317073171,0.05399010639311867,544,Looking forward to being a total dizz when I retire.
2125,1,1,39,41,1.0731707317073171,0.05399010639311867,544,"So, how's middle management treating you?"
2125,0,3,38,41,1.0731707317073171,0.04117547077105886,544,Let's follow up with Facetime.
2125,1,1,39,41,1.0731707317073171,0.05399010639311867,544,"Yes, faster than the cloud, but I wish I'd sprung for the cocobolo."
2125,1,1,39,41,1.0731707317073171,0.05399010639311867,544,Have your guy call my guy.
2125,0,3,38,41,1.0731707317073171,0.04117547077105886,544,"Stanford, Schmanford! Mine has a Harvard MBA!"
2125,0,3,38,41,1.0731707317073171,0.04117547077105886,544,Met you new boss...same as my old boss.
2125,0,3,38,41,1.0731707317073171,0.04117547077105886,544,What I wrote was just off the top of my head.
2125,0,3,38,41,1.0731707317073171,0.04117547077105886,544,My artificial intelligence is smarter than yours.
2125,0,3,38,41,1.0731707317073171,0.04117547077105886,544,"If you think your desk is bigger than mine, I say you're dreaming."
2125,1,1,39,41,1.0731707317073171,0.05399010639311867,544,"They're not heavy, they're our brothers."
2125,1,1,39,41,1.0731707317073171,0.05399010639311867,544,"I've got 'work balance' down, now I just need the 'life' part."
2125,1,1,39,41,1.0731707317073171,0.05399010639311867,544,"With the latest polling techniques, pretty soon we won't even need to bother holding elections."
2125,1,1,39,41,1.0731707317073171,0.05399010639311867,544,"Oh yeah, well I have something heavy on my mind as well."
2125,0,3,38,41,1.0731707317073171,0.04117547077105886,544,I know all your passwords now.
2125,0,3,38,41,1.0731707317073171,0.04117547077105886,544,"My secretary sometimes combs my hair with his feet. But he has a girlfriend, so it's chill."
2125,0,3,38,41,1.0731707317073171,0.04117547077105886,544,"Yes, clean desk = clean mind."
2125,0,3,38,41,1.0731707317073171,0.04117547077105886,544,I think Google Hat will do as well as Google Glass.
2125,1,1,39,41,1.0731707317073171,0.05399010639311867,544,"Activity tracker alerted: Quick, shift to left buttock!"
2125,0,3,38,41,1.0731707317073171,0.04117547077105886,544,Having a bad hair day too?
2125,0,3,38,41,1.0731707317073171,0.04117547077105886,544,"No George, YOU always have work on YOUR mind."
2125,0,3,38,41,1.0731707317073171,0.04117547077105886,544,I see you made a deal with the man too.
2125,0,3,38,41,1.0731707317073171,0.04117547077105886,544,"They say, ""Great minds Google alike."""
2125,1,1,39,41,1.0731707317073171,0.05399010639311867,544,I've got your pencils.
2125,0,3,38,41,1.0731707317073171,0.04117547077105886,544,We could be the victims of downsizing.
2125,0,3,38,41,1.0731707317073171,0.04117547077105886,544,Just a little advice if you want to move up the corporate ladder...pencils.
2125,0,3,38,41,1.0731707317073171,0.04117547077105886,544,"So, this is how you have a head-to-head competition."
2125,1,1,39,41,1.0731707317073171,0.05399010639311867,544,You talkin' to you?
2125,1,1,39,41,1.0731707317073171,0.05399010639311867,544,That's my person talking to your person.
2125,1,1,39,41,1.0731707317073171,0.05399010639311867,544,"What do you mean, you can't see yourself working late?"
2125,0,3,38,41,1.0731707317073171,0.04117547077105886,544,My new app... it's like Google glasses but for executives.
2125,0,3,38,41,1.0731707317073171,0.04117547077105886,544,You negotiated the hard legal fee caps.
2125,0,3,38,41,1.0731707317073171,0.04117547077105886,544,I thought having technology implanted in my head would be less noticeable.
2125,1,1,39,41,1.0731707317073171,0.05399010639311867,544,Dont you ever feel like technology is taking over your brain.
2125,1,1,39,41,1.0731707317073171,0.05399010639311867,544,When will the office learn we want to be left alone??
2125,0,3,38,41,1.0731707317073171,0.04117547077105886,544,"Man, talking to you is taxing."
2125,1,1,39,41,1.0731707317073171,0.05399010639311867,544,Why am I suddenly thinking of kittens with baby ducks right now.?
2125,0,3,38,41,1.0731707317073171,0.04117547077105886,544,"They may be high-minded, but are they top value?"
2125,1,1,39,41,1.0731707317073171,0.05399010639311867,544,""" I have always thought that two heads were better than one""!"
2125,1,1,39,41,1.0731707317073171,0.05399010639311867,544,"its ok, tax season is approaching it's normal to have our accountants on our minds"
2125,1,1,39,41,1.0731707317073171,0.05399010639311867,544,I don't think it was such a good idea to upgrade the voices in our head to VoIP
2125,0,3,38,41,1.0731707317073171,0.04117547077105886,544,Those two are really going head to head in order to get ahead!
2125,0,3,38,41,1.0731707317073171,0.04117547077105886,544,How do YOU deal with being micro-managed?
2125,1,1,39,41,1.0731707317073171,0.05399010639311867,544,"'That's funny, my left side is so logical but I still voted for him."""
2125,0,3,38,41,1.0731707317073171,0.04117547077105886,544,I'm glad I didn't go for the i-Desk Plus.
2125,0,3,38,41,1.0731707317073171,0.04117547077105886,544,"Like you, I've always had a head for figures."
2125,0,3,38,41,1.0731707317073171,0.04117547077105886,544,Why can't we think outside the box?
2125,0,3,38,41,1.0731707317073171,0.04117547077105886,544,It's a work station and a bald spot cover and you are a selfie. It's a work station and a bald spot cover.
2125,0,3,38,41,1.0731707317073171,0.04117547077105886,544,"I don't know about you, but the micro bureaucrat with his micro computer is giving me a macro headache."
2125,1,1,39,41,1.0731707317073171,0.05399010639311867,544,"It's weird, but we can see where you're going with this."
2125,0,3,38,41,1.0731707317073171,0.04117547077105886,544,"Well, speaking off the top of my head, I expect we think the same way."
2125,0,3,38,41,1.0731707317073171,0.04117547077105886,544,Have your people give my people the name the name of your salon.
2125,0,3,38,41,1.0731707317073171,0.04117547077105886,544,I see you also work at Headbook.
2125,1,1,39,41,1.0731707317073171,0.05399010639311867,544,This is the only way I know of getting ahead.
2125,0,3,38,41,1.0731707317073171,0.04117547077105886,544,You'll wonder how you ever got by without autocorrect.
2125,0,3,38,41,1.0731707317073171,0.04117547077105886,544,"Sync, don't blink!"
2125,0,3,38,41,1.0731707317073171,0.04117547077105886,544,"Warnin' you: it's tripled spaced, but, hey, I gotta be me!"
2125,0,3,38,41,1.0731707317073171,0.04117547077105886,544,I look ridiculous?
2125,1,1,39,41,1.0731707317073171,0.05399010639311867,544,I see you're running Windows 19 too.
2125,1,1,39,41,1.0731707317073171,0.05399010639311867,544,"A: ""I'm stuck!"" B: ""Press Ctrl+Alt+Delete"""
2125,1,1,39,41,1.0731707317073171,0.05399010639311867,544,I've heard they want to eliminate duplication of effort.
2125,0,3,38,41,1.0731707317073171,0.04117547077105886,544,All I think about is work.
2125,0,3,38,41,1.0731707317073171,0.04117547077105886,544,My wife hates it when I bring work home.
2125,0,3,38,41,1.0731707317073171,0.04117547077105886,544,Would you like a pen?
2125,1,1,39,41,1.0731707317073171,0.05399010639311867,544,Maybe we've been putting in too many hours.
2125,0,3,38,41,1.0731707317073171,0.04117547077105886,544,Beards are out. Desk hats are in.
2125,0,3,38,41,1.0731707317073171,0.04117547077105886,544,Who are you wearing?
2125,0,3,38,41,1.0731707317073171,0.04117547077105886,544,You're redundant.
2125,1,1,39,41,1.0731707317073171,0.05399010639311867,544,Do you think the FBI has something on us?
2125,1,1,39,41,1.0731707317073171,0.05399010639311867,544,Our relationship's become so. . . virtual. Can't we just talk?
2125,1,1,39,41,1.0731707317073171,0.05399010639311867,544,This isn't what I had in mind when I agreed to work from home.
2125,1,1,39,41,1.0731707317073171,0.05399010639311867,544,"""Does he know that I wear nothing under the desk?"", both man wonders."
2125,0,3,38,41,1.0731707317073171,0.04117547077105886,544,I hate having our brains audited
2125,1,1,39,41,1.0731707317073171,0.05399010639311867,544,I always bring my work home with me. You?
2125,1,1,39,41,1.0731707317073171,0.05399010639311867,544,"What are you working on?"" ""What are you working on?"
2125,0,3,38,41,1.0731707317073171,0.04117547077105886,544,"We need to talk over lunch, I'll have my people get in touch with your people."
2125,1,1,39,41,1.0731707317073171,0.05399010639311867,544,"Owning our own business is great, but the office overhead is killing us!"
2125,0,3,38,41,1.0731707317073171,0.04117547077105886,544,"Have your people call my people, and we'll Skype"
2125,0,3,38,41,1.0731707317073171,0.04117547077105886,544,"Brain storm , or soft wear and tear ?"
2125,0,3,38,41,1.0731707317073171,0.04117547077105886,544,"OK, your telling me 'I' have a man at a desk on 'MY' head! Dude you are suffering from a classic case of projection"
2125,0,3,38,41,1.0731707317073171,0.04117547077105886,544,I'm the head of the foreign desk.
2125,1,1,39,41,1.0731707317073171,0.05399010639311867,544,"Whether we're left brain or right brain, bringing the office home with us each night is a headache."
2125,0,3,38,41,1.0731707317073171,0.04117547077105886,544,"just a second, my brain is still booting up."
2125,0,3,38,41,1.0731707317073171,0.04117547077105886,544,"Do you remember if I sent you that e-mail, off the top of your head?"
2125,0,3,38,41,1.0731707317073171,0.04117547077105886,544,I feel like work is always on my mind these days
2125,1,1,39,41,1.0731707317073171,0.05399010639311867,544,Lunch tomorrow? I will have my admin text yours.
2125,0,3,38,41,1.0731707317073171,0.04117547077105886,544,The boss said these hats will keep us focused
2125,0,3,38,41,1.0731707317073171,0.04117547077105886,544,They did say that desktops were going to make a comeback.
2125,0,3,38,41,1.0731707317073171,0.04117547077105886,544,I like the way you think!
2125,0,3,38,41,1.0731707317073171,0.04117547077105886,544,Can you send me an email to remind me I really need to speak with you in person?
2125,0,3,38,41,1.0731707317073171,0.04117547077105886,544,"No, there's no one on my head. Why, is there someone on your head?"
2125,1,1,39,41,1.0731707317073171,0.05399010639311867,544,"When they talk about their jobs, it all goes over my head."
2125,0,3,38,41,1.0731707317073171,0.04117547077105886,544,"Oh man, you have the same hat."
2125,0,3,38,41,1.0731707317073171,0.04117547077105886,544,"Left brain...right brain, for me they are both the same."
2125,0,3,38,41,1.0731707317073171,0.04117547077105886,544,The world has regressed back to prehistoric times--non-verbal communication.
2125,1,1,39,41,1.0731707317073171,0.05399010639311867,544,Why do always have to dress like me?
2125,0,3,38,41,1.0731707317073171,0.04117547077105886,544,"Yeah, I clicked on ""gray fedora"" too."
2125,0,3,38,41,1.0731707317073171,0.04117547077105886,544,"No, the boss likes me best!"
2125,0,3,38,41,1.0731707317073171,0.04117547077105886,544,We cannot be accused of not having our heads in the job.
2125,0,3,38,41,1.0731707317073171,0.04117547077105886,544,Does yours sync with your iWatch?
2125,0,3,38,41,1.0731707317073171,0.04117547077105886,544,"I use my head in my desk job, you?"
2125,1,1,39,41,1.0731707317073171,0.05399010639311867,544,"You got any aspirin, my head's killing me!"
2125,0,3,38,41,1.0731707317073171,0.04117547077105886,544,16 hour days and both of us have finally gotten a head.
2125,1,1,39,41,1.0731707317073171,0.05399010639311867,544,"When I was told some of us would be moving up in the company, I had something different in mind."
2125,0,3,38,41,1.0731707317073171,0.04117547077105886,544,"""I was going to ask you the same thing""."
2125,0,3,38,41,1.0731707317073171,0.04117547077105886,544,"1) ""Every time I sneeze, my Workers Comp premium goes up ..."" 2) ""I've been writing my hat off as a business expense for years..."" 3) ""Don't go to bed without first removing the chair mat..."""
2125,1,1,39,41,1.0731707317073171,0.05399010639311867,544,"Seriously? I have guy-working-at-desk hair, too?"
2125,0,3,38,41,1.0731707317073171,0.04117547077105886,544,our thoughts are not our own.
2125,0,3,38,41,1.0731707317073171,0.04117547077105886,544,I see you're also wearing your thinking cap.
2125,0,3,38,41,1.0731707317073171,0.04117547077105886,544,It's almost like you can read my mind.
2125,0,3,38,41,1.0731707317073171,0.04117547077105886,544,"Funny, the voice in my head says the exact same thing."
2125,1,1,39,41,1.0731707317073171,0.05399010639311867,544,I just gave my brain desk a huge raise!
2125,0,3,38,41,1.0731707317073171,0.04117547077105886,544,I have something I need to tell you but I can't get a connection.
2125,1,1,39,41,1.0731707317073171,0.05399010639311867,544,"When they asked if I wanted to be computerized, I was thinking more like a chip."
2125,0,3,38,41,1.0731707317073171,0.04117547077105886,544,"Who was the genius who said, ""Two desks are better than one?"""
2125,0,3,38,41,1.0731707317073171,0.04117547077105886,544,"Next time, let's pay full price for hair restorers."
2125,0,3,38,41,1.0731707317073171,0.04117547077105886,544,"At first I was resistant, but now I don't know how I could function without a little desk head guy."
2125,1,1,39,41,1.0731707317073171,0.05399010639311867,544,"Okay, my guy will get in touch with yours."
2125,1,1,39,41,1.0731707317073171,0.05399010639311867,544,It's not what I expected A.I. to be.
2125,0,3,38,41,1.0731707317073171,0.04117547077105886,544,No. My guy is the left brained one!
2125,0,3,38,41,1.0731707317073171,0.04117547077105886,544,I think we're all feeling the weightiness of our line of business.
2125,0,3,38,41,1.0731707317073171,0.04117547077105886,544,Let me think about it... I'll have my inner voice contact your inner voice.
2125,0,3,38,41,1.0731707317073171,0.04117547077105886,544,So how long have you been in technical support?
2125,1,1,39,41,1.0731707317073171,0.05399010639311867,544,The life of a giant was so much easier in the old days.
2125,1,1,39,41,1.0731707317073171,0.05399010639311867,544,Find coffee near me.
2125,1,1,39,41,1.0731707317073171,0.05399010639311867,544,The good news is they've really lowered our overhead.
2125,0,3,38,41,1.0731707317073171,0.04117547077105886,544,Nate Silver says there's a 31% chance of a desk growing out of my head.
2125,1,1,39,41,1.0731707317073171,0.05399010639311867,544,Input meets Putin
2125,0,3,38,41,1.0731707317073171,0.04117547077105886,544,"Definitely, we're in a left brain right brain conflict!"
2125,1,1,39,41,1.0731707317073171,0.05399010639311867,544,"Well, they must have free will."
2125,1,1,39,41,1.0731707317073171,0.05399010639311867,544,Personnel downsizing; he covers angel and devil.
2125,0,3,38,41,1.0731707317073171,0.04117547077105886,544,Somehow I had expected more from wearable computing.
2125,0,3,38,41,1.0731707317073171,0.04117547077105886,544,How're you enjoying Google HeadMail?
2125,1,1,39,41,1.0731707317073171,0.05399010639311867,544,I predicted your staff cut!
2125,0,3,38,41,1.0731707317073171,0.04117547077105886,544,Fortunately for us we now live in a paperless society.
2125,0,3,38,41,1.0731707317073171,0.04117547077105886,544,"There's an accountant, with a desktop and a landline on my head too?"
2125,0,3,38,41,1.0731707317073171,0.04117547077105886,544,"""Are you surfing what I'm surfing?"
2125,1,1,39,41,1.0731707317073171,0.05399010639311867,544,If we could only get them to speak to one another!
2125,1,1,39,41,1.0731707317073171,0.05399010639311867,544,Not my idea of work/life balance
2125,0,3,38,41,1.0731707317073171,0.04117547077105886,544,I miss my porn fantasies. You?
2125,0,3,38,41,1.0731707317073171,0.04117547077105886,544,I told you to leave the office at work
2125,0,3,38,41,1.0731707317073171,0.04117547077105886,544,My hair stylist was pretty annoyed.
2502,0,3,39,42,1.0714285714285714,0.04022089331224806,544,Aha! I think I've finally figured out how to get into his head!
2502,0,3,39,42,1.0714285714285714,0.04022089331224806,544,"I see you've got the WiFi Sci-Fi Network connection, too."
2502,1,1,40,42,1.0714285714285714,0.05271774316741633,544,These lidtops are not as convenient as our laptops.
2502,1,1,40,42,1.0714285714285714,0.05271774316741633,544,"So, less than symbol, HTML, greater than symbol, less than symbol, TITLE, greater than symbol, less than symbol, IMG SRC=’desk.jpg’, ALIGN=’TOP’, greater than symbol…."
2502,1,1,40,42,1.0714285714285714,0.05271774316741633,544,How's work? Off the top of my head I would say fine - How bout you?
2502,0,3,39,42,1.0714285714285714,0.04022089331224806,544,"Still, the nice part is we can work from home"
2502,1,1,40,42,1.0714285714285714,0.05271774316741633,544,"Okay, seriously, what the fuck is going on here?"
2502,1,1,40,42,1.0714285714285714,0.05271774316741633,544,You have to have a head for business to succeed in this company!
2502,0,3,39,42,1.0714285714285714,0.04022089331224806,544,Why don't I get a stapler?
2502,1,1,40,42,1.0714285714285714,0.05271774316741633,544,Personal accounting has come a long way.
2502,0,3,39,42,1.0714285714285714,0.04022089331224806,544,"From what I see, we are on the same page?"
2502,1,1,40,42,1.0714285714285714,0.05271774316741633,544,Face it we're at loggerheads.
2502,0,3,39,42,1.0714285714285714,0.04022089331224806,544,This twins research is starting to wear on me.
2502,1,1,40,42,1.0714285714285714,0.05271774316741633,544,"I can't answer that, you'll have to go through my PA."
2502,1,1,40,42,1.0714285714285714,0.05271774316741633,544,Another My amygdala struggles with live feeds.
2502,1,1,40,42,1.0714285714285714,0.05271774316741633,544,I just get him to check with PR to make sure I dont say anything stupid. We've outsourced PR to the same team managing the presidential campaigns.
2502,0,3,39,42,1.0714285714285714,0.04022089331224806,544,"Off the top of my head, I can't think of a more convient CPA firm."
2502,0,3,39,42,1.0714285714285714,0.04022089331224806,544,The world is getting to technical for me.
2502,1,1,40,42,1.0714285714285714,0.05271774316741633,544,"I know, I've got work on my mind all the time too."
2502,0,3,39,42,1.0714285714285714,0.04022089331224806,544,I suppose there had to be a downside to this brain augmentation process
2502,0,3,39,42,1.0714285714285714,0.04022089331224806,544,We're trying out new training methods.
2502,0,3,39,42,1.0714285714285714,0.04022089331224806,544,"You brought work home, too? Let's just order out tonight."
2502,0,3,39,42,1.0714285714285714,0.04022089331224806,544,"Proof that if you work hard, you can get a head."
2502,0,3,39,42,1.0714285714285714,0.04022089331224806,544,You only think you know me.
2502,0,3,39,42,1.0714285714285714,0.04022089331224806,544,My work-life balance is precarious at best.
2502,0,3,39,42,1.0714285714285714,0.04022089331224806,544,I see that you let the job go to your head too!
2502,1,1,40,42,1.0714285714285714,0.05271774316741633,544,"Another Singularity-Beta tester, I presume?"
2529,0,3,40,43,1.069767441860465,0.03930950021993099,544,I leave my phone at home now.
2529,0,3,40,43,1.069767441860465,0.03930950021993099,544,I'm confused.......are you the email inbox or the email trash?
2529,0,3,40,43,1.069767441860465,0.03930950021993099,544,The left hand does not know what the Right Hand is doing
2529,1,1,41,43,1.069767441860465,0.051503946641122844,544,"Phil, are you also having a hallucination that each of our desks are sitting on big heads with anxious expressions?"
2529,0,3,40,43,1.069767441860465,0.03930950021993099,544,"As an ""alter ego"", I have to say you're a huge disappointment."
2529,1,1,41,43,1.069767441860465,0.051503946641122844,544,"I hit my 30's, and suddenly had free real estate up there."
2529,1,1,41,43,1.069767441860465,0.051503946641122844,544,These hats aren't selling like I'd hoped.
2529,0,3,40,43,1.069767441860465,0.03930950021993099,544,I have a split-screen headache.
2529,1,1,41,43,1.069767441860465,0.051503946641122844,544,"I'm not crazy about the look. But on the plus side, the toupée practically pays for itself."
2538,0,3,41,44,1.0681818181818181,0.03843843094202265,544,My guy will get up with your guy to confirm.
2539,0,2,37,39,1.0512820512820513,0.03578157512432619,544,"Yea, my company's downsizing, too in an effort to ""stay ahead"""
2539,0,2,37,39,1.0512820512820513,0.03578157512432619,544,Do you have something on your mind you want to get off?....Do YOU have something on YOUR mind YOU want to get off?
2539,1,0,38,39,1.0512820512820513,0.05128205128205128,544,I'm thinking of upgrading him to a standing desk
2539,0,2,37,39,1.0512820512820513,0.03578157512432619,544,"No, I'm still of two minds about it."
2539,0,2,37,39,1.0512820512820513,0.03578157512432619,544,I suspect these headaches are work related.
2539,1,0,38,39,1.0512820512820513,0.05128205128205128,544,My skill set is better than yours. I have a backup system of pencils.
2539,0,2,37,39,1.0512820512820513,0.03578157512432619,544,It appears that some employees were taking the company's work-life balance challenge too literally.
2539,1,0,38,39,1.0512820512820513,0.05128205128205128,544,My simulation can kick your simulation's butt.
2539,0,2,37,39,1.0512820512820513,0.03578157512432619,544,My display of superior executive functioning got me to where I am today. You?
2539,1,0,38,39,1.0512820512820513,0.05128205128205128,544,"I hate the whole ""mobile office"" concept."
2539,1,0,38,39,1.0512820512820513,0.05128205128205128,544,My server used to be in my garage and I see you're bringing your server with you too as well as your operator.
2539,0,2,37,39,1.0512820512820513,0.03578157512432619,544,DO I HAVE A MAN AT A DESK ON MY HEAD YOU HAVE A MAN AT A DESK ON YOUR HEAD
2539,0,2,37,39,1.0512820512820513,0.03578157512432619,544,"Maybe we should break up, we've both got a lot on our minds right now."
2539,0,2,37,39,1.0512820512820513,0.03578157512432619,544,"Not marbles, pencils - you've lost your pencils."
2539,0,2,37,39,1.0512820512820513,0.03578157512432619,544,I've got work on my mind too
2539,0,2,37,39,1.0512820512820513,0.03578157512432619,544,"Is work always on your mind, too?"
2539,0,2,37,39,1.0512820512820513,0.03578157512432619,544,The reason for the recent downsizing of the company is completely over my head.
2539,0,2,37,39,1.0512820512820513,0.03578157512432619,544,Who knew that being office space pays more than an internship?
2539,0,2,37,39,1.0512820512820513,0.03578157512432619,544,"I see it hasn't solved your bulging eye problem, either."
2539,0,2,37,39,1.0512820512820513,0.03578157512432619,544,We just don't click anymore.
2539,0,2,37,39,1.0512820512820513,0.03578157512432619,544,"WikiLeaks to Russian Hackers: ""We tried our best, but Hillary still won."""
2539,0,2,37,39,1.0512820512820513,0.03578157512432619,544,I can't seem to get the office off my head
2539,0,2,37,39,1.0512820512820513,0.03578157512432619,544,"We're identical twins, remember?"
2539,0,2,37,39,1.0512820512820513,0.03578157512432619,544,Is my ISP on straight?
2539,0,2,37,39,1.0512820512820513,0.03578157512432619,544,Do you ever feel as if someone else is controlling you?
2539,1,0,38,39,1.0512820512820513,0.05128205128205128,544,"Spare me the accusations, big nose, why the hell would I want two pencil containers?"
2539,0,2,37,39,1.0512820512820513,0.03578157512432619,544,I actually prefer it to a standing desk.
2539,0,2,37,39,1.0512820512820513,0.03578157512432619,544,I guess they've given us a head start again.
2539,0,2,37,39,1.0512820512820513,0.03578157512432619,544,I've found the 6th difference...your nose is slightly larger than mine!
2539,0,2,37,39,1.0512820512820513,0.03578157512432619,544,"Somehow, I feel connected to you."
2539,0,2,37,39,1.0512820512820513,0.03578157512432619,544,Bet my porn's better than yours.
2539,0,2,37,39,1.0512820512820513,0.03578157512432619,544,"I hate it when he says..."" take a little off the top"" ."
2539,0,2,37,39,1.0512820512820513,0.03578157512432619,544,These new A.I. devices lack common sense.
2539,0,2,37,39,1.0512820512820513,0.03578157512432619,544,"Like you, I've always had a good head for business."
2539,0,2,37,39,1.0512820512820513,0.03578157512432619,544,When an accountant has a left brain and right brain dispute
2539,0,2,37,39,1.0512820512820513,0.03578157512432619,544,My computer can beat your computer.
2539,0,2,37,39,1.0512820512820513,0.03578157512432619,544,looks like you have work on your mind
2539,0,2,37,39,1.0512820512820513,0.03578157512432619,544,It's out of our pay grade. Let the head honchos decide.
2539,0,2,37,39,1.0512820512820513,0.03578157512432619,544,"I don't understand, your guy emailed my guy with 'them' as the header?"
2539,1,0,38,39,1.0512820512820513,0.05128205128205128,544,"The Availability Heuristic—We no longer see the world with our eyes, but rather, through the internet."
2539,0,2,37,39,1.0512820512820513,0.03578157512432619,544,1100000110100100101010010100001001001001001010.
2539,0,2,37,39,1.0512820512820513,0.03578157512432619,544,"Constantly fantasizing about ALEXA, SIRI and CORTANA kept me from getting much work done, but Frank seems to keep me on task."
2539,0,2,37,39,1.0512820512820513,0.03578157512432619,544,"When the boss said he values transparency, I imagined something different."
2539,0,2,37,39,1.0512820512820513,0.03578157512432619,544,Ixnay on the upgradeway alktay.
2539,0,2,37,39,1.0512820512820513,0.03578157512432619,544,I'm thinking we double bill.
2539,0,2,37,39,1.0512820512820513,0.03578157512432619,544,Work is always on my mind!
2539,0,2,37,39,1.0512820512820513,0.03578157512432619,544,Desk Club for men.
2539,0,2,37,39,1.0512820512820513,0.03578157512432619,544,"I know corporate said this would increase efficiency, but all my guy does is scroll Facebook"
2539,0,2,37,39,1.0512820512820513,0.03578157512432619,544,My wife thinks I'm obsessed with work. Do you think that's a problem?
2539,0,2,37,39,1.0512820512820513,0.03578157512432619,544,It's their idea of work-life balance.
2539,1,0,38,39,1.0512820512820513,0.05128205128205128,544,We're being micromanaged to pieces.
2539,0,2,37,39,1.0512820512820513,0.03578157512432619,544,#ditto
2539,0,2,37,39,1.0512820512820513,0.03578157512432619,544,"Bob, the memo should have read ""outsource admin work on THAT project,"" not ""outsource admin work on HAT project."""
2539,0,2,37,39,1.0512820512820513,0.03578157512432619,544,My guy will reach out to your guy
2539,0,2,37,39,1.0512820512820513,0.03578157512432619,544,"Look, this is just off the top of my head..."
2539,0,2,37,39,1.0512820512820513,0.03578157512432619,544,Wanna switch?
2539,0,2,37,39,1.0512820512820513,0.03578157512432619,544,I can't get work off my mind -- can you?
2539,0,2,37,39,1.0512820512820513,0.03578157512432619,544,Mine is buying and selling aardvarks. Yours?
2539,0,2,37,39,1.0512820512820513,0.03578157512432619,544,What's the emoticon for an 'Electronic Handshake?'
2539,0,2,37,39,1.0512820512820513,0.03578157512432619,544,Our minds are working overtime.
2539,1,0,38,39,1.0512820512820513,0.05128205128205128,544,Are you in or out?
2539,0,2,37,39,1.0512820512820513,0.03578157512432619,544,Have your conscience call my conscience.
2539,1,0,38,39,1.0512820512820513,0.05128205128205128,544,"Really? I can't get work off my mind, either!"
2539,1,0,38,39,1.0512820512820513,0.05128205128205128,544,We can simply kiss the old fashioned way Donald.
2539,1,0,38,39,1.0512820512820513,0.05128205128205128,544,"I've promised to release my brain, but only after the audit is complete."
2539,1,0,38,39,1.0512820512820513,0.05128205128205128,544,This down sizng has gone too far
2539,0,2,37,39,1.0512820512820513,0.03578157512432619,544,I'm thinking maybe a cat would have been better.
2539,0,2,37,39,1.0512820512820513,0.03578157512432619,544,I'm not sure that this was a new product worth lining up for.
2539,1,0,38,39,1.0512820512820513,0.05128205128205128,544,We have to cut down on overhead Welcome to head office What these guys do is over my head too Your guy's using a private email server too?
2539,0,2,37,39,1.0512820512820513,0.03578157512432619,544,Now they will answer your emails.
2539,1,0,38,39,1.0512820512820513,0.05128205128205128,544,They're the latest in security surveill - - - - .
2539,0,2,37,39,1.0512820512820513,0.03578157512432619,544,"Delete, delete!"
2539,0,2,37,39,1.0512820512820513,0.03578157512432619,544,So this is what you meant by uploading the desktop?
2539,0,2,37,39,1.0512820512820513,0.03578157512432619,544,Do we have to pass everything by the legal team?
2539,0,2,37,39,1.0512820512820513,0.03578157512432619,544,I'm not sure the bonus for joining the hair club is worth it.
2539,0,2,37,39,1.0512820512820513,0.03578157512432619,544,We never seem able to get work off of our minds.
2539,0,2,37,39,1.0512820512820513,0.03578157512432619,544,"Hey, you seem to have a lot of your mind."
2539,0,2,37,39,1.0512820512820513,0.03578157512432619,544,They didn't mention they'd be tackling our budget head-on.
2539,0,2,37,39,1.0512820512820513,0.03578157512432619,544,I'll have mind people call your people.
2539,1,0,38,39,1.0512820512820513,0.05128205128205128,544,Screenage Mutant Ninjas
2539,0,2,37,39,1.0512820512820513,0.03578157512432619,544,That computes.
2539,0,2,37,39,1.0512820512820513,0.03578157512432619,544,I really miss the days of the implanted chip...
2539,0,2,37,39,1.0512820512820513,0.03578157512432619,544,Wouldn't it be trippy if they had little guys at work on their heads?
2539,0,2,37,39,1.0512820512820513,0.03578157512432619,544,Let me calculate the overhead on that.
2539,0,2,37,39,1.0512820512820513,0.03578157512432619,544,I know my pencil holder don't make me head honcho.
2539,1,0,38,39,1.0512820512820513,0.05128205128205128,544,The new HR policy feels a little overboard.
2539,0,2,37,39,1.0512820512820513,0.03578157512432619,544,"Life was a lot more interesting before he figured out ""delete browser history""."
2539,0,2,37,39,1.0512820512820513,0.03578157512432619,544,"Up-sourcing is awesome, but I worry about infinite regress."
2539,0,2,37,39,1.0512820512820513,0.03578157512432619,544,This new cyber-security policy is ridiculous.
2539,0,2,37,39,1.0512820512820513,0.03578157512432619,544,Is it mind control or are we two really dull guys?
2539,0,2,37,39,1.0512820512820513,0.03578157512432619,544,"Now that I've got him, I don't have to take responsibility for any of my decisions"
2539,0,2,37,39,1.0512820512820513,0.03578157512432619,544,I'd join you at Trivia Night but mine leaves promptly at five.
2539,0,2,37,39,1.0512820512820513,0.03578157512432619,544,I don't like the way you think.
2539,0,2,37,39,1.0512820512820513,0.03578157512432619,544,"The only time I can relax anymore is when I get the ""Blue Screen of Death."
2539,0,2,37,39,1.0512820512820513,0.03578157512432619,544,"When I was told that I could work at the company's headquarters, I didn't know the job duties."
2539,0,2,37,39,1.0512820512820513,0.03578157512432619,544,I bet you get a lot of left-handed compliments.
2539,0,2,37,39,1.0512820512820513,0.03578157512432619,544,This outsourcing isn't really what I bargained for.
2539,1,0,38,39,1.0512820512820513,0.05128205128205128,544,"Same here. ""Have you a head for business?"", they said."
2539,1,0,38,39,1.0512820512820513,0.05128205128205128,544,I see you got the new Mack headtop.
2539,0,2,37,39,1.0512820512820513,0.03578157512432619,544,"I guess they took ""thinking out of the box"" literally."
2539,0,2,37,39,1.0512820512820513,0.03578157512432619,544,"I am fact checking your answer. Me too, your WRONG!"
2539,0,2,37,39,1.0512820512820513,0.03578157512432619,544,Just wait until you see the orthopedist.
2539,1,0,38,39,1.0512820512820513,0.05128205128205128,544,"you know, Sheldon, being identical twins doesn't mean we need to have the same office apparel."
2539,1,0,38,39,1.0512820512820513,0.05128205128205128,544,"Unlike the shoulder angel, he runs a full cost-benefit regression."
2539,1,0,38,39,1.0512820512820513,0.05128205128205128,544,I understand it all traces back to some tiny foreigner named Gulliver.
2539,0,2,37,39,1.0512820512820513,0.03578157512432619,544,Do you have the same migraine that I have?
2539,1,0,38,39,1.0512820512820513,0.05128205128205128,544,"""Mine handed a cease and desist letter to my barber""."
2539,0,2,37,39,1.0512820512820513,0.03578157512432619,544,So I see you Fall intern is working out well too?
2539,1,0,38,39,1.0512820512820513,0.05128205128205128,544,"""What a loser, spending all day at that miserable job""."
2539,0,2,37,39,1.0512820512820513,0.03578157512432619,544,'And this is definitely what they mean by getting a head in business?'
2539,0,2,37,39,1.0512820512820513,0.03578157512432619,544,"He says technically we're right, but 'work hats off' is a kind of unwritten rule of Fight Club."
2539,0,2,37,39,1.0512820512820513,0.03578157512432619,544,I'll have my office call your office.
2539,0,2,37,39,1.0512820512820513,0.03578157512432619,544,Technology don't leave the office without it..
2539,0,2,37,39,1.0512820512820513,0.03578157512432619,544,Right brain vs left brain - can you see the difference???
2539,0,2,37,39,1.0512820512820513,0.03578157512432619,544,How DOES one improve one's executive functioning?
2539,0,2,37,39,1.0512820512820513,0.03578157512432619,544,No more slogan hats for me either.
2539,1,0,38,39,1.0512820512820513,0.05128205128205128,544,So what game are they playing again?
2539,1,0,38,39,1.0512820512820513,0.05128205128205128,544,It's not you it's me.
2539,0,2,37,39,1.0512820512820513,0.03578157512432619,544,This work assignment is not sinking in!
2539,0,2,37,39,1.0512820512820513,0.03578157512432619,544,"Upon reflection, it appears that my desk job dwells too heavily on my mind."
2539,0,2,37,39,1.0512820512820513,0.03578157512432619,544,Is your guy passive aggressive?
2539,1,0,38,39,1.0512820512820513,0.05128205128205128,544,Okay... But no sexting.
2539,1,0,38,39,1.0512820512820513,0.05128205128205128,544,"When your head and brain at work is still working double time, the stress is real."
2539,0,2,37,39,1.0512820512820513,0.03578157512432619,544,I forgot to turn my out-of-office on.
2539,0,2,37,39,1.0512820512820513,0.03578157512432619,544,Perhaps building the wall here will help us to ignore him.
2539,0,2,37,39,1.0512820512820513,0.03578157512432619,544,"When I said we needed more work-life balance, this is not what I had in mind."
2539,0,2,37,39,1.0512820512820513,0.03578157512432619,544,"""Reply y'all."" That one got me."
2539,0,2,37,39,1.0512820512820513,0.03578157512432619,544,I suggest you upgrade to 5 point 1.
2539,0,2,37,39,1.0512820512820513,0.03578157512432619,544,"Well, my subconscious is EF Hutton, and EF Hutton says..."
2539,1,0,38,39,1.0512820512820513,0.05128205128205128,544,This is not what I had in mind when I said we needed to get ahead on our work.
2539,0,2,37,39,1.0512820512820513,0.03578157512432619,544,"Something tells me your wife always complains about your ""office on the brain,"" too."
2539,1,0,38,39,1.0512820512820513,0.05128205128205128,544,What? You thought you were the only person in the world with a desk on your head?
2539,0,2,37,39,1.0512820512820513,0.03578157512432619,544,Something about this job is giving me headaches.
2539,0,2,37,39,1.0512820512820513,0.03578157512432619,544,How the right hand knows what the left hand is doing.
2539,0,2,37,39,1.0512820512820513,0.03578157512432619,544,I see you got work on your mind too.
2539,0,2,37,39,1.0512820512820513,0.03578157512432619,544,This is my first ultra-Skype.
2539,0,2,37,39,1.0512820512820513,0.03578157512432619,544,"I don't know, what's on your mind?"
2539,0,2,37,39,1.0512820512820513,0.03578157512432619,544,I see you joined the CPA for men club.
2539,0,2,37,39,1.0512820512820513,0.03578157512432619,544,"Hmm, ""Improve Your Executive Function!""- maybe the implantable chip would be worth the extra $89.99."
2539,0,2,37,39,1.0512820512820513,0.03578157512432619,544,I'll have my person will get ahold of your person.
2539,1,0,38,39,1.0512820512820513,0.05128205128205128,544,"Yeah, but Clinton said she didn't like cookie dough at a conference in 1987."
2539,0,2,37,39,1.0512820512820513,0.03578157512432619,544,What a coincidence that we both have the name Chirality!
2539,1,0,38,39,1.0512820512820513,0.05128205128205128,544,I am Prince Narwhal of Mozambique and I am reaching out to you with a unique financial offer that can make you a millionaire.
2539,0,2,37,39,1.0512820512820513,0.03578157512432619,544,"It always seems like I have work on my mind, but I've mostly been thinking about the office fantasy football league"
2539,0,2,37,39,1.0512820512820513,0.03578157512432619,544,"""I can never remember - am I the In Box or the Out Box""?"
2539,0,2,37,39,1.0512820512820513,0.03578157512432619,544,And life? It's hard enough balancing work.
2539,1,0,38,39,1.0512820512820513,0.05128205128205128,544,My googler sez......
2539,1,0,38,39,1.0512820512820513,0.05128205128205128,544,they never slip if you use a good glue.
2539,1,0,38,39,1.0512820512820513,0.05128205128205128,544,What does bi-polar mean?
2539,0,2,37,39,1.0512820512820513,0.03578157512432619,544,Did you catch the merger last night?
2539,0,2,37,39,1.0512820512820513,0.03578157512432619,544,Let's synchronize a fart.
2539,0,2,37,39,1.0512820512820513,0.03578157512432619,544,"I agree--it's heavier than the Galaxy 7, but it's worth the tradeoff."
2539,0,2,37,39,1.0512820512820513,0.03578157512432619,544,Got any more of those cookies?
2539,1,0,38,39,1.0512820512820513,0.05128205128205128,544,Mine works on retianer. Yours?
2539,0,2,37,39,1.0512820512820513,0.03578157512432619,544,The plans include an executive lounge on my nose.
2539,0,2,37,39,1.0512820512820513,0.03578157512432619,544,They said standing desks would be more ergonomic.
2539,0,2,37,39,1.0512820512820513,0.03578157512432619,544,When we agreed to job share we stayed on top and got a head.
2539,0,2,37,39,1.0512820512820513,0.03578157512432619,544,I'm considering leaving the Google beta-testing program.
2539,1,0,38,39,1.0512820512820513,0.05128205128205128,544,"Russia, and yours?"
2539,0,2,37,39,1.0512820512820513,0.03578157512432619,544,Remember when I could just hand you a thumb drive?
2539,0,2,37,39,1.0512820512820513,0.03578157512432619,544,"Is this what they mean by ""Think outside the box""?"
2539,0,2,37,39,1.0512820512820513,0.03578157512432619,544,Lets' do lunch. I'll have my ego contact your ego.
2539,0,2,37,39,1.0512820512820513,0.03578157512432619,544,"You should try drawing on the Right side of your brain, Charlie"
2539,1,0,38,39,1.0512820512820513,0.05128205128205128,544,Well?
2539,1,0,38,39,1.0512820512820513,0.05128205128205128,544,I'm suffering from a little brain freeze.
2539,1,0,38,39,1.0512820512820513,0.05128205128205128,544,"The twins had an idea on their brain to work in an office, side by side"
2539,0,2,37,39,1.0512820512820513,0.03578157512432619,544,"I don't know about you, but I found that cleaning out the filing cabinets was a real weight off."
2539,1,0,38,39,1.0512820512820513,0.05128205128205128,544,"I don't buy into the notion of face-time as an accurate measure of productivity, do you?"
2539,0,2,37,39,1.0512820512820513,0.03578157512432619,544,"So, what do you think of gotomeeting.com's new app?"
2539,1,0,38,39,1.0512820512820513,0.05128205128205128,544,Let's see how many new apps we can download in an hour
2539,0,2,37,39,1.0512820512820513,0.03578157512432619,544,Have you tried restarting?
2539,0,2,37,39,1.0512820512820513,0.03578157512432619,544,The resemblance IS uncanny.
2539,1,0,38,39,1.0512820512820513,0.05128205128205128,544,new mouse?
2539,0,2,37,39,1.0512820512820513,0.03578157512432619,544,It's like a song that you can't get out of your head. We can't stop thinking about work.
2539,0,2,37,39,1.0512820512820513,0.03578157512432619,544,"Ergonomically speaking, it's even better than a standing desk."
2539,0,2,37,39,1.0512820512820513,0.03578157512432619,544,Balancing personal time and work is going to my head.
2539,0,2,37,39,1.0512820512820513,0.03578157512432619,544,They'll think twice about falling down on the job.
2539,0,2,37,39,1.0512820512820513,0.03578157512432619,544,Not even two heads squared plus tech support can inspire a caption.
2539,0,2,37,39,1.0512820512820513,0.03578157512432619,544,Identical twins having identical thoughts
2539,0,2,37,39,1.0512820512820513,0.03578157512432619,544,"Bro, I said we should go as Chia pets, not CIA pests."
2539,0,2,37,39,1.0512820512820513,0.03578157512432619,544,"I can't catch a break. At last year's party, some guy was wearing the exact same tie as me."
2539,0,2,37,39,1.0512820512820513,0.03578157512432619,544,"When they installed the new mobile office app, I was warned that my system might not be compatible. But it's a free upload - so, of course."
2539,0,2,37,39,1.0512820512820513,0.03578157512432619,544,I just got mine too. Do you happen to know if they come with an optional chin strap?
2539,1,0,38,39,1.0512820512820513,0.05128205128205128,544,We need some help.
2539,0,2,37,39,1.0512820512820513,0.03578157512432619,544,It's a left brain-right brain thing.
2539,0,2,37,39,1.0512820512820513,0.03578157512432619,544,"Yes, I think we're on the same page."
2539,0,2,37,39,1.0512820512820513,0.03578157512432619,544,This isn't what I was expecting when they said we'd be getting standing desks.
2539,0,2,37,39,1.0512820512820513,0.03578157512432619,544,"Cool, we're hat twins again!"
2539,0,2,37,39,1.0512820512820513,0.03578157512432619,544,Talking Heads
2539,1,0,38,39,1.0512820512820513,0.05128205128205128,544,I've always had mousy hair.
2539,0,2,37,39,1.0512820512820513,0.03578157512432619,544,I miss the devil and angel on my shoulders. They didn't muss up my hair.
2539,0,2,37,39,1.0512820512820513,0.03578157512432619,544,Are you into artificial intelligence also?
2539,0,2,37,39,1.0512820512820513,0.03578157512432619,544,Perhaps Blackberet?
2539,0,2,37,39,1.0512820512820513,0.03578157512432619,544,Do you also spend every waking moment fantasizing about tech support?
2539,0,2,37,39,1.0512820512820513,0.03578157512432619,544,Executive function is overrated.
2539,1,0,38,39,1.0512820512820513,0.05128205128205128,544,I hate waking up with desk-head.
2539,0,2,37,39,1.0512820512820513,0.03578157512432619,544,I think we need to unplug.
2539,0,2,37,39,1.0512820512820513,0.03578157512432619,544,"I'm telling you, it's seasonal: ""Do you see what I see?"""
2539,0,2,37,39,1.0512820512820513,0.03578157512432619,544,I'll have my people get hold of your people.
2539,0,2,37,39,1.0512820512820513,0.03578157512432619,544,"Of all the hats you could have worn tonight, I can't believe you chose the identical Stephen Jones original!"
2539,0,2,37,39,1.0512820512820513,0.03578157512432619,544,"If you want to know what I'm really thinking, check my Facebook page."
2539,0,2,37,39,1.0512820512820513,0.03578157512432619,544,"Speaking off the top of your head's better than off the cuff, right?"
2539,0,2,37,39,1.0512820512820513,0.03578157512432619,544,I have a better head for business !
2539,1,0,38,39,1.0512820512820513,0.05128205128205128,544,I have the feeling you and I are connected somehow.
2539,0,2,37,39,1.0512820512820513,0.03578157512432619,544,I always thought I had a head for business........but you??
2539,0,2,37,39,1.0512820512820513,0.03578157512432619,544,"I don't know about you, but I missed the days of the fedora hat."
2539,0,2,37,39,1.0512820512820513,0.03578157512432619,544,"They told us that wearing these things will help us concentrate on work, but all I've been thinking about is how to kill my boss."
2539,0,2,37,39,1.0512820512820513,0.03578157512432619,544,How 'bout I have my guy call your guy?
2539,0,2,37,39,1.0512820512820513,0.03578157512432619,544,I know what you're thinking. We're both just a step below our dream jobs.
2539,0,2,37,39,1.0512820512820513,0.03578157512432619,544,"well, we are obviously very different....."
2539,0,2,37,39,1.0512820512820513,0.03578157512432619,544,"""Have you heard of that new hair product, 'Desk Away'?"
2539,0,2,37,39,1.0512820512820513,0.03578157512432619,544,I prefer the laptop version.
2539,0,2,37,39,1.0512820512820513,0.03578157512432619,544,"President Trump pioneered some ""interesting"" new NSA surveillance techniques."
2539,0,2,37,39,1.0512820512820513,0.03578157512432619,544,"Wait, I may have to have to reboot."
2539,0,2,37,39,1.0512820512820513,0.03578157512432619,544,Yours sort out what she wants yet?
2539,0,2,37,39,1.0512820512820513,0.03578157512432619,544,This whole work-life balance thing is driving me crazy.
2539,0,2,37,39,1.0512820512820513,0.03578157512432619,544,Oops. Should not have sent that email.
2539,0,2,37,39,1.0512820512820513,0.03578157512432619,544,What are the chances?!? Reunited after all these years and we both wear the same hat!
2539,0,2,37,39,1.0512820512820513,0.03578157512432619,544,Ever feel like your brain is running dial-up?
2539,1,0,38,39,1.0512820512820513,0.05128205128205128,544,"Cutbacks are imminent, according to the head office."
2539,0,2,37,39,1.0512820512820513,0.03578157512432619,544,I'm getting rid of him. He says he wants a bigger desk.
2539,0,2,37,39,1.0512820512820513,0.03578157512432619,544,On Fridays mine busts out the footmouse.
2539,0,2,37,39,1.0512820512820513,0.03578157512432619,544,"Hey, the boss wants that new cat video on his desk by 8 o'clock Monday morning."
2539,0,2,37,39,1.0512820512820513,0.03578157512432619,544,What happened to the 800 pound gorilla?
2539,0,2,37,39,1.0512820512820513,0.03578157512432619,544,Just say whatever's top-of-mind...
2539,0,2,37,39,1.0512820512820513,0.03578157512432619,544,The pencils I took from the office are weighing on my mind.
2539,0,2,37,39,1.0512820512820513,0.03578157512432619,544,I'm always grateful for your 'second opinion.'
2539,0,2,37,39,1.0512820512820513,0.03578157512432619,544,Have your telepath set up a meeting with my telepath
2539,0,2,37,39,1.0512820512820513,0.03578157512432619,544,And why is the right wing better?
2539,1,0,38,39,1.0512820512820513,0.05128205128205128,544,i am scared these presidential polls have almost got inside my head.
2539,0,2,37,39,1.0512820512820513,0.03578157512432619,544,Mine wants to use a VR headset.
2539,0,2,37,39,1.0512820512820513,0.03578157512432619,544,How do you spell synergy?
2539,1,0,38,39,1.0512820512820513,0.05128205128205128,544,Meet for lunch? Have your life-coach text mine.
2539,0,2,37,39,1.0512820512820513,0.03578157512432619,544,it's too late - I already pushed send.
2539,0,2,37,39,1.0512820512820513,0.03578157512432619,544,I didn't think sharing files was going to involve THIS!
2539,0,2,37,39,1.0512820512820513,0.03578157512432619,544,Where do you see yourself in five years?
2539,0,2,37,39,1.0512820512820513,0.03578157512432619,544,Very personal email servers
2539,0,2,37,39,1.0512820512820513,0.03578157512432619,544,My executive function is working fine. How's yours?
2539,0,2,37,39,1.0512820512820513,0.03578157512432619,544,Are we FaceTiming yet?
2539,1,0,38,39,1.0512820512820513,0.05128205128205128,544,I need some way to get the office out of my head.
2539,0,2,37,39,1.0512820512820513,0.03578157512432619,544,I thought these standing desks would be a little better on my back.
2539,0,2,37,39,1.0512820512820513,0.03578157512432619,544,Do you ever wish you had a job that would let you leave the office at work?
2539,0,2,37,39,1.0512820512820513,0.03578157512432619,544,"We're much alike, you and I, but there's little man on your head."
2539,0,2,37,39,1.0512820512820513,0.03578157512432619,544,I’m guessing we go to the same barber.
2539,1,0,38,39,1.0512820512820513,0.05128205128205128,544,Text me.
2539,0,2,37,39,1.0512820512820513,0.03578157512432619,544,Some say '...All intelligence is artificial.'
2539,1,0,38,39,1.0512820512820513,0.05128205128205128,544,I think my google-hat is tracking my thoughts.
2539,0,2,37,39,1.0512820512820513,0.03578157512432619,544,Two head are better than one.
2539,0,2,37,39,1.0512820512820513,0.03578157512432619,544,"I think the new i-hat, ahhhh, needs some fashion input."
2539,1,0,38,39,1.0512820512820513,0.05128205128205128,544,"Hey, can you past the stapler"
2539,0,2,37,39,1.0512820512820513,0.03578157512432619,544,So this is what they meant when they said we were going to be short staff?
2539,0,2,37,39,1.0512820512820513,0.03578157512432619,544,"I'd say, off the top of my head, it goes over 2500 by Thursday."
2539,0,2,37,39,1.0512820512820513,0.03578157512432619,544,"Off the top of my head, I think we see eye to eye on their proposal."
2539,0,2,37,39,1.0512820512820513,0.03578157512432619,544,See what I saw?
2539,1,0,38,39,1.0512820512820513,0.05128205128205128,544,I’m starting to prefer ‘casual Fridays’ to ‘freaky Fridays’—how about you?
2539,0,2,37,39,1.0512820512820513,0.03578157512432619,544,"The deal is rather complex, I'm afraid. In fact, I believe it's over both of our heads."
2539,1,0,38,39,1.0512820512820513,0.05128205128205128,544,Free Riders in a Organization!
2539,0,2,37,39,1.0512820512820513,0.03578157512432619,544,Admin gave us heads-up for conducting future meetings via email.
2539,0,2,37,39,1.0512820512820513,0.03578157512432619,544,"Sorry, my synapses are paused for updates."
2539,0,2,37,39,1.0512820512820513,0.03578157512432619,544,I'll have to check with the boss upstairs.
2539,1,0,38,39,1.0512820512820513,0.05128205128205128,544,You won't
2539,0,2,37,39,1.0512820512820513,0.03578157512432619,544,Don't you think this is getting just a little weird?
2539,0,2,37,39,1.0512820512820513,0.03578157512432619,544,I dare you to think about Gulliver's Travels.
2539,0,2,37,39,1.0512820512820513,0.03578157512432619,544,they say that we have balanced thoughts
2539,0,2,37,39,1.0512820512820513,0.03578157512432619,544,My boss has been riding me all week. You?
2539,0,2,37,39,1.0512820512820513,0.03578157512432619,544,I think you dropped your pen holder.
2539,0,2,37,39,1.0512820512820513,0.03578157512432619,544,So they can't replace us with machines if the machines are built into us.
2539,0,2,37,39,1.0512820512820513,0.03578157512432619,544,Have you tried turning your brain on and off?
2539,0,2,37,39,1.0512820512820513,0.03578157512432619,544,I feel we're very similar.
2539,0,2,37,39,1.0512820512820513,0.03578157512432619,544,Are you reading my mind?
2539,0,2,37,39,1.0512820512820513,0.03578157512432619,544,"They are not just the President and VP for the Hair Club for men, they are also clients."
2539,0,2,37,39,1.0512820512820513,0.03578157512432619,544,My wife's been complaining that I always have work on my mind too.
2539,0,2,37,39,1.0512820512820513,0.03578157512432619,544,I hate it when Nate and Fred play their head games.
2539,0,2,37,39,1.0512820512820513,0.03578157512432619,544,What's on your mind?
2539,0,2,37,39,1.0512820512820513,0.03578157512432619,544,Did you hack my costume?
2539,0,2,37,39,1.0512820512820513,0.03578157512432619,544,My directives come from head office
2539,1,0,38,39,1.0512820512820513,0.05128205128205128,544,Not what I had in mind for a Management Support position.
2539,1,0,38,39,1.0512820512820513,0.05128205128205128,544,Mine says he's not teleworking.
2539,1,0,38,39,1.0512820512820513,0.05128205128205128,544,Can you suggest three time windows this week for us to see eye-to-eye?
2539,0,2,37,39,1.0512820512820513,0.03578157512432619,544,The IT department made these wearable devices sound much cooler.
2539,0,2,37,39,1.0512820512820513,0.03578157512432619,544,My therapist said it's to improve my headspace.
2539,1,0,38,39,1.0512820512820513,0.05128205128205128,544,This is taking out-sourcing too far.
2539,0,2,37,39,1.0512820512820513,0.03578157512432619,544,"Every time the company starts downsizing, *we* have to carry the burden."
2539,1,0,38,39,1.0512820512820513,0.05128205128205128,544,I wish I had a hat as neat as yours
2539,0,2,37,39,1.0512820512820513,0.03578157512432619,544,That's what we ended up with after the boss returned from that office management conference in Africa.
2539,1,0,38,39,1.0512820512820513,0.05128205128205128,544,Need a pencil?
2539,0,2,37,39,1.0512820512820513,0.03578157512432619,544,"Frankly, I feel a little silly. Are you sure this will get us the job?"
2539,0,2,37,39,1.0512820512820513,0.03578157512432619,544,Why no pens or pencils?
2539,1,0,38,39,1.0512820512820513,0.05128205128205128,544,Is it my Analysis Paralysis or yours this time?
2539,0,2,37,39,1.0512820512820513,0.03578157512432619,544,They're just trying to get ahead in life.
2539,0,2,37,39,1.0512820512820513,0.03578157512432619,544,"When I said I'd work from home, I didn't think I'd have to take him with me. Did you?"
2539,0,2,37,39,1.0512820512820513,0.03578157512432619,544,I see you also have a real-time fact checker surgically installed. I finally took the plunge after the third presidential debate.
2539,0,2,37,39,1.0512820512820513,0.03578157512432619,544,"The voice in my head is saying ""No!"""
2539,0,2,37,39,1.0512820512820513,0.03578157512432619,544,"What's on your mind, Paul?"
2539,0,2,37,39,1.0512820512820513,0.03578157512432619,544,WeeWork is really taking off.
2539,0,2,37,39,1.0512820512820513,0.03578157512432619,544,"What does your tiny guy do when he needs to go to the bathroom?"" ""I don't care, we are no longer on speaking terms due to that very issue."
2539,0,2,37,39,1.0512820512820513,0.03578157512432619,544,We've been hacked!
2539,1,0,38,39,1.0512820512820513,0.05128205128205128,544,They say the devil is in the details!
2539,0,2,37,39,1.0512820512820513,0.03578157512432619,544,He gives me such a headache.
2539,0,2,37,39,1.0512820512820513,0.03578157512432619,544,Very few people mouse with their left hands.
2539,0,2,37,39,1.0512820512820513,0.03578157512432619,544,So this is what Bill Gates had in mind?
2539,0,2,37,39,1.0512820512820513,0.03578157512432619,544,This takes transplants too far!
2539,1,0,38,39,1.0512820512820513,0.05128205128205128,544,Did you get my e-mail?
2539,0,2,37,39,1.0512820512820513,0.03578157512432619,544,I'd like for you to meet the new head of my company.
2539,0,2,37,39,1.0512820512820513,0.03578157512432619,544,"Keep your chin up, we're all totally wired differently."
2539,0,2,37,39,1.0512820512820513,0.03578157512432619,544,"""Have you had trouble with balancing your work load and keeping your hair clean?"
2539,0,2,37,39,1.0512820512820513,0.03578157512432619,544,"I,ll bet you my headache is worse than your headache."
2539,0,2,37,39,1.0512820512820513,0.03578157512432619,544,"Off the top of my head, I don't know what I did with my pencils!"
2539,0,2,37,39,1.0512820512820513,0.03578157512432619,544,"I thought I was getting a fedora,,,you?"
2539,0,2,37,39,1.0512820512820513,0.03578157512432619,544,Mine comes with a free desktop.
2539,1,0,38,39,1.0512820512820513,0.05128205128205128,544,"Want to barbecue this weekend, or is that a bad idea?"
2539,0,2,37,39,1.0512820512820513,0.03578157512432619,544,Mine's a head writer
2539,0,2,37,39,1.0512820512820513,0.03578157512432619,544,Your pad or mine?
2539,0,2,37,39,1.0512820512820513,0.03578157512432619,544,This hair gel is a little stiff.
2539,0,2,37,39,1.0512820512820513,0.03578157512432619,544,"Did yours ask for a standing desk, too?"
2539,0,2,37,39,1.0512820512820513,0.03578157512432619,544,'At least they're still outside our heads.'
2539,1,0,38,39,1.0512820512820513,0.05128205128205128,544,Art. Commerce! Art! Commerce!! ART!!! COMMERCE!!!
2539,0,2,37,39,1.0512820512820513,0.03578157512432619,544,"No, I'm renting office space in your head."
2539,0,2,37,39,1.0512820512820513,0.03578157512432619,544,This micro-managing is giving me a headache. You?
2539,0,2,37,39,1.0512820512820513,0.03578157512432619,544,Let's talk offline.
2539,0,2,37,39,1.0512820512820513,0.03578157512432619,544,There was a time when we giants were on top.
2539,0,2,37,39,1.0512820512820513,0.03578157512432619,544,"The bureaucracy is weighing me down, too."
2539,1,0,38,39,1.0512820512820513,0.05128205128205128,544,"There's only one guy that works over me, too."
2539,0,2,37,39,1.0512820512820513,0.03578157512432619,544,I see your fact checker is hard at work this week.
2539,0,2,37,39,1.0512820512820513,0.03578157512432619,544,IT said they were going to install new office suites over the weekend. Didn't you get that e-mail?
2539,1,0,38,39,1.0512820512820513,0.05128205128205128,544,That's gonna leave a mark
2539,0,2,37,39,1.0512820512820513,0.03578157512432619,544,I see I'm not the only person with work on the brain.
2539,1,0,38,39,1.0512820512820513,0.05128205128205128,544,"Well, off the top of my head I would say we've been at this too long!"
2539,1,0,38,39,1.0512820512820513,0.05128205128205128,544,"So you believe in ""individualism""?"
2539,0,2,37,39,1.0512820512820513,0.03578157512432619,544,What do you do when yours needs a bathroom?
2539,0,2,37,39,1.0512820512820513,0.03578157512432619,544,"Remember, balance is the secret to a successful head office."
2539,0,2,37,39,1.0512820512820513,0.03578157512432619,544,Your googling ability is undeniable but it's what is on your desktop that matters!
2539,1,0,38,39,1.0512820512820513,0.05128205128205128,544,Be patient these reverse VR devices are the next big thing
2539,0,2,37,39,1.0512820512820513,0.03578157512432619,544,You have a call on line #1 from head office.
2539,1,0,38,39,1.0512820512820513,0.05128205128205128,544,"My internet is slow, give me a second"
2539,0,2,37,39,1.0512820512820513,0.03578157512432619,544,You get the same headaches?
2539,0,2,37,39,1.0512820512820513,0.03578157512432619,544,Who are these guys and how did they get on our heads?
2539,0,2,37,39,1.0512820512820513,0.03578157512432619,544,I am in over my head with my reflective pessimistic life.
2539,0,2,37,39,1.0512820512820513,0.03578157512432619,544,I had that problem too. But then I got him a quiet keyboard.
2539,0,2,37,39,1.0512820512820513,0.03578157512432619,544,I see you on me.
2539,0,2,37,39,1.0512820512820513,0.03578157512432619,544,They worked hard to get to the top.
2539,0,2,37,39,1.0512820512820513,0.03578157512432619,544,"Hello, help desk...how may I help you?"
2539,0,2,37,39,1.0512820512820513,0.03578157512432619,544,My hat says I'm all business. Yours?
2539,1,0,38,39,1.0512820512820513,0.05128205128205128,544,They told me this hat was one of a kind.
2539,0,2,37,39,1.0512820512820513,0.03578157512432619,544,The giant twins were too afraid to speak about what was on their minds.
2539,1,0,38,39,1.0512820512820513,0.05128205128205128,544,"This Virtual reality app. is suppose to let you feel like you are interacting with real people. But it feels like all it is, is a dumb looking hat. See you have virtual headaches too."
2539,0,2,37,39,1.0512820512820513,0.03578157512432619,544,We clicked on the first sight.
2539,0,2,37,39,1.0512820512820513,0.03578157512432619,544,I'm thinking of getting a standing desk.
2539,1,0,38,39,1.0512820512820513,0.05128205128205128,544,"I like my hair how it is now, but it thinks I should cut more and modernize it."
2539,0,2,37,39,1.0512820512820513,0.03578157512432619,544,I've had to learn to always work with my shoes off.
2539,1,0,38,39,1.0512820512820513,0.05128205128205128,544,"Profits are up, I just hate the splinters."
2539,0,2,37,39,1.0512820512820513,0.03578157512432619,544,Looks like we're taking a haircut.
2539,0,2,37,39,1.0512820512820513,0.03578157512432619,544,Thus proves that two heads are more innovative than one!
2539,1,0,38,39,1.0512820512820513,0.05128205128205128,544,Does yours also call himself an 'executive?'
2539,0,2,37,39,1.0512820512820513,0.03578157512432619,544,"No, it's you who is a head case."
2539,1,0,38,39,1.0512820512820513,0.05128205128205128,544,My barber hates it.
2539,0,2,37,39,1.0512820512820513,0.03578157512432619,544,It spawns ideas.
2539,1,0,38,39,1.0512820512820513,0.05128205128205128,544,Let's see you find five differences in our mental images ... and the little black dot’s don’t count!
2539,0,2,37,39,1.0512820512820513,0.03578157512432619,544,A clean desk is a clean mind.
2539,0,2,37,39,1.0512820512820513,0.03578157512432619,544,"So, let's talk about micro managers..."
2539,0,2,37,39,1.0512820512820513,0.03578157512432619,544,"Oh, I was thinking that telecommuting would be different; didn't you?"
2539,0,2,37,39,1.0512820512820513,0.03578157512432619,544,Where do you go for hats?
2539,1,0,38,39,1.0512820512820513,0.05128205128205128,544,i hate my wife
2539,0,2,37,39,1.0512820512820513,0.03578157512432619,544,Do you know who the new department head is going to be?
2539,0,2,37,39,1.0512820512820513,0.03578157512432619,544,I also have a little work on my mind.
2539,0,2,37,39,1.0512820512820513,0.03578157512432619,544,"'If you show me yours, I'll show you mine.'"
2539,0,2,37,39,1.0512820512820513,0.03578157512432619,544,I think that I know what you have on your mind.
2539,0,2,37,39,1.0512820512820513,0.03578157512432619,544,I agree that group think is is till an issue here
2539,1,0,38,39,1.0512820512820513,0.05128205128205128,544,email me.
2539,1,0,38,39,1.0512820512820513,0.05128205128205128,544,Good —LOL :)
2539,0,2,37,39,1.0512820512820513,0.03578157512432619,544,It's the office gossip that gets to me.
2539,1,0,38,39,1.0512820512820513,0.05128205128205128,544,Sometimes I hear voices in my head!
2539,0,2,37,39,1.0512820512820513,0.03578157512432619,544,It's hard to shake a micro-manager.
2539,1,0,38,39,1.0512820512820513,0.05128205128205128,544,"Here's a thought, just off the top of my head..."
2539,0,2,37,39,1.0512820512820513,0.03578157512432619,544,Did they tell you it's the only cure for baldness that works?
2539,1,0,38,39,1.0512820512820513,0.05128205128205128,544,I can never get ahead of you
2539,1,0,38,39,1.0512820512820513,0.05128205128205128,544,"You know Karl, we could just talk text in person..."
2539,0,2,37,39,1.0512820512820513,0.03578157512432619,544,The eyes are the Microsoft® Windows® to the soul.
2539,0,2,37,39,1.0512820512820513,0.03578157512432619,544,"Two execs thinking about Desk Set. Remember, Spencer Tracy was a computer expert & Katherine Hepburn was devine!"
2539,0,2,37,39,1.0512820512820513,0.03578157512432619,544,Getting a head at work.
2539,1,0,38,39,1.0512820512820513,0.05128205128205128,544,Your homunculus is sexting again.
2539,0,2,37,39,1.0512820512820513,0.03578157512432619,544,My writer's block is in remission; how about yours?
2539,0,2,37,39,1.0512820512820513,0.03578157512432619,544,I can't get work off my mind either.
2539,0,2,37,39,1.0512820512820513,0.03578157512432619,544,You want a caption? Let him google that for you.
2539,1,0,38,39,1.0512820512820513,0.05128205128205128,544,"I asked the IT Dept to back up everything, but this is ridiculous!"
2539,0,2,37,39,1.0512820512820513,0.03578157512432619,544,Mom always liked you best.
2539,0,2,37,39,1.0512820512820513,0.03578157512432619,544,I think I'm busy playing solitaire that night.
2539,1,0,38,39,1.0512820512820513,0.05128205128205128,544,And Dilbert thinks he has it bad.
2539,0,2,37,39,1.0512820512820513,0.03578157512432619,544,"I know, my wife too has been getting on me about taking work home with me."
2539,0,2,37,39,1.0512820512820513,0.03578157512432619,544,Accounting overhead got you down too?
2539,0,2,37,39,1.0512820512820513,0.03578157512432619,544,It feels like you're hacking my every thought.
2539,0,2,37,39,1.0512820512820513,0.03578157512432619,544,"When our COO mentioned having better work-life balance, I did not envision this."
2539,0,2,37,39,1.0512820512820513,0.03578157512432619,544,I've always felt we were connected in a way I just couldn't explain.
2539,1,0,38,39,1.0512820512820513,0.05128205128205128,544,Outsourcing is such a headache
2539,0,2,37,39,1.0512820512820513,0.03578157512432619,544,he's starting to get in my head
2539,0,2,37,39,1.0512820512820513,0.03578157512432619,544,"It would seem that ""One of a Kind Head Wear"" is somewhat misleading."
2539,0,2,37,39,1.0512820512820513,0.03578157512432619,544,Two Feds are better than one.
2539,0,2,37,39,1.0512820512820513,0.03578157512432619,544,You're trying to get ahead of your emails too?
2539,0,2,37,39,1.0512820512820513,0.03578157512432619,544,"Well, I still think accountant action figures are cool."
2539,0,2,37,39,1.0512820512820513,0.03578157512432619,544,"My guy started complaining that ""he's overworked and under-appreciated"", so I'm like I can replace you with a younger, faster, cheaper version from China...haven't heard a peep since."
2539,0,2,37,39,1.0512820512820513,0.03578157512432619,544,Did you get a haircut?
2539,1,0,38,39,1.0512820512820513,0.05128205128205128,544,"When you're ""old school"", you get pens."
2539,0,2,37,39,1.0512820512820513,0.03578157512432619,544,They review our dreams to determine which client to bill.
2539,1,0,38,39,1.0512820512820513,0.05128205128205128,544,Sometimes I feel like we're a hemisphere apart.
2539,0,2,37,39,1.0512820512820513,0.03578157512432619,544,Shots of tequila seem to lighten him up.
2539,0,2,37,39,1.0512820512820513,0.03578157512432619,544,"No, you're the weird one! The office drone that lives on your head is left-handed!"
2539,0,2,37,39,1.0512820512820513,0.03578157512432619,544,"Okay, let's ditch the conservative haircuts."
2539,0,2,37,39,1.0512820512820513,0.03578157512432619,544,I can't wait until they miniaturize these work implants!
2539,1,0,38,39,1.0512820512820513,0.05128205128205128,544,What is your right hand doing?... Enquiring minds want to know...
2539,0,2,37,39,1.0512820512820513,0.03578157512432619,544,And we thought quarterly performance reviews were bad.
2539,0,2,37,39,1.0512820512820513,0.03578157512432619,544,I thought we agreed not to take work home with us.
2539,0,2,37,39,1.0512820512820513,0.03578157512432619,544,Left brain - right brain. It's all the same to me.
2539,0,2,37,39,1.0512820512820513,0.03578157512432619,544,I always feel like somebody's watching me.
2539,0,2,37,39,1.0512820512820513,0.03578157512432619,544,I think it is about time for you to get your own hair stylist.
2539,0,2,37,39,1.0512820512820513,0.03578157512432619,544,"Well, now one of us has to change."
2539,1,0,38,39,1.0512820512820513,0.05128205128205128,544,Let's just say we're of two minds.
2539,0,2,37,39,1.0512820512820513,0.03578157512432619,544,"I watching Facebook, Twitter and porn -- how 'bout you?"
2539,0,2,37,39,1.0512820512820513,0.03578157512432619,544,We both shouldn't have deducted lunch last week.
2539,0,2,37,39,1.0512820512820513,0.03578157512432619,544,"Hey, dude, get off of my cloud"
2539,0,2,37,39,1.0512820512820513,0.03578157512432619,544,Things are so much better with life hacks
2539,1,0,38,39,1.0512820512820513,0.05128205128205128,544,Welcome to New York
2539,0,2,37,39,1.0512820512820513,0.03578157512432619,544,Why do you always disagree with me?
2539,0,2,37,39,1.0512820512820513,0.03578157512432619,544,You don't want to know where they put my id.
2539,0,2,37,39,1.0512820512820513,0.03578157512432619,544,May I pick your brains?
2539,0,2,37,39,1.0512820512820513,0.03578157512432619,544,Have you upgraded to version ten?
2539,1,0,38,39,1.0512820512820513,0.05128205128205128,544,Posture maketh the man.
2539,0,2,37,39,1.0512820512820513,0.03578157512432619,544,Man this place has really done a head job on both of us.
2539,1,0,38,39,1.0512820512820513,0.05128205128205128,544,"When ordering food online, always wear a hair internet."
2539,0,2,37,39,1.0512820512820513,0.03578157512432619,544,"So, does your super ego use Excel too?"
2539,1,0,38,39,1.0512820512820513,0.05128205128205128,544,Did anyone say something about lack of communication?
2539,0,2,37,39,1.0512820512820513,0.03578157512432619,544,I agree...telecommuting isn't much better than a desk job.
2539,0,2,37,39,1.0512820512820513,0.03578157512432619,544,Let's get a conference table and put our heads together.
2539,0,2,37,39,1.0512820512820513,0.03578157512432619,544,"Oh, you can read my mind. I'm getting that smart phone, too."
2539,1,0,38,39,1.0512820512820513,0.05128205128205128,544,This shampoo really works!
2539,0,2,37,39,1.0512820512820513,0.03578157512432619,544,"I know what you mean, work is always at the top of my mind too."
2539,1,0,38,39,1.0512820512820513,0.05128205128205128,544,They say you are your work.
2539,0,2,37,39,1.0512820512820513,0.03578157512432619,544,"A little above our heads, isn't it?"
2539,0,2,37,39,1.0512820512820513,0.03578157512432619,544,"It feels wrong to say so, but it makes me nostalgic for cubicles."
2539,0,2,37,39,1.0512820512820513,0.03578157512432619,544,I've always been amazed at how we think alike.
2539,0,2,37,39,1.0512820512820513,0.03578157512432619,544,Not it's even plugged in. Mine guy just likes hit the keys.
2539,1,0,38,39,1.0512820512820513,0.05128205128205128,544,I think our microaggressions are being microaudited.
2539,0,2,37,39,1.0512820512820513,0.03578157512432619,544,"Our barber will never admit I, but I'll bet he does better work for customers who tip well."
2539,0,2,37,39,1.0512820512820513,0.03578157512432619,544,You look ridiculous without the pencil jar.
2539,0,2,37,39,1.0512820512820513,0.03578157512432619,544,It;s always on my mind too.
2539,1,0,38,39,1.0512820512820513,0.05128205128205128,544,My name is Brad and I am an update maniac.
2539,1,0,38,39,1.0512820512820513,0.05128205128205128,544,I don't know...I can't make up my mind.  Me neither.
2539,0,2,37,39,1.0512820512820513,0.03578157512432619,544,What's on your mind?
2539,0,2,37,39,1.0512820512820513,0.03578157512432619,544,Where is your. Pencil holder?
2539,0,2,37,39,1.0512820512820513,0.03578157512432619,544,"My neck is okay, but the receptionist gives me cramps."
2539,0,2,37,39,1.0512820512820513,0.03578157512432619,544,You have a headache and hear voice too?
2539,1,0,38,39,1.0512820512820513,0.05128205128205128,544,We can’t get work off our minds until our bosses get us out from under their desks.
2539,0,2,37,39,1.0512820512820513,0.03578157512432619,544,My accountant tells me this is the best way to get ahead
2539,0,2,37,39,1.0512820512820513,0.03578157512432619,544,Mt. Rushmore 2026 had a certain honesty about it but many felt failed as a work of art.
2539,1,0,38,39,1.0512820512820513,0.05128205128205128,544,Have your office call my office.
2539,0,2,37,39,1.0512820512820513,0.03578157512432619,544,My regards will take 1-3 business days to send.
2539,0,2,37,39,1.0512820512820513,0.03578157512432619,544,Your guy is really phoning it in huh?
2539,0,2,37,39,1.0512820512820513,0.03578157512432619,544,Seems like we have a meeting of the minds.
2539,0,2,37,39,1.0512820512820513,0.03578157512432619,544,I invented it to make it easier to take your work home with you.
2539,0,2,37,39,1.0512820512820513,0.03578157512432619,544,Just let them be. Their some of the only people MILDLY GOOD at there job.
2539,1,0,38,39,1.0512820512820513,0.05128205128205128,544,I was always the overachiever.
2539,0,2,37,39,1.0512820512820513,0.03578157512432619,544,Are sure that the only way to get a raise around here is to get under the desk?
2539,0,2,37,39,1.0512820512820513,0.03578157512432619,544,How do you tie your shoes?
2539,1,0,38,39,1.0512820512820513,0.05128205128205128,544,Meanwhile back at the head office...
2539,0,2,37,39,1.0512820512820513,0.03578157512432619,544,I'm just more comfortable emailing us.
2539,1,0,38,39,1.0512820512820513,0.05128205128205128,544,Snowflakes.
3004,0,2,38,40,1.05,0.03489912202260563,544,We're head and shoulders above everone here.
3004,0,2,38,40,1.05,0.03489912202260563,544,"My Head of Intel accessed your databases, and We have some questions......."
3004,0,2,38,40,1.05,0.03489912202260563,544,I say it's back to the drawing board on these virtual reality assistants.
3004,0,2,38,40,1.05,0.03489912202260563,544,"Of course, the real computer power is in my laptop."
3004,0,2,38,40,1.05,0.03489912202260563,544,If only you could read my mind.
3004,0,2,38,40,1.05,0.03489912202260563,544,I use the fact-check app too!
3004,0,2,38,40,1.05,0.03489912202260563,544,You are not! I'm ahead!
3004,0,2,38,40,1.05,0.03489912202260563,544,So Mac or PC?
3004,1,0,39,40,1.05,0.04999999999999999,544,My Mac vs. your Dell.
3004,0,2,38,40,1.05,0.03489912202260563,544,Our overheads are getting out of hand.
3004,0,2,38,40,1.05,0.03489912202260563,544,Yours is also named Hal?
3004,0,2,38,40,1.05,0.03489912202260563,544,"Off the top of my head, I'd say our figures agree."
3004,0,2,38,40,1.05,0.03489912202260563,544,I think I know what's causing our headaches.
3004,0,2,38,40,1.05,0.03489912202260563,544,They say it's the latest in desk top technology.
3004,0,2,38,40,1.05,0.03489912202260563,544,"Apparently on their planet, 'headquarters"" is a literal term."
3004,1,0,39,40,1.05,0.04999999999999999,544,My inner voice gave up and got a desk job too.
3004,0,2,38,40,1.05,0.03489912202260563,544,A computer for your thoughts?
3004,0,2,38,40,1.05,0.03489912202260563,544,"""What makes you think we were separated at birth?"
3004,0,2,38,40,1.05,0.03489912202260563,544,"I've heard of standing on the shoulders of giants, but ???????"
3004,1,0,39,40,1.05,0.04999999999999999,544,So you're sure we're supposed to attend the Thanksgiving party in full head desk?
3004,1,0,39,40,1.05,0.04999999999999999,544,"We just can't get those numbers out of our heads, can we?"
3004,0,2,38,40,1.05,0.03489912202260563,544,"I know everyone said Google Glass was a stop-gap, but I didn't think it was to this."
3004,0,2,38,40,1.05,0.03489912202260563,544,I've got the whole world in my hands.
3004,1,0,39,40,1.05,0.04999999999999999,544,I'll have my people talk to your people.
3004,0,2,38,40,1.05,0.03489912202260563,544,I don't like what I see.
3004,0,2,38,40,1.05,0.03489912202260563,544,"Wish Marvin a happy birthday."" ""Happy birthday Marvin."
3004,0,2,38,40,1.05,0.03489912202260563,544,Which temp agency placed you?
3004,0,2,38,40,1.05,0.03489912202260563,544,I have much different things on my mind than you do.
3004,1,0,39,40,1.05,0.04999999999999999,544,Let's have a drink and get work off our minds.
3004,0,2,38,40,1.05,0.03489912202260563,544,Executive function is the key to success.
3004,0,2,38,40,1.05,0.03489912202260563,544,My doctor still can't determine why I keep getting paper cuts on my scalp.
3004,0,2,38,40,1.05,0.03489912202260563,544,"I'm right-handed, and you're left-handed. Don't you see, that makes us totally different."
3004,0,2,38,40,1.05,0.03489912202260563,544,Heads of business
3004,0,2,38,40,1.05,0.03489912202260563,544,You have writers desk block too?
3004,0,2,38,40,1.05,0.03489912202260563,544,These pollsters are getting really in depth these day.
3004,0,2,38,40,1.05,0.03489912202260563,544,Great minds think alike
3004,0,2,38,40,1.05,0.03489912202260563,544,Do you ever feel controlled by our jobs?
3004,0,2,38,40,1.05,0.03489912202260563,544,I think there's something we need to talk about.
3004,0,2,38,40,1.05,0.03489912202260563,544,I see you have the same thing on your mind.
3004,0,2,38,40,1.05,0.03489912202260563,544,I liked the idea of a head-top computer from the get-go.
3004,0,2,38,40,1.05,0.03489912202260563,544,I just hope he doesn't come on vacation with me.
3004,0,2,38,40,1.05,0.03489912202260563,544,Mirror brain farts
3004,0,2,38,40,1.05,0.03489912202260563,544,Mine's being downsized Wednesday.
3004,0,2,38,40,1.05,0.03489912202260563,544,Had a feeling you were a lefty.
3004,0,2,38,40,1.05,0.03489912202260563,544,"I have these feelings for you, but something is holding me back."
3004,1,0,39,40,1.05,0.04999999999999999,544,Just can't get work off my mind. How about you?
3004,0,2,38,40,1.05,0.03489912202260563,544,I don't know if I can afford it. Let me check with my head accountant and I'll get back to you.
3004,0,2,38,40,1.05,0.03489912202260563,544,"Love the redwood desk, really nice"
3004,0,2,38,40,1.05,0.03489912202260563,544,It's a slight improvement over that little red guy with the pointy tail and pitchfork.
3004,1,0,39,40,1.05,0.04999999999999999,544,Where are your pencils?
3004,0,2,38,40,1.05,0.03489912202260563,544,Where did our server go?
3004,1,0,39,40,1.05,0.04999999999999999,544,How can you work without a jar of pencils on your desk?
3004,0,2,38,40,1.05,0.03489912202260563,544,Use your mind. Your desk is slipping.
3004,1,0,39,40,1.05,0.04999999999999999,544,Computing sort of grows on you doesn't it?
3004,1,0,39,40,1.05,0.04999999999999999,544,It'll be better once they switch to standing desks.
3059,0,2,39,41,1.048780487804878,0.034059122057973054,544,"Well, what's that about minds and something similar?"
3059,0,2,39,41,1.048780487804878,0.034059122057973054,544,All of this Tweeting is for the birds.
3059,0,2,39,41,1.048780487804878,0.034059122057973054,544,"""I've got an idea, let's create a button so we can instantly minimize a window."" I'm screaming Yessssssss in my head."
3059,1,0,40,41,1.048780487804878,0.04878048780487807,544,"I'm getting really tired of him e-mailing the help desk about ""how to get this nerd off my butt."""
3059,0,2,39,41,1.048780487804878,0.034059122057973054,544,i can't wait to go wireless and get rid of all these cords!
3059,0,2,39,41,1.048780487804878,0.034059122057973054,544,"Yeah, the bluetooth range still sucks, but - oh look - is that mistletoe hanging from my desk..?"
3065,0,2,40,42,1.0476190476190477,0.033258585512837065,544,"I don't know about you, but I've had enough of the business casual look."
3066,0,1,37,38,1.0263157894736843,0.02666903735313325,544,"Meditation helps me get out of my head, too, but I'm not sure this is better."
3066,0,1,37,38,1.0263157894736843,0.02666903735313325,544,I think this personal digital assistant thing has gone too far
3066,0,1,37,38,1.0263157894736843,0.02666903735313325,544,Where are your pencils?
3066,0,1,37,38,1.0263157894736843,0.02666903735313325,544,"The money’s great, but the keyboarding is driving me crazy."
3066,0,1,37,38,1.0263157894736843,0.02666903735313325,544,I'm a left-leaning right brain.
3066,0,1,37,38,1.0263157894736843,0.02666903735313325,544,Stop touching my *.doc!
3066,0,1,37,38,1.0263157894736843,0.02666903735313325,544,"Sometimes I just feel like my job is on me 24/7, you ever get that feeling?"
3066,0,1,37,38,1.0263157894736843,0.02666903735313325,544,I'll have my peep call your peep
3066,0,1,37,38,1.0263157894736843,0.02666903735313325,544,"Dude, reboot - you froze again. And here I am talking and talking and talking..."
3066,0,1,37,38,1.0263157894736843,0.02666903735313325,544,"Don't worry, we are on top of it."
3066,0,1,37,38,1.0263157894736843,0.02666903735313325,544,*Girl talks to you* Processing............
3066,0,1,37,38,1.0263157894736843,0.02666903735313325,544,I see you've also got work on your mind.
3066,0,1,37,38,1.0263157894736843,0.02666903735313325,544,How's your internship going so far?
3066,0,1,37,38,1.0263157894736843,0.02666903735313325,544,This isn't what I expected when my boss gave me permission to work from home.
3066,0,1,37,38,1.0263157894736843,0.02666903735313325,544,My voices in my head are bigger than your voices!
3066,0,1,37,38,1.0263157894736843,0.02666903735313325,544,I did not think the office of the future would look anything like this.
3066,0,1,37,38,1.0263157894736843,0.02666903735313325,544,You were going to vote for a third party also?
3066,0,1,37,38,1.0263157894736843,0.02666903735313325,544,It's turtles all the way down!
3066,0,1,37,38,1.0263157894736843,0.02666903735313325,544,White collar quality family time
3066,0,1,37,38,1.0263157894736843,0.02666903735313325,544,This is not what I expected when they requested more head space.
3066,0,1,37,38,1.0263157894736843,0.02666903735313325,544,I preferred bumps.
3066,0,1,37,38,1.0263157894736843,0.02666903735313325,544,My overhead is giving me a real headache.
3066,0,1,37,38,1.0263157894736843,0.02666903735313325,544,I think we almost got this telepathic thing worked out?
3066,0,1,37,38,1.0263157894736843,0.02666903735313325,544,We think so alike!
3066,0,1,37,38,1.0263157894736843,0.02666903735313325,544,Even on vacation dammit.
3066,0,1,37,38,1.0263157894736843,0.02666903735313325,544,I guess it was just a matter of time before our psyches had to manifest themselves for Obamacare purposes.
3066,0,1,37,38,1.0263157894736843,0.02666903735313325,544,I can't stop thinking about work either.
3066,0,1,37,38,1.0263157894736843,0.02666903735313325,544,We're merely thinking outside the cubicle.
3066,0,1,37,38,1.0263157894736843,0.02666903735313325,544,Hacked! You too?
3066,0,1,37,38,1.0263157894736843,0.02666903735313325,544,Bureaucrats are the new body snatchers
3066,0,1,37,38,1.0263157894736843,0.02666903735313325,544,This is outsourcing!
3066,0,1,37,38,1.0263157894736843,0.02666903735313325,544,This open floor office thing is gone too far.
3066,0,1,37,38,1.0263157894736843,0.02666903735313325,544,So grateful for the company's no email at home policy. Makes life so much easier.
3066,0,1,37,38,1.0263157894736843,0.02666903735313325,544,I'm unable to think outside the box anymore.
3066,0,1,37,38,1.0263157894736843,0.02666903735313325,544,Desktop P.C. joke Oy Vey.
3066,0,1,37,38,1.0263157894736843,0.02666903735313325,544,I'll have my person get in touch with your person.
3066,0,1,37,38,1.0263157894736843,0.02666903735313325,544,When did you first know you could never wear a hat?
3066,0,1,37,38,1.0263157894736843,0.02666903735313325,544,Similarly nuanced? Absolutely not. My scholarly magnum opus is on waiting whereas yours is on procrastinating.
3066,0,1,37,38,1.0263157894736843,0.02666903735313325,544,"You know we're just office avatars, right?"
3066,0,1,37,38,1.0263157894736843,0.02666903735313325,544,"It's much easier to remember things now, isn't it?"
3066,0,1,37,38,1.0263157894736843,0.02666903735313325,544,"The boss is really pushing this work-life integration mandate, huh?"
3066,0,1,37,38,1.0263157894736843,0.02666903735313325,544,"Back in my day, we were able to sweep these things under the rug."
3066,0,1,37,38,1.0263157894736843,0.02666903735313325,544,I see you and I both have the same taste in hats.
3066,0,1,37,38,1.0263157894736843,0.02666903735313325,544,Why don't you get your own pencils?
3066,0,1,37,38,1.0263157894736843,0.02666903735313325,544,We shouldn't have asked for assistants who kept on top of things.
3066,0,1,37,38,1.0263157894736843,0.02666903735313325,544,Stop copying me.
3066,0,1,37,38,1.0263157894736843,0.02666903735313325,544,Are we empathizing yet?
3066,0,1,37,38,1.0263157894736843,0.02666903735313325,544,"Business, as usual."
3066,0,1,37,38,1.0263157894736843,0.02666903735313325,544,My accountant can beat up your accountant.
3066,0,1,37,38,1.0263157894736843,0.02666903735313325,544,working ahead.
3066,0,1,37,38,1.0263157894736843,0.02666903735313325,544,The micromanagement has really gotten out of hand.
3066,0,1,37,38,1.0263157894736843,0.02666903735313325,544,Blackberry finally comes out with its answer to Google Glass and Apple Watch.
3066,0,1,37,38,1.0263157894736843,0.02666903735313325,544,"Well, it's better than being the back office, that's for sure."
3066,0,1,37,38,1.0263157894736843,0.02666903735313325,544,"I can't shake him. I can't shake him, either."
3066,0,1,37,38,1.0263157894736843,0.02666903735313325,544,"Now that we got the office out of your head, what should we do with it?"
3066,0,1,37,38,1.0263157894736843,0.02666903735313325,544,The man upstairs is not smiling down on you.
3066,0,1,37,38,1.0263157894736843,0.02666903735313325,544,Did your computer just freeze?
3066,0,1,37,38,1.0263157894736843,0.02666903735313325,544,A 'pentium' for your thoughts!
3066,0,1,37,38,1.0263157894736843,0.02666903735313325,544,"You just have to be special, don't you?"
3066,0,1,37,38,1.0263157894736843,0.02666903735313325,544,You first. No! You first.
3066,0,1,37,38,1.0263157894736843,0.02666903735313325,544,I liked it better when the wives just controlled the checkbook.
3066,0,1,37,38,1.0263157894736843,0.02666903735313325,544,"I'd go with my gut, but it's on garden leave."
3066,0,1,37,38,1.0263157894736843,0.02666903735313325,544,The I.T. guy whisperer.
3066,0,1,37,38,1.0263157894736843,0.02666903735313325,544,Your left brain is connected to my right brain.
3066,0,1,37,38,1.0263157894736843,0.02666903735313325,544,I'm more wireless than you.
3066,0,1,37,38,1.0263157894736843,0.02666903735313325,544,I bet you I'll finish my to-do list before you do.
3066,0,1,37,38,1.0263157894736843,0.02666903735313325,544,This new billable hours technique gives me a headache.
3066,0,1,37,38,1.0263157894736843,0.02666903735313325,544,The portability of the job really fits my lifestyle.
3066,0,1,37,38,1.0263157894736843,0.02666903735313325,544,Mine went to Headvard.
3066,0,1,37,38,1.0263157894736843,0.02666903735313325,544,what happens if we sneezed
3066,0,1,37,38,1.0263157894736843,0.02666903735313325,544,"Other than overhead costs dropping, do you see any other benefit with a virtualized workplace?"
3066,0,1,37,38,1.0263157894736843,0.02666903735313325,544,Teleworking is NOT all in your head.
3066,0,1,37,38,1.0263157894736843,0.02666903735313325,544,Those guys on Easter Island don't know what there're missing.
3066,0,1,37,38,1.0263157894736843,0.02666903735313325,544,OK. I'll check it out. But what's a newspaper?
3066,0,1,37,38,1.0263157894736843,0.02666903735313325,544,Hold on--I'm checking with my IT guy....
3066,0,1,37,38,1.0263157894736843,0.02666903735313325,544,I really wanted to be a cowboy.
3066,0,1,37,38,1.0263157894736843,0.02666903735313325,544,"If they separate us surgically, won't have to talk to each other?"
3066,0,1,37,38,1.0263157894736843,0.02666903735313325,544,"It was the corporate dark ages! No wireless, no mental telepathy."
3066,0,1,37,38,1.0263157894736843,0.02666903735313325,544,We might have gone too far with this whole 'outsourcing' deal...
3066,0,1,37,38,1.0263157894736843,0.02666903735313325,544,"I'm so grateful we have each other when dealing with Mom, now that she's lost all executive function!"
3066,0,1,37,38,1.0263157894736843,0.02666903735313325,544,"Well, my monitor sits up higher, I have a pencil holder, ...."
3066,0,1,37,38,1.0263157894736843,0.02666903735313325,544,You mean you're in constant communication with your accountant also??
3066,0,1,37,38,1.0263157894736843,0.02666903735313325,544,Apparently its work LIFE balance.
3066,0,1,37,38,1.0263157894736843,0.02666903735313325,544,I have the best screen saver for when I fall asleep
3066,0,1,37,38,1.0263157894736843,0.02666903735313325,544,"Say no more, I'm already working on it."
3066,0,1,37,38,1.0263157894736843,0.02666903735313325,544,It's a real pain in the butt when he works from home.
3066,0,1,37,38,1.0263157894736843,0.02666903735313325,544,I also have an old set of Google glasses.
3066,0,1,37,38,1.0263157894736843,0.02666903735313325,544,Being a workaholic used to be all in my head. I see you've been able to push it out too.
3066,0,1,37,38,1.0263157894736843,0.02666903735313325,544,It's Cotillion for desk jobs.
3066,0,1,37,38,1.0263157894736843,0.02666903735313325,544,"Well, that's a load off my mind."
3066,0,1,37,38,1.0263157894736843,0.02666903735313325,544,"Yes, he's arrogant...but your assistant spends the day emailing his friends."
3066,0,1,37,38,1.0263157894736843,0.02666903735313325,544,"Yes, delete is fine, as long as it is not preceded by ctrl and alt."
3066,0,1,37,38,1.0263157894736843,0.02666903735313325,544,Is that big tax audit on your mind? Me too.
3066,0,1,37,38,1.0263157894736843,0.02666903735313325,544,All that computer stuff confuses me. It just goes right over my head.
3066,0,1,37,38,1.0263157894736843,0.02666903735313325,544,"I just found 30,000 emails. Is your new handle ""Hillary?"
3066,0,1,37,38,1.0263157894736843,0.02666903735313325,544,Did you receive my mind-mail? I just cybered it to you.
3066,0,1,37,38,1.0263157894736843,0.02666903735313325,544,We’ve found that our shared office arrangement works well with our company’s mobile culture.
3066,0,1,37,38,1.0263157894736843,0.02666903735313325,544,"I wasn't sure about the man-buns without the buns, but they seem to work."
3066,0,1,37,38,1.0263157894736843,0.02666903735313325,544,"Yep, you're dying."
3066,0,1,37,38,1.0263157894736843,0.02666903735313325,544,whats the problem? I can tell them apart
3066,0,1,37,38,1.0263157894736843,0.02666903735313325,544,Substituting your intelligence for his intelligence is not artificial intelligence.
3066,0,1,37,38,1.0263157894736843,0.02666903735313325,544,"Where I work, the right hand doesn't know what the left hand is doing."
3066,0,1,37,38,1.0263157894736843,0.02666903735313325,544,Can you tell me which server he's using?
3066,0,1,37,38,1.0263157894736843,0.02666903735313325,544,Is this cloud computing?
3066,0,1,37,38,1.0263157894736843,0.02666903735313325,544,I answered a help-wanted ad for a guy with a head on his shoulders. What's your story?
3066,0,1,37,38,1.0263157894736843,0.02666903735313325,544,And I thought I was the only blockhead in the office.
3066,0,1,37,38,1.0263157894736843,0.02666903735313325,544,"My guy offered to go wireless and operate from the cloud, but he's covering a bald spot."
3066,0,1,37,38,1.0263157894736843,0.02666903735313325,544,Be honest. Do you think I have a good head for business?
3066,0,1,37,38,1.0263157894736843,0.02666903735313325,544,"Well, right off the top of my head I have to say you're wrong!"
3066,0,1,37,38,1.0263157894736843,0.02666903735313325,544,Ugh. It's all about the technology these days.
3066,0,1,37,38,1.0263157894736843,0.02666903735313325,544,I love working outside the box!
3066,0,1,37,38,1.0263157894736843,0.02666903735313325,544,Maybe we should talk merger?
3066,0,1,37,38,1.0263157894736843,0.02666903735313325,544,What's on the top of your mind?
3066,0,1,37,38,1.0263157894736843,0.02666903735313325,544,My load is about to get a lot heavier with Headquarters looking to expand
3066,0,1,37,38,1.0263157894736843,0.02666903735313325,544,"I'm thinking more about work now that these computer chips were implanted, how about you?"
3066,0,1,37,38,1.0263157894736843,0.02666903735313325,544,What's your overhead rate these days?
3066,0,1,37,38,1.0263157894736843,0.02666903735313325,544,"Dude, it can't possibly be healthy to have accounting on the mind like this all the time."
3066,0,1,37,38,1.0263157894736843,0.02666903735313325,544,Don't you find meditation liberating?
3066,0,1,37,38,1.0263157894736843,0.02666903735313325,544,"I know we're expected to shoulder our share of the weight around here, but this is over the top!"
3066,0,1,37,38,1.0263157894736843,0.02666903735313325,544,"My temp is ninety-eight point six, but he doesn't look a day over forty."
3066,0,1,37,38,1.0263157894736843,0.02666903735313325,544,I think we see eye to eye on this problem.
3066,0,1,37,38,1.0263157894736843,0.02666903735313325,544,"Frankly Tom, I'm not seeing much executive ability."
3066,0,1,37,38,1.0263157894736843,0.02666903735313325,544,These new auditors have been nothing but a huge headache.
3066,0,1,37,38,1.0263157894736843,0.02666903735313325,544,Looks like we've both surrendered to the dark side.
3066,0,1,37,38,1.0263157894736843,0.02666903735313325,544,I told them we were fraternal because my monitor is on the left.
3066,0,1,37,38,1.0263157894736843,0.02666903735313325,544,"Left brain, right brain..."
3066,0,1,37,38,1.0263157894736843,0.02666903735313325,544,What's up with your hat?
3066,0,1,37,38,1.0263157894736843,0.02666903735313325,544,They ain't heavy...they're our brothers.
3066,0,1,37,38,1.0263157894736843,0.02666903735313325,544,Mental telepathy email!
3066,0,1,37,38,1.0263157894736843,0.02666903735313325,544,You should see what is in my top left lobe.
3066,0,1,37,38,1.0263157894736843,0.02666903735313325,544,You wanted to us to work like a horse so I spiked the water cooler with Ketamine.
3066,0,1,37,38,1.0263157894736843,0.02666903735313325,544,I thought all the noise was just on my head.
3066,0,1,37,38,1.0263157894736843,0.02666903735313325,544,I'm not sure if those stand up desks will work out.
3066,0,1,37,38,1.0263157894736843,0.02666903735313325,544,"What's on your mind, Jimmy?"
3066,0,1,37,38,1.0263157894736843,0.02666903735313325,544,"It was either this, Ritalin, or divorce... your wife too?"
3066,0,1,37,38,1.0263157894736843,0.02666903735313325,544,Nice hat.
3066,0,1,37,38,1.0263157894736843,0.02666903735313325,544,Well we have just a week to hack US President Election
3066,0,1,37,38,1.0263157894736843,0.02666903735313325,544,They said you always had a head for business.
3066,0,1,37,38,1.0263157894736843,0.02666903735313325,544,Nice hat.
3066,0,1,37,38,1.0263157894736843,0.02666903735313325,544,You were just on mind. I was going to send you an email
3066,0,1,37,38,1.0263157894736843,0.02666903735313325,544,"We all have business deals on our mind, Ken. The difference is I make millions and you're still visualizing."
3066,0,1,37,38,1.0263157894736843,0.02666903735313325,544,My hacker trumps yours again.
3066,0,1,37,38,1.0263157894736843,0.02666903735313325,544,It's just tough to find the right balance. Especially when Walter's dieting.
3066,0,1,37,38,1.0263157894736843,0.02666903735313325,544,I have no idea - what makes you think that?
3066,0,1,37,38,1.0263157894736843,0.02666903735313325,544,They say great minds think alike
3066,0,1,37,38,1.0263157894736843,0.02666903735313325,544,"Off the top of my head, I think you are open-minded."
3066,0,1,37,38,1.0263157894736843,0.02666903735313325,544,actually two guys talking about in there head hows the work going what I am gone do with the due the date the other one telling on hes head I have it figure out everything under control
3066,0,1,37,38,1.0263157894736843,0.02666903735313325,544,Mirror image?
3066,0,1,37,38,1.0263157894736843,0.02666903735313325,544,O.K....who goes first this morning?
3066,0,1,37,38,1.0263157894736843,0.02666903735313325,544,We've really got to stop taking our work home with us.
3066,0,1,37,38,1.0263157894736843,0.02666903735313325,544,"What's up, Bro."
3066,0,1,37,38,1.0263157894736843,0.02666903735313325,544,You think you have work on your mind.
3066,0,1,37,38,1.0263157894736843,0.02666903735313325,544,Do you hear someone typing?
3066,0,1,37,38,1.0263157894736843,0.02666903735313325,544,Quit calling me every time you have a brain fart.
3066,0,1,37,38,1.0263157894736843,0.02666903735313325,544,"I know our personal workstations were designed to be ergonomic, but mine's really giving me a headache."
3066,0,1,37,38,1.0263157894736843,0.02666903735313325,544,Virtual reality gone wrong.
3066,0,1,37,38,1.0263157894736843,0.02666903735313325,544,I'll have my person get in touch with your person.
3066,0,1,37,38,1.0263157894736843,0.02666903735313325,544,I know. I can't get work off my mind either.
3066,0,1,37,38,1.0263157894736843,0.02666903735313325,544,I'm thinking vacations are never going to be the same.
3066,0,1,37,38,1.0263157894736843,0.02666903735313325,544,Why do you always forget about the pencils?
3066,0,1,37,38,1.0263157894736843,0.02666903735313325,544,I see you have done away with pencils...
3066,0,1,37,38,1.0263157894736843,0.02666903735313325,544,Amazon's Mechanical Turk 2.0
3066,0,1,37,38,1.0263157894736843,0.02666903735313325,544,how do you like your micro-manager?
3066,0,1,37,38,1.0263157894736843,0.02666903735313325,544,Mine has a party in the back.
3066,0,1,37,38,1.0263157894736843,0.02666903735313325,544,"No matter how hard I try, I just can't get work off my mind."" ""I know exactly what you mean."
3066,0,1,37,38,1.0263157894736843,0.02666903735313325,544,"No problem, you only have to be a good sport for a week."
3066,0,1,37,38,1.0263157894736843,0.02666903735313325,544,You ever feel like we're really just men in suits sitting at desks?
3066,0,1,37,38,1.0263157894736843,0.02666903735313325,544,Where do you keep your pens?
3066,0,1,37,38,1.0263157894736843,0.02666903735313325,544,Head of the office is an awesome responsibility .
3066,0,1,37,38,1.0263157894736843,0.02666903735313325,544,At least these mobile assistants won't catch on fire.
3066,0,1,37,38,1.0263157894736843,0.02666903735313325,544,Another new desktop videoconferencing system?
3066,0,1,37,38,1.0263157894736843,0.02666903735313325,544,Bob: Did you ever think about getting a desk job? Tom: Yes. It's been on my mind a lot lately.
3066,0,1,37,38,1.0263157894736843,0.02666903735313325,544,Call me?
3066,0,1,37,38,1.0263157894736843,0.02666903735313325,544,"I do not recall his name at this moment, its just on top of my head."
3066,0,1,37,38,1.0263157894736843,0.02666903735313325,544,The network's down. We'll have to talk later.
3066,0,1,37,38,1.0263157894736843,0.02666903735313325,544,Pencil for your thoughts...
3066,0,1,37,38,1.0263157894736843,0.02666903735313325,544,We've always had a head for business.
3066,0,1,37,38,1.0263157894736843,0.02666903735313325,544,DELETE . . . DELETE . . . DELETE
3066,0,1,37,38,1.0263157894736843,0.02666903735313325,544,They're my pencils now.
3066,0,1,37,38,1.0263157894736843,0.02666903735313325,544,"Silicon Valley, Schmilicon Valley: These cerebral implants may be of value to management, but I have not had a date in two years!"
3066,0,1,37,38,1.0263157894736843,0.02666903735313325,544,We think too much about work all the time.
3066,0,1,37,38,1.0263157894736843,0.02666903735313325,544,It's true. Heavy is the head that wears the Crown Modular Desk System.
3066,0,1,37,38,1.0263157894736843,0.02666903735313325,544,"Did you get my e-mail? Yes, I replied"
3066,0,1,37,38,1.0263157894736843,0.02666903735313325,544,Does your hard drive also have 2 gigabytes of MAN.
3066,0,1,37,38,1.0263157894736843,0.02666903735313325,544,I'm a changed man.
3066,0,1,37,38,1.0263157894736843,0.02666903735313325,544,You always find a way to avoid my questions about your wife.
3066,0,1,37,38,1.0263157894736843,0.02666903735313325,544,"Don't worry, in two hours we'll only have six hours left."
3066,0,1,37,38,1.0263157894736843,0.02666903735313325,544,"Let me get this straight; you're white, straight a male AND a CEO? Woah same!"
3066,0,1,37,38,1.0263157894736843,0.02666903735313325,544,"I've heard of neuroplasticity, but this is ridiculous!"
3066,0,1,37,38,1.0263157894736843,0.02666903735313325,544,New company policy to always have work on our mind's is not being enbraced. Stupid Company.
3066,0,1,37,38,1.0263157894736843,0.02666903735313325,544,Your secretary said you were away from your desk.
3066,0,1,37,38,1.0263157894736843,0.02666903735313325,544,I am beginning to get a headache - maybe we should switch to using our mobile phones to connect?
3066,0,1,37,38,1.0263157894736843,0.02666903735313325,544,I just can't seem to get my work off my mind. How do you do it?
3066,0,1,37,38,1.0263157894736843,0.02666903735313325,544,"The pay is good, but we're micromanaged."
3066,0,1,37,38,1.0263157894736843,0.02666903735313325,544,I miss the days when hats allowed self-expression.
3066,0,1,37,38,1.0263157894736843,0.02666903735313325,544,"Uh...hur, And why were you fired."
3066,0,1,37,38,1.0263157894736843,0.02666903735313325,544,"Control-C, Control-V"
3066,0,1,37,38,1.0263157894736843,0.02666903735313325,544,"Are you ""good boss or bad boss?"""
3066,0,1,37,38,1.0263157894736843,0.02666903735313325,544,I'm pretty sure mine is just shopping on Amazon all day.
3066,0,1,37,38,1.0263157894736843,0.02666903735313325,544,My doctor said I have to stop taking work home with me
3066,0,1,37,38,1.0263157894736843,0.02666903735313325,544,I miss ignorance.
3066,0,1,37,38,1.0263157894736843,0.02666903735313325,544,"I think they're taking this ""Twins"" thing a bit too far but at least they moved us to a larger office with so much more headroom."
3066,0,1,37,38,1.0263157894736843,0.02666903735313325,544,"Please, fix the image in the mirror...it does not match with me."
3066,0,1,37,38,1.0263157894736843,0.02666903735313325,544,You see... we aren't just talking heads - we are programmed to say stupid things.
3066,0,1,37,38,1.0263157894736843,0.02666903735313325,544,I don't even use pencils anymore.
3066,0,1,37,38,1.0263157894736843,0.02666903735313325,544,Dad told me I have a better mind for business than you.
3066,0,1,37,38,1.0263157894736843,0.02666903735313325,544,I always have work on my mind.
3066,0,1,37,38,1.0263157894736843,0.02666903735313325,544,I miss pen and paper.
3066,0,1,37,38,1.0263157894736843,0.02666903735313325,544,I can't get work off of my mind.
3066,0,1,37,38,1.0263157894736843,0.02666903735313325,544,"Everything we say is off the top of our heads now, it seems."
3066,0,1,37,38,1.0263157894736843,0.02666903735313325,544,This lice check can't come fast enough
3066,0,1,37,38,1.0263157894736843,0.02666903735313325,544,Trump is guided by Hillary and Hillary is guided by Trump.
3066,0,1,37,38,1.0263157894736843,0.02666903735313325,544,Is this really better than a cell phone battery fire?
3066,0,1,37,38,1.0263157894736843,0.02666903735313325,544,My doctor also said it could meta-stasize.
3066,0,1,37,38,1.0263157894736843,0.02666903735313325,544,How is that replacement medulla oblongata working for you?
3066,0,1,37,38,1.0263157894736843,0.02666903735313325,544,Who wore it best?
3066,0,1,37,38,1.0263157894736843,0.02666903735313325,544,"Ever since they became Facebook friends, I've been obsessed with cat videos..."
3066,0,1,37,38,1.0263157894736843,0.02666903735313325,544,"I considered getting the left brain-computer interface technology, but that just seemed too logical so I went with the right brained system."
3066,0,1,37,38,1.0263157894736843,0.02666903735313325,544,I just didn't realize this is how the temp hair piece would look.
3066,0,1,37,38,1.0263157894736843,0.02666903735313325,544,"Jim, you've been had a blank stare on your face for 2 minutes..."" ""Slow Wifi Connection"
3066,0,1,37,38,1.0263157894736843,0.02666903735313325,544,Where does your computer print to?
3066,0,1,37,38,1.0263157894736843,0.02666903735313325,544,The ultimate double header
3066,0,1,37,38,1.0263157894736843,0.02666903735313325,544,Where's Dr. Ben when you really need him?
3066,0,1,37,38,1.0263157894736843,0.02666903735313325,544,"Tomayto, Tomahto..."
3066,0,1,37,38,1.0263157894736843,0.02666903735313325,544,We've got to quit bringing work home with us for goodness sake!
3066,0,1,37,38,1.0263157894736843,0.02666903735313325,544,Do I bill for bathroom breaks? Are you kidding? I do some of my best work in the bathroom.
3066,0,1,37,38,1.0263157894736843,0.02666903735313325,544,I know what you mean. I can't get work off my mind either.
3066,0,1,37,38,1.0263157894736843,0.02666903735313325,544,I think we BOTH need some acupuncture!
3066,0,1,37,38,1.0263157894736843,0.02666903735313325,544,There has got to be a way to parlay this into a buck.
3066,0,1,37,38,1.0263157894736843,0.02666903735313325,544,"No, I meant I wanted to watch the Spencer Tracy / Katherine Hepburn version of ""Desk Set!"""
3066,0,1,37,38,1.0263157894736843,0.02666903735313325,544,Then I discovered everyone had an idea full of desks.
3066,0,1,37,38,1.0263157894736843,0.02666903735313325,544,"Who is the new head of the company going to be? Ready, set, go!"
3066,0,1,37,38,1.0263157894736843,0.02666903735313325,544,Have your virtual people get back to my virtual people
3066,0,1,37,38,1.0263157894736843,0.02666903735313325,544,This is crazy.
3066,0,1,37,38,1.0263157894736843,0.02666903735313325,544,I wonder if we get overtime
3066,0,1,37,38,1.0263157894736843,0.02666903735313325,544,We find ourselves in an unusual situation
3066,0,1,37,38,1.0263157894736843,0.02666903735313325,544,"You ""Do you still have a headache?"
3066,0,1,37,38,1.0263157894736843,0.02666903735313325,544,"I know just how you feel...work is always on my mind, too."
3066,0,1,37,38,1.0263157894736843,0.02666903735313325,544,"Yeah me too, I've got work in the brain all day."
3066,0,1,37,38,1.0263157894736843,0.02666903735313325,544,"""So where do you think you'll be in five years?"
3066,0,1,37,38,1.0263157894736843,0.02666903735313325,544,Could you help me process what you just told me?
3066,0,1,37,38,1.0263157894736843,0.02666903735313325,544,"Well, MY intuition tells me that YOU are just mimicking me! Copycat--that's who you are."
3066,0,1,37,38,1.0263157894736843,0.02666903735313325,544,I've heard of ear-worms but this is ridiculous
3066,0,1,37,38,1.0263157894736843,0.02666903735313325,544,I never thought I would say this but I do miss the days of the Franklin Planners.
3066,0,1,37,38,1.0263157894736843,0.02666903735313325,544,No need to double-check. My brainpower looks to be online with yours.
3066,0,1,37,38,1.0263157894736843,0.02666903735313325,544,I thought we were entirely wireless.
3066,0,1,37,38,1.0263157894736843,0.02666903735313325,544,The sad part is that they get no overtime pay.
3066,0,1,37,38,1.0263157894736843,0.02666903735313325,544,I think we need to re-boot.
3066,0,1,37,38,1.0263157894736843,0.02666903735313325,544,Colonel Sanders goes too far with this Kentucky Fried Boss lunch.
3066,0,1,37,38,1.0263157894736843,0.02666903735313325,544,Are you operating on MAC or a PC?
3066,0,1,37,38,1.0263157894736843,0.02666903735313325,544,"Hello, I'm Watson. Who are you?"
3066,0,1,37,38,1.0263157894736843,0.02666903735313325,544,I can store twice as much with this than on the Google Cloud.
3066,0,1,37,38,1.0263157894736843,0.02666903735313325,544,Need a little help to clear my head...you?
3066,0,1,37,38,1.0263157894736843,0.02666903735313325,544,"Doctor can you help me to get this growth off my ass, Oh! never mind."
3066,0,1,37,38,1.0263157894736843,0.02666903735313325,544,What's on your mind?
3066,0,1,37,38,1.0263157894736843,0.02666903735313325,544,"I swear, I didn't get your email."
3066,0,1,37,38,1.0263157894736843,0.02666903735313325,544,My thinking cap is smarter than yours!
3066,0,1,37,38,1.0263157894736843,0.02666903735313325,544,"So since we both think alike, let's put our heads together and find the solution."
3066,0,1,37,38,1.0263157894736843,0.02666903735313325,544,I find it difficult to keep an eye on one of my staff.
3066,0,1,37,38,1.0263157894736843,0.02666903735313325,544,I'm downloading a dat base on cartoons.
3066,0,1,37,38,1.0263157894736843,0.02666903735313325,544,"I'm right, you know."
3066,0,1,37,38,1.0263157894736843,0.02666903735313325,544,This is what we get for telling the boss what's really on our minds.
3066,0,1,37,38,1.0263157894736843,0.02666903735313325,544,Who's your Daddy?
3066,0,1,37,38,1.0263157894736843,0.02666903735313325,544,The decision to outsource our thinking weighs heavy on my mind.
3066,0,1,37,38,1.0263157894736843,0.02666903735313325,544,"When my wife told me I had to go on vacation, I didn't think it would be this much fun."
3066,0,1,37,38,1.0263157894736843,0.02666903735313325,544,Can the manager tell that I'm spying on him?
3066,0,1,37,38,1.0263157894736843,0.02666903735313325,544,A load of work is on my mind right now. How about you? yes!
3066,0,1,37,38,1.0263157894736843,0.02666903735313325,544,Are you seeing what I'm seeing?
3066,0,1,37,38,1.0263157894736843,0.02666903735313325,544,Where's the bathroom?
3066,0,1,37,38,1.0263157894736843,0.02666903735313325,544,"""Tough to get a head. What are you renting for?"
3066,0,1,37,38,1.0263157894736843,0.02666903735313325,544,No. Twin keys. Not twinkies.
3066,0,1,37,38,1.0263157894736843,0.02666903735313325,544,I'll expense lunch if you expense dinner.
3066,0,1,37,38,1.0263157894736843,0.02666903735313325,544,My virtual office can beat your virtual office.
3066,0,1,37,38,1.0263157894736843,0.02666903735313325,544,"Like you, I have a lot on my mind these days."
3066,0,1,37,38,1.0263157894736843,0.02666903735313325,544,I'm just very confused. You?
3066,0,1,37,38,1.0263157894736843,0.02666903735313325,544,I don't know. What do YOU want to talk about?
3066,0,1,37,38,1.0263157894736843,0.02666903735313325,544,I am pretty sure these hats will make us chick magnets.
3066,0,1,37,38,1.0263157894736843,0.02666903735313325,544,"yea, it's always on my mind too."
3066,0,1,37,38,1.0263157894736843,0.02666903735313325,544,You'll get use to it.
3066,0,1,37,38,1.0263157894736843,0.02666903735313325,544,"The class action suit said it was supposed to be ""A little 'dab' ll do ya!"""
3066,0,1,37,38,1.0263157894736843,0.02666903735313325,544,"I don't like to take work home with me, but it looks i have to."
3066,0,1,37,38,1.0263157894736843,0.02666903735313325,544,"You'll get used to the hat, it's the manager's shoes you never get comfortable with."
3066,0,1,37,38,1.0263157894736843,0.02666903735313325,544,Looks like we both have a head for business!
3066,0,1,37,38,1.0263157894736843,0.02666903735313325,544,Tell me what's on your mind... I'm not a mind reader.
3066,0,1,37,38,1.0263157894736843,0.02666903735313325,544,How often do you take yours off for a bathroom break?
3066,0,1,37,38,1.0263157894736843,0.02666903735313325,544,I'll just comment that out until you change your mind.
3066,0,1,37,38,1.0263157894736843,0.02666903735313325,544,Who gets the vacant office with the wood desk?
3066,0,1,37,38,1.0263157894736843,0.02666903735313325,544,Some days work is just over my head.
3066,0,1,37,38,1.0263157894736843,0.02666903735313325,544,You’re right—telepathic commuting is the way to go.
3066,0,1,37,38,1.0263157894736843,0.02666903735313325,544,"I'm not sure how I feel about this ""thinking outside the box"" thing."
3066,0,1,37,38,1.0263157894736843,0.02666903735313325,544,Seriously? This is what you daydream about? You need to get a life.
3066,0,1,37,38,1.0263157894736843,0.02666903735313325,544,"What do you mean, ""You're each going your separate ways?"""
3066,0,1,37,38,1.0263157894736843,0.02666903735313325,544,....Dad?!?
3066,0,1,37,38,1.0263157894736843,0.02666903735313325,544,It's the new stand up desk.
3066,0,1,37,38,1.0263157894736843,0.02666903735313325,544,Me too! Always have work on the brain!
3066,0,1,37,38,1.0263157894736843,0.02666903735313325,544,"These implants make reading Hilary's 650,000 emails much more efficient."
3066,0,1,37,38,1.0263157894736843,0.02666903735313325,544,It's the only way to get ahead in this business.
3066,0,1,37,38,1.0263157894736843,0.02666903735313325,544,Work is such a headache.
3066,0,1,37,38,1.0263157894736843,0.02666903735313325,544,My guy's staying with Windows 7.
3066,0,1,37,38,1.0263157894736843,0.02666903735313325,544,Brain-to-brain communication isn't as cool as it sounds.
3066,0,1,37,38,1.0263157894736843,0.02666903735313325,544,"Ever since the conjoined twin surgery, you seem to be going through e-mail hiding withdrawal."
3066,0,1,37,38,1.0263157894736843,0.02666903735313325,544,Down-sizing sucks!
3066,0,1,37,38,1.0263157894736843,0.02666903735313325,544,The god in me sees the god in you.
3066,0,1,37,38,1.0263157894736843,0.02666903735313325,544,I guess this means summer Fridays are over.
3066,0,1,37,38,1.0263157894736843,0.02666903735313325,544,Do you want to be the pitcher or the catcher?
3066,0,1,37,38,1.0263157894736843,0.02666903735313325,544,"There's a cream for that, and it isn't Bryl."
3066,0,1,37,38,1.0263157894736843,0.02666903735313325,544,"You know Geoff,I think we've both got work on our minds,let's go and grab a beer..."
3066,0,1,37,38,1.0263157894736843,0.02666903735313325,544,I've never met someone with such similar thought patterns!
3066,0,1,37,38,1.0263157894736843,0.02666903735313325,544,you must be really busy
3066,0,1,37,38,1.0263157894736843,0.02666903735313325,544,Is there a party in the back?
3066,0,1,37,38,1.0263157894736843,0.02666903735313325,544,Our work is too caught up in our hair.
3066,0,1,37,38,1.0263157894736843,0.02666903735313325,544,You don't wanna know the excel data I've seen.
3066,0,1,37,38,1.0263157894736843,0.02666903735313325,544,Let's try to be clearheaded about this.
3066,0,1,37,38,1.0263157894736843,0.02666903735313325,544,I'll have my brain parasite contact yours.
3066,0,1,37,38,1.0263157894736843,0.02666903735313325,544,It's called being resourceful.
3066,0,1,37,38,1.0263157894736843,0.02666903735313325,544,Where'd you get your hat?
3066,0,1,37,38,1.0263157894736843,0.02666903735313325,544,"So, the guys above you got downsized too?"
3066,0,1,37,38,1.0263157894736843,0.02666903735313325,544,My barber has a heck of a time.
3066,0,1,37,38,1.0263157894736843,0.02666903735313325,544,"Well, better on my case than up my you-know where."
3066,0,1,37,38,1.0263157894736843,0.02666903735313325,544,I missed something in the Privacy Statement.
3066,0,1,37,38,1.0263157894736843,0.02666903735313325,544,Some people just have to get ahead.
3066,0,1,37,38,1.0263157894736843,0.02666903735313325,544,The office is always with me. How about you?
3066,0,1,37,38,1.0263157894736843,0.02666903735313325,544,It appears we are now making major headway.
3066,0,1,37,38,1.0263157894736843,0.02666903735313325,544,TopHat is much better with call-screening. Some students are too engaging.
3066,0,1,37,38,1.0263157894736843,0.02666903735313325,544,Your DNA apparently also counterreacts to Rogaine
3066,0,1,37,38,1.0263157894736843,0.02666903735313325,544,Geez...and I thought cube farms were a bad idea.....
3066,0,1,37,38,1.0263157894736843,0.02666903735313325,544,"And when it's not him, it's the head of Sanitation and Plumbing."
3066,0,1,37,38,1.0263157894736843,0.02666903735313325,544,This new operating system seems to have a slower processing speed.
3066,0,1,37,38,1.0263157894736843,0.02666903735313325,544,"My mind is always on work, ya know!"
3066,0,1,37,38,1.0263157894736843,0.02666903735313325,544,"You know, that was top of mind for me too."
3066,0,1,37,38,1.0263157894736843,0.02666903735313325,544,"Yes I agree,our turn to be downsized must be soon."
3066,0,1,37,38,1.0263157894736843,0.02666903735313325,544,I know what you're thinking!
3066,0,1,37,38,1.0263157894736843,0.02666903735313325,544,These new shoes are much more comfortable.
3066,0,1,37,38,1.0263157894736843,0.02666903735313325,544,I always said we think alike!
3066,0,1,37,38,1.0263157894736843,0.02666903735313325,544,This would be a lot easier with dual monitors.
3066,0,1,37,38,1.0263157894736843,0.02666903735313325,544,"Hey computer programmer, click faster so i can win this staring contest."
3066,0,1,37,38,1.0263157894736843,0.02666903735313325,544,Only his hairdresser knew for sure.
3066,0,1,37,38,1.0263157894736843,0.02666903735313325,544,"No it's not a brain fart, it's dial-up"
3066,0,1,37,38,1.0263157894736843,0.02666903735313325,544,They've got a Vice President model out now?
3066,0,1,37,38,1.0263157894736843,0.02666903735313325,544,Great minds conclude on the concordance of multiple premises...alike
3066,0,1,37,38,1.0263157894736843,0.02666903735313325,544,ditto to you too
3066,0,1,37,38,1.0263157894736843,0.02666903735313325,544,I see you have the retro desk top as well...
3066,0,1,37,38,1.0263157894736843,0.02666903735313325,544,This headquarters job isn't what I expected.
3066,0,1,37,38,1.0263157894736843,0.02666903735313325,544,You too…
3066,0,1,37,38,1.0263157894736843,0.02666903735313325,544,We've outsourced thinking.
3066,0,1,37,38,1.0263157894736843,0.02666903735313325,544,"The ad said ""email server."""
3066,0,1,37,38,1.0263157894736843,0.02666903735313325,544,"It's the new 'afro'. An ""affront to society""."
3066,0,1,37,38,1.0263157894736843,0.02666903735313325,544,The only time he really bothers me is when he talks politics or religion.
3066,0,1,37,38,1.0263157894736843,0.02666903735313325,544,sometime I just don't feel in control.
3066,0,1,37,38,1.0263157894736843,0.02666903735313325,544,It's more like the guy who uses the computer.
3066,0,1,37,38,1.0263157894736843,0.02666903735313325,544,At last: non talking heads
3066,0,1,37,38,1.0263157894736843,0.02666903735313325,544,"""I'll let you be in my dream if you let me be in yours"" (Bob Dylan)"
3066,0,1,37,38,1.0263157894736843,0.02666903735313325,544,They say I can emote an emoticon by twisting my face in some weird way.
3066,0,1,37,38,1.0263157894736843,0.02666903735313325,544,Nudge when you're ready.
3066,0,1,37,38,1.0263157894736843,0.02666903735313325,544,Talking heads are always under the bureau chiefs.
3066,0,1,37,38,1.0263157894736843,0.02666903735313325,544,We're going laptop soon. Can't wait.
3066,0,1,37,38,1.0263157894736843,0.02666903735313325,544,"I don't think this is what they meant by ""mindfulness."
3066,0,1,37,38,1.0263157894736843,0.02666903735313325,544,"Oh shit, do I have a desk on my head too?"
3066,0,1,37,38,1.0263157894736843,0.02666903735313325,544,Remember when cartoon representations of your mind were more interesting?
3066,0,1,37,38,1.0263157894736843,0.02666903735313325,544,"I, too, always seem to have work on my mind!"
3066,0,1,37,38,1.0263157894736843,0.02666903735313325,544,"Avoiding the zookeeper, Ella took refuge in the Smith's living room."
3066,0,1,37,38,1.0263157894736843,0.02666903735313325,544,do you know what deja vu is?
3066,0,1,37,38,1.0263157894736843,0.02666903735313325,544,I can't get work off my mind.
3066,0,1,37,38,1.0263157894736843,0.02666903735313325,544,The Lilliputians sure have come a long way since Gulliver's visit.
3066,0,1,37,38,1.0263157894736843,0.02666903735313325,544,I recommend my upgrade to the new Russian Hacker-Proof version.
3066,0,1,37,38,1.0263157894736843,0.02666903735313325,544,Great Minds think alike.
3066,0,1,37,38,1.0263157894736843,0.02666903735313325,544,Do you get the feeling that woman aren't attracted to men with strong executive functioning?
3066,0,1,37,38,1.0263157894736843,0.02666903735313325,544,"My statements about you were truthful, not at all libelous. I will not issue a retraction. I have advised my lawyer that he may be hearing from your lawyer."
3066,0,1,37,38,1.0263157894736843,0.02666903735313325,544,This is such an improvement over what we had to wear in ENIAC days?
3066,0,1,37,38,1.0263157894736843,0.02666903735313325,544,I'll say it if you won't: One head isn't better than two.
3066,0,1,37,38,1.0263157894736843,0.02666903735313325,544,I hate Work Hat Wednesdays.
3066,0,1,37,38,1.0263157894736843,0.02666903735313325,544,I see you were too cheap to spring for the upgrade pencil set.
3066,0,1,37,38,1.0263157894736843,0.02666903735313325,544,He's really improved my executive functions.
3066,0,1,37,38,1.0263157894736843,0.02666903735313325,544,"These days, work is always on the mind"
3066,0,1,37,38,1.0263157894736843,0.02666903735313325,544,"We should get out more, and do some fun, 'Guy' things."
3066,0,1,37,38,1.0263157894736843,0.02666903735313325,544,"At this job, we don't take our work home with us, instead they send a worker home with us."
3066,0,1,37,38,1.0263157894736843,0.02666903735313325,544,There head games are giving me a headache.
3066,0,1,37,38,1.0263157894736843,0.02666903735313325,544,I prefer the Disney princess version.
3066,0,1,37,38,1.0263157894736843,0.02666903735313325,544,Dreams of success.
3066,0,1,37,38,1.0263157894736843,0.02666903735313325,544,We'll be in touch.
3066,0,1,37,38,1.0263157894736843,0.02666903735313325,544,I see you took my advise and updated your office management software.
3066,0,1,37,38,1.0263157894736843,0.02666903735313325,544,We should find a new head hunter
3066,0,1,37,38,1.0263157894736843,0.02666903735313325,544,What makes you think I'm thinking about work again?
3066,0,1,37,38,1.0263157894736843,0.02666903735313325,544,That last productivity idea from corporate is for the birds.
3066,0,1,37,38,1.0263157894736843,0.02666903735313325,544,They tell us we're sleepwalking into a surveillance society but I can't say I've noticed.
3066,0,1,37,38,1.0263157894736843,0.02666903735313325,544,I had no idea this is what they meant by minor staff reductions.
3066,0,1,37,38,1.0263157894736843,0.02666903735313325,544,I think you and I see eye to eye.
3066,0,1,37,38,1.0263157894736843,0.02666903735313325,544,I told them we always use our heads. I didn't mean...
3066,0,1,37,38,1.0263157894736843,0.02666903735313325,544,"I'm certain Malcom is dyslexic. I heard him mumble ""matter over mind."""
3066,0,1,37,38,1.0263157894736843,0.02666903735313325,544,Your people ARE my people.
3066,0,1,37,38,1.0263157894736843,0.02666903735313325,544,I can't seem to think of my password off the top of my head.
3066,0,1,37,38,1.0263157894736843,0.02666903735313325,544,And how was your day?
3066,0,1,37,38,1.0263157894736843,0.02666903735313325,544,I can't see who is putting those ideas in your head.
3066,0,1,37,38,1.0263157894736843,0.02666903735313325,544,Are you thinking what I'm thinking? Work is always on our minds!
3066,0,1,37,38,1.0263157894736843,0.02666903735313325,544,This coworking concept is fostering creativity and innovation.
3066,0,1,37,38,1.0263157894736843,0.02666903735313325,544,I sure miss head games!
3066,0,1,37,38,1.0263157894736843,0.02666903735313325,544,"This new version of Office is really great! Yes, it's certainly worth the extra cost."
3066,0,1,37,38,1.0263157894736843,0.02666903735313325,544,Our overhead is weighing us down.
3066,0,1,37,38,1.0263157894736843,0.02666903735313325,544,Have your man get in touch with mine.
3066,0,1,37,38,1.0263157894736843,0.02666903735313325,544,Maybe we should thing about just closing the offices for the holidays.
3066,0,1,37,38,1.0263157894736843,0.02666903735313325,544,"Haircut's out of the question; too much work on my mind, too."
3066,0,1,37,38,1.0263157894736843,0.02666903735313325,544,"Do you want to do this meeting by email, or should we just talk?"
3066,0,1,37,38,1.0263157894736843,0.02666903735313325,544,It's so nice to be out of the office and not have to think about work...
3066,0,1,37,38,1.0263157894736843,0.02666903735313325,544,Do you believe in free will?
3066,0,1,37,38,1.0263157894736843,0.02666903735313325,544,"Oscar, my identical twin, are you mimicking me, or is that my reflection?"
3066,0,1,37,38,1.0263157894736843,0.02666903735313325,544,I see you were headhunted too.
3066,0,1,37,38,1.0263157894736843,0.02666903735313325,544,"It may be lonely at the top, but it hurts like hell down here."
3066,0,1,37,38,1.0263157894736843,0.02666903735313325,544,They say their from headquarters.
3066,0,1,37,38,1.0263157894736843,0.02666903735313325,544,Desktop synapses making connection.
3066,0,1,37,38,1.0263157894736843,0.02666903735313325,544,"It'll only be a few days: he's in witness protection. Not a word to the Trump ""children"", understand? They sue at the drop of a hat..."
3066,0,1,37,38,1.0263157894736843,0.02666903735313325,544,I leased the office space for only 75 cents a square inch with a shave.
3066,0,1,37,38,1.0263157894736843,0.02666903735313325,544,The French have a solution to our work life balance equation - the guilotine.
3066,0,1,37,38,1.0263157894736843,0.02666903735313325,544,You're spell cheque awl write?
3066,0,1,37,38,1.0263157894736843,0.02666903735313325,544,"I don't know how, but I think people are starting to suspect we're playing video games with each other during work hours."
3066,0,1,37,38,1.0263157894736843,0.02666903735313325,544,I miss my mullet too.
3066,0,1,37,38,1.0263157894736843,0.02666903735313325,544,I always mix up left and right!
3066,0,1,37,38,1.0263157894736843,0.02666903735313325,544,I hear ya. I've been on vacation over 3 months; but I'm still in work mode.
3066,0,1,37,38,1.0263157894736843,0.02666903735313325,544,did you try to turn it off and on again ?
3066,0,1,37,38,1.0263157894736843,0.02666903735313325,544,Some of our best thoughts fly from the top of our heads.
3066,0,1,37,38,1.0263157894736843,0.02666903735313325,544,Your reflection isn't always seen the same by others.
3066,0,1,37,38,1.0263157894736843,0.02666903735313325,544,Who knew the Lilliputians were business whizzes?
3066,0,1,37,38,1.0263157894736843,0.02666903735313325,544,I SEEE by your outfit that you are an office worker.
3066,0,1,37,38,1.0263157894736843,0.02666903735313325,544,Wait! Was your biological father from Silicon Valley too?
3066,0,1,37,38,1.0263157894736843,0.02666903735313325,544,It's time we got back to the ashram.
3066,0,1,37,38,1.0263157894736843,0.02666903735313325,544,I don't know about you but I sure am tired of supporting my brother-in-law.
3066,0,1,37,38,1.0263157894736843,0.02666903735313325,544,I see you also have a guy.
3066,0,1,37,38,1.0263157894736843,0.02666903735313325,544,Headtop. I didn't see that one coming.
3066,0,1,37,38,1.0263157894736843,0.02666903735313325,544,"I'd call it a ""splitt'n"" image in that overbearing nightmare last night."
3066,0,1,37,38,1.0263157894736843,0.02666903735313325,544,Maybe the progressive lenses aren't working.
3066,0,1,37,38,1.0263157894736843,0.02666903735313325,544,I think you might have something on your chin.
3066,0,1,37,38,1.0263157894736843,0.02666903735313325,544,Who says you can't get a head nowadays?
3066,0,1,37,38,1.0263157894736843,0.02666903735313325,544,"Hey Bill, I don't think middle management learned anything from the delegation workshop."
3066,0,1,37,38,1.0263157894736843,0.02666903735313325,544,"Today I met a guy who looks just like me, and he also thinks about work all the time."
3066,0,1,37,38,1.0263157894736843,0.02666903735313325,544,I'm not texting you...I'm not texting you....I'm not texting you....I'm not texting you.....
3066,0,1,37,38,1.0263157894736843,0.02666903735313325,544,You're supposed to be a balanced budget? I'm supposed to be a balanced budget!
3066,0,1,37,38,1.0263157894736843,0.02666903735313325,544,A day at Twinlabs.
3066,0,1,37,38,1.0263157894736843,0.02666903735313325,544,We thought a little too far outside the box...
3066,0,1,37,38,1.0263157894736843,0.02666903735313325,544,No more commuting but the overhead is killing me.
3066,0,1,37,38,1.0263157894736843,0.02666903735313325,544,They can never separate us.
3066,0,1,37,38,1.0263157894736843,0.02666903735313325,544,Don't you just love your iDesk S7. They've reduced the top-heaviness of the S6.
3066,0,1,37,38,1.0263157894736843,0.02666903735313325,544,Don't ask me. You're the brains.
3066,0,1,37,38,1.0263157894736843,0.02666903735313325,544,Mine's bigger.
3066,0,1,37,38,1.0263157894736843,0.02666903735313325,544,Have you submitted your caption to the new cartoon yet?
3066,0,1,37,38,1.0263157894736843,0.02666903735313325,544,"I know, I know; male pattern blandness, brah."
3066,0,1,37,38,1.0263157894736843,0.02666903735313325,544,I caught my Wi-Fi in my zipper.
3066,0,1,37,38,1.0263157894736843,0.02666903735313325,544,"If you ask me, the guys in IT have too much time on their hands."
3066,0,1,37,38,1.0263157894736843,0.02666903735313325,544,I think my people must be talking to your people.
3066,0,1,37,38,1.0263157894736843,0.02666903735313325,544,Can we at least ask who he's voting for?
3066,0,1,37,38,1.0263157894736843,0.02666903735313325,544,Are you sure you want to leave this page?
3066,0,1,37,38,1.0263157894736843,0.02666903735313325,544,Maybe we should use a different shampoo.
3066,0,1,37,38,1.0263157894736843,0.02666903735313325,544,I'm not sure which one of us is redundant.
3066,0,1,37,38,1.0263157894736843,0.02666903735313325,544,I'm having second thoughts about the new economy.
3066,0,1,37,38,1.0263157894736843,0.02666903735313325,544,I'm a more of a hands on kind of guy
3066,0,1,37,38,1.0263157894736843,0.02666903735313325,544,Let's go crazy.
3066,0,1,37,38,1.0263157894736843,0.02666903735313325,544,We're the sitting image of one another.
3066,0,1,37,38,1.0263157894736843,0.02666903735313325,544,We must come from the same gene pool.
3066,0,1,37,38,1.0263157894736843,0.02666903735313325,544,"Hey Bill, in retrospect, I don't think leasing our head space to an alien race was a pragmatic decision."
3066,0,1,37,38,1.0263157894736843,0.02666903735313325,544,I don't know about you but sometimes I feel like I'm channeling my inner workaholic.
3066,0,1,37,38,1.0263157894736843,0.02666903735313325,544,What's that cologne you're wearing?
3066,0,1,37,38,1.0263157894736843,0.02666903735313325,544,"'Giants Heads in Commerce' ...it's like 'Cheese Heads in Dairy,' Frank."
3066,0,1,37,38,1.0263157894736843,0.02666903735313325,544,iThought you texted Uber
3066,0,1,37,38,1.0263157894736843,0.02666903735313325,544,I thought you knew where the OCD rally was.
3066,0,1,37,38,1.0263157894736843,0.02666903735313325,544,Work's been giving me a headache.
3066,0,1,37,38,1.0263157894736843,0.02666903735313325,544,Still not talking?
3066,0,1,37,38,1.0263157894736843,0.02666903735313325,544,The eyes have it.
3066,0,1,37,38,1.0263157894736843,0.02666903735313325,544,The man upstairs told me to tell you that you'e fired.
3066,0,1,37,38,1.0263157894736843,0.02666903735313325,544,I'm bored. Me too.
3066,0,1,37,38,1.0263157894736843,0.02666903735313325,544,Being on top of your people really is a balancing act.
3066,0,1,37,38,1.0263157894736843,0.02666903735313325,544,I'll have my people handle this one.
3066,0,1,37,38,1.0263157894736843,0.02666903735313325,544,"Yes, the market's heading in the right direction!"
3066,0,1,37,38,1.0263157894736843,0.02666903735313325,544,How are your enjoying telepathically commuting?
3066,0,1,37,38,1.0263157894736843,0.02666903735313325,544,"Maybe if I copy his font, he''ll want me to be his confidant."
3066,0,1,37,38,1.0263157894736843,0.02666903735313325,544,"It looks like we both let computers go over our heads, dang technology !"
3066,0,1,37,38,1.0263157894736843,0.02666903735313325,544,I'm just happy my wife is not making all my decisions.
3066,0,1,37,38,1.0263157894736843,0.02666903735313325,544,"Technically, it's not wiretapping."
3066,0,1,37,38,1.0263157894736843,0.02666903735313325,544,Get over it. We are Siamese terminals.
3066,0,1,37,38,1.0263157894736843,0.02666903735313325,544,"See, I told you if we worked hard, we could get a head."
3066,0,1,37,38,1.0263157894736843,0.02666903735313325,544,Don't move. It's a balancing act.
3066,0,1,37,38,1.0263157894736843,0.02666903735313325,544,Do you google through your Windows?
3066,0,1,37,38,1.0263157894736843,0.02666903735313325,544,I use him mostly for updating my todo list.
3066,0,1,37,38,1.0263157894736843,0.02666903735313325,544,Nerd!
3066,0,1,37,38,1.0263157894736843,0.02666903735313325,544,"This Halloween I thought I had finally found a costume nobody else would have...."" ""Me too"
3066,0,1,37,38,1.0263157894736843,0.02666903735313325,544,I finally got a computer of my own.
3066,0,1,37,38,1.0263157894736843,0.02666903735313325,544,Let's keep in touch.
3066,0,1,37,38,1.0263157894736843,0.02666903735313325,544,Heavy is the head that wears the hollow men
3551,0,1,38,39,1.0256410256410255,0.025976216673306556,544,"Double, double, toil and trouble!"
3551,0,1,38,39,1.0256410256410255,0.025976216673306556,544,How do you like your new smart phone?
3551,0,1,38,39,1.0256410256410255,0.025976216673306556,544,...it's like you're the only one who can really understand me.
3551,0,1,38,39,1.0256410256410255,0.025976216673306556,544,I believe micromanaged employees reduce overhead.
3551,0,1,38,39,1.0256410256410255,0.025976216673306556,544,I didn't realize how close hell was to the surface.
3551,0,1,38,39,1.0256410256410255,0.025976216673306556,544,So what if the 'Beach Blanket Babylon' audition was a bust? We can still put the hats to work for us.
3551,0,1,38,39,1.0256410256410255,0.025976216673306556,544,The tiny house movement has gone too far.
3551,0,1,38,39,1.0256410256410255,0.025976216673306556,544,You too? It's hell. I'm either looking at it or thinking about looking at it?
3551,0,1,38,39,1.0256410256410255,0.025976216673306556,544,I'm on top of it.
3551,0,1,38,39,1.0256410256410255,0.025976216673306556,544,Work's on my mind
3551,0,1,38,39,1.0256410256410255,0.025976216673306556,544,What's this I hear about cloud computing?
3551,0,1,38,39,1.0256410256410255,0.025976216673306556,544,Social Media has just taken over our brains!!!
3551,0,1,38,39,1.0256410256410255,0.025976216673306556,544,"There goes thinking outside of the box, Bill."
3551,0,1,38,39,1.0256410256410255,0.025976216673306556,544,Let's consult our thinking caps on that one
3551,0,1,38,39,1.0256410256410255,0.025976216673306556,544,I've been assured the new process won't become a burden.
3551,0,1,38,39,1.0256410256410255,0.025976216673306556,544,These microspaces are getting out of control.
3551,0,1,38,39,1.0256410256410255,0.025976216673306556,544,"I see that you have work on your brain, too."
3551,0,1,38,39,1.0256410256410255,0.025976216673306556,544,They say these things you can do with your face can closely approximate emoticons.
3551,0,1,38,39,1.0256410256410255,0.025976216673306556,544,"""Hey - don't mean to snitch ... but your head-clone is a slacker!"
3551,0,1,38,39,1.0256410256410255,0.025976216673306556,544,How do you like your new Dodd-Frank regulator?
3551,0,1,38,39,1.0256410256410255,0.025976216673306556,544,I'll hack you before you can hack me!
3551,0,1,38,39,1.0256410256410255,0.025976216673306556,544,Has yours figured out how to turn off SafeSearch?
3551,0,1,38,39,1.0256410256410255,0.025976216673306556,544,I know Cloud computing would reduce my overhead but I'm already going bald.
3551,0,1,38,39,1.0256410256410255,0.025976216673306556,544,Do you feel like sometimes you have the weight of your desk on your head?
3551,0,1,38,39,1.0256410256410255,0.025976216673306556,544,Mine's the head of special projects--kind of prestigious.
3551,0,1,38,39,1.0256410256410255,0.025976216673306556,544,Mine's a snapback.
3551,0,1,38,39,1.0256410256410255,0.025976216673306556,544,"Kiss me, you beautiful machine"
3551,0,1,38,39,1.0256410256410255,0.025976216673306556,544,I will have my office will give your office a call.
3551,0,1,38,39,1.0256410256410255,0.025976216673306556,544,It's the new Google Office.
3551,0,1,38,39,1.0256410256410255,0.025976216673306556,544,Don't you think this cloning thing has gone far enough?
3551,0,1,38,39,1.0256410256410255,0.025976216673306556,544,wow! i totally get you!
3551,0,1,38,39,1.0256410256410255,0.025976216673306556,544,Our new moniker is the desk set.
3551,0,1,38,39,1.0256410256410255,0.025976216673306556,544,Two heads are better than one.
3551,0,1,38,39,1.0256410256410255,0.025976216673306556,544,Your turn or mine?
3551,0,1,38,39,1.0256410256410255,0.025976216673306556,544,"Did you buy your hat at the Staples clearence, too?"
3551,0,1,38,39,1.0256410256410255,0.025976216673306556,544,I think mine's going bald.
3551,0,1,38,39,1.0256410256410255,0.025976216673306556,544,I am beside myself with worry about work.
3551,0,1,38,39,1.0256410256410255,0.025976216673306556,544,No. Are you hacking me?
3551,0,1,38,39,1.0256410256410255,0.025976216673306556,544,I think I'm ahead on my work right now.
3551,0,1,38,39,1.0256410256410255,0.025976216673306556,544,I think I'll order a good book in print and a manual typewriter.
3551,0,1,38,39,1.0256410256410255,0.025976216673306556,544,"Easy for you, I work on my right brain."
3551,0,1,38,39,1.0256410256410255,0.025976216673306556,544,"Off the top of my head, we are missing the big picture."
3551,0,1,38,39,1.0256410256410255,0.025976216673306556,544,My hat man is promoted to senior manager since I am five minutes older than you
3551,0,1,38,39,1.0256410256410255,0.025976216673306556,544,I didn't get the memo.
3551,0,1,38,39,1.0256410256410255,0.025976216673306556,544,You know what people are going to say about how we got promoted . . .
3551,0,1,38,39,1.0256410256410255,0.025976216673306556,544,Sorry we're late for our 3 o'clock
3551,0,1,38,39,1.0256410256410255,0.025976216673306556,544,"I prefer ""Words With Friends"" the old fashioned way."
3551,0,1,38,39,1.0256410256410255,0.025976216673306556,544,I've heard switching to a standing desk may help.
3551,0,1,38,39,1.0256410256410255,0.025976216673306556,544,I'm afraid these will not pass Steve's design criteria.
3551,0,1,38,39,1.0256410256410255,0.025976216673306556,544,"I don't know about yours, but mine is a wig."
3551,0,1,38,39,1.0256410256410255,0.025976216673306556,544,TopHat is much better with screening. Some students are way too engaging!
3551,0,1,38,39,1.0256410256410255,0.025976216673306556,544,"I don't remember, are we friends?"
3551,0,1,38,39,1.0256410256410255,0.025976216673306556,544,"I have a dream, but there's no use trying to explain it to you."
3551,0,1,38,39,1.0256410256410255,0.025976216673306556,544,Where you stand depends upon where you sit.
3551,0,1,38,39,1.0256410256410255,0.025976216673306556,544,"Mike, How r u? My therapist says I need more face-to-face interaction. Best, Dave"
3551,0,1,38,39,1.0256410256410255,0.025976216673306556,544,Amazing how much we think alike.
3551,0,1,38,39,1.0256410256410255,0.025976216673306556,544,My boss is a real micro-manager.
3551,0,1,38,39,1.0256410256410255,0.025976216673306556,544,I almost forgot it was Tuesday
3551,0,1,38,39,1.0256410256410255,0.025976216673306556,544,I miss my Palm Pilot.
3551,0,1,38,39,1.0256410256410255,0.025976216673306556,544,Did I say follicle? I meant cubicle.
3551,0,1,38,39,1.0256410256410255,0.025976216673306556,544,I know what our ad said. 'Small bussiness managers needed to control overhead'. When did employment agencies become so literal?
3551,0,1,38,39,1.0256410256410255,0.025976216673306556,544,Your personal assistant is better than mine.
3551,0,1,38,39,1.0256410256410255,0.025976216673306556,544,Headdesk.
3551,0,1,38,39,1.0256410256410255,0.025976216673306556,544,Pencil?
3551,0,1,38,39,1.0256410256410255,0.025976216673306556,544,Do you think they'll notice if we start doing the Swim?
3551,0,1,38,39,1.0256410256410255,0.025976216673306556,544,Work is always on my mind. How about you?
3551,0,1,38,39,1.0256410256410255,0.025976216673306556,544,Okay - we got it! Time to call Barnum & Bailey!
3551,0,1,38,39,1.0256410256410255,0.025976216673306556,544,"If we put our heads together, we can get this done."
3551,0,1,38,39,1.0256410256410255,0.025976216673306556,544,First it's the haircut. Now it's the desk. What's next? You gonna move in with my wife?
3551,0,1,38,39,1.0256410256410255,0.025976216673306556,544,Not quite what I had envisioned when the boss told us we needed to reduce overhead expenses.
3551,0,1,38,39,1.0256410256410255,0.025976216673306556,544,We've got to do something. The boss is all over us!
3551,0,1,38,39,1.0256410256410255,0.025976216673306556,544,I’m exchanging him. He’s developed an addiction to online gambling.
3551,0,1,38,39,1.0256410256410255,0.025976216673306556,544,I remember when computer work was your dream job. Nightmares are dreams.
3551,0,1,38,39,1.0256410256410255,0.025976216673306556,544,I agree -- outsourcing my executive functions was the best thing I ever did.
3551,0,1,38,39,1.0256410256410255,0.025976216673306556,544,"Let's just concede, we're over the the top."
3551,0,1,38,39,1.0256410256410255,0.025976216673306556,544,Sometimes I also use my smart desk as a phone.
3551,0,1,38,39,1.0256410256410255,0.025976216673306556,544,His commute is terribly uncomfortable.
3551,0,1,38,39,1.0256410256410255,0.025976216673306556,544,I didn't think it was contagious
3551,0,1,38,39,1.0256410256410255,0.025976216673306556,544,"So far all they know is Free Cell, but pretty soon we've got trouble."
3551,0,1,38,39,1.0256410256410255,0.025976216673306556,544,"No, it really is a sign of genius"
3551,0,1,38,39,1.0256410256410255,0.025976216673306556,544,I can't go to the game as my guy has to work all weekend.
3551,0,1,38,39,1.0256410256410255,0.025976216673306556,544,This Internet of things has gone too far.
3551,0,1,38,39,1.0256410256410255,0.025976216673306556,544,Let's keep our work top of mind.
3551,0,1,38,39,1.0256410256410255,0.025976216673306556,544,You get the pencil holder free when you order through Amazon
3551,0,1,38,39,1.0256410256410255,0.025976216673306556,544,If you're not going to talk about it...
3551,0,1,38,39,1.0256410256410255,0.025976216673306556,544,I wish I could get him off but I've been on hold for twenty minutes!
3551,0,1,38,39,1.0256410256410255,0.025976216673306556,544,This new head app is over-stimulating .
3551,0,1,38,39,1.0256410256410255,0.025976216673306556,544,I was naive to think that artificial intelligence would have it better than a cubicle.
3551,0,1,38,39,1.0256410256410255,0.025976216673306556,544,Thinking with our little men isn't supposed to be boring.
3551,0,1,38,39,1.0256410256410255,0.025976216673306556,544,"Outsourcing the amygdala has done wonders for our marriage, don't you think?"
3551,0,1,38,39,1.0256410256410255,0.025976216673306556,544,For10/31: Let's tell him to pack his trunks and leave.
3551,0,1,38,39,1.0256410256410255,0.025976216673306556,544,Pst... did you get that email he sent you.
3551,0,1,38,39,1.0256410256410255,0.025976216673306556,544,"When some hippie weirdo preaches mindfulness, tell him your mind's already full."
3551,0,1,38,39,1.0256410256410255,0.025976216673306556,544,Do you want an answer off the top of my head?I'd say it's .
3551,0,1,38,39,1.0256410256410255,0.025976216673306556,544,This agile working is really getting out of hand.
3551,0,1,38,39,1.0256410256410255,0.025976216673306556,544,The new system is definitely more efficient but it's hard on my hair!
3551,0,1,38,39,1.0256410256410255,0.025976216673306556,544,Great minds think alike.
3551,0,1,38,39,1.0256410256410255,0.025976216673306556,544,"Now imagine 100's of them, and that is what my company is like."
3551,0,1,38,39,1.0256410256410255,0.025976216673306556,544,"Dude, your guy's playing head games with mine."
3551,0,1,38,39,1.0256410256410255,0.025976216673306556,544,Keep this under your hat.
3551,0,1,38,39,1.0256410256410255,0.025976216673306556,544,I want your job.
3551,0,1,38,39,1.0256410256410255,0.025976216673306556,544,I got mine from the Small Business Administration.
3551,0,1,38,39,1.0256410256410255,0.025976216673306556,544,But mine's Republican!
3551,0,1,38,39,1.0256410256410255,0.025976216673306556,544,"No, you're the left brain."
3551,0,1,38,39,1.0256410256410255,0.025976216673306556,544,I've opened a branch office. Now I can't sit down.
3551,0,1,38,39,1.0256410256410255,0.025976216673306556,544,"Well, this is billable, so I should run."
3551,0,1,38,39,1.0256410256410255,0.025976216673306556,544,They both are head strong.
3551,0,1,38,39,1.0256410256410255,0.025976216673306556,544,You know -- sometimes I miss the old 9 to 5
3551,0,1,38,39,1.0256410256410255,0.025976216673306556,544,Do you think it makes me look fat?
3551,0,1,38,39,1.0256410256410255,0.025976216673306556,544,They said our minds were just like computers.
3551,0,1,38,39,1.0256410256410255,0.025976216673306556,544,Oh how I wish I could delete some files from my brain.
3551,0,1,38,39,1.0256410256410255,0.025976216673306556,544,I think I prefer the old task management system.
3551,0,1,38,39,1.0256410256410255,0.025976216673306556,544,I'm still waiting to go wireless too.
3551,0,1,38,39,1.0256410256410255,0.025976216673306556,544,I'm trying out this work life balance thing.
3551,0,1,38,39,1.0256410256410255,0.025976216673306556,544,"A friendship is born by coincidence on ""whacky hat day."""
3551,0,1,38,39,1.0256410256410255,0.025976216673306556,544,It's better than a pickle doughnut.
3551,0,1,38,39,1.0256410256410255,0.025976216673306556,544,Is the new programming giving you a headache too?
3551,0,1,38,39,1.0256410256410255,0.025976216673306556,544,Two heads are better than one.
3551,0,1,38,39,1.0256410256410255,0.025976216673306556,544,"A word of advice ""keep it under your hat"" !!!!!!!!!"
3551,0,1,38,39,1.0256410256410255,0.025976216673306556,544,'Fascinatior' is a misnomer if you ask me.
3551,0,1,38,39,1.0256410256410255,0.025976216673306556,544,No. You?
3551,0,1,38,39,1.0256410256410255,0.025976216673306556,544,I'm still buffering
3551,0,1,38,39,1.0256410256410255,0.025976216673306556,544,"No, you can't borrow a pencil."
3551,0,1,38,39,1.0256410256410255,0.025976216673306556,544,When did you get your Harry transplant?
3551,0,1,38,39,1.0256410256410255,0.025976216673306556,544,"You need to take a break from social media."" ""Who are you kidding, you know you want to check it!"
3551,0,1,38,39,1.0256410256410255,0.025976216673306556,544,Do you ever feel you're not in control of your destiny?
3551,0,1,38,39,1.0256410256410255,0.025976216673306556,544,Matter over mind!
3551,0,1,38,39,1.0256410256410255,0.025976216673306556,544,Being a Mirror Twin sucks!
3551,0,1,38,39,1.0256410256410255,0.025976216673306556,544,Separated at merge.
3551,0,1,38,39,1.0256410256410255,0.025976216673306556,544,It feels like I'm always stuck at the office.
3551,0,1,38,39,1.0256410256410255,0.025976216673306556,544,"Dave, this is not what I meant when I said you and Tim needed to be ""desk jockeys""."
3551,0,1,38,39,1.0256410256410255,0.025976216673306556,544,Looks like you have head virus too.
3551,0,1,38,39,1.0256410256410255,0.025976216673306556,544,The Executive Hair-weave? One of the many ways Trump changed the game.
3551,0,1,38,39,1.0256410256410255,0.025976216673306556,544,"Fine, what do you want to talk about?"
3685,0,1,39,40,1.025,0.025318484177091666,544,Settled..I'll just have my zeros talk to your ones
3685,0,1,39,40,1.025,0.025318484177091666,544,you're the creative one; get us out from under!
3685,0,1,39,40,1.025,0.025318484177091666,544,Who knew wearable tech would get so corporate so fast
3685,0,1,39,40,1.025,0.025318484177091666,544,"I'm mouse Matt, who are you?"
3685,0,1,39,40,1.025,0.025318484177091666,544,Did you notice that my desk has pencils and yours doesn't!
3685,0,1,39,40,1.025,0.025318484177091666,544,Can you tell what's missing from your desk
3685,0,1,39,40,1.025,0.025318484177091666,544,This virtual reality cubicle stuff is edgy.
3685,0,1,39,40,1.025,0.025318484177091666,544,"When they said this was going to be a brainstorming meeting, I never imagined this."
3685,0,1,39,40,1.025,0.025318484177091666,544,"Don't know about you, but I try not to take my head home with me."
3685,0,1,39,40,1.025,0.025318484177091666,544,"You're saying...if we merge, our stock price will double?"
3685,0,1,39,40,1.025,0.025318484177091666,544,I hear the design team has Macs.
3685,0,1,39,40,1.025,0.025318484177091666,544,Looks like we've got work on the brain.
3685,0,1,39,40,1.025,0.025318484177091666,544,"Yah, that's what happened to me too! It started off as a spot on the floor under the desk and just kept growing!"
3685,0,1,39,40,1.025,0.025318484177091666,544,"What do you mean, I can't dye my hair?"
3685,0,1,39,40,1.025,0.025318484177091666,544,"trying to get ""ahead"" in the buisiness world."
3685,0,1,39,40,1.025,0.025318484177091666,544,It was a cold drink of water for Bert to realize he was no longer head and shoulder's ahead of everyone else in the office
3685,0,1,39,40,1.025,0.025318484177091666,544,"Yeah, I take it home with me too."
3685,0,1,39,40,1.025,0.025318484177091666,544,These new exercise desks are freakin awesome!
3685,0,1,39,40,1.025,0.025318484177091666,544,Your hair is sticking out over your ear.
3704,0,1,40,41,1.024390243902439,0.02469323991623974,544,How much did you pay for yours?
3705,0,1,42,43,1.0232558139534884,0.023531040266750583,544,I believe we're iPhone 1 concept art.
3706,0,0,36,36,1.0,0.028171808490950554,544,"Oh no, my head itches."
3706,0,0,37,37,1.0,0.02739983121755955,544,I see you're finally getting your head around technology...
3706,0,0,36,36,1.0,0.028171808490950554,544,This new Indian poker app is neither fun nor subtle.
3706,0,0,36,36,1.0,0.028171808490950554,544,early story board for Pacific Rim 2
3706,0,0,36,36,1.0,0.028171808490950554,544,"When I was in college I had pretty girls and beer on the brain. Corporate life has changed things for me, unfortunately."
3706,0,0,36,36,1.0,0.028171808490950554,544,Mine used to be a cricket too.
3706,0,0,36,36,1.0,0.028171808490950554,544,Mirror mirror on the wall
3706,0,0,36,36,1.0,0.028171808490950554,544,"My Internet just went down, so I guess this date is over."
3706,0,0,36,36,1.0,0.028171808490950554,544,It's the only way to get ahead.
3706,0,0,36,36,1.0,0.028171808490950554,544,I still think it's your turn to pay the tip.
3706,0,0,36,36,1.0,0.028171808490950554,544,"Can you hear me, yes I am talking to you, Hello, hello can you please move out of the way."
3706,0,0,36,36,1.0,0.028171808490950554,544,"I must be Right. We're not British, but we both seem to get our news through a Mirror image."
3706,0,0,36,36,1.0,0.028171808490950554,544,I can't get Kylie Jenner's latest bathroom selfie with Gigi Hadid out of my head. You?
3706,0,0,37,37,1.0,0.02739983121755955,544,I think there's more to this private email server thing.
3706,0,0,36,36,1.0,0.028171808490950554,544,Iambackmrtrumpbigly99percent
3706,0,0,36,36,1.0,0.028171808490950554,544,"I work hands on, while tou need a mouse for results."
3706,0,0,36,36,1.0,0.028171808490950554,544,We are virtually twins at work.
3706,0,0,36,36,1.0,0.028171808490950554,544,"""But most importantly, I like anchovies on my Pizza""."
3706,0,0,37,37,1.0,0.02739983121755955,544,DOUBLEHEADER
3706,0,0,36,36,1.0,0.028171808490950554,544,hard to believe that before the Trump Presidency Holocaust fact checking implants were not required for all politicians.
3706,0,0,36,36,1.0,0.028171808490950554,544,Tell me again what our futures look like.
3706,0,0,36,36,1.0,0.028171808490950554,544,Who the hell told Paul about a standing desk?
3706,0,0,37,37,1.0,0.02739983121755955,544,The Headtop Computer genius also gave us the Sphincter Cam.
3706,0,0,36,36,1.0,0.028171808490950554,544,My fact checker says yours is wrong 37% of the time.
3706,0,0,36,36,1.0,0.028171808490950554,544,These desks on our heads look really stupid.
3706,0,0,36,36,1.0,0.028171808490950554,544,Can you give me some more color on that?
3706,0,0,36,36,1.0,0.028171808490950554,544,The constitution protects my freedom of speech.~(stop)~
3706,0,0,36,36,1.0,0.028171808490950554,544,What an interesting guy!
3706,0,0,37,37,1.0,0.02739983121755955,544,"I know we are interns, but I feel they are taking advantage of us."
3706,0,0,36,36,1.0,0.028171808490950554,544,My subjective processor is rewriting reality as we speak
3706,0,0,36,36,1.0,0.028171808490950554,544,How can we reduce our overhead?
3706,0,0,36,36,1.0,0.028171808490950554,544,"I never take my micro-temp off, even when I sleep."
3706,0,0,36,36,1.0,0.028171808490950554,544,My guy can type faster than yours
3706,0,0,36,36,1.0,0.028171808490950554,544,It feels as if you're right next to me.
3706,0,0,36,36,1.0,0.028171808490950554,544,Cybernetics isn't what I imagined it would be
3706,0,0,36,36,1.0,0.028171808490950554,544,"I've gotten four looks already, these hairdos are really doing their jobs."
3706,0,0,37,37,1.0,0.02739983121755955,544,What do you mean I'm a head case!?
3706,0,0,36,36,1.0,0.028171808490950554,544,I want to marry for security.
3706,0,0,36,36,1.0,0.028171808490950554,544,"You wanna be unique? Conjoined twins with separate desks--now, that's unique!"
3706,0,0,36,36,1.0,0.028171808490950554,544,The future of online dating.
3706,0,0,36,36,1.0,0.028171808490950554,544,"Contracting out my brain has been just fine and dandy, but everyone could see I was full of crap when I outsourced my colon."
3706,0,0,36,36,1.0,0.028171808490950554,544,He told me he would do anything to get ahead!
3706,0,0,36,36,1.0,0.028171808490950554,544,Now's not a great time. Can we jump on a call later this week?
3706,0,0,36,36,1.0,0.028171808490950554,544,I'll write it - you defend it and get crushed by the editor!
3706,0,0,36,36,1.0,0.028171808490950554,544,So how's your day going?
3706,0,0,36,36,1.0,0.028171808490950554,544,I hate these mirror image dreams.
3706,0,0,36,36,1.0,0.028171808490950554,544,I see you take work home too.
3706,0,0,36,36,1.0,0.028171808490950554,544,Who do you think writes those ads that follow you everywhere?
3706,0,0,36,36,1.0,0.028171808490950554,544,"Is this another version of ""the little head doing the thinking for the big head""?"
3706,0,0,36,36,1.0,0.028171808490950554,544,"My friend, you do know what a small nose means, don't you?"
3706,0,0,36,36,1.0,0.028171808490950554,544,"Ever since he started telecommuting on Tuesdays, my job satisfaction index has declined."
3706,0,0,36,36,1.0,0.028171808490950554,544,That's an expensive purchase - better take this one to the boy's upstairs.
3706,0,0,36,36,1.0,0.028171808490950554,544,I'm glad our meeting of the minds came with prudent counsel.
3706,0,0,36,36,1.0,0.028171808490950554,544,"My wife says all I speak is work, but I don't know what she's talking about the stocks look great right now."
3706,0,0,36,36,1.0,0.028171808490950554,544,"Y'know, you're not the only intern here with a private workstation, so don't let it go to your head."
3706,0,0,36,36,1.0,0.028171808490950554,544,"And if it rains, my odds change to 2/1. I'm a mudder."
3706,0,0,36,36,1.0,0.028171808490950554,544,At least no one brought up lateral mobility.
3706,0,0,36,36,1.0,0.028171808490950554,544,Are you my mirror-image doppelganger?
3706,0,0,36,36,1.0,0.028171808490950554,544,"Let's face it, the poll numbers will never agree, and besides they didn't call me personally."
3706,0,0,36,36,1.0,0.028171808490950554,544,Your a desk head
3706,0,0,36,36,1.0,0.028171808490950554,544,At least we've eliminated the need for those bothersome telephones.
3706,0,0,36,36,1.0,0.028171808490950554,544,It's not fair; we should get at least time and a half.
3706,0,0,36,36,1.0,0.028171808490950554,544,Right brain? Sounds...impracticable.
3706,0,0,36,36,1.0,0.028171808490950554,544,Great minds...
3706,0,0,37,37,1.0,0.02739983121755955,544,Multitasking?
3706,0,0,36,36,1.0,0.028171808490950554,544,I GOT MY CAPTION AT BARNEY'S
3706,0,0,36,36,1.0,0.028171808490950554,544,I think it's NICE how we've been on each other's minds.
3706,0,0,36,36,1.0,0.028171808490950554,544,"Just a heads-up, don't put in an e-mail what you don't want on the front page of the newspaper tomorrow morning."
3706,0,0,36,36,1.0,0.028171808490950554,544,Is it Friday yet?
3706,0,0,36,36,1.0,0.028171808490950554,544,"""Mirror, mirror on the wall, should this be my Tinder photo or not at all?"
3706,0,0,36,36,1.0,0.028171808490950554,544,I don't like Melvin's desktop antics either.
3706,0,0,36,36,1.0,0.028171808490950554,544,"Your dyslexias is getting worse. I said, 'Let's put on our thinking CAPS!"
3706,0,0,36,36,1.0,0.028171808490950554,544,I am thinking about deleting ALL of your files.
3706,0,0,36,36,1.0,0.028171808490950554,544,"By any chance, does yours already found a caption for this cartoon yet?"
3706,0,0,36,36,1.0,0.028171808490950554,544,"Oh you have the Personal Accountant 5, mines only the S4."
3706,0,0,36,36,1.0,0.028171808490950554,544,Up-Up-Down-Down-Left-Right-Left-Right-B-A-Start...
3706,0,0,36,36,1.0,0.028171808490950554,544,They say better headphones are on the way.
3706,0,0,37,37,1.0,0.02739983121755955,544,The twins were always thinking about work.
3706,0,0,36,36,1.0,0.028171808490950554,544,Your name is in my ROM. Can you help me bring it back to my RAM?
3706,0,0,36,36,1.0,0.028171808490950554,544,"Jerry, I thought you were gonna let me have that giant today?"
3706,0,0,36,36,1.0,0.028171808490950554,544,"Oh hi Gary, I didn't realize you too would be participating in crazy ass hat day."
3706,0,0,36,36,1.0,0.028171808490950554,544,Oy Vey (see what I'm doing here?)
3706,0,0,36,36,1.0,0.028171808490950554,544,Notice: I will be away from my desk until after election
3706,0,0,36,36,1.0,0.028171808490950554,544,There may be some lingering resentment
3706,0,0,36,36,1.0,0.028171808490950554,544,Too long; didn't listen.
3706,0,0,37,37,1.0,0.02739983121755955,544,"Relax; it’s all in our heads, anyway."
3706,0,0,36,36,1.0,0.028171808490950554,544,I bet the Kentucky Derby hasn't seen anything like us.
3706,0,0,36,36,1.0,0.028171808490950554,544,How long are we going to avoid talking about getting a bigger room?
3706,0,0,36,36,1.0,0.028171808490950554,544,Your alter ego looks familiar....
3706,0,0,36,36,1.0,0.028171808490950554,544,Barbara thinks I need a new haircut.
3706,0,0,36,36,1.0,0.028171808490950554,544,"Have you reached 10,000 steps a month yet?"
3706,0,0,37,37,1.0,0.02739983121755955,544,How is it we completely disagree on who should be president?
3706,0,0,37,37,1.0,0.02739983121755955,544,"People may laugh and jeer, but we won't let that discourage us"
3706,0,0,36,36,1.0,0.028171808490950554,544,"You're right Chumley, hats are a disadvantage."
3706,0,0,36,36,1.0,0.028171808490950554,544,I'm playing video games. You still working on that math problem ?
3706,0,0,36,36,1.0,0.028171808490950554,544,swagger jacker...ass...bitch
3706,0,0,36,36,1.0,0.028171808490950554,544,"""If there's something on your mind,just say it!"
3706,0,0,36,36,1.0,0.028171808490950554,544,Paul stared into the mirror for a long time.
3706,0,0,37,37,1.0,0.02739983121755955,544,Do we have to think for everyone these days? No one can get the job done themselves.
3706,0,0,36,36,1.0,0.028171808490950554,544,whats one your mind? Work.
3706,0,0,36,36,1.0,0.028171808490950554,544,Just had to bring your work home with you didn't you.
3706,0,0,36,36,1.0,0.028171808490950554,544,"While search is still pervasive, you gotta keep it top of mind!"
3706,0,0,36,36,1.0,0.028171808490950554,544,"If you don't cut down on that spam, my people are going to knock your block off."
3706,0,0,36,36,1.0,0.028171808490950554,544,I'm just not sure this Easter Island business model is doing for me.
3706,0,0,36,36,1.0,0.028171808490950554,544,Needed: Volunteers needed to try our new Personal Robotic Assistants. Must have good posture and balancing skills.
3706,0,0,36,36,1.0,0.028171808490950554,544,It is my inner 'in box' trying not to be relegated to your dialog mentality.
3706,0,0,36,36,1.0,0.028171808490950554,544,great minds work their but off alike
3706,0,0,36,36,1.0,0.028171808490950554,544,A new attempt to see if osmosis may work.
3706,0,0,36,36,1.0,0.028171808490950554,544,Number 9 is missing.
3706,0,0,36,36,1.0,0.028171808490950554,544,I'm left; you're right. My hair goes forward; yours goes back. Even our computers are political.
3706,0,0,36,36,1.0,0.028171808490950554,544,I think outside the box and outside the desk.
3706,0,0,36,36,1.0,0.028171808490950554,544,You have to have a plan Fred. You and the other fools that work here will never make it to the top.
3706,0,0,36,36,1.0,0.028171808490950554,544,"So Jim, any plans for the weekend?"" ""Uh, just work. What do you have in mind?"" ""Work."
3706,0,0,36,36,1.0,0.028171808490950554,544,Maybe we could vacation in Bora Bora this winter.
3706,0,0,36,36,1.0,0.028171808490950554,544,"Appears the board was split on keeping things the way they are, or using AI robots"
3706,0,0,36,36,1.0,0.028171808490950554,544,The buck stops up here.
3706,0,0,36,36,1.0,0.028171808490950554,544,I am so tired of desktops.
3706,0,0,36,36,1.0,0.028171808490950554,544,I think yours is checking Facebook again.
3706,0,0,36,36,1.0,0.028171808490950554,544,What we won't do when we find some hair in the shower?
3706,0,0,36,36,1.0,0.028171808490950554,544,"I don't care if he IS a radio producer, this is bullshit!"
3706,0,0,36,36,1.0,0.028171808490950554,544,2k16 gaming
3706,0,0,36,36,1.0,0.028171808490950554,544,I think your idea is missing a thing or two
3706,0,0,36,36,1.0,0.028171808490950554,544,"Thinking out loud, a double check of Hilary's e-mails is warranted."
3706,0,0,36,36,1.0,0.028171808490950554,544,If only you didn't blend in so well.
3706,0,0,36,36,1.0,0.028171808490950554,544,"My parents always said if you want to get ahead, get a desk job. Yours too?"
3706,0,0,36,36,1.0,0.028171808490950554,544,“What great luck to find a job calling for Pituitary gigantism.”-
3706,0,0,36,36,1.0,0.028171808490950554,544,Being an airhead seems less weighty.
3706,0,0,36,36,1.0,0.028171808490950554,544,Brothers for Life
3706,0,0,36,36,1.0,0.028171808490950554,544,We are always on working mode.
3706,0,0,36,36,1.0,0.028171808490950554,544,"We route for the financials, we're ""desks heads"", check your inbox."
3706,0,0,36,36,1.0,0.028171808490950554,544,"We've been working too much."" ""What makes you think that?"
3706,0,0,36,36,1.0,0.028171808490950554,544,"Ok, I believe there is more to life than reflecting on how different my image is in the mirror."
3706,0,0,36,36,1.0,0.028171808490950554,544,"Working Hard"" meets ""Hardly Working"
3706,0,0,36,36,1.0,0.028171808490950554,544,I used to root for the Cubes.
3706,0,0,36,36,1.0,0.028171808490950554,544,The desk jockey in me bows to the desk jockey in you.
3706,0,0,36,36,1.0,0.028171808490950554,544,I'll have my people contact your people.
3706,0,0,36,36,1.0,0.028171808490950554,544,What Do You Think?
3706,0,0,36,36,1.0,0.028171808490950554,544,Productivity increased once we got rid of the hamster wheel.
3706,0,0,36,36,1.0,0.028171808490950554,544,Good help is so hard to find these days.
3706,0,0,36,36,1.0,0.028171808490950554,544,iContact
3706,0,0,36,36,1.0,0.028171808490950554,544,It takes a strong neck to work in IT support.
3706,0,0,36,36,1.0,0.028171808490950554,544,"I forgot, are you the left brain or the right?"
3706,0,0,36,36,1.0,0.028171808490950554,544,"You make me?"" ""Me make you?"
3706,0,0,36,36,1.0,0.028171808490950554,544,"They say that by 2025 it'll all be digitized, and only the smart phone will remain."
3706,0,0,36,36,1.0,0.028171808490950554,544,Man Accidentally Discovers Function of Unlabeled Copier Buttons
3706,0,0,36,36,1.0,0.028171808490950554,544,I think my brain is left side dominant too
3706,0,0,36,36,1.0,0.028171808490950554,544,Bob M.'s always creating problems.
3706,0,0,36,36,1.0,0.028171808490950554,544,"Yeah it's more thorough than a smartphone, but I'm still not sure about it."
3706,0,0,36,36,1.0,0.028171808490950554,544,"Jacks over aces, my friend. Now give me your tiny man's tie."
3706,0,0,36,36,1.0,0.028171808490950554,544,Call IT. You need to update your program.
3706,0,0,36,36,1.0,0.028171808490950554,544,The obsolescence of fibbing.
3706,0,0,36,36,1.0,0.028171808490950554,544,I have a pounding headache. How about you?
3706,0,0,36,36,1.0,0.028171808490950554,544,Damn...looks like white collar dandruff is contagious.
3706,0,0,37,37,1.0,0.02739983121755955,544,This talking head job was much simpler when we first started.
3706,0,0,36,36,1.0,0.028171808490950554,544,If it's work then where's the other hand?
3706,0,0,36,36,1.0,0.028171808490950554,544,Do you ever hear your intern watching cat videos?
3706,0,0,36,36,1.0,0.028171808490950554,544,This outsourcing has gone too far.
3706,0,0,36,36,1.0,0.028171808490950554,544,"There's Microsoft Office Mobile and Microsoft Office Mobile Pro. He would be the ""Pro""."
3706,0,0,36,36,1.0,0.028171808490950554,544,So your online self-description wasn't just a come-on?
3706,0,0,37,37,1.0,0.02739983121755955,544,Send me an e-mail about your Small-Hands support group.
3706,0,0,36,36,1.0,0.028171808490950554,544,We can't seem to shut down the workload!
3706,0,0,36,36,1.0,0.028171808490950554,544,They are #2 HB SOFT !
3706,0,0,36,36,1.0,0.028171808490950554,544,Sheer pressure of work is making me pop-eyed
3706,0,0,37,37,1.0,0.02739983121755955,544,Do you ever get the feeling that you're boxed in?
3706,0,0,36,36,1.0,0.028171808490950554,544,My brain is too far right to attempt leaning to the left.
3706,0,0,36,36,1.0,0.028171808490950554,544,New brains for two and six? What's not to like?
3706,0,0,36,36,1.0,0.028171808490950554,544,I think I see your point.
3706,0,0,36,36,1.0,0.028171808490950554,544,Copy me if you want...but Mom still likes me best.
3706,0,0,36,36,1.0,0.028171808490950554,544,lol we;re touching dicks
3706,0,0,37,37,1.0,0.02739983121755955,544,"Oh for Pete's sake ,get your head out of the box and smarten up!!"
3706,0,0,36,36,1.0,0.028171808490950554,544,Are you also overwhelmed by the same weight and burdens of catastrophic fear that are possessing the world lately?
3706,0,0,36,36,1.0,0.028171808490950554,544,I'll quit Snapchat if you stop sexting.
3706,0,0,36,36,1.0,0.028171808490950554,544,Mirror mirror on the wall - have I become the biggest office wonk of all?
3706,0,0,36,36,1.0,0.028171808490950554,544,You idiot. I said I needed the nimblest horse not limbless!
3706,0,0,36,36,1.0,0.028171808490950554,544,Let us vote for one each
3706,0,0,36,36,1.0,0.028171808490950554,544,They're invading my headspace!
3706,0,0,36,36,1.0,0.028171808490950554,544,Boys only have one thing on their mind.
3706,0,0,36,36,1.0,0.028171808490950554,544,"I don't know about you, but I can't get the office out of my head"
3706,0,0,37,37,1.0,0.02739983121755955,544,We thought we'd never thought you.
3706,0,0,36,36,1.0,0.028171808490950554,544,I’m beginning to lose confidence in Apple.
3706,0,0,36,36,1.0,0.028171808490950554,544,The new methods of overhead accounting are a bit much.
3706,0,0,36,36,1.0,0.028171808490950554,544,I had the same nightmare! But it did get me out of my parents’ basement.
3706,0,0,36,36,1.0,0.028171808490950554,544,Imitation is NOT flattery
3706,0,0,36,36,1.0,0.028171808490950554,544,Are you thinking what I'm thinking? Lets spike his coffee next meeting.
3706,0,0,36,36,1.0,0.028171808490950554,544,I don't mind the retro personal assistants; it's the bathroom attendants that bother me.
3706,0,0,36,36,1.0,0.028171808490950554,544,This thinking cap is useful but not very stylish.
3706,0,0,36,36,1.0,0.028171808490950554,544,Heavy is the head of he who is audited by the IRS.
3706,0,0,36,36,1.0,0.028171808490950554,544,"just when you thought desktops were a thing of the past, these guys show up."
3706,0,0,36,36,1.0,0.028171808490950554,544,You will never get ahead with a desk atop your.......
3706,0,0,36,36,1.0,0.028171808490950554,544,I never really liked you.
3706,0,0,37,37,1.0,0.02739983121755955,544,Medieval Mouse... - Medieval Pencils...
3706,0,0,36,36,1.0,0.028171808490950554,544,"I don't know, what do you think?"
3706,0,0,36,36,1.0,0.028171808490950554,544,"I know our accountants get in our heads, but mine does Trump's taxes."
3706,0,0,36,36,1.0,0.028171808490950554,544,I know how long you’ve been rehearsing this argument in your head...a tongue-sticking-out emoticon is your big comeback?
3706,0,0,36,36,1.0,0.028171808490950554,544,Would you do me a favor and send me an e-mail?
3706,0,0,36,36,1.0,0.028171808490950554,544,I guess that in these low-overhead work-spaces we'll have to get used to a little dandruff.
3706,0,0,36,36,1.0,0.028171808490950554,544,"I am NOT trying to get in your head, you silly savage. We're already there."
3706,0,0,36,36,1.0,0.028171808490950554,544,You've got a long way to go if you want to be employee of the month.
3706,0,0,36,36,1.0,0.028171808490950554,544,A head of the game
3706,0,0,36,36,1.0,0.028171808490950554,544,"Work on your mind, too?"
3706,0,0,36,36,1.0,0.028171808490950554,544,They just needed a little off the top.
3706,0,0,36,36,1.0,0.028171808490950554,544,"The downsizing rumors were on everyone's mind, though many misunderstood the term"
3706,0,0,37,37,1.0,0.02739983121755955,544,"I heard it's just desks, all the way down."
3706,0,0,36,36,1.0,0.028171808490950554,544,"How's your system running today Jim?"" ""Not to well, he hasn't had his coffee yet."
3706,0,0,37,37,1.0,0.02739983121755955,544,Digital eye contact will improve networking and sales.
3706,0,0,36,36,1.0,0.028171808490950554,544,"So, how did yours get a head?"
3706,0,0,36,36,1.0,0.028171808490950554,544,I never thought that office work is so hard.
3706,0,0,36,36,1.0,0.028171808490950554,544,This is nothing. You should see the #facepalm guys.
3706,0,0,36,36,1.0,0.028171808490950554,544,I find myself thinking about head office shrinkage all the time.
3706,0,0,36,36,1.0,0.028171808490950554,544,I see your daughter is into doll houses also.
3706,0,0,36,36,1.0,0.028171808490950554,544,Two human subjectivities speaking face-to-face in an intimate and meaningful manner was so last century.
3706,0,0,36,36,1.0,0.028171808490950554,544,Which twin has the Toni?
3706,0,0,36,36,1.0,0.028171808490950554,544,"It's only because of Putin, WikiLeaks and the FBI that we are having this conversation."
3706,0,0,36,36,1.0,0.028171808490950554,544,"I have pens, and you don't."
3706,0,0,36,36,1.0,0.028171808490950554,544,The only drawback is when business is doing well he taps his feet a lot!
3706,0,0,36,36,1.0,0.028171808490950554,544,Send back to me the Top Secret diagrams I sent to you.
3706,0,0,36,36,1.0,0.028171808490950554,544,"Stop making sense, stop making sense, stop making sense, making sense."
3706,0,0,36,36,1.0,0.028171808490950554,544,They're trying to make the glass ceiling just a little bit higher.
3706,0,0,36,36,1.0,0.028171808490950554,544,"Hey Weirdo, your guy is stapler-less. Get away from me before it's catching. Honk, honk!"
3706,0,0,36,36,1.0,0.028171808490950554,544,"i know, no headphone jack!?"
3706,0,0,36,36,1.0,0.028171808490950554,544,Who would have thought neglected brain cells would go to this extreme to mirror our megabyte mania -- and in duplicate?
3706,0,0,36,36,1.0,0.028171808490950554,544,"Sure, I'd like to believe you're my long-lost twin, but how can I be sure?"
3706,0,0,36,36,1.0,0.028171808490950554,544,"For me the hardest part was no longer being able to say, ""off the top of my head..."""
3706,0,0,36,36,1.0,0.028171808490950554,544,"In my job, I wear a lot of hats."
3706,0,0,36,36,1.0,0.028171808490950554,544,How's the stress holding up?
3706,0,0,36,36,1.0,0.028171808490950554,544,Are you sure those were shiitake mushrooms?
3706,0,0,36,36,1.0,0.028171808490950554,544,I just want to Reboot my life
3706,0,0,36,36,1.0,0.028171808490950554,544,Stay away from my hat store.
3706,0,0,36,36,1.0,0.028171808490950554,544,What can I say? I carry my work home too.
3706,0,0,36,36,1.0,0.028171808490950554,544,Two Seen as One
3706,0,0,36,36,1.0,0.028171808490950554,544,"Have your help desk call me help desk, if you need help with anything."
3706,0,0,36,36,1.0,0.028171808490950554,544,"Don't just sit there, Charles. Get to Work!"
3706,0,0,36,36,1.0,0.028171808490950554,544,"Lunch? Sure, have your guy talk to my guy."
3706,0,0,37,37,1.0,0.02739983121755955,544,I'm taking a 35% rent hit because of my dandruff.
3706,0,0,36,36,1.0,0.028171808490950554,544,Did yours wipe his shoes at least?
3706,0,0,36,36,1.0,0.028171808490950554,544,You think they'd realize how Wikileaks works by now
3706,0,0,36,36,1.0,0.028171808490950554,544,"When they leave for lunch, let's go through their search history."
3706,0,0,36,36,1.0,0.028171808490950554,544,Who is in YOUR head?
3706,0,0,36,36,1.0,0.028171808490950554,544,They all look alike...
3706,0,0,36,36,1.0,0.028171808490950554,544,We need a bigger server
3706,0,0,36,36,1.0,0.028171808490950554,544,Do you notice we both have very small hands!
3706,0,0,36,36,1.0,0.028171808490950554,544,Thinking outside yourself.
3706,0,0,36,36,1.0,0.028171808490950554,544,"At least our brains operate on the latest software, Trump's brain must still be using DOS"
3706,0,0,36,36,1.0,0.028171808490950554,544,"I know we said we wanted a ""heads up,"" but I didn't expect this."
3706,0,0,36,36,1.0,0.028171808490950554,544,I also refused a teleprompter
3706,0,0,36,36,1.0,0.028171808490950554,544,My homunculus is faster than your homunculus.
3706,0,0,36,36,1.0,0.028171808490950554,544,Now make a duplicate copy. Save it as 'ad infinitum.'
3706,0,0,36,36,1.0,0.028171808490950554,544,There's an app for hat.
3706,0,0,36,36,1.0,0.028171808490950554,544,She said our new toupe's make us look smarter
3706,0,0,36,36,1.0,0.028171808490950554,544,What's making you think these rediculous thoughts?
3706,0,0,36,36,1.0,0.028171808490950554,544,So how long have you been on the team?
3706,0,0,36,36,1.0,0.028171808490950554,544,This isn't what I thought they meant by mind control!
3706,0,0,36,36,1.0,0.028171808490950554,544,You mind working?
3706,0,0,37,37,1.0,0.02739983121755955,544,I don't see how this reflects on you.
3706,0,0,36,36,1.0,0.028171808490950554,544,"Sorry, but I don’t have enough memory to keep you in mind."
3706,0,0,36,36,1.0,0.028171808490950554,544,Stock option for your thoughts.
3706,0,0,36,36,1.0,0.028171808490950554,544,"Oh, yeah? Why don't you make me get out of your face?"
3706,0,0,36,36,1.0,0.028171808490950554,544,These nostalgia hats are bound to catch on.
3706,0,0,36,36,1.0,0.028171808490950554,544,I bought your guy an office composting chair.
3706,0,0,36,36,1.0,0.028171808490950554,544,"Ah, yes. With the pens is better."
3706,0,0,36,36,1.0,0.028171808490950554,544,"Oh, like your brain farts don't stink."
3706,0,0,36,36,1.0,0.028171808490950554,544,I think that I have imagined a new foot salve for dry skin in the winter.
3706,0,0,36,36,1.0,0.028171808490950554,544,Double tasking was a requirement for working at Google.
3706,0,0,37,37,1.0,0.02739983121755955,544,I guess it's time to put our clothes back on.
3706,0,0,36,36,1.0,0.028171808490950554,544,I'm on vacation too.
3706,0,0,36,36,1.0,0.028171808490950554,544,"No,"
3706,0,0,36,36,1.0,0.028171808490950554,544,The pencils cost extra.
3706,0,0,36,36,1.0,0.028171808490950554,544,It's a real time fairy tale.
3706,0,0,36,36,1.0,0.028171808490950554,544,I need to pee!
3706,0,0,36,36,1.0,0.028171808490950554,544,Mine's an airbnb. But I used to sublet.
3706,0,0,36,36,1.0,0.028171808490950554,544,Have you heard what Suits have been riding over our heads these days?
3706,0,0,36,36,1.0,0.028171808490950554,544,I feel like I'm looking in the mirror...
3706,0,0,36,36,1.0,0.028171808490950554,544,Even clones have small idiosyncrasies.
3706,0,0,36,36,1.0,0.028171808490950554,544,"""We Can't Let work get into our heads Jared'! It is gonna be alright,we only have 35 more years to go."
3706,0,0,36,36,1.0,0.028171808490950554,544,My VR-AI is. Your VR-AI isn't.
3706,0,0,36,36,1.0,0.028171808490950554,544,People can be so complaining at times.
3706,0,0,36,36,1.0,0.028171808490950554,544,"Yes, sweetheart, 'chick' is politically correct."
3706,0,0,36,36,1.0,0.028171808490950554,544,It's about time you got your head in the work!
3706,0,0,37,37,1.0,0.02739983121755955,544,"C'mon, man, do you really think neatness counts?"
3706,0,0,36,36,1.0,0.028171808490950554,544,Cool hat.
3706,0,0,36,36,1.0,0.028171808490950554,544,This insomnia isn't getting to you?
3706,0,0,36,36,1.0,0.028171808490950554,544,I grant you left trumps right.
3706,0,0,36,36,1.0,0.028171808490950554,544,The Russian hackers are probably way better than we think they are.
3706,0,0,36,36,1.0,0.028171808490950554,544,"If you're free after work, I'll show you around my brain. . ."
3706,0,0,36,36,1.0,0.028171808490950554,544,Do you think they're twins too?
3706,0,0,36,36,1.0,0.028171808490950554,544,I hate it when he tap-dances Beyoncé's 'Sorry' 9-5.
3706,0,0,36,36,1.0,0.028171808490950554,544,This not what I imagined my other half would look like.
3706,0,0,36,36,1.0,0.028171808490950554,544,Where does yours relieve himself?
3706,0,0,36,36,1.0,0.028171808490950554,544,can you do lunch today?
3706,0,0,36,36,1.0,0.028171808490950554,544,"There must be some kind of way out of here, said the senior-systems-operations-management-consultant to the junior-marketing-point-of-sale-systems-manager"
3706,0,0,36,36,1.0,0.028171808490950554,544,I have a head for business and a body for sin.
3706,0,0,36,36,1.0,0.028171808490950554,544,You're the one who's over-intellectualizing!
3706,0,0,36,36,1.0,0.028171808490950554,544,I wonder if our Assistants will ever get us out of this Psych Ward.
3706,0,0,37,37,1.0,0.02739983121755955,544,"We're hardwired, so yes we are booking the same vacation days."
3706,0,0,36,36,1.0,0.028171808490950554,544,You too? These headworks are killing me.
3706,0,0,36,36,1.0,0.028171808490950554,544,We need to loosen up!
3706,0,0,36,36,1.0,0.028171808490950554,544,How is retirement treating you?
3706,0,0,36,36,1.0,0.028171808490950554,544,This is me reminding me to schedule an appointment for my bipolar disorder!
3706,0,0,37,37,1.0,0.02739983121755955,544,Just giving you the heads up ... your e-mails will always be recoverable for your opponents to read.
3706,0,0,36,36,1.0,0.028171808490950554,544,Mine's left handed also.
3706,0,0,36,36,1.0,0.028171808490950554,544,I was always the artistic one! You were good in math!
3706,0,0,36,36,1.0,0.028171808490950554,544,"Just off the top of my head, how about never--is never good for you?"
3706,0,0,36,36,1.0,0.028171808490950554,544,I'm of two minds about working here.
3706,0,0,36,36,1.0,0.028171808490950554,544,This Hillary Clinton Wikileaks thing is really messing with my head. You too?
3706,0,0,36,36,1.0,0.028171808490950554,544,"In box, out box. I prefer off box"
3706,0,0,37,37,1.0,0.02739983121755955,544,I don't know. I'll have to check in with the top boss first.
3706,0,0,36,36,1.0,0.028171808490950554,544,"Hey, you wanna start a comedy routine?"
3706,0,0,37,37,1.0,0.02739983121755955,544,It may be a good idea to contact Norton.
3706,0,0,36,36,1.0,0.028171808490950554,544,"Someday, I'm going to make it. 4 gigs of RAM, a touchscreen. The whole 9 yards."
3706,0,0,36,36,1.0,0.028171808490950554,544,Are you getting a Wi-Fi signal?
3706,0,0,36,36,1.0,0.028171808490950554,544,Samsung went all out to fix their battery issue.
3706,0,0,36,36,1.0,0.028171808490950554,544,"What's yours is mine, as they say"
3706,0,0,36,36,1.0,0.028171808490950554,544,I hate being disadvantaged by my nephew's DNA code.
3706,0,0,36,36,1.0,0.028171808490950554,544,I KNOW! Right?
3706,0,0,36,36,1.0,0.028171808490950554,544,"Yes, I got your message! What exactly do you mean by ""You've just been texted to death?"""
3706,0,0,36,36,1.0,0.028171808490950554,544,Simon says...
3706,0,0,36,36,1.0,0.028171808490950554,544,It's important for us to communicate well by being ahead of email.
3706,0,0,36,36,1.0,0.028171808490950554,544,Great! People are going to think we cold-called each other last night.
3706,0,0,36,36,1.0,0.028171808490950554,544,Wouldn't like it to be the full time job. would you?
3706,0,0,36,36,1.0,0.028171808490950554,544,You know they say consistency is the hobgoblin of small minds....
3706,0,0,36,36,1.0,0.028171808490950554,544,"A little revealing, wouldn't you say?"
3706,0,0,36,36,1.0,0.028171808490950554,544,"Do you hear voices the voices, too? And the typing and constant paper shuffling?"
3706,0,0,36,36,1.0,0.028171808490950554,544,"The staring contest went on for so long, they had to produce tiny breadwinner copies of themselves to survive."
3706,0,0,36,36,1.0,0.028171808490950554,544,Turns out Spy vs. Spy makes a crummy video game.
3706,0,0,36,36,1.0,0.028171808490950554,544,"Frankly, David Byrne did it better"
3706,0,0,36,36,1.0,0.028171808490950554,544,"Hey, remember, you know when we kinda just talked to each other......"
3706,0,0,36,36,1.0,0.028171808490950554,544,"Strange, I know, but he gives me some of my best ideas. What about yours?"
3706,0,0,36,36,1.0,0.028171808490950554,544,"Confidence booster when preparing for a Halloween Dress-up Party: ""Magic Mirror on the wall, show whose costume's best of all."""
3706,0,0,36,36,1.0,0.028171808490950554,544,At least we're better off than those construction site cranium folks.
3706,0,0,36,36,1.0,0.028171808490950554,544,You want to discuss what?
3706,0,0,36,36,1.0,0.028171808490950554,544,"Two rams, a fight to the death, what's not to like?"
3706,0,0,36,36,1.0,0.028171808490950554,544,When your mind is on break and you just can't compute.
3706,0,0,36,36,1.0,0.028171808490950554,544,Something tells me its going to be a bad hair day.
3706,0,0,36,36,1.0,0.028171808490950554,544,What if we've swapped our few senior moments for frequent coffee breaks?
3706,0,0,36,36,1.0,0.028171808490950554,544,The donkeys have been picking on him again.
3706,0,0,36,36,1.0,0.028171808490950554,544,This is what happens when you're identical twins.
3706,0,0,37,37,1.0,0.02739983121755955,544,Critical updates during rush hour processing left them both speechless.
3706,0,0,36,36,1.0,0.028171808490950554,544,It's hard to meet Cartesian dualists these days.
3706,0,0,37,37,1.0,0.02739983121755955,544,We used to just be in each others heads.
3706,0,0,36,36,1.0,0.028171808490950554,544,Your cubicle looks just like mine!
3706,0,0,36,36,1.0,0.028171808490950554,544,I see you got your Easter bonnet off the clearance rack also
3706,0,0,36,36,1.0,0.028171808490950554,544,My brain age is younger than yours!
3706,0,0,36,36,1.0,0.028171808490950554,544,It was time to make a change.
3706,0,0,36,36,1.0,0.028171808490950554,544,"I'm having trouble spotting the differences...Oh wait, the bangs are longer!"
3706,0,0,36,36,1.0,0.028171808490950554,544,hillary clinton's emails
3706,0,0,36,36,1.0,0.028171808490950554,544,"I preferred the neck implants, myself."
3706,0,0,36,36,1.0,0.028171808490950554,544,this new carpet does not inspire me.
3706,0,0,36,36,1.0,0.028171808490950554,544,Do you ever feel wired at times?
3706,0,0,36,36,1.0,0.028171808490950554,544,"ALL OF A SUDDEN, I FEEL THAT ELECTRONIC COMMUNICATIONS IS HEAD AND SHOULDERS ABOVE TALKING."
3706,0,0,36,36,1.0,0.028171808490950554,544,Where did you buy your hat? It looks exactly like mine...
3706,0,0,36,36,1.0,0.028171808490950554,544,I really envy you right brainers. You never have to sweat the details.
3706,0,0,36,36,1.0,0.028171808490950554,544,My programming of the world is writing an optimistic script. Get a zip drive.
3706,0,0,36,36,1.0,0.028171808490950554,544,Stay single. I gotta balance work AND family.
3706,0,0,36,36,1.0,0.028171808490950554,544,"His shoes aren't the problem, it's Miss Crenshaw's knobby knees."
3706,0,0,36,36,1.0,0.028171808490950554,544,"I know, he keeps getting me new boots!"
3706,0,0,36,36,1.0,0.028171808490950554,544,Real growth will happen only when it is massaged at the top.
3706,0,0,36,36,1.0,0.028171808490950554,544,"I can't really explain why I dislike our two newest hires. Not off the top of my head, anyway."
3706,0,0,36,36,1.0,0.028171808490950554,544,You're the moderator who sensor's me?
3706,0,0,36,36,1.0,0.028171808490950554,544,Headbutt?
3706,0,0,37,37,1.0,0.02739983121755955,544,I have something else to discuss with you.
3706,0,0,36,36,1.0,0.028171808490950554,544,He really misses his BlackBerry.
3706,0,0,37,37,1.0,0.02739983121755955,544,"A push to think ""change"" and think ""outside the box""....what a weight on my mind"
3706,0,0,36,36,1.0,0.028171808490950554,544,"I don't know where head is at, but I'm feeling slightly wired today."
3706,0,0,36,36,1.0,0.028171808490950554,544,I got my mind set on you.
3706,0,0,36,36,1.0,0.028171808490950554,544,Has it really come to computerized puppeteering of an old Marx Brothers routine?
3706,0,0,37,37,1.0,0.02739983121755955,544,I just sent you a desk message.
3706,0,0,36,36,1.0,0.028171808490950554,544,Man what a head job.
3706,0,0,36,36,1.0,0.028171808490950554,544,The desk is always browner on the other side.
3706,0,0,36,36,1.0,0.028171808490950554,544,How to make your Facebook profile picture look like it's popping out of the page.
3706,0,0,36,36,1.0,0.028171808490950554,544,"--Man, she was so hot! --We were at it all night!"
3706,0,0,36,36,1.0,0.028171808490950554,544,I haven't been sleeping. My brain's been working overtime and the keyboard is too damn loud.
3706,0,0,36,36,1.0,0.028171808490950554,544,Working 24 hours a day is so rewarding.
3706,0,0,36,36,1.0,0.028171808490950554,544,Does being left-handed ever slow your headweigh?
3706,0,0,36,36,1.0,0.028171808490950554,544,I can see Russia from your head!
3706,0,0,36,36,1.0,0.028171808490950554,544,There's not much difference between my id and your superego.
3706,0,0,36,36,1.0,0.028171808490950554,544,"Ninja, schminja, I posted it first."
3706,0,0,39,39,1.0,0.025976216673306556,544,When Frank asked for a raise I bought elevator shoes.
3706,0,0,36,36,1.0,0.028171808490950554,544,Slave to twin thought
3706,0,0,36,36,1.0,0.028171808490950554,544,Have you ever gotten to the bottom line?
3706,0,0,37,37,1.0,0.02739983121755955,544,The problem is more than mammoth! Can't you see the elephant in the room?
3706,0,0,36,36,1.0,0.028171808490950554,544,"He's a hoot on casual Fridays, but every time I sneeze it knocks out the surge protector."
3706,0,0,37,37,1.0,0.02739983121755955,544,I'm glad I don't have a neck.
3706,0,0,36,36,1.0,0.028171808490950554,544,My desktop headtop tops your headtop desktop.
3706,0,0,36,36,1.0,0.028171808490950554,544,"""I don't know about you Bill, but I can't get work out of my head lately"". ""Gosh Frank, work is all that's ever on my mind""."
3706,0,0,36,36,1.0,0.028171808490950554,544,"That could work, but I sort of had the opposite idea ..."
3706,0,0,36,36,1.0,0.028171808490950554,544,One soul mate is enough.
3706,0,0,36,36,1.0,0.028171808490950554,544,The comeback control room
3706,0,0,36,36,1.0,0.028171808490950554,544,It's so efficient to do your taxes in real time.
3706,0,0,36,36,1.0,0.028171808490950554,544,You googled?
3706,0,0,36,36,1.0,0.028171808490950554,544,Nobody tells me what I have to do - nobody!
3706,0,0,36,36,1.0,0.028171808490950554,544,Next debate let’s scrap fact checkers.
3706,0,0,36,36,1.0,0.028171808490950554,544,"Mirror, mirror on the wall. I bet my desk is busiest of all."
3706,0,0,36,36,1.0,0.028171808490950554,544,It only works if you are charged with stealing office supplies.
3706,0,0,36,36,1.0,0.028171808490950554,544,Nice ass-hat
3706,0,0,36,36,1.0,0.028171808490950554,544,Did you order virtual pizza?
3706,0,0,36,36,1.0,0.028171808490950554,544,I told you computers are hot.
3706,0,0,36,36,1.0,0.028171808490950554,544,What I'm doing versus what I wish I was doing
3706,0,0,36,36,1.0,0.028171808490950554,544,You bought into the interesting hair piece idea too? What will we do now that he's lost?
3706,0,0,36,36,1.0,0.028171808490950554,544,You have to get the right balance when it comes to computers.
3706,0,0,36,36,1.0,0.028171808490950554,544,Your PC shows numbers and mine shows feelings.
3706,0,0,36,36,1.0,0.028171808490950554,544,Does your mini-me every take coffee breaks?
3706,0,0,36,36,1.0,0.028171808490950554,544,Our promotions have gone to our heads!
3706,0,0,37,37,1.0,0.02739983121755955,544,"I value face-time, too, but I want it on record."
3706,0,0,36,36,1.0,0.028171808490950554,544,Genetic engineering is coming along isn't?
3706,0,0,36,36,1.0,0.028171808490950554,544,"Sure we’re in a rut, but at least one of us should learn to start thinking outside the box."
3706,0,0,36,36,1.0,0.028171808490950554,544,macro psycho Office processor!.... a disease of the mind.
3706,0,0,36,36,1.0,0.028171808490950554,544,"Bob, was it after 1965 we lost our individual identities!!"
3706,0,0,36,36,1.0,0.028171808490950554,544,I take the job home so my wife doesn't know I was fired.
3706,0,0,36,36,1.0,0.028171808490950554,544,My therapist said this would be a good way to visualise my superego
3706,0,0,36,36,1.0,0.028171808490950554,544,"Well, my wife keeps telling me to stop bringing my work home with me."
3706,0,0,36,36,1.0,0.028171808490950554,544,How can I be so intelligent and just be one person?
3706,0,0,36,36,1.0,0.028171808490950554,544,"Jeopardy! said there is no written rule, but it violates the spirit of the game."
3706,0,0,36,36,1.0,0.028171808490950554,544,Like you I am compelled to complete my redundancy.
3706,0,0,36,36,1.0,0.028171808490950554,544,Are you as tired of email as I am?
3706,0,0,36,36,1.0,0.028171808490950554,544,I just can't seem to wrap myself around this one.
3706,0,0,36,36,1.0,0.028171808490950554,544,virtual reality games are virtually making me bored out of my mind.
3706,0,0,36,36,1.0,0.028171808490950554,544,It's the next best thing to having an embedded smart phone.
3706,0,0,37,37,1.0,0.02739983121755955,544,...
3706,0,0,36,36,1.0,0.028171808490950554,544,"""Mind matters but hold onto your desk."
3706,0,0,36,36,1.0,0.028171808490950554,544,It took years for synchronized swimming to reach the Olympics too.
3706,0,0,36,36,1.0,0.028171808490950554,544,One of us has to be a living dead
3706,0,0,36,36,1.0,0.028171808490950554,544,He wants me to move into a pre-war apartment so he can get a standing desk.
3706,0,0,36,36,1.0,0.028171808490950554,544,I see you also like to work from home.
3706,0,0,36,36,1.0,0.028171808490950554,544,For the orthodox business man.
3706,0,0,36,36,1.0,0.028171808490950554,544,At least yours is migratory.
3706,0,0,36,36,1.0,0.028171808490950554,544,I don't know. What do you think?
3706,0,0,36,36,1.0,0.028171808490950554,544,I see you've yet to upgrade to iOS 10. You'll find extra pencil holder is invaluable.
3706,0,0,36,36,1.0,0.028171808490950554,544,"I did take him to the circus...just like you insisted. We had such a great time, next week we're going to the ballgame."
3706,0,0,36,36,1.0,0.028171808490950554,544,Let's just have our guys work it out.
3706,0,0,36,36,1.0,0.028171808490950554,544,I do. I undo
3706,0,0,36,36,1.0,0.028171808490950554,544,I see your position is high overhead too
3706,0,0,36,36,1.0,0.028171808490950554,544,Paternals annoy but identicals irk.
3706,0,0,36,36,1.0,0.028171808490950554,544,What do you think? Left brain or right brain?
3706,0,0,36,36,1.0,0.028171808490950554,544,Did you see my reply?
3706,0,0,36,36,1.0,0.028171808490950554,544,This place hasn't been the same since they took on Charlie Kaufman as a consultant.
3706,0,0,37,37,1.0,0.02739983121755955,544,I am interested. However I think it might be a lateral move.
3706,0,0,36,36,1.0,0.028171808490950554,544,This for an Ivy League degree
3706,0,0,36,36,1.0,0.028171808490950554,544,You've got to keep at it to get ahead in this business.
3706,0,0,36,36,1.0,0.028171808490950554,544,It's critical that we think outside the box!
3706,0,0,36,36,1.0,0.028171808490950554,544,I've printed out 103 photos from my vacation for you
3706,0,0,36,36,1.0,0.028171808490950554,544,Were is this stuff plugged in?
3706,0,0,36,36,1.0,0.028171808490950554,544,He actually funnels some good ideas down for me to size up.
3706,0,0,36,36,1.0,0.028171808490950554,544,"I agree, in the end, everyone has to bear their own desk."
3706,0,0,36,36,1.0,0.028171808490950554,544,I've got my mind on my accountant and my accountant on my mind.
3706,0,0,36,36,1.0,0.028171808490950554,544,Doppelgängers in all but genes.
3706,0,0,36,36,1.0,0.028171808490950554,544,The Winklevi brainstorm a Zuck-free augmented reality start up.
3706,0,0,36,36,1.0,0.028171808490950554,544,"Contest #543, October 31, 2016 (it is 10:27 PM Los Angeles/California time Sunday 10/30. Please accept my submission?) ""I certainly agree! He'll add immensely to the ASS-ets of your campaign!"""
3706,0,0,37,37,1.0,0.02739983121755955,544,The split brain theory has been really weighing on me lately.
3706,0,0,36,36,1.0,0.028171808490950554,544,These guys really always have work on there mind.
3706,0,0,36,36,1.0,0.028171808490950554,544,Same thing. They want our people to build it and ship it back to them for scaresly nothing.
3706,0,0,36,36,1.0,0.028171808490950554,544,I don't know what I'd do without it. How do you like YOUR new iOffice?
3706,0,0,36,36,1.0,0.028171808490950554,544,'time to turn off the office head app.'
3706,0,0,36,36,1.0,0.028171808490950554,544,"Do you have to copy everything that I do? [with ""everything"" underlined]"
3706,0,0,36,36,1.0,0.028171808490950554,544,This job pressure we're under is getting harder to shake off.
3706,0,0,36,36,1.0,0.028171808490950554,544,Forget balance. Think choice.
3706,0,0,36,36,1.0,0.028171808490950554,544,Go fish
3706,0,0,36,36,1.0,0.028171808490950554,544,It's uplifting but still a nightmare.
3706,0,0,36,36,1.0,0.028171808490950554,544,"Every morning, Horatio would tell himself that his pen's and penholder would be returned."
3706,0,0,37,37,1.0,0.02739983121755955,544,Do they know they're getting their own hat honchos tomorrow?
3706,0,0,36,36,1.0,0.028171808490950554,544,I told Dr. Clone to tweak a gene.
3706,0,0,36,36,1.0,0.028171808490950554,544,"It's a good thing they separated us at birth, joined at the head, so we can keep an eye on each other--especially your stock tips of the day."
3706,0,0,36,36,1.0,0.028171808490950554,544,ME™ versa top desk manager ?°
3706,0,0,37,37,1.0,0.02739983121755955,544,are you thinking what I'm thinking ? Isn't work on the brain such a shame
3706,0,0,36,36,1.0,0.028171808490950554,544,The election is over and no one won
3706,0,0,36,36,1.0,0.028171808490950554,544,"Mine wears cleats and Massages my scalp, except when he stands up, then it hurts. How about yours?"
3706,0,0,36,36,1.0,0.028171808490950554,544,My work life balance is literally improving.
3706,0,0,36,36,1.0,0.028171808490950554,544,"""Yah I thought Inside Out was a great movie but for sure unrealistic."
3706,0,0,36,36,1.0,0.028171808490950554,544,"You never do any work! If I had half a brain, I'd fire you."
3706,0,0,36,36,1.0,0.028171808490950554,544,It looks like high tech is out--we'll have to start talking to each other again.
3706,0,0,36,36,1.0,0.028171808490950554,544,"I never really thought about it, a diaper or something, no wait..."
3706,0,0,37,37,1.0,0.02739983121755955,544,"I see WeWorks contacted you, too, about air rights."
3706,0,0,37,37,1.0,0.02739983121755955,544,"I know that it might be quicker to walk to your office right next door to tell you ‘yes,’ but why do that when I can check a hundred other emails at the same time."
3706,0,0,36,36,1.0,0.028171808490950554,544,This is our brain on mobile phones
3706,0,0,36,36,1.0,0.028171808490950554,544,We're over our head
3706,0,0,37,37,1.0,0.02739983121755955,544,Well my guy clips his nails!
3706,0,0,36,36,1.0,0.028171808490950554,544,Guy 1: You ever feel so consumed from work that it feels like you boss lives at a desk on top of your head controlling every single one of your thoughts and actions. Guy 2: No all mine does up there is check social media and stream porn.
3706,0,0,36,36,1.0,0.028171808490950554,544,Sh-h-h. We don't want them to know!!!
3706,0,0,37,37,1.0,0.02739983121755955,544,"What do you mean, this is business as usual?"
3706,0,0,36,36,1.0,0.028171808490950554,544,Finally we have a use for that 90% of our brain that wasn't doing anything.
3706,0,0,36,36,1.0,0.028171808490950554,544,"Ig-bay Other-Bra has on-gay too ar-fay this time, don't you ink-thay?"
3706,0,0,36,36,1.0,0.028171808490950554,544,Do you ever get that feeling that there's a small accountant living on your head?
3706,0,0,36,36,1.0,0.028171808490950554,544,Got pencils?
3706,0,0,36,36,1.0,0.028171808490950554,544,So what's your opinion of the new TurboTax peripherals
3706,0,0,37,37,1.0,0.02739983121755955,544,"Hey, I see you also have the latest desktop computer."
3706,0,0,36,36,1.0,0.028171808490950554,544,I finally figured it out. You're the one with the desk on your head.
3706,0,0,36,36,1.0,0.028171808490950554,544,I think I'm shrinking. How about you?
3706,0,0,36,36,1.0,0.028171808490950554,544,"Win win-it's a small small world, with appropriate salaries!"
3706,0,0,36,36,1.0,0.028171808490950554,544,"- I love her, but my guy upstairs says it's a no go. - Did he make a spreadsheet?"
3706,0,0,36,36,1.0,0.028171808490950554,544,"Even at this nude beach, Shiela complains my head is always some place else!"
3706,0,0,36,36,1.0,0.028171808490950554,544,I got my personal pollster cheap on Amazon.
3706,0,0,36,36,1.0,0.028171808490950554,544,"So, we're working on an app called Watercooler"
3706,0,0,36,36,1.0,0.028171808490950554,544,"Since you have the cream already, I guess I'll get the coffee"
3706,0,0,36,36,1.0,0.028171808490950554,544,"Minimize, Relocate..ok..but this is ridiculous"
3706,0,0,36,36,1.0,0.028171808490950554,544,Anthony Weiner Super Pac?
3706,0,0,36,36,1.0,0.028171808490950554,544,This Top of Mind memory augmentation works but it limits your hair style options.
3706,0,0,36,36,1.0,0.028171808490950554,544,"... and just a fad. Of course, it's all conjecture at this point... so keep it under your hat."
3706,0,0,37,37,1.0,0.02739983121755955,544,"work, work, work, work, work, work, work ,work"
3706,0,0,36,36,1.0,0.028171808490950554,544,The standing desk lasted him a second.
3706,0,0,36,36,1.0,0.028171808490950554,544,How do you like these new implants?
3706,0,0,36,36,1.0,0.028171808490950554,544,"I see you're reading my mind. You're right, I just pushed Delete."
3706,0,0,36,36,1.0,0.028171808490950554,544,You know how it is....a problem at work but you can't remember it off the top of your head.
3706,0,0,36,36,1.0,0.028171808490950554,544,Ha! I sunk your battleship.
3706,0,0,36,36,1.0,0.028171808490950554,544,"Do you ever miss your deerstalker, Mr. Holmes?"
3706,0,0,36,36,1.0,0.028171808490950554,544,I like it. It makes me keep my head still while playing golf.
3706,0,0,36,36,1.0,0.028171808490950554,544,"Yeah, it's really important to think out of the box..."
3706,0,0,36,36,1.0,0.028171808490950554,544,I see we're both still using a mouse.
3706,0,0,36,36,1.0,0.028171808490950554,544,I have to let you go. We're just not compatible any more.
3706,0,0,36,36,1.0,0.028171808490950554,544,"I see you put on your thinking cap today, too."
3706,0,0,36,36,1.0,0.028171808490950554,544,My head-desk guy is way smarter than your head-desk guy.
3706,0,0,36,36,1.0,0.028171808490950554,544,I'm tired of politics. The end is near.
3706,0,0,36,36,1.0,0.028171808490950554,544,"Next year, I am going to support a less urban football team."
3706,0,0,36,36,1.0,0.028171808490950554,544,"Yea, tiny hands, but my pens are bigger than yours."
3706,0,0,36,36,1.0,0.028171808490950554,544,This is stupid.
3706,0,0,36,36,1.0,0.028171808490950554,544,"Sorry, bob. My data bank is full. can you send me an email later?"
3706,0,0,36,36,1.0,0.028171808490950554,544,"Someone is there and work thinks we are sick. Lets go get a doughnut and maybe some coffee, I'll pay."
3706,0,0,36,36,1.0,0.028171808490950554,544,"Butt in, chin up, back straight..."
3706,0,0,36,36,1.0,0.028171808490950554,544,"""WHO ARE YOU SUPPOSE TO REPRESENT?"
3706,0,0,36,36,1.0,0.028171808490950554,544,I too have this thing about bureaucrats...
3706,0,0,36,36,1.0,0.028171808490950554,544,Does yours also have the upcoming quarterly results on his mind?
3706,0,0,36,36,1.0,0.028171808490950554,544,Do you mind?
3706,0,0,36,36,1.0,0.028171808490950554,544,Two heads are better than one.
3706,0,0,36,36,1.0,0.028171808490950554,544,"I feel ya, Bro!!"
3706,0,0,36,36,1.0,0.028171808490950554,544,I didn't know that the world wide web was used in a mind-meld.
3706,0,0,36,36,1.0,0.028171808490950554,544,"We can't shake them, they're rent stabilized."
3706,0,0,36,36,1.0,0.028171808490950554,544,They say this style really puts the CPA in cap.
3706,0,0,36,36,1.0,0.028171808490950554,544,Do you think they might have exploding cell phones in a desk drawer?
3706,0,0,36,36,1.0,0.028171808490950554,544,What's going on? Please tell me this is a dream...
3706,0,0,36,36,1.0,0.028171808490950554,544,I don't like this at all. I feel like we're being jobbed.
3706,0,0,37,37,1.0,0.02739983121755955,544,Working from home gives me nightmares.
3706,0,0,36,36,1.0,0.028171808490950554,544,I can't stop multitasking either
3706,0,0,36,36,1.0,0.028171808490950554,544,"Believe me, I understand what you're desk-ribing."
3706,0,0,36,36,1.0,0.028171808490950554,544,Texting heads never see eye to eye
3706,0,0,36,36,1.0,0.028171808490950554,544,"I'm happy to work in an office, my poor brother-in-law is a hockey player."
3706,0,0,36,36,1.0,0.028171808490950554,544,"A sit-stand Erognomic desk?....,I'm listening"
3706,0,0,36,36,1.0,0.028171808490950554,544,"With haircuts this bad, how can one be afraid of hackers?"
3706,0,0,36,36,1.0,0.028171808490950554,544,"Uh, sure, my vision for the future is exciting. You?"
3706,0,0,36,36,1.0,0.028171808490950554,544,Are you the left side of the brain or am I?
3706,0,0,36,36,1.0,0.028171808490950554,544,Outsearched!
3706,0,0,36,36,1.0,0.028171808490950554,544,Did you get that email from my guy?
3706,0,0,36,36,1.0,0.028171808490950554,544,THIS COMPUTER HAS A MIND OF IT'S OWNE
3706,0,0,36,36,1.0,0.028171808490950554,544,I see that you can't get work off your ind either.
3706,0,0,36,36,1.0,0.028171808490950554,544,You must have spent beaucoup bucks for your weave. It looks real!
3706,0,0,36,36,1.0,0.028171808490950554,544,"I know, but don't you think that we ought to talk about the elephant in the room?"
3706,0,0,36,36,1.0,0.028171808490950554,544,"Your imaginative mind, thinks just as intelligent as I do."
3706,0,0,36,36,1.0,0.028171808490950554,544,"At least we can say we used ""Rapid File Tax Preparers"" that were locally sourced"
3706,0,0,36,36,1.0,0.028171808490950554,544,"Oh, I get it now. '...and Jacket' is quite the ribald Blink-182 joke. Scandalous."
3706,0,0,36,36,1.0,0.028171808490950554,544,I didn't know that we went to the same hair stylist.
3706,0,0,36,36,1.0,0.028171808490950554,544,Let's try to avoid each other at the Fancy Dress Ball later.
3706,0,0,36,36,1.0,0.028171808490950554,544,Are we on the same track? I am afraid that you are tuning me out.
3706,0,0,36,36,1.0,0.028171808490950554,544,two workaholics working together can lead to a wondrous or a dangerous state of mind.
3706,0,0,36,36,1.0,0.028171808490950554,544,My guy will set you up in tax deferred bonds.
3706,0,0,36,36,1.0,0.028171808490950554,544,I can never get it off mind either.
3706,0,0,36,36,1.0,0.028171808490950554,544,"They used to work in the campaign trail, now they want office jobs."
3706,0,0,36,36,1.0,0.028171808490950554,544,I read the next model will be wireless.
3706,0,0,36,36,1.0,0.028171808490950554,544,I see you upgraded to the new telecommuting platform. Have you figured out how to fax?
3706,0,0,36,36,1.0,0.028171808490950554,544,"Swiftly Shake It Off, they're just desk jockey's tryna get ahead; we'll end 'em to 'defeet'."
3706,0,0,36,36,1.0,0.028171808490950554,544,I was hoping for a remote desktop too.
3706,0,0,36,36,1.0,0.028171808490950554,544,"My A.I. has pencils, too - I purchased the luddite add-on item."
3706,0,0,37,37,1.0,0.02739983121755955,544,I have to level-headed to keep my productivity up.
3706,0,0,36,36,1.0,0.028171808490950554,544,Bigwigs always give me a nasty headache!
3706,0,0,37,37,1.0,0.02739983121755955,544,"If I finish first, I get to attend an LA Clipper game at your expense!"
3706,0,0,36,36,1.0,0.028171808490950554,544,How are your executive functioning skills?
3706,0,0,36,36,1.0,0.028171808490950554,544,Do you believe in serendipity?
3706,0,0,36,36,1.0,0.028171808490950554,544,I can't believe he said that.. I wonder what's going on in that little head of his...
3706,0,0,36,36,1.0,0.028171808490950554,544,"This left brain, right brain stuff has gone to my head."
3706,0,0,36,36,1.0,0.028171808490950554,544,I liked it better when there was still a little party in the back.
3706,0,0,36,36,1.0,0.028171808490950554,544,All work and no play has turned me grey.
3706,0,0,36,36,1.0,0.028171808490950554,544,We all have that different side who we may or maynot like..
3706,0,0,36,36,1.0,0.028171808490950554,544,Minds with no creativity.
3706,0,0,36,36,1.0,0.028171808490950554,544,"Me Mac Head, you PC dork"
3706,0,0,36,36,1.0,0.028171808490950554,544,"No, no, you wrote, 'Audaces fortuna iuvat,' to which I responded, 'English, you ungrateful ingrate, English!'"
3706,0,0,36,36,1.0,0.028171808490950554,544,"It's my WikiLeaks platform, do you copy?"
3706,0,0,36,36,1.0,0.028171808490950554,544,No screen peeking
3706,0,0,36,36,1.0,0.028171808490950554,544,"Ah, no...I don't see anything. Do you?"
3706,0,0,36,36,1.0,0.028171808490950554,544,Erwin Schrödingers deslexic office worker experiment. It's called before and after.
3706,0,0,36,36,1.0,0.028171808490950554,544,Trust me. It was just easier to go with the implant to comply with the company’s “Zero Downtime” policy.
3706,0,0,36,36,1.0,0.028171808490950554,544,"Boop-boop, ting-ting, zow-zow, pling-pling...kerplunk!"
3706,0,0,36,36,1.0,0.028171808490950554,544,"Hey, we should schedule a meet up on this matter? Maybe in the break room in 5 minutes?"
3706,0,0,36,36,1.0,0.028171808490950554,544,I'm not sure this new flat-top hairstyle is for me.
3706,0,0,36,36,1.0,0.028171808490950554,544,We're now the Buffulo Bills [v]
3706,0,0,36,36,1.0,0.028171808490950554,544,"No matter how hard I try, nothing clicks."
3706,0,0,36,36,1.0,0.028171808490950554,544,I wonder which ones evil.
3706,0,0,37,37,1.0,0.02739983121755955,544,"Hey, do you what we're supposed to do?"" ""No, just type really fast and look serious and we might get a raise."
3706,0,0,36,36,1.0,0.028171808490950554,544,"I still say we should be paid overtime for work done by our ""Mini-Mes."""
3706,0,0,36,36,1.0,0.028171808490950554,544,"They say there's no accounting for taste, but I'm not so sure.."
3706,0,0,36,36,1.0,0.028171808490950554,544,"Eye butts, Eye pops, I see."
3706,0,0,36,36,1.0,0.028171808490950554,544,"We all have our own minds, we all work at different rates, so don't judge the way we think."
3706,0,0,36,36,1.0,0.028171808490950554,544,"I call it ""Microsoft Office."""
3706,0,0,36,36,1.0,0.028171808490950554,544,"Don't try hard to be in different worlds, or else you will lose all your hair."
3706,0,0,36,36,1.0,0.028171808490950554,544,Are you mocking me...?
3706,0,0,36,36,1.0,0.028171808490950554,544,"We need a break, we're becoming one of those couples that look alike."
3706,0,0,37,37,1.0,0.02739983121755955,544,Objects in mirror are closer than they appear.
3706,0,0,36,36,1.0,0.028171808490950554,544,I don't feel so good. My stomach's computer crashed.
3706,0,0,36,36,1.0,0.028171808490950554,544,"Oh, the man in my brain is the Galaga guy, who's yours"
3706,0,0,36,36,1.0,0.028171808490950554,544,"Well, that's your problem. You don't see me walking around with a lot of work stuff on my mind . . ."
3706,0,0,36,36,1.0,0.028171808490950554,544,Free Riders in an Organization!
3706,0,0,37,37,1.0,0.02739983121755955,544,"No, seriously, I'm really totally a revolutionary, I swear."
3706,0,0,36,36,1.0,0.028171808490950554,544,So...who did you vote for this election?
3706,0,0,36,36,1.0,0.028171808490950554,544,What are we supposed to say again when we meet in the real world?
