rank,funny,somewhat_funny,unfunny,count,score,precision,contest,caption
1,416,324,282,1022,2.131115459882583,0.025536041550852075,545,It's amazing to think he started out in the lobby.
2,141,119,162,422,1.9502369668246446,0.04122624902360429,545,"Before we start, would anyone else like some water?"
3,87,136,122,345,1.8985507246376812,0.04160672554287821,545,He got his start in the lobby.
4,87,107,126,320,1.878125,0.04516675770049859,545,...and I'll need an office with a window.
5,63,98,109,270,1.8296296296296297,0.04754223221128346,545,Ten bucks says he mentions 'sustainable growth'
6,64,90,111,265,1.8226415094339623,0.04880858268395322,545,Don’t look so surprised people…this IS a hedge fund
7,72,73,119,264,1.821969696969697,0.0512872348161474,545,I thought we were moving all of our plants to Mexico.
8,65,80,113,258,1.813953488372093,0.05049595184033708,545,It looks like Millennials are out and Perennials are in...
9,59,69,109,237,1.7890295358649788,0.053057061653849234,545,I thought all our plants moved to Mexico.
10,46,62,99,207,1.7439613526570048,0.05551730696889649,545,"What I said was, ""We need a plan."""
11,49,51,102,202,1.7376237623762376,0.05810795676010354,545,I never thought I be happy to have a Bush in charge again.
12,42,58,96,196,1.7244897959183674,0.056757503066632166,545,They brought him in from the outside.
13,40,59,94,193,1.7202072538860103,0.05664291187253281,545,Keep tabs on the boss. I suspect he is a plant … a Manchurian Cannabis who's been rain-washed.
13,33,73,87,193,1.7202072538860103,0.05320350460599183,545,I bet he got the office with a window sill.
15,44,51,99,194,1.7164948453608246,0.05833342740773986,545,You're probably wondering how I called you all here.
16,42,46,97,185,1.7027027027027026,0.06002561357141967,545,You couldn't be any worse than the previous Bush.
17,43,42,98,183,1.6994535519125684,0.061132338693851436,545,I preferred the elder Bush.
18,36,55,91,182,1.6978021978021978,0.05788532606109241,545,Five years ago she was just a branch manager
19,35,55,90,180,1.6944444444444444,0.057948168273217394,545,"Finally, a CEO who doesn't suck all the oxygen out of the room."
20,34,56,90,180,1.6888888888888889,0.057513601278505404,545,I think he was more effective as a branch manager.
21,32,59,88,179,1.687150837988827,0.05671317858466867,545,We hired him to appeal to perennials.
22,38,41,93,172,1.680232558139535,0.06209673128022638,545,I hear she pollinated her way to the top.
23,33,49,88,170,1.6764705882352942,0.05993553862747296,545,These are not the paid leaves I was hoping for.
24,30,54,85,169,1.6745562130177514,0.05848075152885156,545,He worked his way from the ground up.
25,25,62,80,167,1.6706586826347305,0.05598390537037488,545,Be patient. He'll grow on you.
26,40,33,96,169,1.668639053254438,0.06431570435038804,545,Before the election I would have said he was under-qualified.
26,30,53,86,169,1.668639053254438,0.05858400843864871,545,He worked his way from the ground up.
28,29,51,84,164,1.6646341463414633,0.059473876022191174,545,Don't worry. He'll be out by the end of Autumn...
28,28,53,83,164,1.6646341463414633,0.058841526407935156,545,"Just a friendly reminder, no dogs allowed at the company picnic."
28,28,53,83,164,1.6646341463414633,0.058841526407935156,545,I thought we only hired Ivy League
31,34,40,89,163,1.6625766871165644,0.06289059356330359,545,Just last week I was adorning the lobby of Trump Tower. Now I'm the new Secretary of the Interior.
32,38,29,93,160,1.65625,0.06637922012783726,545,"Who swiped my watering can, and WHO CHANGED THE BOY-GIRL, BOY-GIRL SEATING ??"
33,35,34,90,159,1.6540880503144655,0.06494927159126783,545,Well he can't be worse than the last Bush...
33,33,38,88,159,1.6540880503144655,0.06371173273766971,545,He can't really answer any questions about the annual report -- he's a perennial.
35,27,49,82,158,1.6518987341772151,0.060185431424544585,545,He's the branch manager.
36,28,46,84,158,1.6455696202531647,0.06095000903456274,545,Here comes the talk again about remembering our roots.
37,31,38,87,156,1.641025641025641,0.06362935344174278,545,You can call me Herb.
38,23,52,79,154,1.6363636363636365,0.05886209969288218,545,"Let's all welcome Herb, our new plant manager."
38,27,44,83,154,1.6363636363636365,0.06167881752716453,545,Look who got the window office.
40,23,50,79,152,1.631578947368421,0.05954121281561938,545,All memos will now be refered to as leaflets
41,20,52,76,148,1.6216216216216217,0.058639823680280666,545,Good afternoon. Today we'll be discussing our hedge funds.
42,34,23,90,147,1.619047619047619,0.06916392570744563,545,"I have to admit it, replacing Mr. Trump was not that difficult."
42,27,37,83,147,1.619047619047619,0.06427544553292638,545,She's been in a vegetative state since the election.
42,26,39,82,147,1.619047619047619,0.06354639988497093,545,All he talks about is growth.
42,24,43,80,147,1.619047619047619,0.06206262174698655,545,"Apparently, he's here to provide a much-needed breath of fresh air."
46,26,38,82,146,1.6164383561643836,0.06392918996425169,545,He worked his way up from the reception desk.
46,21,48,77,146,1.6164383561643836,0.06012133375963623,545,I think we were all expecting a little more growth this quarter.
46,28,34,84,146,1.6164383561643836,0.06539027413969527,545,Let's not forget I worked my way from the ground up.
46,24,42,80,146,1.6164383561643836,0.06243392272560052,545,He's the new branch manager.
50,24,43,81,148,1.614864864864865,0.06178360233901645,545,This is our new plant manager.
51,23,43,79,145,1.6137931034482758,0.06204235274514068,545,"Same agenda as last week -- root causes, stem cell research, and leaves of absence."
51,19,51,75,145,1.6137931034482758,0.0588736933757375,545,It could be worse. Moses took orders from a burning bush.
53,20,48,76,144,1.6111111111111112,0.06003682429215371,545,He's from an Ivy League school.
53,20,37,69,126,1.6111111111111112,0.06664020638911448,545,Careful what you say. I think he's a plant.
55,25,37,81,143,1.6083916083916083,0.06434401429205132,545,"When he said we were meeting about the new plant, this wasnt what I expected..."
55,22,43,78,143,1.6083916083916083,0.062005427234211506,545,I am offering you all the opportunity to invest in my hedge fund.
55,24,39,80,143,1.6083916083916083,0.06357404438114794,545,I think it's time we open more branches
55,27,33,83,143,1.6083916083916083,0.06585695322207652,545,"Given recent events, another bush being in charge doesn't seem so bad."
55,27,33,83,143,1.6083916083916083,0.06585695322207652,545,"We're going paperless, effective immediately."
55,27,33,83,143,1.6083916083916083,0.06585695322207652,545,"As your new CEO, my first executive decision is to move our table next to the window."
55,23,41,79,143,1.6083916083916083,0.06279463402820844,545,Please welcome our new Hedge Fund manager.
62,26,34,82,142,1.6056338028169015,0.06550614084153164,545,"Perhaps you could wipe that smirk off your face, Elaine, and tell us all what is so amusing about the fact that I did indeed soil myself..."
62,22,42,78,142,1.6056338028169015,0.06238184034222134,545,I think he got to this position through graft.
64,20,35,69,124,1.6048387096774193,0.06757046849262417,545,He started from the ground up.
65,22,37,75,134,1.6044776119402986,0.0653183434930822,545,He started as a branch manager.
66,25,35,81,141,1.6028368794326242,0.06513910967562168,545,They said they were sending over a new plant manager.
66,25,35,81,141,1.6028368794326242,0.06513910967562168,545,I hear he interned at a hedge fund.
68,22,38,78,138,1.5942028985507246,0.06393235439739463,545,"When you said you'd take ""any Bush"" over Trump, you could've been more specific."
68,16,50,72,138,1.5942028985507246,0.05875905719131383,545,And despite all the dirt he still became CEO.
68,27,28,83,138,1.5942028985507246,0.06794320093121196,545,"Actually, we've never had anyone ask for a glass ceiling before."
68,20,42,76,138,1.5942028985507246,0.062255705707991715,545,"Let me clear the air: although technically a Millennial and a shrub, I do self-identify as a Perennial."
72,27,27,83,137,1.5912408759124088,0.06837589049341312,545,It wasn't me. I only pass oxygen.
73,27,27,84,138,1.5869565217391304,0.06801367998683232,545,I move we smoke it.
74,24,30,80,134,1.5820895522388059,0.06724829207307208,545,Meteoric rise. He started on a secretary's desk.
74,18,42,74,134,1.5820895522388059,0.06204037139589771,545,"Say what you will , but he is the best plant manager we have ever had"
76,24,29,80,133,1.5789473684210527,0.06768182965607984,545,"Ladies, and Gentlemen, I represent the hedge fund that just bought you out."""
76,27,23,83,133,1.5789473684210527,0.0701611970055589,545,Housekeeping accidentally leaves a plant in the CEO’s chair – 4th quarter profits soar and senior staff note a vast improvement in the quality of executive meetings.
76,17,43,73,133,1.5789473684210527,0.06150920174840014,545,What's the dirt on the new guy?
79,18,39,73,130,1.5769230769230769,0.06355159761467849,545,"The good news is by moving it to the south side of the table, we have seen a lot more growth."
79,17,41,72,130,1.5769230769230769,0.06260626945443361,545,Of course HE gets the window office with the good sun.
79,25,25,80,130,1.5769230769230769,0.06981138624906437,545,Everyone told us not to worry-----this could never happen.
79,15,45,70,130,1.5769230769230769,0.060671441438682,545,Next item – company holidays: Labor Day is out and Arbor Day is in.
79,20,35,75,130,1.5769230769230769,0.0654012746674844,545,Another Ivy League chairman?
84,19,38,75,132,1.5757575757575757,0.0637348741279671,545,Allow me to clear the air.
85,22,30,77,129,1.573643410852713,0.0676423221435164,545,You're probably wondering how I called you all here.
85,15,44,70,129,1.573643410852713,0.06105420155823009,545,My roots in this company go deep and I look forward to sunnier days ahead.
85,17,40,72,129,1.573643410852713,0.06300685351553821,545,"Just like you, I want to make this transition as organic as possible."
85,23,28,78,129,1.573643410852713,0.06853180120188729,545,"The company welcomes its new CEO, who narrowly defeated a woman for the position."
85,20,34,75,129,1.573643410852713,0.0658273171483674,545,Please allow me to take a moment to explain the many November-April gaps on my résumé.
90,19,35,74,128,1.5703125,0.0653236130959054,545,You've gotta hand it to him. He sucks the carbon dioxide out of the room.
90,20,33,75,128,1.5703125,0.06625862905287534,545,Before we begin may I have a glass of water?
90,13,47,68,128,1.5703125,0.059405264510189584,545,We began with a little seed money... look at us now.
90,22,29,77,128,1.5703125,0.06809015285702125,545,Are we still moving the plant to Mexico?
90,20,33,75,128,1.5703125,0.06625862905287534,545,Another President Bush?
90,22,29,77,128,1.5703125,0.06809015285702125,545,"I thought we moved all of our plants to China."""
90,25,23,80,128,1.5703125,0.07074859294912865,545,"Finally, someone who doesn't suck the oxygen out of our meetings."
90,23,27,78,128,1.5703125,0.0689876830467259,545,"Honestly, I never thought it would get elected"
98,19,34,74,127,1.5669291338582678,0.06575164247246465,545,"Careful what you say, I think he is a corporate plant."
99,18,35,73,126,1.5634920634920635,0.06521858898122869,545,I’d like to see us double our CO2 emissions by the end of next quarter.
99,20,31,75,126,1.5634920634920635,0.06713741581764,545,"He manages a ton of other branches, too."
101,25,22,81,128,1.5625,0.07080630949687272,545,God not another Bush
102,24,22,79,125,1.56,0.07130126904720516,545,"Sadly, no, it's not the most insane thing I've seen this week."
102,13,44,68,125,1.56,0.06053524699736724,545,That's the new plant manager.
102,22,26,77,125,1.56,0.06946802467044032,545,Bush recommended him.
102,21,28,76,125,1.56,0.0685330153542684,545,"I've seen him standing around in corners here and there, but I had no idea he was the plant manager."
106,22,25,77,124,1.5564516129032258,0.06993910970033257,545,Daddy was a hedge fund.
106,18,33,73,124,1.5564516129032258,0.0660829606739071,545,"When they said this meeting was going to be about the new plant, I'd imagined something quite different."
108,18,32,73,123,1.5528455284552845,0.06652315490825081,545,The chair has the flora.
108,20,28,75,123,1.5528455284552845,0.0684973735379448,545,I'd like you to meet our plant manager
110,16,32,68,116,1.5517241379310345,0.06744960647197595,545,"You can't get rid of me that easily, people. I'm a perennial."
111,15,36,70,121,1.5454545454545454,0.0642824346533225,545,He used to run a branch office
111,17,32,72,121,1.5454545454545454,0.06639061303092922,545,"It may be our annual meeting, but it's a perennial problem."
111,23,20,78,121,1.5454545454545454,0.07234749325038377,545,I see you've turned my father into a table
111,19,28,74,121,1.5454545454545454,0.06843387751900737,545,I will miss you all. I have been appointed Trump's Secretary of Agriculture.
111,18,30,73,121,1.5454545454545454,0.06741998624632421,545,I suppose you're wondering how I called you all here today.
116,12,38,64,114,1.543859649122807,0.06370581216925368,545,We're expecting significant growth.
117,17,31,72,120,1.5416666666666667,0.06683714198023358,545,Just call me Herb.
117,20,25,75,120,1.5416666666666667,0.06990973905910959,545,I want all reports on my windowsill before noon.
117,16,33,71,120,1.5416666666666667,0.06578105749892547,545,Annual meeting with the plant supervisor
120,16,32,71,119,1.5378151260504203,0.06622237698940689,545,...and I'll need your suggestions before autumn.
120,20,24,75,119,1.5378151260504203,0.07039263191070591,545,I think this guy's a plant.
120,13,38,68,119,1.5378151260504203,0.0629135411039259,545,"Coffee all around, and water the chairman."
120,18,28,73,119,1.5378151260504203,0.06833932192172841,545,Another biodiversity hire.
124,16,31,71,118,1.5338983050847457,0.06666906057178501,545,I give him six months. Less if we forget to water him.
124,19,25,74,118,1.5338983050847457,0.06985239646896144,545,Apparently he's one of the Bush family.
124,14,35,69,118,1.5338983050847457,0.06445955735370755,545,"As you are all aware, I am a big fan of hedge funds"""
124,20,23,75,118,1.5338983050847457,0.07088174549276555,545,I thought Phil O. Dendron was an alias.
124,14,35,69,118,1.5338983050847457,0.06445955735370755,545,We anticipate significant growth in the second quarter
124,15,33,70,118,1.5338983050847457,0.06557361577555508,545,She manages our hedge fund.
124,17,29,72,118,1.5338983050847457,0.06774679467818792,545,I have soiled myself.
131,13,36,68,117,1.5299145299145298,0.06374297413090776,545,"Welcome, plant managers"
131,20,22,75,117,1.5299145299145298,0.0713771830863877,545,"As you can see, I am fully qualified to be your new plant manager."
131,18,26,73,117,1.5299145299145298,0.06928187232380663,545,Looks like they've brought the Bush administration back.
131,15,32,70,117,1.5299145299145298,0.0660143255945938,545,Obviously a plant.
131,16,30,71,117,1.5299145299145298,0.06712118443559215,545,Here comes the annual's report.
131,17,28,72,117,1.5299145299145298,0.06821008441839455,545,I can't stop thinking he might be a plant.
131,13,36,68,117,1.5299145299145298,0.06374297413090776,545,That would explain the Miracle-Gro in the vending machines.
138,13,37,69,119,1.5294117647058822,0.0629515783148397,545,I wish I had been nicer to it in the elevator coming up.
138,14,35,70,119,1.5294117647058822,0.0640728574797991,545,Apparently he came up in a hedge fund.
138,13,37,69,119,1.5294117647058822,0.0629515783148397,545,"Well, why not? The last CEO was just nuts."
138,17,29,73,119,1.5294117647058822,0.06732474007018817,545,Which bathroom will you use?
142,16,29,71,116,1.5258620689655173,0.06757882498009204,545,Be careful what you say; I think he's a plant.
142,17,27,72,116,1.5258620689655173,0.0686791280024082,545,Who wants to be my new Branch Manager?
142,12,37,67,116,1.5258620689655173,0.06298569230995937,545,Of course he got the promotion -- he's got dirt on everyone.
142,20,21,75,116,1.5258620689655173,0.0718790493510797,545,I wonder what his second wish would have been. . .
142,15,31,70,116,1.5258620689655173,0.06646030806585727,545,Millennials might support this idea but perennials will not.
142,12,37,67,116,1.5258620689655173,0.06298569230995937,545,He declined direct compensation..... but did request indirect sunlight.
142,17,27,72,116,1.5258620689655173,0.0686791280024082,545,"So, is this your first ficus group?"
142,13,35,68,116,1.5258620689655173,0.06416480712389101,545,He favors hedging.
142,17,27,72,116,1.5258620689655173,0.0686791280024082,545,You're probably wondering how I asked you all to this meeting...
151,13,34,68,115,1.5217391304347827,0.06459145337044177,545,Can you really be Chairman when you're still illegal in 22 states?
151,10,40,65,115,1.5217391304347827,0.06094579513482283,545,He's not even Ivy League.
151,13,34,68,115,1.5217391304347827,0.06459145337044177,545,My main objective here is growth.
151,20,20,75,115,1.5217391304347827,0.07238745027684698,545,Be respectful. He was just elected President.
151,19,22,74,115,1.5217391304347827,0.0713259255550622,545,It's as if Donald never left
151,15,30,70,115,1.5217391304347827,0.06691163165772746,545,"Ten years on the job, Johnson, and you still haven't blossomed."
151,13,34,68,115,1.5217391304347827,0.06459145337044177,545,"Before we start, does anyone else need more water?"
151,13,34,68,115,1.5217391304347827,0.06459145337044177,545,She uprooted her family for this job.
151,16,28,71,115,1.5217391304347827,0.06804205870192431,545,"OK, we've gone green. Now what ?"
151,17,26,72,115,1.5217391304347827,0.06915400967183924,545,Be careful what you say; I think he's a plant.
151,16,28,71,115,1.5217391304347827,0.06804205870192431,545,He's planning a hosta takeover.
162,17,25,72,114,1.5175438596491229,0.06963481398549005,545,I heard that he was involved in some graft in his past.
162,11,37,66,114,1.5175438596491229,0.06258973516515243,545,I think he's a bit green to be running a company.
162,17,25,72,114,1.5175438596491229,0.06963481398549005,545,"When I suggested that a little pot might help us think better, this wasn't what I had in mind."
162,15,29,70,114,1.5175438596491229,0.06736836444907833,545,Meet our new branch manager.
162,10,39,65,114,1.5175438596491229,0.06133693465538474,545,Maybe he'll grow into the job.
162,17,25,72,114,1.5175438596491229,0.06963481398549005,545,He's only here because his father is this table.
162,14,31,69,114,1.5175438596491229,0.06620605058013096,545,Suddenly having a bush in charge didn't seem so bad.
162,13,33,68,114,1.5175438596491229,0.0650229631614392,545,He's a little green for a CEO.
162,16,27,71,114,1.5175438596491229,0.06851096206935663,545,So much for machines taking over the world.
171,16,24,69,109,1.5137614678899083,0.07093219268956086,545,Who knew he was a pothead?
172,12,33,66,111,1.5135135135135136,0.06508970042590431,545,"First off, anyone thirsty? Need more light?"
173,14,30,69,113,1.5132743362831858,0.06665552454167607,545,I think he's full of fertilizer.
173,14,30,69,113,1.5132743362831858,0.06665552454167607,545,I'm being transferred to our field office.
173,14,30,69,113,1.5132743362831858,0.06665552454167607,545,This new guy looks like he is straight from the nursery.
173,19,20,74,113,1.5132743362831858,0.07234015493763701,545,"Well, this looks promising...his dad was a real stick in the mud."
173,19,20,74,113,1.5132743362831858,0.07234015493763701,545,And this is a scale model of our new plant.
173,19,20,74,113,1.5132743362831858,0.07234015493763701,545,Not another Bush.
173,14,30,69,113,1.5132743362831858,0.06665552454167607,545,"Can we get you something...coffee, water, light?"
173,14,30,69,113,1.5132743362831858,0.06665552454167607,545,I think he's a plant from Corporate.
181,18,23,74,115,1.5130434782608695,0.07026724336890042,545,"So, are we just going to stare at it or are we going to smoke it already?"
181,12,35,68,115,1.5130434782608695,0.06342045161368658,545,He's a seasonal employee.
183,11,34,65,110,1.509090909090909,0.06424704008260021,545,"Before we get started, anyone need water?"
184,15,27,70,112,1.5089285714285714,0.06829832701243264,545,He's keeping his promise to bring back plants that went overseas.
184,13,31,68,112,1.5089285714285714,0.06590076745339818,545,I'm glad I voted for legalization.
184,10,37,65,112,1.5089285714285714,0.06213119722266248,545,"Finally, leadership that doesn't suck all the oxygen from the room."
184,12,33,67,112,1.5089285714285714,0.06466866312265704,545,The good news is I've experience 20% growth in the last quarter.
184,16,25,71,112,1.5089285714285714,0.06946608261282873,545,"Obviously, this guy is a corporate plant."
184,20,17,75,112,1.5089285714285714,0.07395293961076187,545,We're sorry sir. We just don't think the country is ready for another Bush presidency.
184,16,25,71,112,1.5089285714285714,0.06946608261282873,545,He always sucks all the oxygen out of the room.
184,17,23,72,112,1.5089285714285714,0.07061452962703574,545,"Well, at least we've broken the grass ceiling."
184,14,29,69,112,1.5089285714285714,0.06711025489313853,545,"Never saw it coming, all our data pointed to a Hosta takeover."
184,14,29,69,112,1.5089285714285714,0.06711025489313853,545,Have we pushed diversity too far?
184,13,31,68,112,1.5089285714285714,0.06590076745339818,545,"Give him some time, he might grow into the position."
195,11,36,67,114,1.5087719298245614,0.06260605228083224,545,A few years ago he was just a plant manager.
196,11,25,57,93,1.5053763440860215,0.07272119440991402,545,He's our new plant manager!
197,15,26,70,111,1.5045045045045045,0.06877168945202533,545,Anybody not finishing their water?
197,12,32,67,111,1.5045045045045045,0.06510103515832386,545,"What he lacks in charisma, he makes up for with several key nutrients."
197,11,34,66,111,1.5045045045045045,0.06383059309520127,545,I could see myself growing here.
197,17,22,72,111,1.5045045045045045,0.07111361049536255,545,I guess this means there won't be a salad option for lunch.
197,12,32,67,111,1.5045045045045045,0.06510103515832386,545,We've brought in a growth specialist.
197,14,28,69,111,1.5045045045045045,0.06757029751514823,545,New growth is very important to me.
203,11,35,67,113,1.5044247787610618,0.06301011021622707,545,He was pruned for this
204,16,25,73,114,1.5,0.06853083760272205,545,"All those in favor of adding Arbor Day to our holiday schedule, say aye."
205,16,22,71,109,1.4954128440366972,0.07094317885747149,545,Remember when we promised to elect the company geranium president when the Cubs win the Series?
205,11,32,66,109,1.4954128440366972,0.06467968228018474,545,We're looking for seed money.
207,11,31,65,107,1.4953271028037383,0.06555896385807518,545,10 bucks says the next vote is about either sunlight or water.
207,13,27,67,107,1.4953271028037383,0.0681956686942413,545,"Sorry I'm late, but compost happens."
207,18,17,72,107,1.4953271028037383,0.07437962049466583,545,"Frankly, I would have preferred a woman."
207,10,33,64,107,1.4953271028037383,0.0642000155676714,545,Excellent growth this quarter!
207,11,31,65,107,1.4953271028037383,0.06555896385807518,545,"Watch what you say, it could be a plant from corporate."
207,14,25,68,107,1.4953271028037383,0.06947650661849573,545,"Be careful, he may be a plant."
207,13,27,67,107,1.4953271028037383,0.0681956686942413,545,He's supposed to be an expert on growth.
207,15,23,69,107,1.4953271028037383,0.07073415522337874,545,Probably one of those Ivy Leaguers.
207,9,35,63,107,1.4953271028037383,0.06281167292497543,545,I always breathe a little easier when he's around.
207,13,27,67,107,1.4953271028037383,0.0681956686942413,545,He gave most of the seed money.
207,15,23,69,107,1.4953271028037383,0.07073415522337874,545,He changed his title from COO to CO2.
207,12,29,66,107,1.4953271028037383,0.06689030935344496,545,"Before we start the meeting, I'd like to take a moment of silence to reflect and photosynthesize."
207,12,29,66,107,1.4953271028037383,0.06689030935344496,545,I worked my way up from the mailroom windowsill.
207,15,23,69,107,1.4953271028037383,0.07073415522337874,545,Maybe he'll grow in office.
207,11,31,65,107,1.4953271028037383,0.06555896385807518,545,Another blooming idiot!
207,16,21,70,107,1.4953271028037383,0.07196983019585497,545,He's a plant from corporate.
207,10,33,64,107,1.4953271028037383,0.0642000155676714,545,"Don't worry, she'll grow on you."
207,9,35,63,107,1.4953271028037383,0.06281167292497543,545,We should watch what we say around him. I think he's a plant.
207,16,21,70,107,1.4953271028037383,0.07196983019585497,545,"--and yet, we get more done than Congress."
207,12,29,66,107,1.4953271028037383,0.06689030935344496,545,I'd like to start with everyone taking a deep breath and exhaling toward me....
207,17,19,71,107,1.4953271028037383,0.0731846445757261,545,Does anyone else need water?
228,12,28,66,106,1.490566037735849,0.06735309196392661,545,"As you can see, third quarter growth has been strong."
228,10,32,64,106,1.490566037735849,0.0646301010247302,545,I hear he came from a hedge fund
228,14,24,68,106,1.490566037735849,0.06997019390951748,545,"When I started here, I was just a plant manager."
228,10,32,64,106,1.490566037735849,0.0646301010247302,545,Careful what you say. He may be a plant.
228,10,32,64,106,1.490566037735849,0.0646301010247302,545,Just imagine what we could do with more seed money
228,16,20,70,106,1.490566037735849,0.07249287602495708,545,"Ladies and gentlemen, I'd like to thank you again for participating in this ficus group."
228,11,30,65,106,1.490566037735849,0.06600563974225228,545,"Alright folks, that should wrap it up. Would one of you turn my chair toward the window on the way out?"
228,19,14,73,106,1.490566037735849,0.07612030367990712,545,The hedge funds are moving in.
228,15,22,69,106,1.490566037735849,0.07124270176693635,545,You think I'm successful? My Dad's a hedge fund!
228,13,26,67,106,1.490566037735849,0.06867411096197981,545,Did anybody remember to bring the rolling papers?
228,13,26,67,106,1.490566037735849,0.06867411096197981,545,"Who knew when I said a potted plant could do a better job, I'd be right?"
228,9,34,63,106,1.490566037735849,0.06322464265735056,545,He worked his way up from plant manager.
228,9,34,63,106,1.490566037735849,0.06322464265735056,545,See what an Ivy League education can do for you?
228,18,16,72,106,1.490566037735849,0.07493067538067516,545,"I've will not tolerate anymore talk of ""moving the plant overseas."""
228,14,24,68,106,1.490566037735849,0.06997019390951748,545,Intel strongly suspects that one of us in this room is a plant.
228,9,34,63,106,1.490566037735849,0.06322464265735056,545,They say the CEO hand-picked him.
228,15,22,69,106,1.490566037735849,0.07124270176693635,545,They don't call this a hedge fund for nothing.
228,13,26,67,106,1.490566037735849,0.06867411096197981,545,I've called you here today to explain why we have not yet filled the position of Plant Manager.
228,9,34,63,106,1.490566037735849,0.06322464265735056,545,I'm so glad we didn't elect another old white guy.
228,13,26,67,106,1.490566037735849,0.06867411096197981,545,"Well, they always did say a potted plant could do the job."
228,12,28,66,106,1.490566037735849,0.06735309196392661,545,Nepotism. His father's the head of the plant.
249,14,24,69,107,1.485981308411215,0.06946464549905487,545,The ficus group loved him.
249,14,24,69,107,1.485981308411215,0.06946464549905487,545,It seems leadership has become a perennial problem!
249,15,22,70,107,1.485981308411215,0.07072250502891228,545,"All in favor of more natural light say ""aye""."
252,13,25,67,105,1.4857142857142858,0.06915805239744421,545,He's the new branch manager.
252,9,33,63,105,1.4857142857142858,0.06364146037613301,545,"- ""Whatever you say, don't question his roots."""
252,13,25,67,105,1.4857142857142858,0.06915805239744421,545,I knew it...it's a hosta takeover.
252,14,23,68,105,1.4857142857142858,0.07046975517594639,545,He is responsible for the seed money.....
252,7,37,61,105,1.4857142857142858,0.06069542909071935,545,"I was skeptical at first, but he's starting to grow on me."
252,13,25,67,105,1.4857142857142858,0.06915805239744421,545,The decision was unanimous--you're the new plant manager.
252,13,25,67,105,1.4857142857142858,0.06915805239744421,545,Focus group? Looks like a ficus group to me.
252,13,25,67,105,1.4857142857142858,0.06915805239744421,545,I'm definitely committed to solar.
252,12,27,66,105,1.4857142857142858,0.06782098516136031,545,I'll begin by thanking all my colleagues in the branch office.
252,11,29,65,105,1.4857142857142858,0.06645702254169437,545,I'd like to report another quarter of growth
252,14,23,68,105,1.4857142857142858,0.07046975517594639,545,"Here's the deal--you give me carbon dioxide, I give you oxygen."
252,14,23,68,105,1.4857142857142858,0.07046975517594639,545,Watch what you say. It may be a plant.
252,10,31,64,105,1.4857142857142858,0.06506447311672546,545,Why am I the only one focused on growth?
252,12,27,66,105,1.4857142857142858,0.06782098516136031,545,I wonder if this is about a hedge fund.
252,16,19,70,105,1.4857142857142858,0.07302250859055849,545,"""Are we sure this is what a decision tree is? '"
252,14,23,68,105,1.4857142857142858,0.07046975517594639,545,"No coffee for me, just a water and indirect sunlight would be great."
268,14,22,68,104,1.4807692307692308,0.07097524159775594,545,We're going paperless.
268,11,28,65,104,1.4807692307692308,0.06691311850228995,545,Should we offer him some water?
268,11,28,65,104,1.4807692307692308,0.06691311850228995,545,Enough about me - let's discuss the other branches.
268,11,28,65,104,1.4807692307692308,0.06691311850228995,545,What does he mean when he says it's time to 'prune staff'?
268,12,26,66,104,1.4807692307692308,0.06829401090203743,545,Are you kidding me? There's another BUSH in charge?
268,13,24,67,104,1.4807692307692308,0.06964752990934939,545,"Now that I've cleared the air, let's move on to new business."
268,17,16,71,104,1.4807692307692308,0.07481713982783726,545,"No one thought to get me some water, seriously?"
268,16,18,70,104,1.4807692307692308,0.07355880582657691,545,It was supposed to be a joke—but this is what we voted for.
268,11,28,65,104,1.4807692307692308,0.06691311850228995,545,At least he doesn't suck all the oxygen from the room.
268,11,28,65,104,1.4807692307692308,0.06691311850228995,545,I hear he wants to open a new Branch
268,13,24,67,104,1.4807692307692308,0.06964752990934939,545,"He doesn't look like much, but they say he really knows hedge funds."
279,16,17,70,103,1.4757281553398058,0.07410184361756676,545,It figures. Anything but a woman in charge.
279,9,31,63,103,1.4757281553398058,0.0644865207917545,545,We haven’t seen this kind of growth in years.
279,12,25,66,103,1.4757281553398058,0.06877218617380192,545,I’ve decided to leave to start a hedge fund.
279,15,19,69,103,1.4757281553398058,0.07280601498793049,545,So anything can become President?
279,16,17,70,103,1.4757281553398058,0.07410184361756676,545,I wouldn't have voted for it if I had actually thought it would win....
279,15,19,69,103,1.4757281553398058,0.07280601498793049,545,"No, YOU tell him he has aphids."
279,13,23,67,103,1.4757281553398058,0.07014257623030133,545,"Nominate the fern, you said. It will be funny, you said."
279,13,23,67,103,1.4757281553398058,0.07014257623030133,545,"The name's O'Dendron. But, you can call me Phil."
279,14,21,68,103,1.4757281553398058,0.07148670092627857,545,"Well, at least he is not sucking all the oxygen out of the room."
288,13,23,68,104,1.4711538461538463,0.06961530209312691,545,"Yes, it is time to discuss hedge funds."
289,11,26,65,102,1.4705882352941178,0.06783944518374625,545,Not the meteoric-rise-from-office-decor speech again.
289,10,28,64,102,1.4705882352941178,0.06639317180308237,545,I've been out in the field much too long.
289,14,20,68,102,1.4705882352941178,0.07200417699781876,545,"All he ever talks about is legalizing marijuana"""
289,12,24,66,102,1.4705882352941178,0.06925552240510074,545,I heard he wants to open a whole new branch
289,15,18,69,102,1.4705882352941178,0.07333988386886164,545,We're going to build a hedge.
289,13,22,67,102,1.4705882352941178,0.07064321937998234,545,One of you will be my next plant manager.
289,13,22,67,102,1.4705882352941178,0.07064321937998234,545,"Get ready for the ""hedge our bets"" joke again."
289,13,22,67,102,1.4705882352941178,0.07064321937998234,545,Let's never forget that this company was started with seed money.
289,10,28,64,102,1.4705882352941178,0.06639317180308237,545,and they said we had to worry about the robots taking over
289,14,20,68,102,1.4705882352941178,0.07200417699781876,545,Don't say anything. I think it's a plant.
289,12,24,66,102,1.4705882352941178,0.06925552240510074,545,Think of me as another Bush running for president.
289,12,24,66,102,1.4705882352941178,0.06925552240510074,545,Just call me Herb.
289,11,26,65,102,1.4705882352941178,0.06783944518374625,545,Well at least we got rid of the dead wood.
289,11,26,65,102,1.4705882352941178,0.06783944518374625,545,Maybe he'll grow into the position.
289,8,32,62,102,1.4705882352941178,0.06340172821417261,545,I'm a perennial not a millennial.
289,9,30,63,102,1.4705882352941178,0.06491468401917021,545,Let me guess....growth.
289,8,32,62,102,1.4705882352941178,0.06340172821417261,545,It's been pruned. That must mean cutbacks.
289,15,18,69,102,1.4705882352941178,0.07333988386886164,545,"Magna cum laude, Trump University."
289,9,30,63,102,1.4705882352941178,0.06491468401917021,545,It shouldn't take much digging to find some dirt on this one.
289,12,24,66,102,1.4705882352941178,0.06925552240510074,545,He's going to bore us again with the story of how he worked his way up from plant manager.
289,17,14,71,102,1.4705882352941178,0.07594084992563561,545,At least it's not a Bush!
289,10,28,64,102,1.4705882352941178,0.06639317180308237,545,Who else wants water?
289,12,24,66,102,1.4705882352941178,0.06925552240510074,545,Uh oh. Here come the perennial cutbacks.
289,13,22,67,102,1.4705882352941178,0.07064321937998234,545,"It was a struggle, but I broke the grass ceiling."
289,11,26,65,102,1.4705882352941178,0.06783944518374625,545,"The problem, sir, is you. We elected you to a five-year term but you're an annual."
289,12,24,66,102,1.4705882352941178,0.06925552240510074,545,This explains the quick change over to full spectrum lighting.
315,9,29,63,101,1.4653465346534653,0.06534653465346535,545,"Here at FTD, we have a somewhat different view of diversity."
315,12,23,66,101,1.4653465346534653,0.06974402481329237,545,"Don't hold your breath, he needs the CO2."
315,12,23,66,101,1.4653465346534653,0.06974402481329237,545,"Before we start, can I get a little water?"
315,13,21,67,101,1.4653465346534653,0.07114948207216507,545,Perhaps next time you'll take a cursory look at qualifications before you vote Green.
315,15,17,69,101,1.4653465346534653,0.07388023012347575,545,This guy takes all the oxygen out of the room.
315,13,21,67,101,1.4653465346534653,0.07114948207216507,545,I''m sure you're all wondering why you've brought me here.
315,10,27,64,101,1.4653465346534653,0.06684451655294354,545,I think he might be a plant.
315,13,21,67,101,1.4653465346534653,0.07114948207216507,545,Good morning...I'm your new plant manager.
315,16,15,70,101,1.4653465346534653,0.07520843174191263,545,This was the choice after the ham sandwich got indicted.
315,10,27,64,101,1.4653465346534653,0.06684451655294354,545,Can I get you some water?
315,8,31,62,101,1.4653465346534653,0.06381339819533473,545,We can't keep moving our plants to Mexico.
315,15,17,69,101,1.4653465346534653,0.07388023012347575,545,"It's not a nightmare, we actually elected him."
315,12,23,66,101,1.4653465346534653,0.06974402481329237,545,I'd like to start this meeting by asking one of you to pass me a glass of water.
315,8,31,62,101,1.4653465346534653,0.06381339819533473,545,"Now, before we start, could someone please get me some water?"
315,10,27,64,101,1.4653465346534653,0.06684451655294354,545,He's just a placeholder until we find someone willing to put down roots.
315,13,21,67,101,1.4653465346534653,0.07114948207216507,545,He really brings a breath of fresh air to the office.
315,11,25,65,101,1.4653465346534653,0.06830965667588253,545,"Eventually, the mix-up was discovered. Mr. Fitzgerald was found in the corner of his office, freshly watered, and away from direct sunlight."
315,11,25,65,101,1.4653465346534653,0.06830965667588253,545,Pssst...I keep forgetting. Is our boss an annual or a perennial?
315,12,23,66,101,1.4653465346534653,0.06974402481329237,545,My sources tell me that he comes potted to every meeting.
334,12,23,67,102,1.4607843137254901,0.06920741158136787,545,"C'mon people, am I the only one photosynthesizing here?"
335,13,20,67,100,1.46,0.07166138105949071,545,"Given the outcome, another bush looks pretty good"
335,11,24,65,100,1.46,0.068784541368778,545,We used to be run by big tobacco.
335,14,18,68,100,1.46,0.07305733185227707,545,Still a better leader than Trump.
335,7,32,61,100,1.46,0.0626357112455213,545,Ficus group
335,9,28,63,100,1.46,0.06578200914591106,545,Looks like the company finally decided to go green.
335,12,22,66,100,1.46,0.07023769168568493,545,Give her credit. She worked hard and broke through the grass ceiling.
335,10,26,64,100,1.46,0.06730002176294544,545,We need to start trimming the staff.
342,9,25,60,94,1.4574468085106382,0.06875846673934934,545,I guess that's one way to clear the air.
343,11,24,66,101,1.4554455445544554,0.06825222946381816,545,I just love having an office full of humans. It's so colorful and adds carbon dioxide to the air.
344,12,21,66,99,1.4545454545454546,0.07073651358600948,545,That's the new plant manager.
344,12,21,66,99,1.4545454545454546,0.07073651358600948,545,The Bush Administration
344,9,27,63,99,1.4545454545454546,0.06622103264406214,545,Certainly looks smarter than our last CEO.
344,11,23,65,99,1.4545454545454546,0.06926406926406926,545,"One day you're at the head of the table, the next you are the table."
344,14,17,68,99,1.4545454545454546,0.07359307359307359,545,"Oh sure, plant yourself at the head of the table and suddenly you're in charge."
349,14,17,69,100,1.45,0.07299508769967214,545,He's a little green but has been groomed for leadership.
349,12,21,67,100,1.45,0.0701729465267237,545,At least it won't take all the oxygen in the room.
351,10,24,64,98,1.4489795918367347,0.06822329548961294,545,At least the Chief has been experiencing record growth this year
351,13,18,67,98,1.4489795918367347,0.07270212070247647,545,"Finally, a true outsider."
351,10,24,64,98,1.4489795918367347,0.06822329548961294,545,"Be careful, I think she's a plant."
351,9,26,63,98,1.4489795918367347,0.06666351784700711,545,This was the only candidate who predicted growth in the next quarter.
351,9,26,63,98,1.4489795918367347,0.06666351784700711,545,They say he's very focused on growth.
351,10,24,64,98,1.4489795918367347,0.06822329548961294,545,The Board thought we needed more biodiversity.
351,8,28,62,98,1.4489795918367347,0.0650663597876309,545,Give me some sage advice.
358,7,29,60,96,1.4479166666666667,0.06432816030015424,545,Well at least he's pro-growth.
358,6,31,59,96,1.4479166666666667,0.06260043100481262,545,He looks too green to run the company.
358,10,23,63,96,1.4479166666666667,0.0692532089108111,545,"Jenkins, when I asked you to find who is the plant in this room, I had something else in mind."
358,11,21,64,96,1.4479166666666667,0.07081881946247395,545,I never trusted him- he always seemed like a plant.
358,10,23,63,96,1.4479166666666667,0.0692532089108111,545,This new guy's pretty green.
358,12,19,65,96,1.4479166666666667,0.07235055933213312,545,My first initiative is to make us paperless.
358,10,23,63,96,1.4479166666666667,0.0692532089108111,545,The growth opportunity can't be denied
358,7,29,60,96,1.4479166666666667,0.06432816030015424,545,We could be waiting a while before the new appointment bears fruit.
358,11,21,64,96,1.4479166666666667,0.07081881946247395,545,First order of business: could you please move me a little closer to the window?
358,12,19,65,96,1.4479166666666667,0.07235055933213312,545,I'm the new plant manager.
368,8,24,58,90,1.4444444444444444,0.06907831071699269,545,The rumors are true. I'm leaving.
369,14,14,67,95,1.4421052631578948,0.07589081193169275,545,"Oh no, he's potted again."
369,14,14,67,95,1.4421052631578948,0.07589081193169275,545,Best meeting we've ever had.
369,12,18,65,95,1.4421052631578948,0.07287994926030475,545,He's the only one in the company who can produce anything.
369,14,14,67,95,1.4421052631578948,0.07589081193169275,545,As to which bathroom I will be using . . .
369,2,38,55,95,1.4421052631578948,0.05542423068342733,545,"Clearly, there's growth potential"
369,11,20,64,95,1.4421052631578948,0.07132687318571529,545,"Before we begin, I would like to thank you all for legalizing me."
369,9,24,62,95,1.4421052631578948,0.06811456897745258,545,"Mark only got the corner office because he ""needs more light""."
369,15,12,68,95,1.4421052631578948,0.0773523076668372,545,"As plant manager, I’d like to discuss the possibility of investing in hedge funds."
369,12,18,65,95,1.4421052631578948,0.07287994926030475,545,And that's the miracle of the secret ballot
369,8,26,61,95,1.4421052631578948,0.06645020948989298,545,Somebody get me a glass of water.
369,10,22,63,95,1.4421052631578948,0.06973921904292898,545,"If you're all wondering why I've called this meeting, I can tell you the rumors are true: I'm leaving."
369,12,18,65,95,1.4421052631578948,0.07287994926030475,545,'New branch manager looks a little green.'
369,14,14,67,95,1.4421052631578948,0.07589081193169275,545,I don't trust him. He could be a plant.
369,11,20,64,95,1.4421052631578948,0.07132687318571529,545,I can't believe he came to the board meeting potted.
369,12,18,65,95,1.4421052631578948,0.07287994926030475,545,We're going paper-free
384,12,17,65,94,1.4361702127659575,0.07341478178761326,545,"Started in medical, switched to recreational."
384,8,25,61,94,1.4361702127659575,0.06689250920171996,545,"...and yes, it's true, I worked my way up from plant manager...."
384,11,19,64,94,1.4361702127659575,0.07183974934197433,545,"The problem, sir, is you. We elected you to a five year term and you're an annual."
384,15,11,68,94,1.4361702127659575,0.07794916281229955,545,The new CEO either needs a urologist or a coaster.
384,8,25,61,94,1.4361702127659575,0.06689250920171996,545,At least he doesn't suck all the air out of the room.
384,10,21,63,94,1.4361702127659575,0.0702294025755063,545,First I propose we get rid of the salad bar in the company cafeteria.
384,10,21,63,94,1.4361702127659575,0.0702294025755063,545,We always said he could be replaced by a potted plant.
384,11,19,64,94,1.4361702127659575,0.07183974934197433,545,I heard he's a corporate plant.
384,12,17,65,94,1.4361702127659575,0.07341478178761326,545,"Oh, man, did I get potted last night!"
384,10,21,63,94,1.4361702127659575,0.0702294025755063,545,"If we want this takeover, I'm going to need more dirt."
384,4,33,57,94,1.4361702127659575,0.0596614229605824,545,I'm going to take an office with a southern exposure.
384,10,21,63,94,1.4361702127659575,0.0702294025755063,545,Perennial meeting of plant managers.
384,10,21,63,94,1.4361702127659575,0.0702294025755063,545,Of course he's in favor of a paperless office.
384,13,15,66,94,1.4361702127659575,0.07495672607797144,545,This is what we get for legalizing marijuana.
384,9,23,62,94,1.4361702127659575,0.06858125390153902,545,I hear he's big on solar.
384,11,19,64,94,1.4361702127659575,0.07183974934197433,545,"The Bylaws clearly imply that if someone's in a persistent vegetative state, he can be replaced by a simple 2/3 vote of the Board."
384,12,17,65,94,1.4361702127659575,0.07341478178761326,545,I said we needed some FOCUS
384,13,15,66,94,1.4361702127659575,0.07495672607797144,545,Allow me to introduce our new Plant Manager.
384,9,23,62,94,1.4361702127659575,0.06858125390153902,545,I heard it was sent from the main branch.
384,11,19,64,94,1.4361702127659575,0.07183974934197433,545,We've never had a Hosta take-over before.
384,11,19,64,94,1.4361702127659575,0.07183974934197433,545,But first we'll hear from the Plant Manager!
384,10,21,63,94,1.4361702127659575,0.0702294025755063,545,Looks like growth has been good this quarter.
384,11,19,64,94,1.4361702127659575,0.07183974934197433,545,When we said a potted plant could do a better job we meant it
384,5,31,58,94,1.4361702127659575,0.06154889104676606,545,Let's not beat around anything during this meeting.
384,8,25,61,94,1.4361702127659575,0.06689250920171996,545,Looks like Bob got some sun.
384,14,13,67,94,1.4361702127659575,0.0764675838753469,545,So are we going to just stare at it or are we gonna roll some sweet sticky buds and get lit?
384,11,19,64,94,1.4361702127659575,0.07183974934197433,545,You think it's an FBI plant?
411,7,26,60,93,1.4301075268817205,0.065578750917107,545,Do not be misled by my persistent vegetative state.
411,8,24,61,93,1.4301075268817205,0.06733740908695961,545,"What a snob, he wants to be called by his Latin name."
411,8,24,61,93,1.4301075268817205,0.06733740908695961,545,"If it asks you to get its coffee, remember: no cream, no sugar, just a dash of Miracle-Gro."
411,7,26,60,93,1.4301075268817205,0.065578750917107,545,"Finally, a Chairman that doesn't suck the oxygen out of the room..."
411,10,20,63,93,1.4301075268817205,0.07072365123448962,545,This must be the new plant manager.
411,11,18,64,93,1.4301075268817205,0.07235736959449474,545,I'm living proof that we don't need to choose between opening more branches and remaining true to our roots.
411,8,24,61,93,1.4301075268817205,0.06733740908695961,545,Careful... He's a plant
411,11,18,64,93,1.4301075268817205,0.07235736959449474,545,"All right, people, we really need to ficus here."
411,7,26,60,93,1.4301075268817205,0.065578750917107,545,"Careful, I think the new guy is a plant."
411,10,20,63,93,1.4301075268817205,0.07072365123448962,545,"Be careful, it could be a plant."
411,12,16,65,93,1.4301075268817205,0.07395500676310494,545,"Be careful, he may be a plant."
411,6,28,59,93,1.4301075268817205,0.06377161187512337,545,"""He's done very well, but then, he is an Invasive""."
411,9,22,62,93,1.4301075268817205,0.06905129074275974,545,Does everyone have enough water?
411,9,22,62,93,1.4301075268817205,0.06905129074275974,545,I think our new CEO is a plant from corporate.
411,7,26,60,93,1.4301075268817205,0.065578750917107,545,"Lastly, I take offense at your suggestions I step down. I am a perennial favorite."
411,9,22,62,93,1.4301075268817205,0.06905129074275974,545,Which one of you is the plant manager?
411,8,24,61,93,1.4301075268817205,0.06733740908695961,545,I think it's a Hosta takeover.
411,7,26,60,93,1.4301075268817205,0.065578750917107,545,Anyone else need more water?
411,8,24,61,93,1.4301075268817205,0.06733740908695961,545,Let us spray...
411,6,28,59,93,1.4301075268817205,0.06377161187512337,545,Do I look like a Money Tree to you people?
411,9,22,62,93,1.4301075268817205,0.06905129074275974,545,Talk about breaking the grass ceiling.
411,9,22,62,93,1.4301075268817205,0.06905129074275974,545,He worked his way up from the front desk.
411,10,20,63,93,1.4301075268817205,0.07072365123448962,545,I told you that even a potted plant could run this company.
411,10,20,63,93,1.4301075268817205,0.07072365123448962,545,"So, why the projection of slow growth until spring?"
411,9,22,62,93,1.4301075268817205,0.06905129074275974,545,Our focus will be on growth.
411,10,20,63,93,1.4301075268817205,0.07072365123448962,545,Could I please have a glass of water?
411,13,14,66,93,1.4301075268817205,0.07551885271922161,545,"Before we begin, is there anyone here who does not celebrate Arbor Day?"
411,12,16,65,93,1.4301075268817205,0.07395500676310494,545,I don't want to hear about any more plant closings.
411,7,26,60,93,1.4301075268817205,0.065578750917107,545,The hedge fund was a little short
411,9,22,62,93,1.4301075268817205,0.06905129074275974,545,He seems much smarter than our last boss.
411,8,24,61,93,1.4301075268817205,0.06733740908695961,545,Apparently he's from a branch in Los Angeles.
411,11,18,64,93,1.4301075268817205,0.07235736959449474,545,"For starters, all meetings from here on in will be paperless."
411,6,28,59,93,1.4301075268817205,0.06377161187512337,545,"People, we need to start thinking outside the pot."
411,10,20,63,93,1.4301075268817205,0.07072365123448962,545,I could use a glass of water.
411,9,22,62,93,1.4301075268817205,0.06905129074275974,545,This new CEO looks pretty green.
411,11,18,64,93,1.4301075268817205,0.07235736959449474,545,He's always sucking the oxygen out of the room.
411,5,30,58,93,1.4301075268817205,0.0619117467889155,545,"I suppose, it is possible he'll grow into the job."
411,9,22,62,93,1.4301075268817205,0.06905129074275974,545,Do you think he's a plant?
411,8,24,61,93,1.4301075268817205,0.06733740908695961,545,I told you he was a plant.
411,11,18,64,93,1.4301075268817205,0.07235736959449474,545,Let's take a photosynthesis break.
411,12,16,65,93,1.4301075268817205,0.07395500676310494,545,The board was perplexed by the new chairman's request for a perennial review.
411,8,24,61,93,1.4301075268817205,0.06733740908695961,545,"We don't have to like him, but we have to water him."
411,11,18,64,93,1.4301075268817205,0.07235736959449474,545,"Before we continue, would someone please get me a glass of water?"
411,9,22,62,93,1.4301075268817205,0.06905129074275974,545,A little advice -- don't mention the aphids.
411,10,20,63,93,1.4301075268817205,0.07072365123448962,545,"Technically, I suppose, this keeps our plant in the U.S."
411,8,24,61,93,1.4301075268817205,0.06733740908695961,545,Let me introduce myself. I'm the new plant manager.
411,11,18,64,93,1.4301075268817205,0.07235736959449474,545,"I knew her when she was a wallflower,"
411,11,18,64,93,1.4301075268817205,0.07235736959449474,545,I think HR missed an important part of the 'Plant Manager' job description.
411,14,12,67,93,1.4301075268817205,0.07705096499541114,545,"First order of business, we're canceling, 'Dog Friendly Fridays' indefinitely."
411,13,14,66,93,1.4301075268817205,0.07551885271922161,545,"First, let me say how honored I am to be the first openly potted plant named to this company's board."
411,9,22,62,93,1.4301075268817205,0.06905129074275974,545,"Careful, he might be a plant."
411,5,30,58,93,1.4301075268817205,0.0619117467889155,545,This might be the corporate 'plant' we were warned about.
411,9,22,62,93,1.4301075268817205,0.06905129074275974,545,The first order of business is to appoint a new plant manager.
411,13,14,66,93,1.4301075268817205,0.07551885271922161,545,"As my first order of business, we're replacing the table. He was my uncle."
465,5,31,60,96,1.4270833333333333,0.060597883095637226,545,This new CEO is starting to grow on me.
466,7,26,61,94,1.425531914893617,0.06503850592404292,545,He hasn't had a creative thought since we pruned him.
466,12,16,66,94,1.425531914893617,0.07330695908205181,545,I'm the new plant manager.
466,9,22,63,94,1.425531914893617,0.06846581958643384,545,"Careful what you say, he might be a plant."
466,5,30,59,94,1.425531914893617,0.061420241403151665,545,I think it's time to think outside the pot.
470,7,25,60,92,1.423913043478261,0.06599905827589363,545,I need you all to breathe more.
470,6,27,59,92,1.423913043478261,0.06416372924063433,545,Who's the new Plant Manager?
470,11,17,64,92,1.423913043478261,0.07287963958652842,545,"Take it from me, money does not grow on trees."
470,10,19,63,92,1.423913043478261,0.07122183880680778,545,I like everyone to meet the new plant manager
470,14,11,67,92,1.423913043478261,0.07764094600132322,545,Who would have guessed that our competitor's plant in our plant was a plant.
470,8,23,61,92,1.423913043478261,0.06778471241027856,545,Anyone else worried about the greenhouse effect?
470,9,21,62,92,1.423913043478261,0.06952451927042388,545,"You know, you can take Affirmative Action too far."
470,13,13,66,92,1.423913043478261,0.07608695652173912,545,"Unlike my predecessor, I am a perennial."
470,9,21,62,92,1.423913043478261,0.06952451927042388,545,"Watch out for the new guy, I hear he's a plant from corporate."
470,8,23,61,92,1.423913043478261,0.06778471241027856,545,"Well... it was either Trump, Clinton or this plant. I think they made the right choice."
470,9,21,62,92,1.423913043478261,0.06952451927042388,545,Today I'd like to introduce everyone to our new plant manager.
470,14,11,67,92,1.423913043478261,0.07764094600132322,545,I called this meeting to clear the air.
470,7,25,60,92,1.423913043478261,0.06599905827589363,545,"On the plus side, it's a money tree."
470,10,19,63,92,1.423913043478261,0.07122183880680778,545,Don't get the idea that I am just another ivy leaguer.
470,9,21,62,92,1.423913043478261,0.06952451927042388,545,I guess we're going paperless.
470,12,15,65,92,1.423913043478261,0.07450055979320994,545,I suppose you're wondering why a potted plant would even want this job.
470,9,21,62,92,1.423913043478261,0.06952451927042388,545,Hail to the leaf.
470,7,25,60,92,1.423913043478261,0.06599905827589363,545,"Personally, I'm all for Hedge Funds."
470,9,21,62,92,1.423913043478261,0.06952451927042388,545,"Wow, he's really gone to pot."
470,8,23,61,92,1.423913043478261,0.06778471241027856,545,His uncle provided our seed money.
470,7,25,60,92,1.423913043478261,0.06599905827589363,545,I know a plant when I see one.
470,11,17,64,92,1.423913043478261,0.07287963958652842,545,Careful what you say. I think he's a plant.
470,13,13,66,92,1.423913043478261,0.07608695652173912,545,Somebody didn't get watered last night...
493,7,24,60,91,1.4175824175824177,0.06642067080816491,545,"Finally, I am seeing some real growth."
493,6,26,59,91,1.4175824175824177,0.06455621787563431,545,"On the positive side, the new CEO will not suck the oxygen from the room."
493,9,20,62,91,1.4175824175824177,0.07000075713167037,545,We need to focus on our roots.
493,10,18,63,91,1.4175824175824177,0.07172381921793725,545,I suspected he was a plant.
493,6,26,59,91,1.4175824175824177,0.06455621787563431,545,The annual meeting of the Board of Plant Parenthood will now come to order.
493,10,18,63,91,1.4175824175824177,0.07172381921793725,545,"Watch what you say, rumor has it that one of our officers is a plant."
493,8,22,61,91,1.4175824175824177,0.06823419783955004,545,I've got so much dirt on this guy.
493,11,16,64,91,1.4175824175824177,0.07340644717875663,545,"When they said a Bush was going to head the committee, this wasn't what I had in mind."
493,10,18,63,91,1.4175824175824177,0.07172381921793725,545,I think there's a plant among us.
493,11,16,64,91,1.4175824175824177,0.07340644717875663,545,I heard he's a biodiversity hire.
493,9,20,62,91,1.4175824175824177,0.07000075713167037,545,They voted for change.
493,10,18,63,91,1.4175824175824177,0.07172381921793725,545,He's the new GMO.
493,12,14,65,91,1.4175824175824177,0.07505136062462714,545,We are all going to miss Herb.
493,12,14,65,91,1.4175824175824177,0.07505136062462714,545,Now that we've broken the grass ceiling.
493,9,20,62,91,1.4175824175824177,0.07000075713167037,545,"Well, so much for the grass ceiling."
493,10,18,63,91,1.4175824175824177,0.07172381921793725,545,"All in favor of adding fertilizer to the vending machines, say 'aye.'"
493,12,14,65,91,1.4175824175824177,0.07505136062462714,545,"Thank God it's not a woman, right?"
493,8,22,61,91,1.4175824175824177,0.06823419783955004,545,I can't help thinking this is a test.
493,11,16,64,91,1.4175824175824177,0.07340644717875663,545,"Apparently, money started to grow on it."
493,11,16,64,91,1.4175824175824177,0.07340644717875663,545,"No, really. Anyone can be president."
493,7,24,60,91,1.4175824175824177,0.06642067080816491,545,Careful what you say. He may be a plant.
493,5,28,58,91,1.4175824175824177,0.06263629157450273,545,All the ideas I'm hearing from you are garden-variety.
493,5,28,58,91,1.4175824175824177,0.06263629157450273,545,I want you to know how pleased I am to be back as an insider for another winter.
493,9,20,62,91,1.4175824175824177,0.07000075713167037,545,"...and c'mon, people... do I REALLY need to put my name on the plant-food in the break room fridge??"
493,7,24,60,91,1.4175824175824177,0.06642067080816491,545,He seems a little green if you ask me.
493,6,26,59,91,1.4175824175824177,0.06455621787563431,545,So much for waiting until he leaves.
493,11,16,64,91,1.4175824175824177,0.07340644717875663,545,I never thought I'd say this but doesn't a bush look good now?
493,5,28,58,91,1.4175824175824177,0.06263629157450273,545,We can all breathe easier now.
493,10,18,63,91,1.4175824175824177,0.07172381921793725,545,I think the new CEO may be a plant.
493,11,16,64,91,1.4175824175824177,0.07340644717875663,545,"Careful what you say, he's a plant."
493,9,20,62,91,1.4175824175824177,0.07000075713167037,545,"After Trump, anything is possible."
493,4,30,57,91,1.4175824175824177,0.06065562445483418,545,Maybe he'll grow on us.
493,14,10,67,91,1.4175824175824177,0.07823750520056426,545,"George was an unusual selection for CEO, but his family had deep roots in the industry."
526,10,17,63,90,1.4111111111111112,0.07222942439840536,545,Seems shady leadership is the new normal.
526,6,25,59,90,1.4111111111111112,0.06494873507910405,545,Our new chairman is growing on me.
526,12,13,65,90,1.4111111111111112,0.07560731134751196,545,"Call me paranoid, but I think he's a plant."
526,4,29,57,90,1.4111111111111112,0.060983296140016775,545,I think we should hedge.
526,9,19,62,90,1.4111111111111112,0.07047979752232285,545,"Just a reminder, the office will be closed tomorrow for Arbor Day."
526,10,17,63,90,1.4111111111111112,0.07222942439840536,545,I always said decriminalizing marijuana would just be the first step.
526,11,15,64,90,1.4111111111111112,0.07393766049221658,545,Of course you control the board. And we control the watering can.
526,6,25,59,90,1.4111111111111112,0.06494873507910405,545,"""I suspected all along that our Board Chairman was a plant""."
526,10,17,63,90,1.4111111111111112,0.07222942439840536,545,"Careful what you say, it could be a plant."
526,8,21,61,90,1.4111111111111112,0.06868561689793795,545,"Yes, fir."
526,5,27,58,90,1.4111111111111112,0.0629972245280561,545,"Regrettably, to keep costs down, plans are underway to move the plant to Mexico."
526,8,21,61,90,1.4111111111111112,0.06868561689793795,545,Would anyone like some water?
526,9,19,62,90,1.4111111111111112,0.07047979752232285,545,I think he's a plant.
526,6,25,59,90,1.4111111111111112,0.06494873507910405,545,Now we will hear directly from the Plant-Manager.
526,11,15,64,90,1.4111111111111112,0.07393766049221658,545,"In short, ladies and gentlemen of the Board, while some see a storm as a time for taking cover, I see it as an opportunity."
526,9,19,62,90,1.4111111111111112,0.07047979752232285,545,Growth is our number one priority.
526,7,23,60,90,1.4111111111111112,0.06684329494057703,545,He'll grow on you
526,7,23,60,90,1.4111111111111112,0.06684329494057703,545,We need to start thinking outside the pot.
526,12,13,65,90,1.4111111111111112,0.07560731134751196,545,"Sandy, I'm the potted plant that you suggested on Facebook could do a better job of running the company."
526,7,23,60,90,1.4111111111111112,0.06684329494057703,545,"Sorry sir, that was rude of me. Not nip it in the bud...curb our spending."
526,9,19,62,90,1.4111111111111112,0.07047979752232285,545,"What makes you think that there's a plant inside the company, Allen?"
526,15,7,68,90,1.4111111111111112,0.08040851447211046,545,President Trump was not available so he provided an equally qualified substitute.
526,12,13,65,90,1.4111111111111112,0.07560731134751196,545,"Actually, this meeting is to go over the company's latest ""plan."" That was a typo."
526,11,15,64,90,1.4111111111111112,0.07393766049221658,545,Welcome to the annuals meeting.
526,9,19,62,90,1.4111111111111112,0.07047979752232285,545,"As you can see, this idea still hasn't borne fruit."
526,10,17,63,90,1.4111111111111112,0.07222942439840536,545,I'm the Plant manager
526,12,13,65,90,1.4111111111111112,0.07560731134751196,545,I'd watch what you say in front of him. I hear he's a corporate plant.
526,10,17,63,90,1.4111111111111112,0.07222942439840536,545,Watch what you say. I think it's a plant.
526,10,17,63,90,1.4111111111111112,0.07222942439840536,545,Will someone please get me some water.
526,11,15,64,90,1.4111111111111112,0.07393766049221658,545,Careful. Could be a plant.
526,8,21,61,90,1.4111111111111112,0.06868561689793795,545,....and I don't want to hear anything more about HEDGE funds!!
526,6,25,59,90,1.4111111111111112,0.06494873507910405,545,"On second thought, don't bring up about the need to trim back."
526,5,27,58,90,1.4111111111111112,0.0629972245280561,545,"I know they told us not to worry about corporate espionage, but I think it's a plant."
526,9,19,62,90,1.4111111111111112,0.07047979752232285,545,I've been supplanted .
526,7,23,60,90,1.4111111111111112,0.06684329494057703,545,"They say he’s the best, but he looks a little green."
526,14,9,67,90,1.4111111111111112,0.07884060698316743,545,"Based on the size of the office Christmas tree, we really did have a bad year."
526,9,19,62,90,1.4111111111111112,0.07047979752232285,545,Our top priority is growth.
526,9,19,62,90,1.4111111111111112,0.07047979752232285,545,Not the first time he's shown up potted.
526,10,17,63,90,1.4111111111111112,0.07222942439840536,545,Guess they went outside for new leadership.
526,7,23,60,90,1.4111111111111112,0.06684329494057703,545,The first order of business now is to hire a new Plant Manager.
526,12,13,65,90,1.4111111111111112,0.07560731134751196,545,We're going paperless.
526,8,21,61,90,1.4111111111111112,0.06868561689793795,545,"As new plant manager, I'm announcing that we are going green."
526,7,23,60,90,1.4111111111111112,0.06684329494057703,545,I'm sorry the board has decided we need to turn over a new leaf.
526,9,19,62,90,1.4111111111111112,0.07047979752232285,545,We would all like to know about the FICUS deduction on our pay stubs.
526,6,25,59,90,1.4111111111111112,0.06494873507910405,545,"I don't agree either, but the board wanted to go with someone from the outside."
526,9,19,62,90,1.4111111111111112,0.07047979752232285,545,Let's discuss our ficus score...
526,6,25,59,90,1.4111111111111112,0.06494873507910405,545,He's a heavy drinker.
526,12,13,65,90,1.4111111111111112,0.07560731134751196,545,I'm thinking of running for President.
526,9,19,62,90,1.4111111111111112,0.07047979752232285,545,"nobody say anything,i think he's a plant."
575,7,20,56,83,1.4096385542168675,0.07075460063566003,545,Watch what you say. I think it's a plant.
576,10,17,64,91,1.4065934065934067,0.07157400428836615,545,CEOs like that don't just grow on trees.
576,8,21,62,91,1.4065934065934067,0.0680767038087962,545,This is their idea of a new hedge fund manager?
576,8,21,62,91,1.4065934065934067,0.0680767038087962,545,Better watch what you say. I think he's a plant.
576,9,19,63,91,1.4065934065934067,0.06984724651459649,545,We are here to welcome out new Plant Manager.
580,5,26,58,89,1.404494382022472,0.06335669472917604,545,"I mean, are we the Board, or are we branch managers?"
580,9,18,62,89,1.404494382022472,0.07096140660005767,545,"I must admit, I do see plenty of growth opportunities"
580,6,24,59,89,1.404494382022472,0.06534090129405302,545,Psst . . . It's time for the annuals report.
580,3,30,56,89,1.404494382022472,0.05918906602726258,545,Management's been pushing perennial growth.
580,10,16,63,89,1.404494382022472,0.07273846191370757,545,I wonder who's going to be the new plant manager.
580,8,20,61,89,1.404494382022472,0.06913869113416549,545,"When I grow, we grow. It's that simple."
580,7,22,60,89,1.404494382022472,0.06726660387467437,545,"No coffee, just water with a touch of fertilizer."
580,11,14,64,89,1.404494382022472,0.07447312573328088,545,I hear he wants to call it a perennial report.
580,10,16,63,89,1.404494382022472,0.07273846191370757,545,"Due to some inherent life cycles, I am switching these boards meetings from annual to perennial."
580,5,26,58,89,1.404494382022472,0.06335669472917604,545,Not bad for a former branch manager.
580,9,18,62,89,1.404494382022472,0.07096140660005767,545,Can't we at least agree that biodiversity matters?
580,8,20,61,89,1.404494382022472,0.06913869113416549,545,Our plans have yet to bear fruit.
580,9,18,62,89,1.404494382022472,0.07096140660005767,545,I think this means we are going green.
580,5,26,58,89,1.404494382022472,0.06335669472917604,545,So the environment finally got a place at the table?
580,9,18,62,89,1.404494382022472,0.07096140660005767,545,"FICO, FCU, FDIC, and now FICUS?"
580,9,18,62,89,1.404494382022472,0.07096140660005767,545,He was right: A potted plant would eventually replace him.
596,11,13,63,87,1.4022988505747127,0.07573884510846961,545,I don't trust him. I think he's a plant.
596,8,19,60,87,1.4022988505747127,0.07024562647794483,545,"Well, this should get the environmentalists off our backs."
596,11,13,63,87,1.4022988505747127,0.07573884510846961,545,The first order of business is ensuring this company becomes a paperless office
596,6,23,58,87,1.4022988505747127,0.06633122663237183,545,Our shareholders were complaining about a lack of biodiversity on the board.
596,9,17,61,87,1.4022988505747127,0.0721232018537785,545,So is this part of our sustainability initiative or our diversity campaign?
596,6,23,58,87,1.4022988505747127,0.06633122663237183,545,What is the plant manager up to now?
596,6,23,58,87,1.4022988505747127,0.06633122663237183,545,This year I want to focus on growth.
596,8,19,60,87,1.4022988505747127,0.07024562647794483,545,Hope it's pot.
596,5,25,57,87,1.4022988505747127,0.06428470595867371,545,I'd appreciate it if we can move this chat to the water cooler.
596,8,19,60,87,1.4022988505747127,0.07024562647794483,545,I am the executive branch.
596,8,19,60,87,1.4022988505747127,0.07024562647794483,545,Even Monsanto couldn't have seen this coming.
596,6,23,58,87,1.4022988505747127,0.06633122663237183,545,I think if we moved her closer to the window she might grow into the job.
596,4,27,56,87,1.4022988505747127,0.06217085501930308,545,I hope this meeting's not bugged.
596,10,15,62,87,1.4022988505747127,0.07395312334176843,545,Can't anyone remember the magic word?
596,7,21,59,87,1.4022988505747127,0.06831646824095204,545,I guess we should cancel that salad order for lunch.
596,9,17,61,87,1.4022988505747127,0.0721232018537785,545,"Before we get started, can we get you some water?"
596,6,23,58,87,1.4022988505747127,0.06633122663237183,545,The last guy was axed.
596,4,27,56,87,1.4022988505747127,0.06217085501930308,545,He was obviously planted.
596,11,13,63,87,1.4022988505747127,0.07573884510846961,545,You're all fired.
596,7,21,59,87,1.4022988505747127,0.06831646824095204,545,I guess the rumors that I heard about this company going to pot were true
616,12,13,67,92,1.4021739130434783,0.07422120353480988,545,Hail to the leaf.
616,7,23,62,92,1.4021739130434783,0.06568355454722916,545,Have you met the new plant manager?
618,5,24,57,86,1.3953488372093024,0.06465539456079225,545,Capacity for growth is something we look for in our senior managers.
618,7,20,59,86,1.3953488372093024,0.06875693178325183,545,"Don't trust him, he's a plant."
618,8,18,60,86,1.3953488372093024,0.07071855116915401,545,just call me basil
618,10,14,62,86,1.3953488372093024,0.0744869726992531,545,They brought in a perennial after losing two CFOs to frost.
618,6,22,58,86,1.3953488372093024,0.06673767943994782,545,Good afternoon. I am your new branch manager.
618,9,16,61,86,1.3953488372093024,0.07262720764755978,545,It's not what he says. It's what he leaves out.
618,9,16,61,86,1.3953488372093024,0.07262720764755978,545,"Now People.. I just want to remind you what happened in the film ""Little Shop of Horrors""."
618,8,18,60,86,1.3953488372093024,0.07071855116915401,545,"Maybe, just maybe, it's time to start thinking ""Inside the Box"" again."
618,8,18,60,86,1.3953488372093024,0.07071855116915401,545,I'm from the branch office...
618,9,16,61,86,1.3953488372093024,0.07262720764755978,545,"First order of business, paperless office."
618,9,16,61,86,1.3953488372093024,0.07262720764755978,545,I always suspected Henry was a plant
618,7,20,59,86,1.3953488372093024,0.06875693178325183,545,We needed a committee member with a negative carbon footprint!
618,9,16,61,86,1.3953488372093024,0.07262720764755978,545,She broke the grass ceiling...
618,7,20,59,86,1.3953488372093024,0.06875693178325183,545,"We'd like to welcome Carl, the new Plant Manager."
618,9,16,61,86,1.3953488372093024,0.07262720764755978,545,"If you thought I was joking when I said that I want this company to be greener, I wasn't."
618,12,10,64,86,1.3953488372093024,0.07807371340172245,545,It won the electoral vote.
618,12,10,64,86,1.3953488372093024,0.07807371340172245,545,Talk to me.
618,10,14,62,86,1.3953488372093024,0.0744869726992531,545,What? I thought you all wanted to discuss ficus responsibility.
618,7,20,59,86,1.3953488372093024,0.06875693178325183,545,Our nation has its POTUS. We have our FICUS.
618,7,20,59,86,1.3953488372093024,0.06875693178325183,545,Try to use gender neutral pronouns.
618,10,14,62,86,1.3953488372093024,0.0744869726992531,545,"You were right, no difference"
618,5,24,57,86,1.3953488372093024,0.06465539456079225,545,"Be careful, I think she's a plant."
618,7,20,59,86,1.3953488372093024,0.06875693178325183,545,How much greener can our company get?
618,6,22,58,86,1.3953488372093024,0.06673767943994782,545,We're going to make America so green again. So green. You won't believe how green I'll make it.
618,6,22,58,86,1.3953488372093024,0.06673767943994782,545,I want to branch out.
618,5,24,57,86,1.3953488372093024,0.06465539456079225,545,They warned us there was no telling what might happen if we legalized it.
618,8,18,60,86,1.3953488372093024,0.07071855116915401,545,I'm never sure when the meeting is over.
618,5,24,57,86,1.3953488372093024,0.06465539456079225,545,It's time for the company to branch out.
646,9,16,62,87,1.3908045977011494,0.07193124267360433,545,I told you his virulent veganism was going to change him.
646,9,16,62,87,1.3908045977011494,0.07193124267360433,545,I am stepping down today to begin my campaign for president.
648,7,19,59,85,1.388235294117647,0.06919731388194097,545,Don't even think about making a plant manager joke.
648,8,17,60,85,1.388235294117647,0.07119255785047891,545,Well he did create a successful start-up with just one cup of water.
648,10,13,62,85,1.388235294117647,0.07502402537140782,545,"Our security has been breached. In other words, one of you is a plant."
648,6,21,58,85,1.388235294117647,0.06714280455609471,545,He's our first CEO with support from all the branches.
648,8,17,60,85,1.388235294117647,0.07119255785047891,545,"As the CEO, we're still waiting for him to blossom."
648,8,17,60,85,1.388235294117647,0.07119255785047891,545,"Honestly, it hadn't even occurred to me that the greenhouse had a glass ceiling."
648,8,17,60,85,1.388235294117647,0.07119255785047891,545,They say he has deep roots in the South.
648,9,15,61,85,1.388235294117647,0.07313338730095657,545,"Solar, I like it."
648,9,15,61,85,1.388235294117647,0.07313338730095657,545,I'm afraid it's time for some pruning.
648,8,17,60,85,1.388235294117647,0.07119255785047891,545,"If I hear one more ""Blame it on Bush"" joke, you're all fired."
648,9,15,61,85,1.388235294117647,0.07313338730095657,545,How about we try smoking some of it.
648,9,15,61,85,1.388235294117647,0.07313338730095657,545,Let's all take a step back and photosynthesize the situation.
648,9,15,61,85,1.388235294117647,0.07313338730095657,545,Who do I have to fire to get a glass of water around here?
648,8,17,60,85,1.388235294117647,0.07119255785047891,545,We need to nip this in the bud.
648,8,17,60,85,1.388235294117647,0.07119255785047891,545,It's an inspired choice for the head of the EPA. Green but not confrontational.
648,9,15,61,85,1.388235294117647,0.07313338730095657,545,Look who's in a good mood. He must have upped his nitrogen this morning.
648,8,17,60,85,1.388235294117647,0.07119255785047891,545,I move we begin going paperless.
648,7,19,59,85,1.388235294117647,0.06919731388194097,545,Tell me you didn't vote green.
648,6,21,58,85,1.388235294117647,0.06714280455609471,545,I can provide the seed money your company needs to grow.
648,8,17,60,85,1.388235294117647,0.07119255785047891,545,"In the interest of greater efficiency, we've decided to move the plant closer to corporate."
648,5,23,57,85,1.388235294117647,0.06502341239000001,545,I started this company as a little seedling...
648,9,15,61,85,1.388235294117647,0.07313338730095657,545,His ambitions seems a little too dependent on solar.
648,11,11,63,85,1.388235294117647,0.076868175649924,545,Isn't he taking this idea of going green a bit too far?
648,6,21,58,85,1.388235294117647,0.06714280455609471,545,His ideas are growing on me.
648,7,19,59,85,1.388235294117647,0.06919731388194097,545,That's weird. The head of the table is putting oxygen back in the room.
648,9,15,61,85,1.388235294117647,0.07313338730095657,545,I still think he's a plant.
648,3,27,55,85,1.388235294117647,0.0605625302411,545,Our new boss looks pretty green.
648,9,15,61,85,1.388235294117647,0.07313338730095657,545,"Is it just me, or is this company going to pot?"
648,11,11,63,85,1.388235294117647,0.076868175649924,545,new rule - no more paper
648,4,25,56,85,1.388235294117647,0.06283257207867651,545,He's the type that kind of grows on you!
648,6,21,58,85,1.388235294117647,0.06714280455609471,545,It's possible we've gone too green.
648,3,27,55,85,1.388235294117647,0.0605625302411,545,The chairman has decided to go green.
648,6,21,58,85,1.388235294117647,0.06714280455609471,545,You want to know how I got to the top? One word: FERTILIZER.
648,8,17,60,85,1.388235294117647,0.07119255785047891,545,It'll be fine as long as he surrounds himself with good people.
682,9,14,60,83,1.3855421686746987,0.07438912806808261,545,"I’m green, but I have deep roots in hedging strategy."
682,6,20,57,83,1.3855421686746987,0.06820679800370742,545,I anticipate first quarter growth.
682,8,16,59,83,1.3855421686746987,0.07238704313935779,545,Everything's going to pot.
685,9,15,62,86,1.3837209302325582,0.07241883923850152,545,"Just think, he started as plant manager."
685,5,23,58,86,1.3837209302325582,0.06442124674190873,545,The card said it needs a place of importance with lots of direct praise.
685,7,19,60,86,1.3837209302325582,0.06853679781122625,545,I heard he left his old firm because of a pot problem.
688,4,24,56,84,1.380952380952381,0.06315650474823882,545,Let's start by clearing the air.
688,8,16,60,84,1.380952380952381,0.07166722418647016,545,Can someone get me a glass of water?
688,10,12,62,84,1.380952380952381,0.07556397612542305,545,The stockholders want growth and profitability. What's profitability?
688,4,24,56,84,1.380952380952381,0.06315650474823882,545,"Before we start, I'd like to say that's a nice pruning, Sir."
688,9,14,61,84,1.380952380952381,0.07364137936811505,545,"Fern, you had something to say?"
688,6,20,58,84,1.380952380952381,0.06754604027849481,545,As CEO and Chairman I oppose this talk about plant closings
688,10,12,62,84,1.380952380952381,0.07556397612542305,545,The awkward silence as they meet the new branch manager.
688,8,16,60,84,1.380952380952381,0.07166722418647016,545,"Yeah, mine says the same thing, ""Come meet the new plant manager""."
688,5,22,57,84,1.380952380952381,0.0653881168459467,545,We've seen slow but consistent growth.
688,5,22,57,84,1.380952380952381,0.0653881168459467,545,I understand some of you suspect I am a plant.
688,6,20,58,84,1.380952380952381,0.06754604027849481,545,He always talked about going green
688,8,16,60,84,1.380952380952381,0.07166722418647016,545,Our former chairman was supplanted.
688,5,22,57,84,1.380952380952381,0.0653881168459467,545,Let's talk growth strategy.
688,8,16,60,84,1.380952380952381,0.07166722418647016,545,"First off, I would like to apologize for my getting potted at the office party."
688,6,20,58,84,1.380952380952381,0.06754604027849481,545,"Looks different, but the IQ is the same"
688,8,16,60,84,1.380952380952381,0.07166722418647016,545,Let me guess. He wants to open more plants.
688,7,18,59,84,1.380952380952381,0.0696371258018947,545,The boss took going green to a whole new level.
688,8,16,60,84,1.380952380952381,0.07166722418647016,545,Call the witch back. Tell her I apologize.
688,9,14,61,84,1.380952380952381,0.07364137936811505,545,He he goes again. Sucking all of the oxygen out of the room.
688,9,14,61,84,1.380952380952381,0.07364137936811505,545,"Yes, I'm the new CEO, COO, majority stockholder and a philodendron. But you can call me Phil."
688,8,16,60,84,1.380952380952381,0.07166722418647016,545,The Board's commitment to diversity knew no bounds.
688,5,22,57,84,1.380952380952381,0.0653881168459467,545,"Actually Larry, I'm sucking the carbon dioxide from the room."
688,8,16,60,84,1.380952380952381,0.07166722418647016,545,".....And from now on, we're going to be paperless."
688,8,16,60,84,1.380952380952381,0.07166722418647016,545,Is this the best candidate The Green Party could come up with?
688,6,20,58,84,1.380952380952381,0.06754604027849481,545,Shall I ask him if he'd like some water?
688,8,16,60,84,1.380952380952381,0.07166722418647016,545,"In my place, Mr. Townsend has been permanently assigned to the lobby."
688,9,14,61,84,1.380952380952381,0.07364137936811505,545,"In retrospect, the board members should have anticipated the impending hosta takeover."
688,7,18,59,84,1.380952380952381,0.0696371258018947,545,Isn't he a bit green to be CEO?
688,6,20,58,84,1.380952380952381,0.06754604027849481,545,No ideas? It's like someone sucked the oxygen out of here.
688,12,8,64,84,1.380952380952381,0.0792694011152679,545,So.... when is it supposed to start burning?
688,9,14,61,84,1.380952380952381,0.07364137936811505,545,I want you to think outside the pot.
688,8,16,60,84,1.380952380952381,0.07166722418647016,545,Thank you all for your attention - and carbon dioxide.
688,7,18,59,84,1.380952380952381,0.0696371258018947,545,"""And Johnson, if you forget to water me again before you go on vacation, don't bother coming back!"
688,6,20,58,84,1.380952380952381,0.06754604027849481,545,At least this CEO won't suck the oxygen out of the room
688,9,14,61,84,1.380952380952381,0.07364137936811505,545,"He's ambitious all right, but I'm not sure the country can take another bush."
723,9,13,60,82,1.3780487804878048,0.07491889402048285,545,"On behalf of our entire company, I extend a warm welcome to our new plant manager."
723,9,13,60,82,1.3780487804878048,0.07491889402048285,545,Can we concentrate on the low-hanging fruit?
725,6,20,59,85,1.3764705882352941,0.06689694944796853,545,Increase our bonuses? Do I look like a Money Tree to you?
725,6,20,59,85,1.3764705882352941,0.06689694944796853,545,Have you had a chance to leaf through our proposal?
725,6,20,59,85,1.3764705882352941,0.06689694944796853,545,I think he's a plant from our competition.
725,7,18,60,85,1.3764705882352941,0.06895878399639879,545,Can we please take this meeting outside?
725,5,22,58,85,1.3764705882352941,0.06476951289477273,545,"Is it me, or does it feel like we're stuck in perennial meetings these days?"
730,6,19,58,83,1.3734939759036144,0.06794676351526412,545,I was brought in to breathe some fresh air into the company.
730,4,23,56,83,1.3734939759036144,0.06347476625918781,545,Don't say anything you don't want made public. I think he's a plant.
730,11,9,63,83,1.3734939759036144,0.07801316859063588,545,She started on the reception desk and gradually just took over the whole company.
730,5,21,57,83,1.3734939759036144,0.06574879703788411,545,"I'll be entering stasis soon, and Simmons, you'll be in charge."
730,8,15,60,83,1.3734939759036144,0.07214207782383265,545,Let's do introductions. I'll start. My name is Fern.
730,6,19,58,83,1.3734939759036144,0.06794676351526412,545,"Speaking as your GMO, I'm increasing the illumination and humidity in our facility."
730,7,17,59,83,1.3734939759036144,0.07007582345195508,545,Bush 2020
730,9,13,61,83,1.3734939759036144,0.07415077715715647,545,"I can't believe she was really saying ""Hosta-style takeover""."
730,9,13,61,83,1.3734939759036144,0.07415077715715647,545,"It's not ideal, but the other candidate had an issue with emails."
730,7,17,59,83,1.3734939759036144,0.07007582345195508,545,I told you the new CEO was a plant.
730,7,17,59,83,1.3734939759036144,0.07007582345195508,545,Be careful what you say...I hear he's a plant...
730,5,21,57,83,1.3734939759036144,0.06574879703788411,545,"We were skeptical, but have to admit that you grew on us"
730,6,19,58,83,1.3734939759036144,0.06794676351526412,545,I think we're taking boardroom diversity a bit far
730,6,19,58,83,1.3734939759036144,0.06794676351526412,545,I realize that I may not be the plant manager you expected.
730,6,19,58,83,1.3734939759036144,0.06794676351526412,545,I want you all to leave!
730,5,21,57,83,1.3734939759036144,0.06574879703788411,545,Boss's new plan sounds like a bonsai scheme.
730,6,19,58,83,1.3734939759036144,0.06794676351526412,545,"Our boss is the strong, silent phenotype"
730,8,15,60,83,1.3734939759036144,0.07214207782383265,545,I hear that he's a perennial winner.
730,6,19,58,83,1.3734939759036144,0.06794676351526412,545,This quarter I would like to continue my growth strategy.
730,6,19,58,83,1.3734939759036144,0.06794676351526412,545,"What do you mean exactly when you say the company is ""going green""?"
730,3,25,55,83,1.3734939759036144,0.06111618109296571,545,At least the new guy adds oxygen to the room instead of sucking it out like the last guy.
730,8,15,60,83,1.3734939759036144,0.07214207782383265,545,"You, with the stupid look on your face, water me."
730,8,15,60,83,1.3734939759036144,0.07214207782383265,545,Wow... He actually is a potted plant.
730,5,21,57,83,1.3734939759036144,0.06574879703788411,545,Watch what you say. They think there's a plant in the office.
730,9,13,61,83,1.3734939759036144,0.07415077715715647,545,At least this one makes oxygen.
730,7,17,59,83,1.3734939759036144,0.07007582345195508,545,Just having him in the room makes me breathe more easily.
756,3,27,59,89,1.3707865168539326,0.05845740544408262,545,We must assume this is an indication that we're going green
757,9,12,60,81,1.3703703703703705,0.07545018069430875,545,"Looks like I'll be trading in my brown nose for a green thumb"""
757,6,18,57,81,1.3703703703703705,0.06904204400854536,545,"He really sucks the oxygen out of these meetings, doesn't he?"
757,5,20,56,81,1.3703703703703705,0.06676946806414795,545,"Firstly, I'd like to thank our previous branch manager"
760,9,13,62,84,1.369047619047619,0.07339751384521162,545,Why the hell are we sitting here staring at a plant?
760,7,17,60,84,1.369047619047619,0.06937918688892442,545,Let's talk about our branches.
762,8,14,60,82,1.3658536585365855,0.07261659082370875,545,Who's going to tell him he's naked?
762,5,20,57,82,1.3658536585365855,0.06610466622032775,545,Our company couldn't send a more positive message than having our first Green CEO
762,9,12,61,82,1.3658536585365855,0.07466112365287757,545,"And Johnson, for the last time, stop staring at my pot...my leaves are up here!"
762,5,20,57,82,1.3658536585365855,0.06610466622032775,545,Just like him to plant himself at the head of the table.
762,8,14,60,82,1.3658536585365855,0.07261659082370875,545,Anybody else thirsty?
762,7,16,59,82,1.3658536585365855,0.07051280125342921,545,Reincarnation doesn't always go as planned.
762,10,10,62,82,1.3658536585365855,0.07665114159203767,545,Board meetings are so much more enjoyable now that marijuana is legal.
762,8,14,60,82,1.3658536585365855,0.07261659082370875,545,It's the plant he promised would bring jobs to Detroit.
762,8,14,60,82,1.3658536585365855,0.07261659082370875,545,Anybody in here read Kafka?
762,10,10,62,82,1.3658536585365855,0.07665114159203767,545,"After his failed Presidential bud, Mr. Bush will be joining our board of directors."
762,6,18,58,82,1.3658536585365855,0.06834428299684821,545,Whose turn was it to bring the coffee and miracle grow?
762,6,18,58,82,1.3658536585365855,0.06834428299684821,545,could someone switch seats with me? I need the southern light
762,5,20,57,82,1.3658536585365855,0.06610466622032775,545,Our final candidate has demonstrated groundbreaking skills.
762,7,16,59,82,1.3658536585365855,0.07051280125342921,545,The board immediately regretted the blind hiring of another Ivy League grad.
762,9,12,61,82,1.3658536585365855,0.07466112365287757,545,"I know some of you have doubts, but as I grow into the position, I look forward to our achieving great success."
762,7,16,59,82,1.3658536585365855,0.07051280125342921,545,You didn't believe me when I said we were going green.
762,6,18,58,82,1.3658536585365855,0.06834428299684821,545,You sure that's the only Bush available these days?
762,7,16,59,82,1.3658536585365855,0.07051280125342921,545,Our company has gone to pot.
762,5,20,57,82,1.3658536585365855,0.06610466622032775,545,"She adds to our diversity, yet decreases our carbon footprint."
762,9,12,61,82,1.3658536585365855,0.07466112365287757,545,Shh! He's a plant.
762,7,16,59,82,1.3658536585365855,0.07051280125342921,545,"Poor J. R., I heard it all started with a simple case of plantar fasciitis."
762,9,12,61,82,1.3658536585365855,0.07466112365287757,545,As your new plant manager I want to thank each of you for all your hard work.
762,5,20,57,82,1.3658536585365855,0.06610466622032775,545,He's our new plant manager!
762,5,20,57,82,1.3658536585365855,0.06610466622032775,545,"Of course, he's got insider info on the competition. He's a plant."
762,8,14,60,82,1.3658536585365855,0.07261659082370875,545,It was a fair election. Now what?
762,7,16,59,82,1.3658536585365855,0.07051280125342921,545,Good morning...I'm your new plant manager.
762,8,14,60,82,1.3658536585365855,0.07261659082370875,545,I don't know if I can go that green.
762,5,20,57,82,1.3658536585365855,0.06610466622032775,545,I think we've taken our green initiative too far.
762,6,18,58,82,1.3658536585365855,0.06834428299684821,545,Word is that he is a plant from corporate.
762,6,18,58,82,1.3658536585365855,0.06834428299684821,545,"Going forward all job cuts will be referred to as ""pruning""."
762,4,22,56,82,1.3658536585365855,0.06378646230861691,545,It would be many years before they could have an actual board meeting.
762,9,12,61,82,1.3658536585365855,0.07466112365287757,545,"Be careful what you say, I think the new guy's a plant."
762,9,12,61,82,1.3658536585365855,0.07466112365287757,545,I knew he was a plant.
762,5,20,57,82,1.3658536585365855,0.06610466622032775,545,: “Watch what you say. I’m pretty sure he’s a plant.”
762,7,16,59,82,1.3658536585365855,0.07051280125342921,545,Twenty bucks he wants to build more plants.
762,5,20,57,82,1.3658536585365855,0.06610466622032775,545,You can all breathe easier now that I'm in charge.
762,5,20,57,82,1.3658536585365855,0.06610466622032775,545,He’s not as green as he looks.
762,6,18,58,82,1.3658536585365855,0.06834428299684821,545,"This is not what I would call, 'staying true to our roots'."
762,6,18,58,82,1.3658536585365855,0.06834428299684821,545,The executive team carefully surveyed the new plant manager
762,8,14,60,82,1.3658536585365855,0.07261659082370875,545,A GMO CEO.
762,5,20,57,82,1.3658536585365855,0.06610466622032775,545,Watch what you say -- I think one of these folks is a plant.
762,11,8,63,82,1.3658536585365855,0.07859078590785908,545,First Trump. Now me. Some people will elect anything.
762,7,16,59,82,1.3658536585365855,0.07051280125342921,545,He certainly has grown in the job.
762,5,20,57,82,1.3658536585365855,0.06610466622032775,545,I hope he remembers when I used to polish his leaves.
806,6,21,64,91,1.3626373626373627,0.06350849791999952,545,Actually I thought our Chairman Bush was a real person...
807,8,13,59,80,1.3625,0.07387071755027431,545,First order of business. I want a glass of water.
807,10,9,61,80,1.3625,0.07803713413367683,545,This is what we get for voting independent.
807,2,25,53,80,1.3625,0.059650219900493386,545,He looked taller in the photo.
807,8,13,59,80,1.3625,0.07387071755027431,545,"Careful what you say...rumor is, this new guy is a plant."
807,3,23,54,80,1.3625,0.06224632061720394,545,Our new plant manager seems a little green.
807,10,9,61,80,1.3625,0.07803713413367683,545,Our executive branch is leaving.
807,4,21,55,80,1.3625,0.06473839762136749,545,Going green was always a goal of his.
807,9,11,60,80,1.3625,0.07598248882206306,545,I would like us to focus more on growth
807,7,15,58,80,1.3625,0.07169677269717149,545,"Careful, I hear he's a plant..."
807,9,11,60,80,1.3625,0.07598248882206306,545,The final candidates were this or Donald Jr.
807,5,19,56,80,1.3625,0.06713803558926051,545,You all know my deeply-rooted views on this matter.
818,5,20,58,83,1.3614457831325302,0.06545196122376797,545,The doctors said it's the worst case of persistent vegetative state they've seen.
818,5,20,58,83,1.3614457831325302,0.06545196122376797,545,"Our CEO may seen a bit different, but he'll grow on you."
818,5,20,58,83,1.3614457831325302,0.06545196122376797,545,Now we'll hear from our Plant Manager
818,8,14,61,83,1.3614457831325302,0.07187165163573657,545,I hear it's artificial.
818,9,12,62,83,1.3614457831325302,0.07388770309814092,545,I guess his ex-wife was a real witch after all.
818,7,16,60,83,1.3614457831325302,0.0697973921330756,545,She just planted herself there.
824,6,17,58,81,1.3580246913580247,0.06873783163987683,545,"I'm from our California office. Relax, just take a deep breath and inhale."
824,7,15,59,81,1.3580246913580247,0.07094738525034375,545,Let's just move our office to Denver so we can smoke it.
824,7,15,59,81,1.3580246913580247,0.07094738525034375,545,"First order of business - Bunyan, you're fired!"
824,6,17,58,81,1.3580246913580247,0.06873783163987683,545,"So tell me, what do you think of the new plant manager?"
824,7,15,59,81,1.3580246913580247,0.07094738525034375,545,I guess the company is serious about going green.
824,4,21,56,81,1.3580246913580247,0.0640906042094687,545,"Here at Rainbow Analytics we pride ourselves on a management team that hails from every race, gender, sexuality, religion and soil type."
824,5,19,57,81,1.3580246913580247,0.06645485327079889,545,Why is everyone staring at me as if I'm the root of the problem
824,5,19,57,81,1.3580246913580247,0.06645485327079889,545,It was thought he could breathe some fresh air into the company.
824,11,7,63,81,1.3580246913580247,0.07917132924926334,545,"Please welcome our new leader, President Bush."
824,8,13,60,81,1.3580246913580247,0.07309017341044782,545,whose going to tell him about the mealybug on his lapel...
824,6,17,58,81,1.3580246913580247,0.06873783163987683,545,The company decided to increase the biodiversity of the workforce.
824,6,17,58,81,1.3580246913580247,0.06873783163987683,545,Those who called our chairman dumber than a potted plant know who they are.
824,6,17,58,81,1.3580246913580247,0.06873783163987683,545,Did you have a chance to leaf through the report?
824,3,23,55,81,1.3580246913580247,0.06163573292032898,545,It's not easy being green!
824,2,25,54,81,1.3580246913580247,0.059078943772866176,545,I am sure he will clear the air.
824,7,15,59,81,1.3580246913580247,0.07094738525034375,545,The new CEO is serious about carbon emissions.
824,5,19,57,81,1.3580246913580247,0.06645485327079889,545,"Are you OK, boss? You're looking a little green."
824,8,13,60,81,1.3580246913580247,0.07309017341044782,545,He's really grown as a leader.
824,8,13,60,81,1.3580246913580247,0.07309017341044782,545,"Dear god, he heard it through the grapevine."
824,4,21,56,81,1.3580246913580247,0.0640906042094687,545,Be careful what you say. I'm pretty sure he's a plant.
844,4,20,55,79,1.3544303797468353,0.06505178493817886,545,I call to order this Board of Directors Meeting of Plant Parenthood.
844,5,18,56,79,1.3544303797468353,0.06750040495038664,545,She's full of fertilizer.
844,7,14,58,79,1.3544303797468353,0.07214876685094763,545,I guess he was serious about going green.
844,7,14,58,79,1.3544303797468353,0.07214876685094763,545,"Usually these meetings are like watching grass grow, but finally a fresh face."
844,5,18,56,79,1.3544303797468353,0.06750040495038664,545,I move that we take it outside.
844,8,12,59,79,1.3544303797468353,0.07436406728343677,545,"First order of business, water me."
844,2,24,53,79,1.3544303797468353,0.0598547812125051,545,Could someone get me a glass of water?
844,6,16,57,79,1.3544303797468353,0.06986325653223797,545,How long before someone supplants him?
844,6,16,57,79,1.3544303797468353,0.06986325653223797,545,Really? No one brought water?
844,8,12,59,79,1.3544303797468353,0.07436406728343677,545,He thinks that we should open up another branch.
844,9,10,60,79,1.3544303797468353,0.07651525630721379,545,He just sits there like a potted plant.
844,6,16,57,79,1.3544303797468353,0.06986325653223797,545,Could someone please pass me some water?
844,5,18,56,79,1.3544303797468353,0.06750040495038664,545,Great. Another plant from the board.
844,7,14,58,79,1.3544303797468353,0.07214876685094763,545,It worked its way up from the mailroom.
844,4,20,55,79,1.3544303797468353,0.06505178493817886,545,I for one oppose any policy that would limit CO2.
844,7,14,58,79,1.3544303797468353,0.07214876685094763,545,Please stay. We're actually nostalgic for Bush leadership.
844,6,16,57,79,1.3544303797468353,0.06986325653223797,545,You see now the hazard in allowing the stockholders to vote.
844,6,16,57,79,1.3544303797468353,0.06986325653223797,545,"'Her roots are showing."""
844,8,12,59,79,1.3544303797468353,0.07436406728343677,545,I told you legalizing marijuana was a slippery slope.
844,10,8,61,79,1.3544303797468353,0.0786075975499934,545,Ironic that no one thought to bring him water.
844,6,16,57,79,1.3544303797468353,0.06986325653223797,545,I blame the electoral college.
844,6,16,57,79,1.3544303797468353,0.06986325653223797,545,Herb's the perennial late bloomer.
844,8,12,59,79,1.3544303797468353,0.07436406728343677,545,The CEO has been supplanted.
844,5,18,56,79,1.3544303797468353,0.06750040495038664,545,I would personally like to address the problem of employees taking too many unauthorized leaves.
844,6,16,57,79,1.3544303797468353,0.06986325653223797,545,It's a meeting to elect a new plant manager.
844,5,18,56,79,1.3544303797468353,0.06750040495038664,545,"I know, but at least it's not Trump."
844,6,16,57,79,1.3544303797468353,0.06986325653223797,545,"Sure he's an Ivy League ficus, I'm just saying he's still too green to be CFO."
844,5,18,56,79,1.3544303797468353,0.06750040495038664,545,I feel like we need more biodiversity
844,4,20,55,79,1.3544303797468353,0.06505178493817886,545,"Uhhh...what, exactly, is a ""Perennial Report?"""
844,7,14,58,79,1.3544303797468353,0.07214876685094763,545,How did this transpire?
844,6,16,57,79,1.3544303797468353,0.06986325653223797,545,"Unfortunately, Fern could not make it today."
844,4,20,55,79,1.3544303797468353,0.06505178493817886,545,First order of business: the salad bar has been causing me some concern.
844,6,16,57,79,1.3544303797468353,0.06986325653223797,545,We all need to get back to our roots.
844,7,14,58,79,1.3544303797468353,0.07214876685094763,545,Should we eat it or smoke it?
844,6,16,57,79,1.3544303797468353,0.06986325653223797,545,Before you can be a board you have to be a tree.
844,5,18,56,79,1.3544303797468353,0.06750040495038664,545,It's time we branch out.
844,4,20,55,79,1.3544303797468353,0.06505178493817886,545,"Here comes the ""let's go green pitch"" again."
844,5,18,56,79,1.3544303797468353,0.06750040495038664,545,Marty did say that his vacation was going to be completely transformative.
844,5,18,56,79,1.3544303797468353,0.06750040495038664,545,Be careful what you say around him... I think he's a plant.
844,7,14,58,79,1.3544303797468353,0.07214876685094763,545,At the end of the day the only color that matters is green.
844,6,16,57,79,1.3544303797468353,0.06986325653223797,545,"First an empty suit, now a potted plant."
844,7,14,58,79,1.3544303797468353,0.07214876685094763,545,"You don't get a vote on climate change, sir."
844,8,12,59,79,1.3544303797468353,0.07436406728343677,545,The board has spoken. I’ve been pruned.
844,4,20,55,79,1.3544303797468353,0.06505178493817886,545,I'm thinking salad for lunch.
844,4,20,55,79,1.3544303797468353,0.06505178493817886,545,At least he doesn't suck all the air out of the room.
844,4,20,55,79,1.3544303797468353,0.06505178493817886,545,I think he's a plant.
844,5,18,56,79,1.3544303797468353,0.06750040495038664,545,So that's 10 garden salads and a t-bone?
844,8,12,59,79,1.3544303797468353,0.07436406728343677,545,I thought we were meeting George H.W. Bush.
844,5,18,56,79,1.3544303797468353,0.06750040495038664,545,Do I have a volunteer to take me home for the weekend?
844,6,16,57,79,1.3544303797468353,0.06986325653223797,545,Is it bugged?
844,4,20,55,79,1.3544303797468353,0.06505178493817886,545,"This will be a new kind of leadership, one firmly rooted in the very soil of America."
844,7,14,58,79,1.3544303797468353,0.07214876685094763,545,"I don't think this is what the Board meant by ""going green."""
844,8,12,59,79,1.3544303797468353,0.07436406728343677,545,Never again will anyone in this company reach for the low hanging fruit.
844,7,14,58,79,1.3544303797468353,0.07214876685094763,545,"I may be green, but I can handle the job."
844,5,18,56,79,1.3544303797468353,0.06750040495038664,545,The chair has the flora.
844,4,20,55,79,1.3544303797468353,0.06505178493817886,545,"Well, he's been threatening to leave for years."
844,6,16,57,79,1.3544303797468353,0.06986325653223797,545,Marijuana won in every state....
844,8,12,59,79,1.3544303797468353,0.07436406728343677,545,"First, I want to address the rumors that I photosynthesized my way to the top."
844,5,18,56,79,1.3544303797468353,0.06750040495038664,545,Now that's what I call a power plant
844,7,14,58,79,1.3544303797468353,0.07214876685094763,545,Let's not water him and see what happens.
844,3,22,54,79,1.3544303797468353,0.06250731780215787,545,He's such a good listener.
844,10,8,61,79,1.3544303797468353,0.0786075975499934,545,"Yes, we agree, even a Bush would have been a better choice."
844,5,18,56,79,1.3544303797468353,0.06750040495038664,545,"'what new branches had you in mind ,Mr Chairman """
844,5,18,56,79,1.3544303797468353,0.06750040495038664,545,I think we've found the root of the problem.
844,7,14,58,79,1.3544303797468353,0.07214876685094763,545,At his first meeting Herb had everyone's undivided attention.
844,7,14,58,79,1.3544303797468353,0.07214876685094763,545,Let's take a moment to synthesize this information
844,2,24,53,79,1.3544303797468353,0.0598547812125051,545,He sure has grown a lot in this position but I wonder if this is the year he finally blooms.
844,10,8,61,79,1.3544303797468353,0.0786075975499934,545,Let's make this quick. I have a housewarming party to get to.
844,8,12,59,79,1.3544303797468353,0.07436406728343677,545,He’s definitely presidential material.
844,8,12,59,79,1.3544303797468353,0.07436406728343677,545,Dare you to ask for a show of hands.
844,8,12,59,79,1.3544303797468353,0.07436406728343677,545,Our leadership has gone to pot.
844,7,14,58,79,1.3544303797468353,0.07214876685094763,545,He got that position by letting everyone else do the talking.
844,4,20,55,79,1.3544303797468353,0.06505178493817886,545,I'd like you all to welcome the new branch manager.
917,8,12,60,80,1.35,0.07356216694105258,545,"Okay, so maybe 'strong roots, branch experience, growth potential, eco-sensitive' left a little to the imagination."
917,6,16,58,80,1.35,0.06912655794018842,545,I think our CEO is potted.
919,3,21,54,78,1.3461538461538463,0.0627564285391123,545,Isn't the new guy a little green to be leading this meeting?
919,8,11,59,78,1.3461538461538463,0.07485566770783876,545,This company has apparently gone to pot.
919,6,15,57,78,1.3461538461538463,0.07026642385937759,545,"Could everyone just exhale, please?"
919,7,13,58,78,1.3461538461538463,0.07259731851098938,545,"Well, that explains the nursery merger."
919,6,15,57,78,1.3461538461538463,0.07026642385937759,545,We get it sir...you want us to be more deeply rooted in the company.
919,8,11,59,78,1.3461538461538463,0.07485566770783876,545,Another quarter of record growth.
919,4,19,55,78,1.3461538461538463,0.06535571632217829,545,I'd like to introduce our new plant manager.
919,4,19,55,78,1.3461538461538463,0.06535571632217829,545,"...I'm going to go out on a limb, here..."
919,5,17,56,78,1.3461538461538463,0.06785550816982638,545,The hiring manager said there was excellent potential for growth.
919,2,23,53,78,1.3461538461538463,0.06004472491388711,545,We need to start thinking about pruning our workforce.
919,2,23,53,78,1.3461538461538463,0.06004472491388711,545,I had heard they were pruning the staff
919,7,13,58,78,1.3461538461538463,0.07259731851098938,545,"Sure he's a little green, but maybe he'll be around longer than his predecessor."
919,7,13,58,78,1.3461538461538463,0.07259731851098938,545,He got overwatered at the office party and tried to pollinate the HR director.
919,4,19,55,78,1.3461538461538463,0.06535571632217829,545,"If he doesn't say something soon, I'm going to water him."
919,7,13,58,78,1.3461538461538463,0.07259731851098938,545,I feel like I could really grow here.
919,4,19,55,78,1.3461538461538463,0.06535571632217829,545,Our new Plant Manager.
919,8,11,59,78,1.3461538461538463,0.07485566770783876,545,"I suggested our next CEO be fastidious, not deciduous."
919,4,19,55,78,1.3461538461538463,0.06535571632217829,545,"""First order of business; Who here is a vegetarian?"
919,8,11,59,78,1.3461538461538463,0.07485566770783876,545,I have the feeling that we voted for the wrong bush...
919,4,19,55,78,1.3461538461538463,0.06535571632217829,545,"Shhhhhhh , it's a plant."
919,5,17,56,78,1.3461538461538463,0.06785550816982638,545,"I'm Leif, the new plant manager. Initially, we'll be dormant, but we anticipate significant growth in the spring."
919,5,17,56,78,1.3461538461538463,0.06785550816982638,545,Let's start with introductions. I'm Fern.
919,6,15,57,78,1.3461538461538463,0.07026642385937759,545,And what are you doing about your carbon foot print
919,6,15,57,78,1.3461538461538463,0.07026642385937759,545,I'd like to address the gross overuse of paper in this office.
919,6,15,57,78,1.3461538461538463,0.07026642385937759,545,I see tremendous growth potential in the coming quarter.
919,5,17,56,78,1.3461538461538463,0.06785550816982638,545,There are rumors that our competitor has placed a plant inside our executive offices.
919,7,13,58,78,1.3461538461538463,0.07259731851098938,545,Our new plant manager will be chairing this meeting.
919,4,19,55,78,1.3461538461538463,0.06535571632217829,545,So this is our new plant manager?
919,5,17,56,78,1.3461538461538463,0.06785550816982638,545,"He's tough, but I hear his bark is worse than his bite."
919,7,13,58,78,1.3461538461538463,0.07259731851098938,545,Bad news. We're out of seed money.
919,3,21,54,78,1.3461538461538463,0.0627564285391123,545,Is it possible to go too green?
919,9,9,60,78,1.3461538461538463,0.07704785085248457,545,A-fern-ative Action
919,8,11,59,78,1.3461538461538463,0.07485566770783876,545,I would rather be supervised by a solar panel.
919,4,19,55,78,1.3461538461538463,0.06535571632217829,545,Get ready for some serious pruning and trimming in every department.
919,7,13,58,78,1.3461538461538463,0.07259731851098938,545,Be careful what you say. I think he might be a plant from headquarters.
919,5,17,56,78,1.3461538461538463,0.06785550816982638,545,Maybe now this company will take climate change seriously.
919,7,13,58,78,1.3461538461538463,0.07259731851098938,545,Are you absorbing any of this?
919,6,15,57,78,1.3461538461538463,0.07026642385937759,545,I wasn't expecting this when they called a meeting of the top plant's employees...
919,8,11,59,78,1.3461538461538463,0.07485566770783876,545,"On Sarah's first day at work, she realized that she was the only one not wearing glasses."
919,8,11,59,78,1.3461538461538463,0.07485566770783876,545,"As the new CEO, my first order is to replace the cafeteria salad bar with healthy water, sunlight, and manure options."
919,7,13,58,78,1.3461538461538463,0.07259731851098938,545,He's fern but fair.
919,7,13,58,78,1.3461538461538463,0.07259731851098938,545,I'm the potted plant you said you'd prefer to Bixby as your Chairman.
919,6,15,57,78,1.3461538461538463,0.07026642385937759,545,What does he know about growing a business?
919,6,15,57,78,1.3461538461538463,0.07026642385937759,545,I knew it was a bad idea to have write-in candidates.
919,4,19,55,78,1.3461538461538463,0.06535571632217829,545,So that's what legal marijuana looks like.
919,6,15,57,78,1.3461538461538463,0.07026642385937759,545,"Despite increased biodiversity on the board of directors, HR continued to receive complaints of asexual nature."
919,6,15,57,78,1.3461538461538463,0.07026642385937759,545,If only it were cannabis I wouldn't mind these meetings.
919,5,17,56,78,1.3461538461538463,0.06785550816982638,545,Am I the only one capable of breathing new life into this company?
919,8,11,59,78,1.3461538461538463,0.07485566770783876,545,I think it is clear we have made a real breakthrough in biotech
919,6,15,57,78,1.3461538461538463,0.07026642385937759,545,"One word, people. Water."
919,8,11,59,78,1.3461538461538463,0.07485566770783876,545,"Jim, I'm afraid your plan just isn't bearing fruit."
919,4,19,55,78,1.3461538461538463,0.06535571632217829,545,The people wanted an outsider.
919,5,17,56,78,1.3461538461538463,0.06785550816982638,545,Anybody bring any rolling papers?
919,4,19,55,78,1.3461538461538463,0.06535571632217829,545,Looks like he's turning over a new leaf.
919,7,13,58,78,1.3461538461538463,0.07259731851098938,545,So what happened to the old plant manager?
919,7,13,58,78,1.3461538461538463,0.07259731851098938,545,We're with Fern
919,4,19,55,78,1.3461538461538463,0.06535571632217829,545,Just wait: he'll wilt.
919,7,13,58,78,1.3461538461538463,0.07259731851098938,545,Previously front lobby of Trump Towers.
919,4,19,55,78,1.3461538461538463,0.06535571632217829,545,"So, with regrets, we've agreed to shut down the plant."
919,6,15,57,78,1.3461538461538463,0.07026642385937759,545,And the first one to feed me horseshit will be fired!
919,5,17,56,78,1.3461538461538463,0.06785550816982638,545,Any photosynthesis deniers?
919,11,5,62,78,1.3461538461538463,0.08125498130568595,545,Between a woman and a potted plant they choose the f***ing plant.
919,3,21,54,78,1.3461538461538463,0.0627564285391123,545,Looks like management was serious about turning over a new leaf
919,8,11,59,78,1.3461538461538463,0.07485566770783876,545,We're sorry. The board feels you've outgrown this position.
919,5,17,56,78,1.3461538461538463,0.06785550816982638,545,I want to talk about security. I think one of us is a plant.
919,7,13,58,78,1.3461538461538463,0.07259731851098938,545,Salary was the deciding factor.
919,3,21,54,78,1.3461538461538463,0.0627564285391123,545,Our business is just too seasonal.
919,6,15,57,78,1.3461538461538463,0.07026642385937759,545,We had to put a leaf in the table to accommodate everyone.
919,5,17,56,78,1.3461538461538463,0.06785550816982638,545,"Let's get down to earth, people."
919,4,19,55,78,1.3461538461538463,0.06535571632217829,545,The company was undergoing a hosta takeover.
919,8,11,59,78,1.3461538461538463,0.07485566770783876,545,All those in favor face the sun.
919,7,13,58,78,1.3461538461538463,0.07259731851098938,545,I called you here today to inform you that our plant in Cleveland will be relocating to Mexico.
919,8,11,59,78,1.3461538461538463,0.07485566770783876,545,Our search firm's choice for plant manager?
919,5,17,56,78,1.3461538461538463,0.06785550816982638,545,"When we elected Bush to be the new Chairman, I thought we meant George."
919,6,15,57,78,1.3461538461538463,0.07026642385937759,545,I would like to present my nominee for Agricultural Secretary.
919,5,17,56,78,1.3461538461538463,0.06785550816982638,545,Welcome to the inaugural Plant Parenthood meeting.
919,6,15,57,78,1.3461538461538463,0.07026642385937759,545,Bear with me as I leaf through the agenda.
919,6,15,57,78,1.3461538461538463,0.07026642385937759,545,"Now I'm legal, and we can start helping all Americans to feel great again."
919,7,13,58,78,1.3461538461538463,0.07259731851098938,545,There was a time when you just couldn't get him to shut up.
919,5,17,56,78,1.3461538461538463,0.06785550816982638,545,Not so loud - he's dormant.
919,9,9,60,78,1.3461538461538463,0.07704785085248457,545,We will not be moving the plant to Mexico.
919,5,17,56,78,1.3461538461538463,0.06785550816982638,545,So this is the plant manager?
919,7,13,58,78,1.3461538461538463,0.07259731851098938,545,At least he cares more about the environment than Trump.
919,6,15,57,78,1.3461538461538463,0.07026642385937759,545,I think the new CEO is a GMO.
919,6,15,57,78,1.3461538461538463,0.07026642385937759,545,Watch what you say. He could be a plant.
919,7,13,58,78,1.3461538461538463,0.07259731851098938,545,I'm opening a new branch next week.
919,5,17,56,78,1.3461538461538463,0.06785550816982638,545,Anyone else feel like a little pot?
919,8,11,59,78,1.3461538461538463,0.07485566770783876,545,"As to pronouns, ""it"" is perfectly acceptable. Now to the Human Resources Committee report - and we'll have to revisit that name as well - . . ."
919,3,21,54,78,1.3461538461538463,0.0627564285391123,545,Could someone bring me a glass of water?
1008,7,12,58,77,1.3376623376623376,0.07304150453184358,545,We've recently discovered that our CEO is a Russian plant
1008,3,20,54,77,1.3376623376623376,0.06299212161566223,545,I say we don't water it
1008,7,12,58,77,1.3376623376623376,0.07304150453184358,545,"He has no qualifications as chairman, but we felt he's the lesser of two evils."
1008,5,16,56,77,1.3376623376623376,0.0682021582133502,545,"No we can't draw the shades, I don't work that way."
1008,6,14,57,77,1.3376623376623376,0.07066327111461151,545,"Ladies and gentlemen, I am proud to be the first shrub to shatter the grass ceiling."
1008,8,10,59,77,1.3376623376623376,0.07534470707311537,545,It looks like we've been targeted for takeover by FTD. You'd better read the card.
1008,1,24,52,77,1.3376623376623376,0.05731038637390178,545,Let's hope that he grows into the job.
1008,4,18,55,77,1.3376623376623376,0.06564884527012349,545,All of these growth strategies involve indirect sunlight.
1008,7,12,58,77,1.3376623376623376,0.07304150453184358,545,Allow me to introduce myself - I'm the new plant supervisor
1008,5,16,56,77,1.3376623376623376,0.0682021582133502,545,"We can disagree about going green, but we have to agree he leads by example."
1008,3,20,54,77,1.3376623376623376,0.06299212161566223,545,"I thought you said he was a vegetarian, not vegetation."
1008,7,12,58,77,1.3376623376623376,0.07304150453184358,545,Of course the new plant manager will be working very closely with me.
1008,6,14,57,77,1.3376623376623376,0.07066327111461151,545,Don't stare at me like I'm a potted plant. Somebody give me an answer!
1008,8,10,59,77,1.3376623376623376,0.07534470707311537,545,It looks like they've drained the swamp.
1008,5,16,56,77,1.3376623376623376,0.0682021582133502,545,We're downsizing. I've called in the Bonsai Team.
1008,6,14,57,77,1.3376623376623376,0.07066327111461151,545,He is very impatiens today.
1008,3,20,54,77,1.3376623376623376,0.06299212161566223,545,"Not what I was expecting when I heard we we'd be unveiling a new plant..."""
1008,5,16,56,77,1.3376623376623376,0.0682021582133502,545,"Let's start the meeting with the annual, or the perennial, report."
1008,8,10,59,77,1.3376623376623376,0.07534470707311537,545,In our last meeting you voted for a new plant.
1008,9,8,60,77,1.3376623376623376,0.07757956163572852,545,Is it sexual harassment if I picture our boss in a skinny little joint?
1008,7,12,58,77,1.3376623376623376,0.07304150453184358,545,"First, let's address care and feeding of the Chair."
1008,6,14,57,77,1.3376623376623376,0.07066327111461151,545,"So let's sell, sell, sell. And remember, it's a jungle out there."
1008,7,12,58,77,1.3376623376623376,0.07304150453184358,545,The first item on our agenda...going paperless.
1008,10,6,61,77,1.3376623376623376,0.07975181429440985,545,Today's meeting is about going paperless. Awkward.
1008,5,16,56,77,1.3376623376623376,0.0682021582133502,545,I heard he got his start in Chia Pets.
1008,4,18,55,77,1.3376623376623376,0.06564884527012349,545,She's from the branch office.
1008,4,18,55,77,1.3376623376623376,0.06564884527012349,545,"As you may have expected, my successor will not be one of you."
1008,5,16,56,77,1.3376623376623376,0.0682021582133502,545,Tell us about your growth plan.
1008,6,14,57,77,1.3376623376623376,0.07066327111461151,545,Ten bucks says this is going to be about soil conservation again.
1008,6,14,57,77,1.3376623376623376,0.07066327111461151,545,Call security. I think we have a plant.
1008,5,16,56,77,1.3376623376623376,0.0682021582133502,545,This new boss seems kind of green.
1008,6,14,57,77,1.3376623376623376,0.07066327111461151,545,He looks like he could use a drink.
1008,4,18,55,77,1.3376623376623376,0.06564884527012349,545,"He pretends to be down to earth, but his family's roots go way back."
1008,7,12,58,77,1.3376623376623376,0.07304150453184358,545,Welcome to our first Green Lives Matter meeting.
1008,4,18,55,77,1.3376623376623376,0.06564884527012349,545,Same charisma as the old CEO.
1008,3,20,54,77,1.3376623376623376,0.06299212161566223,545,His management skills have really blossomed.
1008,4,18,55,77,1.3376623376623376,0.06564884527012349,545,Psst. I don't trust him. I heard he's a plant.
1008,5,16,56,77,1.3376623376623376,0.0682021582133502,545,I wasn't kidding when I said we were going green.
1008,7,12,58,77,1.3376623376623376,0.07304150453184358,545,It's the green candidate.
1008,6,14,57,77,1.3376623376623376,0.07066327111461151,545,I hate taking orders from someone so green.
1008,8,10,59,77,1.3376623376623376,0.07534470707311537,545,Now that corporations are considered people it's only fair...
1008,5,16,56,77,1.3376623376623376,0.0682021582133502,545,Everyone please remain seeded.
1008,5,16,56,77,1.3376623376623376,0.0682021582133502,545,We need to refocus on organic growth.
1008,4,18,55,77,1.3376623376623376,0.06564884527012349,545,"We are going green, people."
1008,5,16,56,77,1.3376623376623376,0.0682021582133502,545,I've decided that we should have more branch offices.
1008,4,18,55,77,1.3376623376623376,0.06564884527012349,545,"As you know, my roots in this industry run deep."
1008,3,20,54,77,1.3376623376623376,0.06299212161566223,545,I preferred the stuffed shirt.
1008,3,20,54,77,1.3376623376623376,0.06299212161566223,545,We're getting back to our roots.
1008,7,12,58,77,1.3376623376623376,0.07304150453184358,545,Could one of you bring me some water?
1008,3,20,54,77,1.3376623376623376,0.06299212161566223,545,"He hasn't said much, but I think he'll grow on you."
1008,4,18,55,77,1.3376623376623376,0.06564884527012349,545,"From now on, our meetings will be carbon neutral."
1008,3,20,54,77,1.3376623376623376,0.06299212161566223,545,I told you one day I'd be legal.
1008,6,14,57,77,1.3376623376623376,0.07066327111461151,545,"Congratulations!Growth is good. We have four new branches, and are greener than ever!"
1008,5,16,56,77,1.3376623376623376,0.0682021582133502,545,Some of you may consider this taking the ivy league too far.
1008,6,14,57,77,1.3376623376623376,0.07066327111461151,545,One of us is a plant.
1008,4,18,55,77,1.3376623376623376,0.06564884527012349,545,"With your help, we can continue to grow the hedge fund my father established."
1008,7,12,58,77,1.3376623376623376,0.07304150453184358,545,That's a Trump plant. It's gonna be Yuge!
1008,4,18,55,77,1.3376623376623376,0.06564884527012349,545,"Careful what you say, he's a plant."
1008,6,14,57,77,1.3376623376623376,0.07066327111461151,545,Not the George Bush I was expecting...
1008,4,18,55,77,1.3376623376623376,0.06564884527012349,545,I'm thinking that this CEO may be a plant.
1008,5,16,56,77,1.3376623376623376,0.0682021582133502,545,Is this about my CO2 emissions?
1008,6,14,57,77,1.3376623376623376,0.07066327111461151,545,"Before we begin, I'd like you all to take a deep breath out."
1008,4,18,55,77,1.3376623376623376,0.06564884527012349,545,"It's very clear that if our business is going to survive, we have to start branching out."
1008,6,14,57,77,1.3376623376623376,0.07066327111461151,545,"If he doesn't come back, he said to water it twice a week."
1008,7,12,58,77,1.3376623376623376,0.07304150453184358,545,Is it narcissistic or just a narcissus?
1008,5,16,56,77,1.3376623376623376,0.0682021582133502,545,"Is anyone else in R&D experiencing potential side effects, or am I the only one?"
1008,9,8,60,77,1.3376623376623376,0.07757956163572852,545,"All those in favor of recreational marijuana, say aye."
1008,5,16,56,77,1.3376623376623376,0.0682021582133502,545,Business is blooming.
1008,4,18,55,77,1.3376623376623376,0.06564884527012349,545,It grows on you.
1008,6,14,57,77,1.3376623376623376,0.07066327111461151,545,This company's going to pot.
1078,7,12,59,78,1.3333333333333333,0.07222883923340606,545,I guess we're no longer beating around the bush.
1078,7,12,59,78,1.3333333333333333,0.07222883923340606,545,"Good, we all agreed again. It's manure for lunch."
1080,4,17,55,76,1.3289473684210527,0.06592967517232824,545,The Monsanto annual meeting will now come to order.
1080,7,11,58,76,1.3289473684210527,0.07348029427864373,545,"""Let's hope he leaves early""."
1080,5,15,56,76,1.3289473684210527,0.06853903458111421,545,"After all, he is the plant manager."
1080,6,13,57,76,1.3289473684210527,0.07105263157894735,545,I'm thinking a big salad for lunch.
1080,8,9,59,76,1.3289473684210527,0.07583027654082859,545,"Effective immediately, we're going paperless."
1080,4,17,55,76,1.3289473684210527,0.06592967517232824,545,The committee for funding plant parenthood will come to order.
1080,4,17,55,76,1.3289473684210527,0.06592967517232824,545,"Effective immediately, we're opening more branch offices."
1080,7,11,58,76,1.3289473684210527,0.07348029427864373,545,"First thing we're going to do, people, is make shrubs great again!"
1080,4,17,55,76,1.3289473684210527,0.06592967517232824,545,All in favor of water for lunch say yeah.
1080,6,13,57,76,1.3289473684210527,0.07105263157894735,545,"He is organic, biodynamic and now legal in California, but almost impossible to interpret."
1080,7,11,58,76,1.3289473684210527,0.07348029427864373,545,He's an Ivy League whiz kid apparently.
1080,4,17,55,76,1.3289473684210527,0.06592967517232824,545,Due to a conflict of interest I recuse myself from our vote about the new branch.
1080,6,13,57,76,1.3289473684210527,0.07105263157894735,545,You think he's just going sit there and photosynthesize all day?
1080,6,13,57,76,1.3289473684210527,0.07105263157894735,545,You suck the oxygen out of the room!
1080,2,21,53,76,1.3289473684210527,0.0603735677458588,545,I take my job as branch manager seriously
1080,6,13,57,76,1.3289473684210527,0.07105263157894735,545,You guys are missing the forest for the tree.
1080,4,17,55,76,1.3289473684210527,0.06592967517232824,545,We are now officially a green company.
1080,2,21,53,76,1.3289473684210527,0.0603735677458588,545,So we went green. Now what?
1080,7,11,58,76,1.3289473684210527,0.07348029427864373,545,Hey Fern. what do you think about the apposing hedge fund.
1080,7,11,58,76,1.3289473684210527,0.07348029427864373,545,His retirement package includes composting
1080,4,17,55,76,1.3289473684210527,0.06592967517232824,545,I heard there were leeks in the department.
1080,3,19,54,76,1.3289473684210527,0.06321269552349637,545,"He's a bit green, isn't he?"
1080,4,17,55,76,1.3289473684210527,0.06592967517232824,545,It's part of our green initiative.
1080,5,15,56,76,1.3289473684210527,0.06853903458111421,545,Stop beating around the bush.
1080,5,15,56,76,1.3289473684210527,0.06853903458111421,545,"Now if you'll all turn to page 2 of your leaflet, we can begin."
1080,5,15,56,76,1.3289473684210527,0.06853903458111421,545,"20 years ago I was an an illegal plant, now I'm president"
1080,7,11,58,76,1.3289473684210527,0.07348029427864373,545,Who wants to tell Ivy that her attitude has poisoned this whole meeting?
1080,3,19,54,76,1.3289473684210527,0.06321269552349637,545,Don't let it see you eating a salad.
1080,5,15,56,76,1.3289473684210527,0.06853903458111421,545,I like it. The listening is about the same but it talks a lot less.
1080,4,17,55,76,1.3289473684210527,0.06592967517232824,545,"OK, ladies and gentlemen, here's how it works: I make the oxygen for you, you make the carbon dioxide for me. We're a team! We're Photosynthesis! Any questions?"
1080,2,21,53,76,1.3289473684210527,0.0603735677458588,545,His speech is rather flowery too.
1080,3,19,54,76,1.3289473684210527,0.06321269552349637,545,"First we grow the boss, then we grow the company."
1080,5,15,56,76,1.3289473684210527,0.06853903458111421,545,"Yes, he's a little green, but I think he's just the sort of leader this company needs."
1080,5,15,56,76,1.3289473684210527,0.06853903458111421,545,"The branch office had great things to say about her, but I don't think she'll bear fruit."
1080,5,15,56,76,1.3289473684210527,0.06853903458111421,545,I've called you all here to be my eyes and ears...and arms and brains. In fact just run it the way you want
1080,4,17,55,76,1.3289473684210527,0.06592967517232824,545,I got this job because of roots in the community.
1080,6,13,57,76,1.3289473684210527,0.07105263157894735,545,"Did I hear ""There will be growth in the spring!"" ?"
1080,3,19,54,76,1.3289473684210527,0.06321269552349637,545,Finally a meeting that bares fruit.
1080,4,17,55,76,1.3289473684210527,0.06592967517232824,545,We think he was sent here from the other company as a plant.
1080,6,13,57,76,1.3289473684210527,0.07105263157894735,545,Call our plant manager.
1080,5,15,56,76,1.3289473684210527,0.06853903458111421,545,"Unanimously agreed, we need a plant manager."
1080,5,15,56,76,1.3289473684210527,0.06853903458111421,545,"I'll say one thing, he sure has inspired growth!"
1080,5,15,56,76,1.3289473684210527,0.06853903458111421,545,"Transparency is fine, but I'll need indirect sunlight and bottled water too."
1080,6,13,57,76,1.3289473684210527,0.07105263157894735,545,The merger with Monsanto is now complete.
1080,7,11,58,76,1.3289473684210527,0.07348029427864373,545,Don't say too much- he might be a plant.
1080,5,15,56,76,1.3289473684210527,0.06853903458111421,545,"Thank you for switching sides, Gary. I prefer to be near the window."
1080,2,21,53,76,1.3289473684210527,0.0603735677458588,545,"Careful what you say, I suspect there's a plant among us."
1080,6,13,57,76,1.3289473684210527,0.07105263157894735,545,"First, I'd like to address the rumors that I'm having an inappropriate relationship with the orchid in the reception area."
1080,7,11,58,76,1.3289473684210527,0.07348029427864373,545,Let me introduce the new Plant Director.
1080,8,9,59,76,1.3289473684210527,0.07583027654082859,545,Let's talk growth.
1080,4,17,55,76,1.3289473684210527,0.06592967517232824,545,This wasn't what I had in mind when I heard we were meeting the new branch manager today.
1080,6,13,57,76,1.3289473684210527,0.07105263157894735,545,Ever since the company went green there seems to be a real lack of leadership.
1080,5,15,56,76,1.3289473684210527,0.06853903458111421,545,This won't be the first time a bush screwed up this company.
1080,6,13,57,76,1.3289473684210527,0.07105263157894735,545,who put miracle grow on the ashes?
1080,6,13,57,76,1.3289473684210527,0.07105263157894735,545,Growth this quarter has been disappointing.
1080,6,13,57,76,1.3289473684210527,0.07105263157894735,545,We need growth opportunities.
1080,3,19,54,76,1.3289473684210527,0.06321269552349637,545,The firm wants to branch out.
1080,7,11,58,76,1.3289473684210527,0.07348029427864373,545,Be careful what you say . She could be a plant .
1080,4,17,55,76,1.3289473684210527,0.06592967517232824,545,That Miracle Grow merger is going to be a top priority in 2017
1080,6,13,57,76,1.3289473684210527,0.07105263157894735,545,"Tell me this isn't their idea of an ""Ivy League"" partner!"
1080,3,19,54,76,1.3289473684210527,0.06321269552349637,545,"Well, we planted a seed. Now what?"
1080,7,11,58,76,1.3289473684210527,0.07348029427864373,545,Is that the new plant manager?
1080,4,17,55,76,1.3289473684210527,0.06592967517232824,545,Perhaps letting the internet choose our new CEO was a mistake.
1080,7,11,58,76,1.3289473684210527,0.07348029427864373,545,"Don't trust him, he's a plant."
1080,5,15,56,76,1.3289473684210527,0.06853903458111421,545,I'd like to see more foliage on casual Fridays.
1080,7,11,58,76,1.3289473684210527,0.07348029427864373,545,Bush replaces Trump at climate talks.
1080,5,15,56,76,1.3289473684210527,0.06853903458111421,545,Let's hear from the plant manager next.
1080,5,15,56,76,1.3289473684210527,0.06853903458111421,545,"Is it me, or does it feel like all the air was just sucked out of the room?"
1080,6,13,57,76,1.3289473684210527,0.07105263157894735,545,Is he saying grow the business or go back to our roots?
1080,5,15,56,76,1.3289473684210527,0.06853903458111421,545,Our latest projections call for growth in the spring.
1080,7,11,58,76,1.3289473684210527,0.07348029427864373,545,Donald Trump's newly formed cabinet learns where oxygen comes from
1080,4,17,55,76,1.3289473684210527,0.06592967517232824,545,Looks like we have another Bush leading us!
1080,5,15,56,76,1.3289473684210527,0.06853903458111421,545,All in favor of smoking the Chairman...
1080,4,17,55,76,1.3289473684210527,0.06592967517232824,545,"Obviously, seniority counts more than performance around here."
1080,10,5,61,76,1.3289473684210527,0.08032425054878166,545,Didn't you ask for a new Plant Manager?
1080,6,13,57,76,1.3289473684210527,0.07105263157894735,545,"We wanted to see the fiscal plan, not the ficus plant."
1080,4,17,55,76,1.3289473684210527,0.06592967517232824,545,I think we've found the plant - now where's the mole?
1080,3,19,54,76,1.3289473684210527,0.06321269552349637,545,I love working for the power plant.
1080,5,15,56,76,1.3289473684210527,0.06853903458111421,545,I knew she dyed her roots.
1080,4,17,55,76,1.3289473684210527,0.06592967517232824,545,"No, YOU tell him he has aphids."
1080,6,13,57,76,1.3289473684210527,0.07105263157894735,545,It was this or a woman as President.
1080,7,11,58,76,1.3289473684210527,0.07348029427864373,545,"When you said the CEO was a potted plant, I thought you just meant he was useless."
1080,5,15,56,76,1.3289473684210527,0.06853903458111421,545,When the company hired a new 'Plant Manager' I had a somewhat different expectation.
1080,6,13,57,76,1.3289473684210527,0.07105263157894735,545,We'd like to congratulate you on your growth this quarter.
1080,3,19,54,76,1.3289473684210527,0.06321269552349637,545,This quarter will be all about organic growth.
1080,5,15,56,76,1.3289473684210527,0.06853903458111421,545,We've been had! He was a plant all along.
1080,6,13,57,76,1.3289473684210527,0.07105263157894735,545,"Well, we elected him."
1080,5,15,56,76,1.3289473684210527,0.06853903458111421,545,The new plant manager looks a bit green.
1168,2,21,54,77,1.3246753246753247,0.05973728780981787,545,We need to start thinking outside the pot.
1168,5,15,57,77,1.3246753246753247,0.06777782863036942,545,"Now that I have the window office,..."
1168,6,13,58,77,1.3246753246753247,0.07025380810679205,545,I've decided to move the plant overseas.
1168,5,15,57,77,1.3246753246753247,0.06777782863036942,545,"I think it's called an office plant, not a corporate spy."
1168,5,15,57,77,1.3246753246753247,0.06777782863036942,545,So further plant closures are off the table?
1168,9,7,61,77,1.3246753246753247,0.07720678760627636,545,Our plant expansion plan has been a great success!
1168,5,15,57,77,1.3246753246753247,0.06777782863036942,545,We won't see any growth without a rainmaker.
1168,5,15,57,77,1.3246753246753247,0.06777782863036942,545,We brought you here to talk about your Ficus score.
1168,5,15,57,77,1.3246753246753247,0.06777782863036942,545,It re-creates the oxygen we suck out of the room.
1168,6,13,58,77,1.3246753246753247,0.07025380810679205,545,"Apparently, it promised to make our company great again."
1168,4,17,56,77,1.3246753246753247,0.06520790254401293,545,Which one of you voted for the plant closing?
1168,8,9,60,77,1.3246753246753247,0.07496082011839542,545,"And to think, all the other women in her family are houseplants."
1168,5,15,57,77,1.3246753246753247,0.06777782863036942,545,I'd say the paradigm on the greenhouse effect has shifted.
1168,4,17,56,77,1.3246753246753247,0.06520790254401293,545,Let's stop beating around the bush
1182,5,15,58,78,1.3205128205128205,0.0670326030971889,545,This new CEO is all about growth.
1183,8,8,59,75,1.32,0.07631135841684003,545,Ladies and gentlemen... I have reason to believe one of us is a plant.
1183,8,8,59,75,1.32,0.07631135841684003,545,His father is a money tree
1183,4,16,55,75,1.32,0.06619654055902001,545,"If I ""grew where I was planted"" I never would have come this far."
1183,7,10,58,75,1.32,0.07391253657576001,545,I understand I have a nickname. Would anyone here like to share it?
1183,5,14,56,75,1.32,0.06886466686438221,545,You did say anything but Trump!
1183,7,10,58,75,1.32,0.07391253657576001,545,I'm replacing all of you with palm trees except for Ferguson. His replacement will be a Spineless Yucca.
1183,5,14,56,75,1.32,0.06886466686438221,545,"As you're new CEO, I'm pleased to announce that we're changing our focus from Artificial Intelligence to mulch and Easter lilies."
1183,6,12,57,75,1.32,0.07143320448294828,545,So all this time I've been turning carbon dioxide into oxygen...what in the world have you all been doing??!
1183,6,12,57,75,1.32,0.07143320448294828,545,"It's definitely getting taller, but I don't see any money growing on it yet."
1183,7,10,58,75,1.32,0.07391253657576001,545,I think it's safe to assume we're facing a public relations challenge.
1183,5,14,56,75,1.32,0.06886466686438221,545,Who's the new Plant Manager?
1183,7,10,58,75,1.32,0.07391253657576001,545,Now the LSD has taken effect; let's start from scratch with the meeting.
1183,7,10,58,75,1.32,0.07391253657576001,545,I suppose he thinks he can run for President now too..
1183,4,16,55,75,1.32,0.06619654055902001,545,Who's got dirt?
1183,5,14,56,75,1.32,0.06886466686438221,545,Perennial numbers are looking great guys!
1183,4,16,55,75,1.32,0.06619654055902001,545,Too bad the old man didn’t have a wife or kids to leave his estate to.
1183,5,14,56,75,1.32,0.06886466686438221,545,"If God could appear as a burning bush, so can I. Who has a lighter?"
1183,4,16,55,75,1.32,0.06619654055902001,545,Isn't anyone going to offer me some water?
1183,9,6,60,75,1.32,0.07863703824397116,545,Are you sure the electoral college was the best way to choose a leader ?
1183,3,18,54,75,1.32,0.06341625676135118,545,Our projections show that we will continue to grow.
1183,5,14,56,75,1.32,0.06886466686438221,545,I hate long meetings. He was a sapling when we sat down.
1183,4,16,55,75,1.32,0.06619654055902001,545,She's from a different branch.
1183,9,6,60,75,1.32,0.07863703824397116,545,"First off, no more paper!"
1183,2,20,53,75,1.32,0.06050835695390563,545,"""Shhh…it could be a plant."
1183,3,18,54,75,1.32,0.06341625676135118,545,From now on we're going to think inside the pot.
1183,7,10,58,75,1.32,0.07391253657576001,545,"I don't care if the new guy is a transplant from North Carolina, I don't want him in the bathroom when I'm in there."
1209,4,16,56,76,1.3157894736842106,0.06545529160062329,545,My roots are deep in this company
1210,7,9,57,73,1.3150684931506849,0.07523861668166248,545,"As we enter into a new presidential term, we meet to say goodbye to our friend, the environment."
1210,5,13,55,73,1.3150684931506849,0.06999867450573467,545,Anybody need some water?
1210,5,13,55,73,1.3150684931506849,0.06999867450573467,545,You're ferned!
1210,5,13,55,73,1.3150684931506849,0.06999867450573467,545,The chairmanship is an annual position.
1210,2,19,52,73,1.3150684931506849,0.06130466475843632,545,"Cannabis, we want you to head up our west-coast operations"
1210,6,11,56,73,1.3150684931506849,0.0726658925243815,545,You'll have to use the transplant bathroom.
1210,6,11,56,73,1.3150684931506849,0.0726658925243815,545,It's just while he's in the White House.
1210,8,7,58,73,1.3150684931506849,0.07772623073310139,545,Talk to me.
1210,4,15,54,73,1.3150684931506849,0.06722571627550439,545,Perhaps just take some time to let the idea grow.
1210,5,13,55,73,1.3150684931506849,0.06999867450573467,545,I think you'll all agree that we've seen tremendous growth this year.
1210,9,5,59,73,1.3150684931506849,0.08013666107207418,545,I'm so glad I can finally come out of the closet . . . Pot is legal!
1210,4,15,54,73,1.3150684931506849,0.06722571627550439,545,I believe someone on this board is a plant.
1210,6,11,56,73,1.3150684931506849,0.0726658925243815,545,Photosynthesis is the new synergy.
1210,5,13,55,73,1.3150684931506849,0.06999867450573467,545,I heard the new CEO was hired to turn over a new leaf.
1210,5,13,55,73,1.3150684931506849,0.06999867450573467,545,Roger—get me a glass of water. You people are killing me.
1210,5,13,55,73,1.3150684931506849,0.06999867450573467,545,That's not the Pot we voted for!
1210,5,13,55,73,1.3150684931506849,0.06999867450573467,545,It's time we turn over a new leaf.
1210,2,19,52,73,1.3150684931506849,0.06130466475843632,545,Does this pot make me look fat?
1210,6,11,56,73,1.3150684931506849,0.0726658925243815,545,"Alright folks, we're going to limit this meeting to 1-2 hours of direct sunlight"
1210,8,7,58,73,1.3150684931506849,0.07772623073310139,545,"So, does this mean we finally have to take climate change seriously?"
1210,3,17,53,73,1.3150684931506849,0.06433334613518435,545,His effectiveness lies in his ability to photosynthesize.
1210,4,15,54,73,1.3150684931506849,0.06722571627550439,545,At the top of our agenda today is the sale of our chainsaw division.
1210,5,13,55,73,1.3150684931506849,0.06999867450573467,545,Now even our meetings have to be carbon-neutral.
1210,2,19,52,73,1.3150684931506849,0.06130466475843632,545,It's about the only thing growing in this company.
1210,7,9,57,73,1.3150684931506849,0.07523861668166248,545,He's always potted after lunch.
1210,7,9,57,73,1.3150684931506849,0.07523861668166248,545,"A lot of dirt, but the winner nonetheless."
1210,6,11,56,73,1.3150684931506849,0.0726658925243815,545,"It didn't take much to make the new CEO happy--water, sunlight and bull sh*t at Board meetings."
1210,5,13,55,73,1.3150684931506849,0.06999867450573467,545,A-fern-ative Action
1210,5,13,55,73,1.3150684931506849,0.06999867450573467,545,CEOregeno
1210,4,15,54,73,1.3150684931506849,0.06722571627550439,545,"""I appreciate your perennial loyalty""."
1210,4,15,54,73,1.3150684931506849,0.06722571627550439,545,The only way the competition could have gotten that kind of information on our next move is if one of you is a plant.
1210,2,19,52,73,1.3150684931506849,0.06130466475843632,545,"This one's much easier to work with, but there will be leaks."
1210,3,17,53,73,1.3150684931506849,0.06433334613518435,545,Someone put a little too much fertilizer on this morning.
1210,5,13,55,73,1.3150684931506849,0.06999867450573467,545,Thanks to your collective denial of global warming I will be taking over now.
1210,4,15,54,73,1.3150684931506849,0.06722571627550439,545,Nice to meet you all. Please call me Bud.
1210,2,19,52,73,1.3150684931506849,0.06130466475843632,545,He's an expert on workplace biodiversity.
1210,5,13,55,73,1.3150684931506849,0.06999867450573467,545,The search for diversity is officially over.
1210,6,11,56,73,1.3150684931506849,0.0726658925243815,545,Can we get you something? Water?
1210,5,13,55,73,1.3150684931506849,0.06999867450573467,545,"Bob, lovin' the new pot!"
1210,5,13,55,73,1.3150684931506849,0.06999867450573467,545,I heard he used to be a nut.
1210,7,9,57,73,1.3150684931506849,0.07523861668166248,545,"Oh no, here comes the 'organic growth' speech again."
1210,5,13,55,73,1.3150684931506849,0.06999867450573467,545,I suspect everyone got the memo about the new green initiative.
1210,5,13,55,73,1.3150684931506849,0.06999867450573467,545,"Higgens, what are the third quarter numbers on our plant in Michigan?"
1210,4,15,54,73,1.3150684931506849,0.06722571627550439,545,Our global warming initiative has eliminated the CEO's carbon footprint completely
1210,5,13,55,73,1.3150684931506849,0.06999867450573467,545,"""Don't irritate him. Irrigate him""."
1210,3,17,53,73,1.3150684931506849,0.06433334613518435,545,Well... better than artificial intelligence.
1210,5,13,55,73,1.3150684931506849,0.06999867450573467,545,Watch what you say. Obviously it's a plant.
1210,2,19,52,73,1.3150684931506849,0.06130466475843632,545,We brought him in to help with our carbon footprint.
1210,4,15,54,73,1.3150684931506849,0.06722571627550439,545,Of course he likes you...you have a green thumb and a brown nose.
1210,5,13,55,73,1.3150684931506849,0.06999867450573467,545,I see they've decided to promote from within.
1210,3,17,53,73,1.3150684931506849,0.06433334613518435,545,This isn't the first time our plant manager tested positive for pot.
1210,5,13,55,73,1.3150684931506849,0.06999867450573467,545,Can we assume that you support the legalizatiion of marijuana?
1210,4,15,54,73,1.3150684931506849,0.06722571627550439,545,"With our new board member, no one can say we are not environmentaly conscious."
1263,5,13,56,74,1.3108108108108107,0.06917741592724358,545,I hope it's understood that I'M the only perennial here.
1263,6,11,57,74,1.3108108108108107,0.07180353836209209,545,Democrats everywhere started to dream of the good old days of Bush.
1263,2,19,53,74,1.3108108108108107,0.060620253492823066,545,The family tree is taking over.
1263,4,15,55,74,1.3108108108108107,0.0664475855650548,545,"But the upside is, I've never been charged with sexual assault."
1263,4,15,55,74,1.3108108108108107,0.0664475855650548,545,I'm afraid our plant manager is potted again.
1263,7,9,58,74,1.3108108108108107,0.07433694484078562,545,"After careful consideration, the Producers of The Apprentice have decided to employ a more intelligent host."
1263,4,15,55,74,1.3108108108108107,0.0664475855650548,545,"Well, surely I'm an improvement over the empty chair who led this company before me."
1270,4,15,56,75,1.3066666666666666,0.06568648806805485,545,"At the monthly board meeting, it became glaringly obvious that the company had gone to pot."
1271,4,14,54,72,1.3055555555555556,0.0674800407774118,545,"May I have a glass of water, please?"
1271,4,14,54,72,1.3055555555555556,0.0674800407774118,545,"Let's wrap this up, I've got to pick my seeds up from school."
1271,1,20,51,72,1.3055555555555556,0.05813645141504052,545,I never do well on these group job interviews.
1271,7,8,57,72,1.3055555555555556,0.07567869464723181,545,The stench of fresh fertilizer quickly filled the room with apprehension.
1271,3,16,53,72,1.3055555555555556,0.06451604138965669,545,Still not as boring as that HR presentation last week.
1271,6,10,56,72,1.3055555555555556,0.07304812466298974,545,Sometimes a plant is just a plant.
1271,2,18,52,72,1.3055555555555556,0.0614091466303077,545,It's a plant from the opposition.
1271,5,12,55,72,1.3055555555555556,0.07031921650623267,545,Good thing it's an annual.
1271,6,10,56,72,1.3055555555555556,0.07304812466298974,545,At their last meeting the board decided to grow the company organically.
1271,5,12,55,72,1.3055555555555556,0.07031921650623267,545,It's clouding over. Let's wrap this up.
1271,5,12,55,72,1.3055555555555556,0.07031921650623267,545,He's potted as usual!
1271,3,16,53,72,1.3055555555555556,0.06451604138965669,545,I still say the orchid was a more attractive candidate.
1271,4,14,54,72,1.3055555555555556,0.0674800407774118,545,"As the first order of business, show your thumbs."
1271,5,12,55,72,1.3055555555555556,0.07031921650623267,545,"I'm grateful for your support during this time of transition. It was not an easy decision, but the truth is I've never really identified as a conifer."
1271,4,14,54,72,1.3055555555555556,0.0674800407774118,545,"This isn't what I meant by ""organic growth""."
1271,2,18,52,72,1.3055555555555556,0.0614091466303077,545,This is not what we meant when we asked for plant expansion.
1271,5,12,55,72,1.3055555555555556,0.07031921650623267,545,He reminds me of that President we had a few years ago.
1271,6,10,56,72,1.3055555555555556,0.07304812466298974,545,"Yes sir, we know Tom is a vegetarian and we already fired him."
1271,5,12,55,72,1.3055555555555556,0.07031921650623267,545,"He says he's all about cost cutting, but he's never willing to close any branches."
1271,4,14,54,72,1.3055555555555556,0.0674800407774118,545,Apparently this year's strategic plan is all about organic growth
1271,1,20,51,72,1.3055555555555556,0.05813645141504052,545,"I vote ""yes"" for more carbon dioxide. How about the rest of you?"
1271,3,16,53,72,1.3055555555555556,0.06451604138965669,545,I think you can all see we aren't showing enough growth in the third quarter . . .
1271,6,10,56,72,1.3055555555555556,0.07304812466298974,545,"Who says I'm not GREEN?!?! I'm the GREENEST EVER!! I'm hugely GREEN!! There's no one GREENER than ME!! I'll make America GREEN again, believe me!! And, you are all FIRED."
1271,6,10,56,72,1.3055555555555556,0.07304812466298974,545,Not another think outside the boxwood meeting.
1271,6,10,56,72,1.3055555555555556,0.07304812466298974,545,And they said a write-in candidate could never become president.
1271,6,10,56,72,1.3055555555555556,0.07304812466298974,545,Allow me to introduce myself. My name is Mary Jane and I am your company’s new stress management consultant.
1271,4,14,54,72,1.3055555555555556,0.0674800407774118,545,Fourth quarter growth has slowed.
1271,6,10,56,72,1.3055555555555556,0.07304812466298974,545,"Could you explain again why going green is good for the company, Melvin?"
1271,5,12,55,72,1.3055555555555556,0.07031921650623267,545,What makes you think it’s carnivorous?
1271,4,14,54,72,1.3055555555555556,0.0674800407774118,545,"This quarter, I am focused on growth and saturation."
1271,3,16,53,72,1.3055555555555556,0.06451604138965669,545,This one is way too green to become a member of the board.
1271,3,16,53,72,1.3055555555555556,0.06451604138965669,545,"I said we need a rubber stamp, not a rubber plant."
1271,7,8,57,72,1.3055555555555556,0.07567869464723181,545,A stress management test in action to see who flips out first.
1271,4,14,54,72,1.3055555555555556,0.0674800407774118,545,You can suck all the oxygen out of the room.
1271,7,8,57,72,1.3055555555555556,0.07567869464723181,545,Let's just say she's grown on me.
1271,5,12,55,72,1.3055555555555556,0.07031921650623267,545,"That's Department of Agriculture, I would guess"
1271,8,6,58,72,1.3055555555555556,0.07822084843721792,545,It was either me or a woman.
1271,3,16,53,72,1.3055555555555556,0.06451604138965669,545,"I'm sure most of you are stunned that I was chosen as CEO. Frankly, so am I. But here we are. Hey, somebody get me a drink of water."
1271,3,16,53,72,1.3055555555555556,0.06451604138965669,545,No dead wood in this company
1271,5,12,55,72,1.3055555555555556,0.07031921650623267,545,We might be taking this green initiative a bit too far.
1271,6,10,56,72,1.3055555555555556,0.07304812466298974,545,Where's Fern?
1271,6,10,56,72,1.3055555555555556,0.07304812466298974,545,And I thought I was potted.
1271,5,12,55,72,1.3055555555555556,0.07031921650623267,545,"When I said ""we need a greener CEO"", I did not mean it quite so literally."
1271,5,12,55,72,1.3055555555555556,0.07031921650623267,545,I'm not sure we should be focused on growth until we're more firmly planted sir.
1271,8,6,58,72,1.3055555555555556,0.07822084843721792,545,It started with a reality tv show.
1271,4,14,54,72,1.3055555555555556,0.0674800407774118,545,He's not going anywhere. He's rooted in the business.
1271,4,14,54,72,1.3055555555555556,0.0674800407774118,545,Wow! 200% growth this quarter!
1271,6,10,56,72,1.3055555555555556,0.07304812466298974,545,I have a feeling someone in here is a plant.
1271,6,10,56,72,1.3055555555555556,0.07304812466298974,545,How about cannabis rex as a new product name?
1271,5,12,55,72,1.3055555555555556,0.07031921650623267,545,It all started with gluten free.
1271,7,8,57,72,1.3055555555555556,0.07567869464723181,545,"Greenhouse Effect, as if that's a bad thing."
1271,8,6,58,72,1.3055555555555556,0.07822084843721792,545,First I'd like to take a moment to thank my father for his years of service to this company as our table.
1271,6,10,56,72,1.3055555555555556,0.07304812466298974,545,I'm still more qualified for CEO than Trump is for President.
1271,5,12,55,72,1.3055555555555556,0.07031921650623267,545,"Photosynthesis, people! This isn't rocket science."
1271,6,10,56,72,1.3055555555555556,0.07304812466298974,545,"Ladies and gentlemen, we'll resume in seven minutes, after our water break."
1271,5,12,55,72,1.3055555555555556,0.07031921650623267,545,Good news. Looks like the new plant is doing well.
1271,7,8,57,72,1.3055555555555556,0.07567869464723181,545,Jill Stein's first cabinet meeting.
1271,2,18,52,72,1.3055555555555556,0.0614091466303077,545,We should never have opened that branch office.
1271,4,14,54,72,1.3055555555555556,0.0674800407774118,545,"Mr. Morganenthau, who had held the majority of our Class A stock prior to his death, apparently was somewhat whimsical in writing his will."
1271,4,14,54,72,1.3055555555555556,0.0674800407774118,545,"Is it my understanding, you want us to deck the halls with boughs of holly?"
1331,4,14,55,73,1.3013698630136987,0.06668073911648509,545,I have a feeling we will have to nip this problem in the bud.
1331,5,12,56,73,1.3013698630136987,0.06947545230457963,545,"After 15 years, the board finally found a CEO in favor of anti-pollution laws."
1331,6,10,57,73,1.3013698630136987,0.07216201200584069,545,Rumor has it he gave our previous CEO a fungus.
1334,3,15,53,71,1.295774647887324,0.06467490657213137,545,We need a little bit more biodiversity in this office.
1334,3,15,53,71,1.295774647887324,0.06467490657213137,545,Our poison pill didn't discourage the takeover so we're gonna try a poison oak.
1334,6,9,56,71,1.295774647887324,0.07341721188439745,545,At least it's a step from Trump.
1334,6,9,56,71,1.295774647887324,0.07341721188439745,545,Is it cynical to think that his choice for Secretary of Global Warming may just be a token?
1334,6,9,56,71,1.295774647887324,0.07341721188439745,545,"From now on, the corporate office will answer to the plant."
1334,4,13,54,71,1.295774647887324,0.06771453335167756,545,Be careful what you say. It might be a plant.
1334,4,13,54,71,1.295774647887324,0.06771453335167756,545,It's come to the point where even I think we're better off with President Bush.
1334,4,13,54,71,1.295774647887324,0.06771453335167756,545,"Oh no, get ready for his latest discussion on climate change."
1334,5,11,55,71,1.295774647887324,0.07062345583414183,545,"Sorry Sir, no one on this board understands photosynthesis!"
1334,4,13,54,71,1.295774647887324,0.06771453335167756,545,"Back when the company was falling apart, he alone was deciduous enough to save it."
1334,4,13,54,71,1.295774647887324,0.06771453335167756,545,Be careful what you say I think there could be a plant.
1334,8,5,58,71,1.295774647887324,0.07870778852643218,545,I heard he's rootless.
1334,5,11,55,71,1.295774647887324,0.07062345583414183,545,I can't believe our CEO was supplanted.
1334,5,11,55,71,1.295774647887324,0.07062345583414183,545,He looks thirsty
1334,5,11,55,71,1.295774647887324,0.07062345583414183,545,Are we all potted or did I just see that leaf talk?
1334,5,11,55,71,1.295774647887324,0.07062345583414183,545,"No, this is not an environmental take-over; I'm just as plastic as you."
1334,5,11,55,71,1.295774647887324,0.07062345583414183,545,Now lets hear the media say we are not serious about our green agenda
1334,3,15,53,71,1.295774647887324,0.06467490657213137,545,Cancel the salad lunch.
1334,3,15,53,71,1.295774647887324,0.06467490657213137,545,Here comes another lecture about organic growth.
1334,6,9,56,71,1.295774647887324,0.07341721188439745,545,His top priority is going paperless.
1334,5,11,55,71,1.295774647887324,0.07062345583414183,545,Does the new plant manager seems green?
1334,4,13,54,71,1.295774647887324,0.06771453335167756,545,"We get it, you're vegan."
1334,2,17,52,71,1.295774647887324,0.06148519377209763,545,"Sadly, he's a perennial."
1334,4,13,54,71,1.295774647887324,0.06771453335167756,545,"He doesn't have much experience, but his potential for growth is amazing..."
1334,4,13,54,71,1.295774647887324,0.06771453335167756,545,What happened to the horse's ass?
1334,5,11,55,71,1.295774647887324,0.07062345583414183,545,I didn't realize we had literally elected a potted plant.
1334,7,7,57,71,1.295774647887324,0.07610848499214815,545,"To start, let's congratulate ourselves on adoption of the new radical diversity policy."
1334,4,13,54,71,1.295774647887324,0.06771453335167756,545,You are to use me for medicinal purposes only.
1334,5,11,55,71,1.295774647887324,0.07062345583414183,545,As of today there will be no vegetarian options in the cafeteria.
1334,4,13,54,71,1.295774647887324,0.06771453335167756,545,"You'll get used to it. In my last panel, the CEO was a goldfish."
1334,5,11,55,71,1.295774647887324,0.07062345583414183,545,"Unlike my predecessor, I'm not a fern, so there are going to be some major changes."
1334,4,13,54,71,1.295774647887324,0.06771453335167756,545,I'm still shocked we voted him in.
1334,5,11,55,71,1.295774647887324,0.07062345583414183,545,I'm afraid Seymour will not be joining us today...
1334,6,9,56,71,1.295774647887324,0.07341721188439745,545,"In his dream, Fred was Chairman of the Board. But when he awoke, he was still a potted plant."
1334,3,15,53,71,1.295774647887324,0.06467490657213137,545,"Organic, sustainable, local, plus it screams diversity of our board!"
1334,4,13,54,71,1.295774647887324,0.06771453335167756,545,…and there's no truth to the rumor that I'm a plant from corporate HQ.
1334,5,11,55,71,1.295774647887324,0.07062345583414183,545,Donald couldn't make it so we found something similar.
1334,4,13,54,71,1.295774647887324,0.06771453335167756,545,"I know some of you were passed over for the position of Plant Manager. I assure you, I am uniquely qualified."
1334,4,13,54,71,1.295774647887324,0.06771453335167756,545,He seems taller since the last board meeting. Maybe photosynthesis is real.
1334,7,7,57,71,1.295774647887324,0.07610848499214815,545,"A show of hands, please, from those of you who have read The Secret Life of Plants."
1334,5,11,55,71,1.295774647887324,0.07062345583414183,545,All in favor of photosynthesis...say aye.
1334,4,13,54,71,1.295774647887324,0.06771453335167756,545,Looks like the boss is potted again.
1334,2,17,52,71,1.295774647887324,0.06148519377209763,545,Congratulate me. I'm legal now.
1334,5,11,55,71,1.295774647887324,0.07062345583414183,545,"he didn't just say ""leaf it to me"" did he?"
1334,6,9,56,71,1.295774647887324,0.07341721188439745,545,The decision we need today is should we shut down the plant.
1334,4,13,54,71,1.295774647887324,0.06771453335167756,545,Our CEO is a GMO.
1334,4,13,54,71,1.295774647887324,0.06771453335167756,545,Next on the agenda is the low level of carbon dioxide in the office
1334,3,15,53,71,1.295774647887324,0.06467490657213137,545,He's growing into the job.
1334,6,9,56,71,1.295774647887324,0.07341721188439745,545,"None of that ""Mr. Settia"" formality. In this room, you can call me Poin."
1334,8,5,58,71,1.295774647887324,0.07870778852643218,545,"First, I am really tired of you all sucking the air out the room."
1334,4,13,54,71,1.295774647887324,0.06771453335167756,545,So I'm going to buy the farm. Best of luck to you all.
1334,2,17,52,71,1.295774647887324,0.06148519377209763,545,Well this company went to pot fast!
1386,2,16,52,70,1.2857142857142858,0.061529360235218926,545,How did our competitor put a plant this high up in the company?
1386,2,16,52,70,1.2857142857142858,0.061529360235218926,545,But we already cut all the low hanging fruit.
1386,1,18,51,70,1.2857142857142858,0.05806706033550432,545,This company needs to get back to its roots.
1386,6,8,56,70,1.2857142857142858,0.07377111135633176,545,Let's not discuss our proprietary business here. I think there might be a plant in the room.
1386,4,12,54,70,1.2857142857142858,0.06792657448194941,545,When are we going to tell him that he wasn't picked to be the Rockefeller Center Christmas Tree?
1386,5,10,55,70,1.2857142857142858,0.07090908401467375,545,Can I get you some water before we start the interview?
1386,1,18,51,70,1.2857142857142858,0.05806706033550432,545,Do you think he'll mind if I leave early?
1386,3,14,53,70,1.2857142857142858,0.06480695059870954,545,"No, no, keep feeding me crap!"
1386,4,12,54,70,1.2857142857142858,0.06792657448194941,545,I hear he likes classical music.
1386,3,14,53,70,1.2857142857142858,0.06480695059870954,545,"So, it's ten to one we transplant the basil."
1386,3,14,53,70,1.2857142857142858,0.06480695059870954,545,Is no one going to offer me a cup of water?
1386,3,14,53,70,1.2857142857142858,0.06480695059870954,545,"As my first order as acting president, we are going completely green."
1386,7,6,57,70,1.2857142857142858,0.07652617555906306,545,Robert?
1386,3,14,53,70,1.2857142857142858,0.06480695059870954,545,Looks like it's a Russian plant
1386,6,8,56,70,1.2857142857142858,0.07377111135633176,545,I don't care if he is a plant. He's the best CEO we've ever had.
1386,3,14,53,70,1.2857142857142858,0.06480695059870954,545,"When we go to lunch, best not to order a salad."
1386,5,10,55,70,1.2857142857142858,0.07090908401467375,545,"You have to hand it to Chairman Smith. He said, 'Plant my ashes when I die and I'll be back.'"
1386,4,12,54,70,1.2857142857142858,0.06792657448194941,545,"I'm not sick, I'm deciduous."
1386,4,12,54,70,1.2857142857142858,0.06792657448194941,545,Don't let the graft fool you--he lost his top leaves years ago.
1386,6,8,56,70,1.2857142857142858,0.07377111135633176,545,Maybe we should have voted for Hillary.
1386,4,12,54,70,1.2857142857142858,0.06792657448194941,545,This is one Bush I can work with.
1386,3,14,53,70,1.2857142857142858,0.06480695059870954,545,I told you that this company was going to pot.
1386,2,16,52,70,1.2857142857142858,0.061529360235218926,545,"Like you, our company has many branches............"
1386,6,8,56,70,1.2857142857142858,0.07377111135633176,545,The election changed everything
1386,3,14,53,70,1.2857142857142858,0.06480695059870954,545,It's about all those plants we've been closing.
1386,5,10,55,70,1.2857142857142858,0.07090908401467375,545,"Whoops, it looks like the boss soiled himself again."
1386,4,12,54,70,1.2857142857142858,0.06792657448194941,545,He said he was taking the company green!
1386,4,12,54,70,1.2857142857142858,0.06792657448194941,545,When the board voted to go green I'll bet you didn't expect this.
1386,3,14,53,70,1.2857142857142858,0.06480695059870954,545,"No worries. I'm just ""medicinal"""
1386,3,14,53,70,1.2857142857142858,0.06480695059870954,545,Let's go over our growth plan.
1386,4,12,54,70,1.2857142857142858,0.06792657448194941,545,This may be taking 'diversity' too far.
1386,4,12,54,70,1.2857142857142858,0.06792657448194941,545,Our new CEO doesn't have one bloomin' idea.
1386,3,14,53,70,1.2857142857142858,0.06480695059870954,545,"Here comes the 'more water, more sunshine' speech."
1386,1,18,51,70,1.2857142857142858,0.05806706033550432,545,I'm glad we finally have someone with roots in this company.
1386,3,14,53,70,1.2857142857142858,0.06480695059870954,545,This branch is underperforming.
1386,2,16,52,70,1.2857142857142858,0.061529360235218926,545,"So, which one of you banned Miracle Grow on the company drug test list?"
1386,2,16,52,70,1.2857142857142858,0.061529360235218926,545,You told me to find a diversity hire that wouldn't upset the rest of the Board.
1386,7,6,57,70,1.2857142857142858,0.07652617555906306,545,"Let me be the first one to say that your leaves look particularly shiny today, Sir."
1386,2,16,52,70,1.2857142857142858,0.061529360235218926,545,Somebody get me a glass of water.
1386,4,12,54,70,1.2857142857142858,0.06792657448194941,545,His bark is worse than his bite.
1386,4,12,54,70,1.2857142857142858,0.06792657448194941,545,This wasn't what I had in mind when they said we needed organic growth.
1386,3,14,53,70,1.2857142857142858,0.06480695059870954,545,"I know what you're all thinking and no, I'm not THAT Robert Plant."
1386,1,18,51,70,1.2857142857142858,0.05806706033550432,545,I'm turning over a new leaf.
1386,4,12,54,70,1.2857142857142858,0.06792657448194941,545,I've gathered you all here to dispel any rumors of the plant closing.
1386,4,12,54,70,1.2857142857142858,0.06792657448194941,545,The Green Party has taken over.
1386,5,10,55,70,1.2857142857142858,0.07090908401467375,545,"When they said ""a Bush"" was taking over, this not what I had in mind."
1386,4,12,54,70,1.2857142857142858,0.06792657448194941,545,There's definitely some room for growth here.
1386,3,14,53,70,1.2857142857142858,0.06480695059870954,545,"Careful what you say around this guy, I hear he's a plant."
1386,4,12,54,70,1.2857142857142858,0.06792657448194941,545,I've never seen him wilt like that.
1386,5,10,55,70,1.2857142857142858,0.07090908401467375,545,Donald can't be with us today.
1386,1,18,51,70,1.2857142857142858,0.05806706033550432,545,The Board thinks he'll be a breath of fresh air.
1386,4,12,54,70,1.2857142857142858,0.06792657448194941,545,Can we get you a glass of water?
1386,2,16,52,70,1.2857142857142858,0.061529360235218926,545,Next I have people coming in for a photosynthesis op.
1386,6,8,56,70,1.2857142857142858,0.07377111135633176,545,I know many of you think I'm a secret agent but I'm just a plant!
1386,4,12,54,70,1.2857142857142858,0.06792657448194941,545,"Lettuce begin, shall we?"
1386,5,10,55,70,1.2857142857142858,0.07090908401467375,545,The consultants said this company could be run by a potted plant.
1386,4,12,54,70,1.2857142857142858,0.06792657448194941,545,Not much of a personality but a leader in his field.
1386,3,14,53,70,1.2857142857142858,0.06480695059870954,545,Next on the agenda: Paid Family Leaf
1386,5,10,55,70,1.2857142857142858,0.07090908401467375,545,I called the meeting for two reasons. Reincarnation is possible and I'm going to need watering.
1386,4,12,54,70,1.2857142857142858,0.06792657448194941,545,Management wasn't kidding when they put out that memo about going green.
1386,6,8,56,70,1.2857142857142858,0.07377111135633176,545,Let's put this hosta takeover behind us.
1386,5,10,55,70,1.2857142857142858,0.07090908401467375,545,"Harold, you son of a beech."
1386,3,14,53,70,1.2857142857142858,0.06480695059870954,545,This isn't what I pictured when I heard we were 'going green.'
1386,5,10,55,70,1.2857142857142858,0.07090908401467375,545,"Board diversity I get, but biodiversity?"
1386,5,10,55,70,1.2857142857142858,0.07090908401467375,545,"You are right, our CEO does have the IQ of a house plant."
1386,5,10,55,70,1.2857142857142858,0.07090908401467375,545,Our new CEO is growing on me.
1386,1,18,51,70,1.2857142857142858,0.05806706033550432,545,I doubt he's ever gonna make a motion....
1386,4,12,54,70,1.2857142857142858,0.06792657448194941,545,That little GMO experiment may have backfired.
1386,5,10,55,70,1.2857142857142858,0.07090908401467375,545,Did our CEO last say he was leaving or leafing?
1386,5,10,55,70,1.2857142857142858,0.07090908401467375,545,"All in favor of legalized pot, say aye."
1386,2,16,52,70,1.2857142857142858,0.061529360235218926,545,I want you all to know I'm resigning as CEO to become the nominee of the Green Party.
1386,1,18,51,70,1.2857142857142858,0.05806706033550432,545,Our start-up has advanced past the seed funding stage.
1386,5,10,55,70,1.2857142857142858,0.07090908401467375,545,I think he's trying to ficus.
1386,3,14,53,70,1.2857142857142858,0.06480695059870954,545,"I just want to say one word to you: ""fertilizer""."
1386,5,10,55,70,1.2857142857142858,0.07090908401467375,545,Isn't he supposed to be at the perennial general meeting?
1386,6,8,56,70,1.2857142857142858,0.07377111135633176,545,MAKE THE SOIL GREAT AGAIN!
1386,5,10,55,70,1.2857142857142858,0.07090908401467375,545,I've been asked to serve in Trump's cabinet.
1386,5,10,55,70,1.2857142857142858,0.07090908401467375,545,"As the first trans plant CEO, we have made history by shattering the grass ceiling."
1386,4,12,54,70,1.2857142857142858,0.06792657448194941,545,I knew becoming a strict vegan wasn't a good idea for him.
1386,6,8,56,70,1.2857142857142858,0.07377111135633176,545,Makes sense to me. A plant running a plant.
1386,2,16,52,70,1.2857142857142858,0.061529360235218926,545,The key to growing this company is switching to solar panels. Trust me.
1386,6,8,56,70,1.2857142857142858,0.07377111135633176,545,'The Little Board Meeting of Horrors'
1386,3,14,53,70,1.2857142857142858,0.06480695059870954,545,"All those in favor my new watering schedule, please say aye."
1386,4,12,54,70,1.2857142857142858,0.06792657448194941,545,I think the Chair wants us to branch out
1386,3,14,53,70,1.2857142857142858,0.06480695059870954,545,Whose turn is it to water him?
1386,5,10,55,70,1.2857142857142858,0.07090908401467375,545,"With water and sunlight, there's nothing we can't do."
1386,7,6,57,70,1.2857142857142858,0.07652617555906306,545,"As usual, Mr. Evergreen will open and close the meeting with a silent prayer."
1386,4,12,54,70,1.2857142857142858,0.06792657448194941,545,Did we merge with Monsanto?
1386,5,10,55,70,1.2857142857142858,0.07090908401467375,545,"After eight hours of deliberations, Ned volunteered to take home the president, keep him away from direct sunlight and keep the soil slightly moist."
1386,5,10,55,70,1.2857142857142858,0.07090908401467375,545,I don't understand why they refuse to hire a perennial.
1386,7,6,57,70,1.2857142857142858,0.07652617555906306,545,I'm sure you're all surprised that I was elected president.
1386,1,18,51,70,1.2857142857142858,0.05806706033550432,545,"I know it's weird, but the new chairman sort of grows on you."
1386,6,8,56,70,1.2857142857142858,0.07377111135633176,545,Watch what you say. It may be a plant.
1386,3,14,53,70,1.2857142857142858,0.06480695059870954,545,We've entered a period of slow growth.
1386,2,16,52,70,1.2857142857142858,0.061529360235218926,545,I think the company is taking this whole 'green initiative' a bit far.
1386,5,10,55,70,1.2857142857142858,0.07090908401467375,545,The Board thought we needed more biodiversity.
1386,3,14,53,70,1.2857142857142858,0.06480695059870954,545,"We're falling into the red now, but if we can make it to the spring, we'll be back in the green."
1386,5,10,55,70,1.2857142857142858,0.07090908401467375,545,The smart strategy is to diversify our hedge funds.
1386,3,14,53,70,1.2857142857142858,0.06480695059870954,545,Twenty years ago today I started working here as a wall flower.
1386,5,10,55,70,1.2857142857142858,0.07090908401467375,545,I'm here because Lisa was sucking all the oxygen out of these meetings.
1386,5,10,55,70,1.2857142857142858,0.07090908401467375,545,Still makes a better president than Donald Trump
1386,7,6,57,70,1.2857142857142858,0.07652617555906306,545,"I don't know if it was the board or some other company behind this, but I have strong suspicions that one of us is a plant."
1386,3,14,53,70,1.2857142857142858,0.06480695059870954,545,He's growing into the job.
1386,6,8,56,70,1.2857142857142858,0.07377111135633176,545,I notice only Miller and Harrison thought to water me.
1386,3,14,53,70,1.2857142857142858,0.06480695059870954,545,Please tell me I don't have salad stuck in my teeth.
1386,5,10,55,70,1.2857142857142858,0.07090908401467375,545,I see tremendous growth potential.
1386,3,14,53,70,1.2857142857142858,0.06480695059870954,545,"First up on today's agenda, who's going to water me."
1386,5,10,55,70,1.2857142857142858,0.07090908401467375,545,It looks like the Chairman took that seed money we approved last quarter quite literally.
1386,4,12,54,70,1.2857142857142858,0.06792657448194941,545,The board agrees that because of rapid growth it's time to re-pot the CEO.
1386,2,16,52,70,1.2857142857142858,0.061529360235218926,545,At least it will be better to have a climber instead of a groper.
1386,3,14,53,70,1.2857142857142858,0.06480695059870954,545,Big deal! I remember when he was just a shrub
1386,4,12,54,70,1.2857142857142858,0.06792657448194941,545,"What date should we choose for ""bring your seedling to work"" day?"
1386,4,12,54,70,1.2857142857142858,0.06792657448194941,545,"As we feared, there's a plant in the board room."
1386,3,14,53,70,1.2857142857142858,0.06480695059870954,545,Is somebody going to say something?
1386,6,8,56,70,1.2857142857142858,0.07377111135633176,545,Could someone please get us some water.
1501,6,8,57,71,1.2816901408450705,0.07283591048208461,545,"OK, meeting over. Let's get potted."
1501,4,12,55,71,1.2816901408450705,0.0670838347287272,545,Read my leaves.
1501,3,14,54,71,1.2816901408450705,0.0640142671206166,545,Our grassroots campaign is getting an upgrade.
1501,5,10,56,71,1.2816901408450705,0.07001896435132925,545,Are there any objections to our new indirect sunlight conference room?
1501,3,14,54,71,1.2816901408450705,0.0640142671206166,545,lets welcome our new plant manager
1506,5,9,54,68,1.2794117647058822,0.0721109896999828,545,It doesn't matter that I didn't win the popular vote.
1506,3,13,52,68,1.2794117647058822,0.06574216082516834,545,"All those in favor of opening another branch say ""aye."""
1506,4,11,53,68,1.2794117647058822,0.06900009617918414,545,"Believe me, we will make America bloom again."
1506,5,9,54,68,1.2794117647058822,0.0721109896999828,545,"We're concerned we might be overplaying our position in the ""Green"" economy."
1506,6,7,55,68,1.2794117647058822,0.07509311818193055,545,You can't see the forest for the CEO's.
1506,2,15,51,68,1.2794117647058822,0.06231412478072636,545,"And each of you will have to turn over a new leaf, so to speak"
1506,5,9,54,68,1.2794117647058822,0.0721109896999828,545,I hope one day I will not be the token plant manager.
1506,4,11,53,68,1.2794117647058822,0.06900009617918414,545,The good news is we are now the leading manufacture of paper. The bad news is my whole family has been wiped out.
1506,6,7,55,68,1.2794117647058822,0.07509311818193055,545,He would like us to just call him Robert.
1506,5,9,54,68,1.2794117647058822,0.0721109896999828,545,He started out as a summer acorn.
1506,2,15,51,68,1.2794117647058822,0.06231412478072636,545,Looks like we're going green.
1506,3,13,52,68,1.2794117647058822,0.06574216082516834,545,"Of course, we're all sorry to hear you're leaving."
1506,4,11,53,68,1.2794117647058822,0.06900009617918414,545,"He talks about STEM, then leaves."
1506,3,13,52,68,1.2794117647058822,0.06574216082516834,545,He was a bit of a wallflower in high school.
1506,4,11,53,68,1.2794117647058822,0.06900009617918414,545,"Once proposition 64 passes, we should all get acquainted with our new source of revenue."
1506,4,11,53,68,1.2794117647058822,0.06900009617918414,545,"""I hear he came up with a way to turn plain old water and sunlight into food. This is going to change everything."
1506,5,9,54,68,1.2794117647058822,0.0721109896999828,545,My bark is really worse than my bite
1506,4,11,53,68,1.2794117647058822,0.06900009617918414,545,I wouldn't trust her. She could be a plant from one of our competitors.
1506,4,11,53,68,1.2794117647058822,0.06900009617918414,545,Our aim should be to grow this company organically.
1506,4,11,53,68,1.2794117647058822,0.06900009617918414,545,He referred to my report as a leaflet.
1506,6,7,55,68,1.2794117647058822,0.07509311818193055,545,It's part of our new Green Initiative
1506,2,15,51,68,1.2794117647058822,0.06231412478072636,545,I think it's time we start questioning the horticulture of this office.
1506,2,15,51,68,1.2794117647058822,0.06231412478072636,545,"Ultimately, the new head of the spy agency turned out to be, indeed, a plant."
1506,4,11,53,68,1.2794117647058822,0.06900009617918414,545,We've called this special meeting to discuss conditions at the plant.
1506,5,9,54,68,1.2794117647058822,0.0721109896999828,545,The next move is a paperless office.
1506,4,11,53,68,1.2794117647058822,0.06900009617918414,545,It's weird being on the board of a power plant.
1506,7,5,56,68,1.2794117647058822,0.07796125936040126,545,Can we trust him? What if he's a plant?
1506,1,17,50,68,1.2794117647058822,0.05868618733921613,545,I told you we needed more than seed capital.
1506,2,15,51,68,1.2794117647058822,0.06231412478072636,545,The new branch manager is an off shoot from the hedge funds Dept I hear.
1506,4,11,53,68,1.2794117647058822,0.06900009617918414,545,"He's still only President-Elect, come January we'll plant him in the Rose Garden"
1506,4,11,53,68,1.2794117647058822,0.06900009617918414,545,Hey! Where's MY water?
1506,1,17,50,68,1.2794117647058822,0.05868618733921613,545,And now the good news: Arbor Day will be a day off for the staff next year.
1506,4,11,53,68,1.2794117647058822,0.06900009617918414,545,The vote was 10 to 1. Today's lunch would be catered by Saul's Deli rather than by indirect sunlight.
1506,3,13,52,68,1.2794117647058822,0.06574216082516834,545,I am looking forward to growing roots here.
1506,3,13,52,68,1.2794117647058822,0.06574216082516834,545,I'm not taking questions about that.
1506,4,11,53,68,1.2794117647058822,0.06900009617918414,545,First let me say that it's an honor to join the team as your plant manager.
1506,2,15,51,68,1.2794117647058822,0.06231412478072636,545,This should shut the environmentalists up.
1506,4,11,53,68,1.2794117647058822,0.06900009617918414,545,"Yes, it's time to turn over a new leaf."
1506,4,11,53,68,1.2794117647058822,0.06900009617918414,545,We're turning over a new leaf.
1506,3,13,52,68,1.2794117647058822,0.06574216082516834,545,"Well, it's better than a PowerPoint."
1506,3,13,52,68,1.2794117647058822,0.06574216082516834,545,What are your plans for growth this year?
1506,6,7,55,68,1.2794117647058822,0.07509311818193055,545,"Once upon a time, I was a wall flower. Now I'm the CEO!"
1506,4,11,53,68,1.2794117647058822,0.06900009617918414,545,I'd like to start with environmental policies.
1506,4,11,53,68,1.2794117647058822,0.06900009617918414,545,I thought we were all bringing pot.
1506,5,9,54,68,1.2794117647058822,0.0721109896999828,545,Do any of you know how to roll it?
1506,5,9,54,68,1.2794117647058822,0.0721109896999828,545,Ever notice that the chairman always finds the sunny side of things?
1506,3,13,52,68,1.2794117647058822,0.06574216082516834,545,I'm sure the chair speaks for all of us.
1506,3,13,52,68,1.2794117647058822,0.06574216082516834,545,I've called you here to discuss our leave policy.
1506,8,3,57,68,1.2794117647058822,0.08072756359406691,545,I'm sure you are wondering why I called this meeting.
1506,5,9,54,68,1.2794117647058822,0.0721109896999828,545,Looks like the boss is going to seed.
1506,6,7,55,68,1.2794117647058822,0.07509311818193055,545,"So, we did get rid of the deadwood."
1506,4,11,53,68,1.2794117647058822,0.06900009617918414,545,We've got to attract more seed money.
1506,4,11,53,68,1.2794117647058822,0.06900009617918414,545,"Somebody said a potted plant could do a better job than the boss. They may be right, we're all paying attention today."
1506,5,9,54,68,1.2794117647058822,0.0721109896999828,545,We're not leaving til I find out which one of called me a perennial
1506,3,13,52,68,1.2794117647058822,0.06574216082516834,545,I'm pleased to report that our organic growth initiatives have been successful
1506,4,11,53,68,1.2794117647058822,0.06900009617918414,545,"Sure, we've made strides, but where's the bio-diversity?"""
1506,4,11,53,68,1.2794117647058822,0.06900009617918414,545,He's going green.
1506,4,11,53,68,1.2794117647058822,0.06900009617918414,545,The board has decided to expand the plant.
1506,6,7,55,68,1.2794117647058822,0.07509311818193055,545,We asked for childcare that's free. Not a white chair and a tree.
1506,2,15,51,68,1.2794117647058822,0.06231412478072636,545,I say let the pruning begin.
1506,4,11,53,68,1.2794117647058822,0.06900009617918414,545,I'm told he's the new branch president .
1506,3,13,52,68,1.2794117647058822,0.06574216082516834,545,Truly a natural leader.
1506,6,7,55,68,1.2794117647058822,0.07509311818193055,545,I'm announcing my bid for the 2020 Republican nomination.
1506,3,13,52,68,1.2794117647058822,0.06574216082516834,545,This company has an important legacy. The table you are sitting around was once a piece of my father.
1506,5,9,54,68,1.2794117647058822,0.0721109896999828,545,Be careful. He has spies everywhere.
1506,4,11,53,68,1.2794117647058822,0.06900009617918414,545,He was a late bloomer
1506,5,9,54,68,1.2794117647058822,0.0721109896999828,545,Who assumed I didn't want a hard copy of the agenda?
1506,4,11,53,68,1.2794117647058822,0.06900009617918414,545,"He's really taking this ""going green"" thing seriously."
1506,5,9,54,68,1.2794117647058822,0.0721109896999828,545,'I meant we should buy a construction plant.'
1506,3,13,52,68,1.2794117647058822,0.06574216082516834,545,"Great, the Board of Directors brought in another green CEO."
1506,3,13,52,68,1.2794117647058822,0.06574216082516834,545,I heard he was elected the nominee of the Green Party.
1506,2,15,51,68,1.2794117647058822,0.06231412478072636,545,This is the guy behind the next Apple.
1506,3,13,52,68,1.2794117647058822,0.06574216082516834,545,If you don't mind. Let's start with a little water.
1506,4,11,53,68,1.2794117647058822,0.06900009617918414,545,"All in favor of a hosta take-over, say ""aye""."
1506,3,13,52,68,1.2794117647058822,0.06574216082516834,545,"Before we get started, it is important we all stay hydrated."
1506,4,11,53,68,1.2794117647058822,0.06900009617918414,545,The introduction of the new CEO literally sucked the oxygen out of the room.
1506,7,5,56,68,1.2794117647058822,0.07796125936040126,545, 
1506,6,7,55,68,1.2794117647058822,0.07509311818193055,545,He always said he wanted to be planted there forever
1506,5,9,54,68,1.2794117647058822,0.0721109896999828,545,"Screw HR, fire all the vegetarians."
1506,5,9,54,68,1.2794117647058822,0.0721109896999828,545,This is what happens when you don't vote.
1506,6,7,55,68,1.2794117647058822,0.07509311818193055,545,"We voted to go green, but this is ridiculous!"
1506,7,5,56,68,1.2794117647058822,0.07796125936040126,545,"Thank you for coming. So, I'm thinking of running in 2020..."
1506,2,15,51,68,1.2794117647058822,0.06231412478072636,545,We're in trouble. The new CEO is waaay too green.
1506,5,9,54,68,1.2794117647058822,0.0721109896999828,545,Relax. We're not the first failing bank to announce the opening of a new branch.
1506,2,15,51,68,1.2794117647058822,0.06231412478072636,545,He insists he's not a plant from outside.
1506,4,11,53,68,1.2794117647058822,0.06900009617918414,545,"Wow, we really ARE easily replaceable."
1506,2,15,51,68,1.2794117647058822,0.06231412478072636,545,"Since he took over, there's certainly been a lot of emphasis on growth."
1506,1,17,50,68,1.2794117647058822,0.05868618733921613,545,I need not remind anyone in this room how crucial this fourth quarter is. I'm going to need each and every one of you exhaling all the CO2 you can.
1506,4,11,53,68,1.2794117647058822,0.06900009617918414,545,"Plants create jobs, people. We need to build more plants."
1506,5,9,54,68,1.2794117647058822,0.0721109896999828,545,"A victim to the greenhouse glass ceiling, Kate watches as yet another of her office plants is promoted over her."
1506,5,9,54,68,1.2794117647058822,0.0721109896999828,545,I've always heard a potted plant could be president...I guess we are about to find out.
1506,4,11,53,68,1.2794117647058822,0.06900009617918414,545,Our company prides itself on its diversity.
1506,4,11,53,68,1.2794117647058822,0.06900009617918414,545,"Sir, the board has arranged for Security to water you over the holiday weekend."
1506,1,17,50,68,1.2794117647058822,0.05868618733921613,545,I told you we were going green.
1506,5,9,54,68,1.2794117647058822,0.0721109896999828,545,Where's the Plant Manager?
1506,2,15,51,68,1.2794117647058822,0.06231412478072636,545,"Secretary of Agriculture. Well, Trump did say he wanted to shake up Washington."
1506,5,9,54,68,1.2794117647058822,0.0721109896999828,545,Let's hope he grows in the job.
1506,5,9,54,68,1.2794117647058822,0.0721109896999828,545,Mr. Trump will be back in four years!
1506,4,11,53,68,1.2794117647058822,0.06900009617918414,545,"Don't worry, I hear He's an Industrial plant!"
1506,4,11,53,68,1.2794117647058822,0.06900009617918414,545,I told you the new boss would be a plant from headquarters.
1506,3,13,52,68,1.2794117647058822,0.06574216082516834,545,I think the new boss is a plant.
1506,4,11,53,68,1.2794117647058822,0.06900009617918414,545,I read his self-evaluation last night -- you'd think he was a tree!
1506,3,13,52,68,1.2794117647058822,0.06574216082516834,545,Be careful what you say. It might be a plant.
1506,4,11,53,68,1.2794117647058822,0.06900009617918414,545,"We haven't had any harassment issues, and the oxygen is a plus."
1506,2,15,51,68,1.2794117647058822,0.06231412478072636,545,Let's all give a warm welcome to our new plant manager.
1506,4,11,53,68,1.2794117647058822,0.06900009617918414,545,Bush Cabinet
1506,3,13,52,68,1.2794117647058822,0.06574216082516834,545,Is it rude to water him?
1506,4,11,53,68,1.2794117647058822,0.06900009617918414,545,I see they are taking an organic approach to leadership.
1506,2,15,51,68,1.2794117647058822,0.06231412478072636,545,I thought 'fern' was just a nickname.
1506,2,15,51,68,1.2794117647058822,0.06231412478072636,545,I realize some of you think I'm too green to lead this company.
1506,6,7,55,68,1.2794117647058822,0.07509311818193055,545,We’re branching out into stem cell research.
1506,6,7,55,68,1.2794117647058822,0.07509311818193055,545,"No, I'm Phil. My sister is Rhoda."
1506,4,11,53,68,1.2794117647058822,0.06900009617918414,545,Careful what you say. There is a plant on the board.
1506,5,9,54,68,1.2794117647058822,0.0721109896999828,545,"So far, he's the best CEO this company has ever had."
1506,4,11,53,68,1.2794117647058822,0.06900009617918414,545,We didn't get to where we are today without you guys getting you're hands dirty.
1506,3,13,52,68,1.2794117647058822,0.06574216082516834,545,I've been transferred to a branch office.
1506,4,11,53,68,1.2794117647058822,0.06900009617918414,545,It is great to see someone break through the grass ceiling.
1506,3,13,52,68,1.2794117647058822,0.06574216082516834,545,"If Trump can be president, I can be your CEO."
1506,5,9,54,68,1.2794117647058822,0.0721109896999828,545,Ever since he became President he's been sending this fern in his place.
1506,4,11,53,68,1.2794117647058822,0.06900009617918414,545,Does the Chairman look pot bound to you?
1506,3,13,52,68,1.2794117647058822,0.06574216082516834,545,Now to talk about growth in our branch office...
1506,1,17,50,68,1.2794117647058822,0.05868618733921613,545,He's really grown with the company.
1506,4,11,53,68,1.2794117647058822,0.06900009617918414,545,The Green Party examines why it only managed 2 percent of the popular vote
1506,4,11,53,68,1.2794117647058822,0.06900009617918414,545,"Welcome to the Cannabis, Inc think tank."
1506,5,9,54,68,1.2794117647058822,0.0721109896999828,545,He always did like a little pot!
1506,4,11,53,68,1.2794117647058822,0.06900009617918414,545,Fern's going to report on the new plant manager.
1506,2,15,51,68,1.2794117647058822,0.06231412478072636,545,Are we going to talk about STEM education again?
1633,5,10,57,72,1.2777777777777777,0.06915039466443099,545,"Well it has always been my ambition to join a law firm like Ficus, Philodendron & Fushia"
1634,5,9,55,69,1.2753623188405796,0.07117350883117408,545,"I've leafed through all of your recommendations; however, none of them address the roots of the problem."
1634,2,15,52,69,1.2753623188405796,0.06153776060943875,545,It's time for us to go dormant until the spring quarter
1634,3,13,53,69,1.2753623188405796,0.0649088086497521,545,His opinions will grow on you.
1637,4,11,55,70,1.2714285714285714,0.06724827634518965,545,"We don't need to whisper, I don't think it can hear us."
1638,5,8,54,67,1.2686567164179106,0.07237675171740394,545,First time running the meeting without the plant supervisor.
1638,3,12,52,67,1.2686567164179106,0.0658318017406144,545,Why did the drinking fountain step down?
1638,2,14,51,67,1.2686567164179106,0.06230202312960611,545,"Uproot yourselves, and think outside of the pot."
1638,4,10,53,67,1.2686567164179106,0.06918171835672447,545,The day marijuana became legal in New York .
1638,4,10,53,67,1.2686567164179106,0.06918171835672447,545,The new chair of the Climate Change Committee was rumored to have real roots in phytology.
1638,3,12,52,67,1.2686567164179106,0.0658318017406144,545,"I don't think this is what he meant by ""invest in a rubber plant""."
1638,2,14,51,67,1.2686567164179106,0.06230202312960611,545,The complaint has been duly noted: the seat at the head of the table should be assigned by seniority rather than who requires direct sunlight.
1638,1,16,50,67,1.2686567164179106,0.05855986724428589,545,He's got the sunniest office in the building.
1638,4,10,53,67,1.2686567164179106,0.06918171835672447,545,soooo... who again voted for the green candidate?
1638,3,12,52,67,1.2686567164179106,0.0658318017406144,545,"Maybe he's going a little overboard with this ""blind trust"" thing."
1638,4,10,53,67,1.2686567164179106,0.06918171835672447,545,"As your new CEO, my first change is to eliminate the cafeteria salad bar."
1638,3,12,52,67,1.2686567164179106,0.0658318017406144,545,Keep talking. Apparently they like it.
1638,3,12,52,67,1.2686567164179106,0.0658318017406144,545,Finally something that's alive around here.
1638,4,10,53,67,1.2686567164179106,0.06918171835672447,545,They suspected a plant in the office.
1638,1,16,50,67,1.2686567164179106,0.05855986724428589,545,I always thought the potted plant references were metaphorical.
1638,2,14,51,67,1.2686567164179106,0.06230202312960611,545,"I've heard of a power plant, but this is ridiculous."
1638,3,12,52,67,1.2686567164179106,0.0658318017406144,545,I think he's really grown in this position.
1638,5,8,54,67,1.2686567164179106,0.07237675171740394,545,Our competition has put a plant in this boardroom and no one leaves until we find out who it is.
1638,0,18,49,67,1.2686567164179106,0.05456165335924858,545,This seems like a pretty small step towards becoming carbon neutral.
1638,2,14,51,67,1.2686567164179106,0.06230202312960611,545,He's all that's left of the Green Party.
1638,3,12,52,67,1.2686567164179106,0.0658318017406144,545,The first meeting of The Ficus Focus Group.
1638,2,14,51,67,1.2686567164179106,0.06230202312960611,545,The society pages say he's a climber.
1638,2,14,51,67,1.2686567164179106,0.06230202312960611,545,How about we make like a tree and leave?
1638,6,6,55,67,1.2686567164179106,0.07543658411895597,545,His mother was a pistil. He's a son of a gun.
1638,3,12,52,67,1.2686567164179106,0.0658318017406144,545,"""THAT'S"" the Supreme Court nominee?"
1638,5,8,54,67,1.2686567164179106,0.07237675171740394,545,Be careful what you say. Looks like a plant.
1638,3,12,52,67,1.2686567164179106,0.0658318017406144,545,It is time to turn over a new leaf.
1638,4,10,53,67,1.2686567164179106,0.06918171835672447,545,They can't fool me; it's a plant.
1638,4,10,53,67,1.2686567164179106,0.06918171835672447,545,I think he's a plant from our competition.
1638,2,14,51,67,1.2686567164179106,0.06230202312960611,545,"Sorry I'm late everyone, I was getting a bucket of water."
1638,5,8,54,67,1.2686567164179106,0.07237675171740394,545,I think it's time we turned over a new leaf.
1638,4,10,53,67,1.2686567164179106,0.06918171835672447,545,"The Board has decided to ""Go Green"" and we've started with the CEO!"
1638,4,10,53,67,1.2686567164179106,0.06918171835672447,545,Are you guys feeding me horse manure?
1638,2,14,51,67,1.2686567164179106,0.06230202312960611,545,I think we may have taken this green initiative a step too far...
1638,5,8,54,67,1.2686567164179106,0.07237675171740394,545,I thought it said 'focus group' too.
1638,1,16,50,67,1.2686567164179106,0.05855986724428589,545,It has come to my attention that this board is in need of some pruning.
1638,4,10,53,67,1.2686567164179106,0.06918171835672447,545,"One more thing, let's keep the Watering Can gossip to a minimum."
1638,5,8,54,67,1.2686567164179106,0.07237675171740394,545,Evidently the presidency is going to pot
1638,5,8,54,67,1.2686567164179106,0.07237675171740394,545,I thought we agreed to stop watering it?
1638,5,8,54,67,1.2686567164179106,0.07237675171740394,545,"I'm just going to sit here until one of you gals brings me a cup of water,"
1638,5,8,54,67,1.2686567164179106,0.07237675171740394,545,"As a vegan she always said ""You are what you eat"""
1638,4,10,53,67,1.2686567164179106,0.06918171835672447,545,I've been saying this organisation needed a decision tree
1638,2,14,51,67,1.2686567164179106,0.06230202312960611,545,"With all due respect, I don't think light and water are gonna grow this company"
1638,3,12,52,67,1.2686567164179106,0.0658318017406144,545,Maybe he meant make America green again?
1638,1,16,50,67,1.2686567164179106,0.05855986724428589,545,A show of hands for those in favor of a window box...
1638,3,12,52,67,1.2686567164179106,0.0658318017406144,545,He used to be the CEO of House and Garden.
1638,3,12,52,67,1.2686567164179106,0.0658318017406144,545,So this is what he meant by going green.
1638,2,14,51,67,1.2686567164179106,0.06230202312960611,545,Careful what you say -- it's a plant.
1638,5,8,54,67,1.2686567164179106,0.07237675171740394,545,I hear he gets about 200 times the fertilizer as the Philodendron downstairs.
1638,3,12,52,67,1.2686567164179106,0.0658318017406144,545,"Mr. Green is not a dynamic speaker, but I find his presence very relaxing."
1638,6,6,55,67,1.2686567164179106,0.07543658411895597,545,"You said the company has plants in every department, but this is ridiculous!"
1638,4,10,53,67,1.2686567164179106,0.06918171835672447,545,Can I copy your notes after the meeting? I'm having trouble hearing what Fern is saying.
1638,4,10,53,67,1.2686567164179106,0.06918171835672447,545,Your former Chair was about to suck all the oxygen from the room...
1638,3,12,52,67,1.2686567164179106,0.0658318017406144,545,"""Welcome to the biennial meeting""."
1638,3,12,52,67,1.2686567164179106,0.0658318017406144,545,I'm pleased to announce that we have secured our first round of seed funding.
1638,3,12,52,67,1.2686567164179106,0.0658318017406144,545,Our profit margin isn't the only thing that's wilting.
1638,2,14,51,67,1.2686567164179106,0.06230202312960611,545,These green initiatives are getting out of hand.
1638,5,8,54,67,1.2686567164179106,0.07237675171740394,545,He's taken 'going vegan' to a whole new level.
1638,5,8,54,67,1.2686567164179106,0.07237675171740394,545,"At least he can't run for President, he's English Ivy"
1638,3,12,52,67,1.2686567164179106,0.0658318017406144,545,"He's less prickly than the cactus, but still has serious intellectual limitations."
1638,4,10,53,67,1.2686567164179106,0.06918171835672447,545,"How much do you want to bet he uses the, 'if a tree falls in the forest' line again?"
1638,5,8,54,67,1.2686567164179106,0.07237675171740394,545,"Be careful what you say, there's a plant in the room."
1638,5,8,54,67,1.2686567164179106,0.07237675171740394,545,"When they said they wanted to grow the company, I thought it was a metaphor."
1638,5,8,54,67,1.2686567164179106,0.07237675171740394,545,As the board saw fit to compete head on with hedge funds...
1638,4,10,53,67,1.2686567164179106,0.06918171835672447,545,"As predicted the board chairman was a plant all along, but for whom?"
1638,3,12,52,67,1.2686567164179106,0.0658318017406144,545,"Okay, then. Let's roll up our leaves and get to work."
1638,2,14,51,67,1.2686567164179106,0.06230202312960611,545,I enjoy board meetings more since the Old Man started using pot.
1638,5,8,54,67,1.2686567164179106,0.07237675171740394,545,Careful what you say about the merger - that's an FTC plant.
1638,4,10,53,67,1.2686567164179106,0.06918171835672447,545,Now that the former director has been supplanted...
1638,3,12,52,67,1.2686567164179106,0.0658318017406144,545,"From what we've all heard, the competition has a lot of dirt on you."
1638,3,12,52,67,1.2686567164179106,0.0658318017406144,545,Suspicion grew that one of them was a plant.
1638,5,8,54,67,1.2686567164179106,0.07237675171740394,545,You are all about to discover that I am more than just a potted plant.
1638,3,12,52,67,1.2686567164179106,0.0658318017406144,545,The board eventually discovered the competition's plant in their midst.
1638,2,14,51,67,1.2686567164179106,0.06230202312960611,545,"I'm deciduous by nature, so please feel free to remove your coats."
1638,3,12,52,67,1.2686567164179106,0.0658318017406144,545,"Is it me, or is Fern looking under the weather?"
1638,4,10,53,67,1.2686567164179106,0.06918171835672447,545,"We will build a wall, a magnificient tall wall, and the deer will pay for it."
1638,2,14,51,67,1.2686567164179106,0.06230202312960611,545,"Allow me to clear up a few things before we get down to business. First, I've never met Moses and though, there is a resemblance, I am not that 'burning bush.'"
1638,3,12,52,67,1.2686567164179106,0.0658318017406144,545,He is serious about going green!
1638,4,10,53,67,1.2686567164179106,0.06918171835672447,545,I like him better than the last guy.
1638,6,6,55,67,1.2686567164179106,0.07543658411895597,545,"I know the board said they picked a perennial as president, but I'm telling you, he's a fall guy."
1638,2,14,51,67,1.2686567164179106,0.06230202312960611,545,Our competitors have planted a traitor on this board. Nobody leaves this room until we figure out which one is the plant.
1638,5,8,54,67,1.2686567164179106,0.07237675171740394,545,I've gone to pot.
1638,4,10,53,67,1.2686567164179106,0.06918171835672447,545,"More water and less dogs, that's what we need."
1638,5,8,54,67,1.2686567164179106,0.07237675171740394,545,I called this meeting to let you know we're going green.
1638,1,16,50,67,1.2686567164179106,0.05855986724428589,545,Looks like the boss is turning over a new leaf.
1638,3,12,52,67,1.2686567164179106,0.0658318017406144,545,The repotting will affect some more than others.
1638,4,10,53,67,1.2686567164179106,0.06918171835672447,545,"I'd like to thank all you who came today: Bud, Rose, Iris, Violet and all the rest."
1638,3,12,52,67,1.2686567164179106,0.0658318017406144,545,I always suspected a plant in the executive suite.
1638,4,10,53,67,1.2686567164179106,0.06918171835672447,545,I assure you the plant is not closing.
1638,5,8,54,67,1.2686567164179106,0.07237675171740394,545,I still think we should move it to Mexico.
1638,4,10,53,67,1.2686567164179106,0.06918171835672447,545,I can’t tell you how wrong it is that some of you think that I suck out all the oxygen from a room.
1638,4,10,53,67,1.2686567164179106,0.06918171835672447,545,I am finally legal thanks to the committee.
1638,3,12,52,67,1.2686567164179106,0.0658318017406144,545,These diversity quotas are getting a little out of hand
1638,5,8,54,67,1.2686567164179106,0.07237675171740394,545,Does this mean no Christmas tree.
1638,4,10,53,67,1.2686567164179106,0.06918171835672447,545,The dead wood is finally gone.
1638,2,14,51,67,1.2686567164179106,0.06230202312960611,545,Time to prune?
1638,3,12,52,67,1.2686567164179106,0.0658318017406144,545,I really want us to grow...
1638,3,12,52,67,1.2686567164179106,0.0658318017406144,545,I want to announce that our company has gone green.
1638,5,8,54,67,1.2686567164179106,0.07237675171740394,545,"He's got it all now - sunlight, water and the big chair."
1638,5,8,54,67,1.2686567164179106,0.07237675171740394,545,You're probably wondering why I called this meeting.
1638,3,12,52,67,1.2686567164179106,0.0658318017406144,545,How many 'groundbreaking' ideas can he have?
1638,2,14,51,67,1.2686567164179106,0.06230202312960611,545,"As your new CEO, I intend to grow into the job."
1638,5,8,54,67,1.2686567164179106,0.07237675171740394,545,Who forgot the water?
1638,2,14,51,67,1.2686567164179106,0.06230202312960611,545,Thank you all for your support for bio-diversity.
1638,2,14,51,67,1.2686567164179106,0.06230202312960611,545,"With other states passing legalization laws, Colorado felt it had to up the ante..."
1638,3,12,52,67,1.2686567164179106,0.0658318017406144,545,I'm here to speak to you about plant operations..
1638,3,12,52,67,1.2686567164179106,0.0658318017406144,545,I'm thinking if we move her seat closer to the light she'll grow into the job.
1638,1,16,50,67,1.2686567164179106,0.05855986724428589,545,What's your opinion on global warming?
1638,3,12,52,67,1.2686567164179106,0.0658318017406144,545,Something tells me the new boss is a plant...
1638,4,10,53,67,1.2686567164179106,0.06918171835672447,545,Whose bright idea was it to put a Mr Greentree's name on the stockholders ballot for Chairman ?
1638,5,8,54,67,1.2686567164179106,0.07237675171740394,545,It was the senior poinsettia in the Trump Tower lobby.
1638,1,16,50,67,1.2686567164179106,0.05855986724428589,545,So we are in agreement that it's time to open a new branch office?
1638,5,8,54,67,1.2686567164179106,0.07237675171740394,545,"Oh no, another bathroom policy issue..."
1638,4,10,53,67,1.2686567164179106,0.06918171835672447,545,"Well, at least our new leader is a color found in nature."
1638,5,8,54,67,1.2686567164179106,0.07237675171740394,545,I've always suspected we had a plant on our board.
1638,2,14,51,67,1.2686567164179106,0.06230202312960611,545,I heard we were going green
1638,5,8,54,67,1.2686567164179106,0.07237675171740394,545,I can't believe you're all so stunned by this revelation. I suspected he was a plant from day one.
1638,3,12,52,67,1.2686567164179106,0.0658318017406144,545,Watch what you say. That's a company plant.
1638,2,14,51,67,1.2686567164179106,0.06230202312960611,545,You may be questioning whether I'm qualified to be here.
1638,6,6,55,67,1.2686567164179106,0.07543658411895597,545,"They said he had a stroke and was a vegetable, but we never expected THIS!"
1638,4,10,53,67,1.2686567164179106,0.06918171835672447,545,"So, this is our new growth model?"
1638,3,12,52,67,1.2686567164179106,0.0658318017406144,545,Welcome to the law fern.
1638,2,14,51,67,1.2686567164179106,0.06230202312960611,545,"As all of you can imagine, it's pretty important I go south for the winter."
1638,4,10,53,67,1.2686567164179106,0.06918171835672447,545,Bonsai is hurtful. We prefer to be called little trees.
1638,3,12,52,67,1.2686567164179106,0.0658318017406144,545,"C'mon people, it doesn't take a genus."
1638,2,14,51,67,1.2686567164179106,0.06230202312960611,545,It just wants all the dirt.
1638,3,12,52,67,1.2686567164179106,0.0658318017406144,545,The chairman seems to grow on us
1638,3,12,52,67,1.2686567164179106,0.0658318017406144,545,As your new chairman I intend to take a more organic approach to how our plants operate.
1638,2,14,51,67,1.2686567164179106,0.06230202312960611,545,Ohhhh.....this is a coniference call.
1638,3,12,52,67,1.2686567164179106,0.0658318017406144,545,"Actually, we think you're exceptionally qualified."
1638,2,14,51,67,1.2686567164179106,0.06230202312960611,545,Another boring plant update.
1638,3,12,52,67,1.2686567164179106,0.0658318017406144,545,My father founded this firm. In fact his trunk is our conference table.
1638,1,16,50,67,1.2686567164179106,0.05855986724428589,545,"Before we begin, could I get a glass of water too?"
1638,5,8,54,67,1.2686567164179106,0.07237675171740394,545,The question has been called. Who will water the chairperson?
1638,5,8,54,67,1.2686567164179106,0.07237675171740394,545,So do we smoke it or salute it?
1638,3,12,52,67,1.2686567164179106,0.0658318017406144,545,At least we don't work for an animal or a mineral.
1638,3,12,52,67,1.2686567164179106,0.0658318017406144,545,Next Agenda Item: The Greenhouse Effect.
1638,2,14,51,67,1.2686567164179106,0.06230202312960611,545,Someone said he came from Amazon!
1638,3,12,52,67,1.2686567164179106,0.0658318017406144,545,The board wanted a CEO with strong roots in the company
1638,3,12,52,67,1.2686567164179106,0.0658318017406144,545,our CEO is such a pothead
1638,3,12,52,67,1.2686567164179106,0.0658318017406144,545,Good morning. Let me introduce myself. I'm the new Plant Manager.
1638,4,10,53,67,1.2686567164179106,0.06918171835672447,545,I'm living proof you can still work your way up from the mailroom.
1638,4,10,53,67,1.2686567164179106,0.06918171835672447,545,"Okay, Okay. We get it, going ""Green"" is in."
1638,4,10,53,67,1.2686567164179106,0.06918171835672447,545,"Well, it looks like the boss is potted again."
1638,5,8,54,67,1.2686567164179106,0.07237675171740394,545,I didn't know the Bushes had another child.
1638,3,12,52,67,1.2686567164179106,0.0658318017406144,545,Just lay on the fertilizer and I'm sure he'll grow to appreciate you.
1638,4,10,53,67,1.2686567164179106,0.06918171835672447,545,We have to start thinking green.
1638,3,12,52,67,1.2686567164179106,0.0658318017406144,545,What a breath of fresh air! I just love how he's a real outsider.
1638,3,12,52,67,1.2686567164179106,0.0658318017406144,545,We hope he leaves soon.
1638,2,14,51,67,1.2686567164179106,0.06230202312960611,545,"I don't know, he seems a little green."
1638,3,12,52,67,1.2686567164179106,0.0658318017406144,545,We're expecting record growth this year
1638,6,6,55,67,1.2686567164179106,0.07543658411895597,545,...and maybe Trump will be effective as president
1638,6,6,55,67,1.2686567164179106,0.07543658411895597,545,"I wanted people who are ruthless, not rootless."
1638,5,8,54,67,1.2686567164179106,0.07237675171740394,545,We've voted you out. You never really were one of us.
1638,2,14,51,67,1.2686567164179106,0.06230202312960611,545,Okay. Who's the mole?
1638,3,12,52,67,1.2686567164179106,0.0658318017406144,545,She's an expert on green energy.
1638,3,12,52,67,1.2686567164179106,0.0658318017406144,545,We promised our investors a new chairman and new plant.
1638,3,12,52,67,1.2686567164179106,0.0658318017406144,545,""" I didn't ask for this reincarnation."" ""What's on the agenda""?"
1638,3,12,52,67,1.2686567164179106,0.0658318017406144,545,Don't divulge any company secrets -- I suspect the new CEO is a plant.
1638,3,12,52,67,1.2686567164179106,0.0658318017406144,545,Don't look surprised. I have deep roots going back long before any of you.
1638,2,14,51,67,1.2686567164179106,0.06230202312960611,545,Our new CEO is committed to green initiatives....
1638,6,6,55,67,1.2686567164179106,0.07543658411895597,545,I prefer it to Trump.
1638,5,8,54,67,1.2686567164179106,0.07237675171740394,545,I propose we invest in shrubbery as a hedge against inflation.
1638,4,10,53,67,1.2686567164179106,0.06918171835672447,545,I call our perennial board meeting to order.
1638,3,12,52,67,1.2686567164179106,0.0658318017406144,545,Maybe he needs to be repotted.
1638,4,10,53,67,1.2686567164179106,0.06918171835672447,545,Our company will continue to promote diversity.
1638,2,14,51,67,1.2686567164179106,0.06230202312960611,545,I believe there is a real opportunity for growth here.
1638,4,10,53,67,1.2686567164179106,0.06918171835672447,545,Good grief! Another vegetarian.
1638,5,8,54,67,1.2686567164179106,0.07237675171740394,545,"Hello, my name is Fern, I'll be moderating today."
1638,3,12,52,67,1.2686567164179106,0.0658318017406144,545,"We they said the new CEO was a bush, I expected Jeb."
1638,2,14,51,67,1.2686567164179106,0.06230202312960611,545,We've finally gone green.
1638,5,8,54,67,1.2686567164179106,0.07237675171740394,545,"Having come up through agri products, I'd like to share some wisdom..."
1638,5,8,54,67,1.2686567164179106,0.07237675171740394,545,"He hasn't shown us much so far, but we expect him to really bloom in the Spring."
1638,3,12,52,67,1.2686567164179106,0.0658318017406144,545,President Bush.
1638,3,12,52,67,1.2686567164179106,0.0658318017406144,545,"With fronds like those, who needs enemies."
1638,4,10,53,67,1.2686567164179106,0.06918171835672447,545,"Yes, we are now sorry you didn't run."
1638,4,10,53,67,1.2686567164179106,0.06918171835672447,545,Proof positive a potted plant can run this place.
1638,5,8,54,67,1.2686567164179106,0.07237675171740394,545,"Hedge funds are old news, welcome to the future...Geranium funds!"
1638,2,14,51,67,1.2686567164179106,0.06230202312960611,545,And what would be so bad about running this company into the ground?
1638,3,12,52,67,1.2686567164179106,0.0658318017406144,545,"I've heard about this guy. Apparently everywhere he goes, he just concentrates on growth and leaves."
1638,2,14,51,67,1.2686567164179106,0.06230202312960611,545,"Motion carried! We get raises. Our CEO gets a bigger pot."""
1638,3,12,52,67,1.2686567164179106,0.0658318017406144,545,I think it's about time for the Board to turn over a new leaf.
1638,4,10,53,67,1.2686567164179106,0.06918171835672447,545,I don't know how Hillary lost this chairmanship vote either. The polls had her ahead by 10%.
1638,5,8,54,67,1.2686567164179106,0.07237675171740394,545,"Team, our numbers this quarter are so bad I soiled myself."
1638,4,10,53,67,1.2686567164179106,0.06918171835672447,545,I think the new management's message is pretty clear - they're planning to ficus.
1638,3,12,52,67,1.2686567164179106,0.0658318017406144,545,"I guess they're right, going green starts at the top."
1638,5,8,54,67,1.2686567164179106,0.07237675171740394,545,The potted plant is only here to break tie votes.
1638,3,12,52,67,1.2686567164179106,0.0658318017406144,545,I heard he was trying to improve worldwide plant productivity.
1638,4,10,53,67,1.2686567164179106,0.06918171835672447,545,"He seems a little too, ehm, green to be CEO."
1638,4,10,53,67,1.2686567164179106,0.06918171835672447,545,"Not my first choice either, but the other plant was temperamentally unfit to be chairman."
1638,3,12,52,67,1.2686567164179106,0.0658318017406144,545,"Team, I'm not sure it makes sense to move the plant to Mexico anymore given the recent election results."
1638,3,12,52,67,1.2686567164179106,0.0658318017406144,545,Jack says the future is in beanstalks.
1638,4,10,53,67,1.2686567164179106,0.06918171835672447,545,She built this company from the ground up.
1638,5,8,54,67,1.2686567164179106,0.07237675171740394,545,"When our last CEO said he'd leave a green plant as his legacy, I thought he meant the factory!"
1638,4,10,53,67,1.2686567164179106,0.06918171835672447,545,Our CEO seems to be a bit potted.
1638,3,12,52,67,1.2686567164179106,0.0658318017406144,545,Watch what you say. It might be a plant.
1834,4,10,54,68,1.2647058823529411,0.06827116008146468,545,It's our new biodiversity hiring policy
1834,5,8,55,68,1.2647058823529411,0.07141381422136295,545,Maybe they've taken affirmative action too far.
1834,2,14,52,68,1.2647058823529411,0.06150600111631588,545,The new GM could be here for awhile. He looks like a perenial.
1834,5,8,55,68,1.2647058823529411,0.07141381422136295,545,"Well, we've tried every other growth strategy."
1834,3,12,53,68,1.2647058823529411,0.06497668609658862,545,"And for all you conspiracy theorists, I am, indeed, a plant."
1834,3,12,53,68,1.2647058823529411,0.06497668609658862,545,We told him to be careful of that vegan diet.
1834,3,12,53,68,1.2647058823529411,0.06497668609658862,545,"Just to be clear, I'm using the term ""pruning"" in a metaphorical sense."
1834,4,10,54,68,1.2647058823529411,0.06827116008146468,545,"Remember, he likes his coffee with extra grounds."
1842,4,10,55,69,1.2608695652173914,0.0673837412910942,545,"I heard the new chief was a plant from the competition, but I had no idea..."
1843,3,11,52,66,1.2575757575757576,0.06588329747412035,545,The buzz is she's a plant.
1843,7,3,56,66,1.2575757575757576,0.07877442954960256,545,"Meet the new moss, same as the ole moss."
1843,3,11,52,66,1.2575757575757576,0.06588329747412035,545,This 'diversity initiative' is getting silly.
1843,3,11,52,66,1.2575757575757576,0.06588329747412035,545,"If he asks, you're a pescatarian."
1843,2,13,51,66,1.2575757575757576,0.062244746122568174,545,I started out as a green shoot in accounting.
1843,2,13,51,66,1.2575757575757576,0.062244746122568174,545,Seems like he met at least one growth target.
1843,3,11,52,66,1.2575757575757576,0.06588329747412035,545,I expect you each to blossom at some point this next year.
1843,2,13,51,66,1.2575757575757576,0.062244746122568174,545,"Please welcome Fern, our new branch manager."
1843,4,9,53,66,1.2575757575757576,0.06933115715364845,545,I firmly believe that 'going green' is more than just a fad. I'm committed.
1843,3,11,52,66,1.2575757575757576,0.06588329747412035,545,I like the division's new emphasis on growth
1843,3,11,52,66,1.2575757575757576,0.06588329747412035,545,"If it starts singing 'Feed Me, Seymour,' I am out of here."
1843,2,13,51,66,1.2575757575757576,0.062244746122568174,545,Plant Manager assumes CEO role.
1843,5,7,54,66,1.2575757575757576,0.0726154929644106,545,"WITH DIVERSITY AS OUR GOAL, WE WANT TO WELCOME EUPHORBIA PULCHERRIMA TO OUR COMPANY."
1843,3,11,52,66,1.2575757575757576,0.06588329747412035,545,I expect your full support as we branch out and seed new territory.
1843,5,7,54,66,1.2575757575757576,0.0726154929644106,545,Which one of you didn't water me last week?
1843,2,13,51,66,1.2575757575757576,0.062244746122568174,545,"Don't worry, I have control of the watering can"
1843,4,9,53,66,1.2575757575757576,0.06933115715364845,545,"Well, we always knew he was potted."
1843,3,11,52,66,1.2575757575757576,0.06588329747412035,545,The Medical Marijuana Dispensary's hydroponic sample was a big hit at the Board Meeting.
1843,4,9,53,66,1.2575757575757576,0.06933115715364845,545,Don't order any vegetarian dish at lunch
1843,4,9,53,66,1.2575757575757576,0.06933115715364845,545,the potted plant most definitely does NOT have the floor
1843,4,9,53,66,1.2575757575757576,0.06933115715364845,545,Let's all welcome the newest member of our biodiversity initiative!
1843,5,7,54,66,1.2575757575757576,0.0726154929644106,545,"Successful and smooth transition, Mr. President."
1843,2,13,51,66,1.2575757575757576,0.062244746122568174,545,I'm sorry to report that our long-term growth this quarter has been slow.
1843,3,11,52,66,1.2575757575757576,0.06588329747412035,545,"My only concern is that our new CEO is organic, non-GMO, and free trade."
1843,4,9,53,66,1.2575757575757576,0.06933115715364845,545,You can never tell if she likes the idea.
1843,2,13,51,66,1.2575757575757576,0.062244746122568174,545,...it's his proxy
1843,4,9,53,66,1.2575757575757576,0.06933115715364845,545,His awkward silences can really suck the carbon dioxide out of a room.
1843,3,11,52,66,1.2575757575757576,0.06588329747412035,545,Potty break
1843,5,7,54,66,1.2575757575757576,0.0726154929644106,545,Trump won ! No way we are moving this plant to Mexico.
1843,3,11,52,66,1.2575757575757576,0.06588329747412035,545,"I know we're trying to go green, but seriously!?"
1843,3,11,52,66,1.2575757575757576,0.06588329747412035,545,What's stomata?
1843,3,11,52,66,1.2575757575757576,0.06588329747412035,545,"For once, we actually started on thyme."
1843,4,9,53,66,1.2575757575757576,0.06933115715364845,545,They reckon he'll be our candidate in 2020
1843,2,13,51,66,1.2575757575757576,0.062244746122568174,545,I thought we had at least agreed on no more Bushes.
1843,5,7,54,66,1.2575757575757576,0.0726154929644106,545,The motion to eliminate all paper use in our company passed unanimously.
1843,3,11,52,66,1.2575757575757576,0.06588329747412035,545,Just call me Flora.
1843,3,11,52,66,1.2575757575757576,0.06588329747412035,545,"Ladies and gentlemen, I've seen the light."
1843,2,13,51,66,1.2575757575757576,0.062244746122568174,545,Just look. It thinks this board is going to fall for the whole ‘I’m a late bloomer’ line again.
1843,5,7,54,66,1.2575757575757576,0.0726154929644106,545,"When they said our new boss was a spy, I wasn't expecting a plant."
1843,4,9,53,66,1.2575757575757576,0.06933115715364845,545,How's it growing boss?
1843,2,13,51,66,1.2575757575757576,0.062244746122568174,545,We could do worse.
1843,5,7,54,66,1.2575757575757576,0.0726154929644106,545,"Well, Mary Jane, as part of the interview process we like to ask our candidates..where do you see yourself in five years?"
1843,4,9,53,66,1.2575757575757576,0.06933115715364845,545,"Well, this really shatters the glasshouse ceiling."
1843,3,11,52,66,1.2575757575757576,0.06588329747412035,545,You wouldn't think that the Chairman would have to save his seat.
1843,2,13,51,66,1.2575757575757576,0.062244746122568174,545,It grows on you.
1843,5,7,54,66,1.2575757575757576,0.0726154929644106,545,"On no, I recognize the new boss; my notepad is his father..."
1843,3,11,52,66,1.2575757575757576,0.06588329747412035,545,"All those in favor, show a green thumbs up."
1843,0,17,49,66,1.2575757575757576,0.05424027551056534,545,I'm Virginia Creeper. I've taken over from Poison Ivy
1843,4,9,53,66,1.2575757575757576,0.06933115715364845,545,"Oh, now you notice me."
1843,2,13,51,66,1.2575757575757576,0.062244746122568174,545,I understand now why our headquarters is in Colorado
1843,3,11,52,66,1.2575757575757576,0.06588329747412035,545,The old chairman had to leave because of a pollination scandal.
1843,5,7,54,66,1.2575757575757576,0.0726154929644106,545,They say he's a legend at photosynergy.
1843,5,7,54,66,1.2575757575757576,0.0726154929644106,545,Who replaced the coffee with Miracle Growth?
1843,3,11,52,66,1.2575757575757576,0.06588329747412035,545,...having agreed to your CEO's 'Green Parachute'-we will now proceed to new business...
1843,6,5,55,66,1.2575757575757576,0.07575757575757576,545,The Green Initiative worked.
1843,4,9,53,66,1.2575757575757576,0.06933115715364845,545,The rumors that you may have heard about me and the potted palm tree in conference room D are completely unfounded.
1843,3,11,52,66,1.2575757575757576,0.06588329747412035,545,Explain again how your 'water and sunlight' growth plan would translate to our electronics division.
1843,4,9,53,66,1.2575757575757576,0.06933115715364845,545,"Stop sucking the oxygen out of the room, Wyman."
1843,3,11,52,66,1.2575757575757576,0.06588329747412035,545,He is sucking all the CO2 out of the room.
1843,3,11,52,66,1.2575757575757576,0.06588329747412035,545,As I was saying: seed funding is the key to growth.
1843,3,11,52,66,1.2575757575757576,0.06588329747412035,545,I fear our competitors have introduced a plant
1843,3,11,52,66,1.2575757575757576,0.06588329747412035,545,"""It's time this company gets more green."" -- Felix Redmond, age 13"
1843,6,5,55,66,1.2575757575757576,0.07575757575757576,545,"Before we start, if you could all please pour your glasses of water on me."
1843,2,13,51,66,1.2575757575757576,0.062244746122568174,545,Is that the new plant manager?
1843,4,9,53,66,1.2575757575757576,0.06933115715364845,545,She got totally potted last night.
1843,3,11,52,66,1.2575757575757576,0.06588329747412035,545,"Dammit people, the conference room windows were supposed to face SOUTH and EAST!"
1843,4,9,53,66,1.2575757575757576,0.06933115715364845,545,Anyone who disagrees can leaf.
1843,4,9,53,66,1.2575757575757576,0.06933115715364845,545,I see that you've finally decided a Bush could indeed turn out to be a better choice as your leader.
1843,3,11,52,66,1.2575757575757576,0.06588329747412035,545,"we haven't seen much growth, so we are going to have to get a new branch manager."
1843,2,13,51,66,1.2575757575757576,0.062244746122568174,545,We went green. What do you expect?
1843,3,11,52,66,1.2575757575757576,0.06588329747412035,545,"Now we can honestly say our company is ""going green""!"
1843,3,11,52,66,1.2575757575757576,0.06588329747412035,545,He's reduced greenhouse gas emissions and improved occupant comfort. Now can we get LEED-certified?
1843,4,9,53,66,1.2575757575757576,0.06933115715364845,545,"Sir, it has come to our attention that you are a potted plant."
1843,4,9,53,66,1.2575757575757576,0.06933115715364845,545,Annual or perennial?
1843,1,15,50,66,1.2575757575757576,0.05837985914390767,545,"""Rumor has it that it could be a plant."" Elaine Ryning, San Francisco, Calif."
1843,5,7,54,66,1.2575757575757576,0.0726154929644106,545,He's the new GMO.
1843,2,13,51,66,1.2575757575757576,0.062244746122568174,545,I've learned that many of you have complained that there's a plant here in the company.
1843,5,7,54,66,1.2575757575757576,0.0726154929644106,545,"Good morning, Mr. President"
1843,5,7,54,66,1.2575757575757576,0.0726154929644106,545,Shh! He's a plant.
1843,3,11,52,66,1.2575757575757576,0.06588329747412035,545,"'we're very sorry about your family. no paper print outs next time, people."""
1843,3,11,52,66,1.2575757575757576,0.06588329747412035,545,"And now, agenda item #1... my proposal to promote that guy in charge of our indoor sprinkler system."
1843,4,9,53,66,1.2575757575757576,0.06933115715364845,545,Politics has failed us. It's time to look to other life forms for leadership.
1843,3,11,52,66,1.2575757575757576,0.06588329747412035,545,Rumor has it they're putting him in charge of the plant.
1843,5,7,54,66,1.2575757575757576,0.0726154929644106,545,I had no idea the new boss was that much of a pothead.
1843,2,13,51,66,1.2575757575757576,0.062244746122568174,545,He's still green....but we think he'll grow into the job
1843,1,15,50,66,1.2575757575757576,0.05837985914390767,545,"Yeah, I'm a little green but get used to me. I plan on putting down roots."
1843,4,9,53,66,1.2575757575757576,0.06933115715364845,545,His father was chairman of the board.
1843,2,13,51,66,1.2575757575757576,0.062244746122568174,545,The Chairman wants us to keep his plant watered while he is away. Can we manage that?
1843,5,7,54,66,1.2575757575757576,0.0726154929644106,545,"Bad news, he's all about the glass ceiling."
1843,2,13,51,66,1.2575757575757576,0.062244746122568174,545,I hear the new CEO is going green.
1843,3,11,52,66,1.2575757575757576,0.06588329747412035,545,"Look, we should at least give it a chance."
1843,3,11,52,66,1.2575757575757576,0.06588329747412035,545,I guess I misunderstood when he said he was having an implant
1843,4,9,53,66,1.2575757575757576,0.06933115715364845,545,I'd like to clear the air.
1843,4,9,53,66,1.2575757575757576,0.06933115715364845,545,As your new GMO from now on it is all about organic growth--anyone that disagrees can leave.
1843,3,11,52,66,1.2575757575757576,0.06588329747412035,545,He said some new things were sprouting in his head.
1843,5,7,54,66,1.2575757575757576,0.0726154929644106,545,"Broke through the greenhouse ceiling, I hear."
1843,3,11,52,66,1.2575757575757576,0.06588329747412035,545,Looks like our CEO is in a vegetative state.
1843,3,11,52,66,1.2575757575757576,0.06588329747412035,545,"Well, do we smoke it or do we eat it?"
1843,3,11,52,66,1.2575757575757576,0.06588329747412035,545,"I nominate the fern in the hallway, next to the elevator, as co-chair."
1843,4,9,53,66,1.2575757575757576,0.06933115715364845,545,People! Take a leaf from my book.
1843,3,11,52,66,1.2575757575757576,0.06588329747412035,545,We all agreed to GO GREEN?
1843,2,13,51,66,1.2575757575757576,0.062244746122568174,545,"The ""undercover boss"" thing was a fabulous idea; you will not believe what goes on down there."
1843,2,13,51,66,1.2575757575757576,0.062244746122568174,545,You're right. It does make the room look bigger.
1843,5,7,54,66,1.2575757575757576,0.0726154929644106,545,I move we revise our estimation of the previous CEO's intelligence.
1843,3,11,52,66,1.2575757575757576,0.06588329747412035,545,I'm breathing better already
1843,4,9,53,66,1.2575757575757576,0.06933115715364845,545,We replaced Donald Trump with something more down to earth.
1843,3,11,52,66,1.2575757575757576,0.06588329747412035,545,He's announcing our new paid sick leaves policy.
1843,3,11,52,66,1.2575757575757576,0.06588329747412035,545,Diversity hire.
1843,4,9,53,66,1.2575757575757576,0.06933115715364845,545,I expected someone taller
1843,1,15,50,66,1.2575757575757576,0.05837985914390767,545,"Starting today, we will turn over a new leaf."
1843,3,11,52,66,1.2575757575757576,0.06588329747412035,545,Inside every ficus plant is a CEO crying to get out.
1843,3,11,52,66,1.2575757575757576,0.06588329747412035,545,Forget sentience - the other candidate just wasn't trustworthy.
1843,2,13,51,66,1.2575757575757576,0.062244746122568174,545,As you know I'm from the Michigan plant.
1843,4,9,53,66,1.2575757575757576,0.06933115715364845,545,"Mr. President, how exactly do you plan to make America great again?"
1843,4,9,53,66,1.2575757575757576,0.06933115715364845,545,"He's always been a little potty, but I never thought he'd end up like that."
1843,4,9,53,66,1.2575757575757576,0.06933115715364845,545,Please pass your waters to the head of the table.
1843,5,7,54,66,1.2575757575757576,0.0726154929644106,545,I don't care what you say. I don't like Bush either but he's still better than Trump.
1843,0,17,49,66,1.2575757575757576,0.05424027551056534,545,All you people do is suck up my air.
1843,2,13,51,66,1.2575757575757576,0.062244746122568174,545,"Are you gonna finish that water, Krebbs?"
1843,5,7,54,66,1.2575757575757576,0.0726154929644106,545,I always thought the first one to break the greenhouse ceiling would be taller.
1843,4,9,53,66,1.2575757575757576,0.06933115715364845,545,"Sir, I understand that you can convert CO2 to O but I do not think that addresses our declining revenue."
1843,2,13,51,66,1.2575757575757576,0.062244746122568174,545,"You're wondering why I called YEW all here (heh, heh, heh)!"
1843,3,11,52,66,1.2575757575757576,0.06588329747412035,545,The meeting was adjourned when it was discovered that the president was in fact made of plastic
1843,2,13,51,66,1.2575757575757576,0.062244746122568174,545,Did he say that we can be replaced or replanted?
1843,6,5,55,66,1.2575757575757576,0.07575757575757576,545,Production isn't keeping up with sales...what's going on down at the plant?
1843,2,13,51,66,1.2575757575757576,0.062244746122568174,545,This diversity initiative is really shaking things up around here.
1843,3,11,52,66,1.2575757575757576,0.06588329747412035,545,Don't you think this is taking diversity too far?
1843,5,7,54,66,1.2575757575757576,0.0726154929644106,545,No water for me. I tend to leak.
1843,4,9,53,66,1.2575757575757576,0.06933115715364845,545,"Yep, an invasive hostile takeover species."
1843,2,13,51,66,1.2575757575757576,0.062244746122568174,545,"This whole ""going green"" thing is getting out of hand."
1843,3,11,52,66,1.2575757575757576,0.06588329747412035,545,There's no limit to how green this company can be.
1843,5,7,54,66,1.2575757575757576,0.0726154929644106,545,"It's an honor, Justice Thomas."
1843,1,15,50,66,1.2575757575757576,0.05837985914390767,545,Stupid photosynthesis! He expects all of us to make our own food.
1843,5,7,54,66,1.2575757575757576,0.0726154929644106,545,The boss is big on biodiversity in hiring.
1843,3,11,52,66,1.2575757575757576,0.06588329747412035,545,"First off, anyone who's a vegetarian is fired."
1843,1,15,50,66,1.2575757575757576,0.05837985914390767,545,"Gee Sid, I think I speak for us all when I say You look quite lush this morning!"
1843,6,5,55,66,1.2575757575757576,0.07575757575757576,545,Can I take back my bet about the election.
1843,5,7,54,66,1.2575757575757576,0.0726154929644106,545,Now let’s have a sunshine break on the rooftop.
1843,5,7,54,66,1.2575757575757576,0.0726154929644106,545,I know we voted for change - but this is ridiculous.
1843,2,13,51,66,1.2575757575757576,0.062244746122568174,545,There's going to have to be some pruning.
1843,3,11,52,66,1.2575757575757576,0.06588329747412035,545,He looks a little wilted. Maybe he saw the latest sales figures.
1843,0,17,49,66,1.2575757575757576,0.05424027551056534,545,Shirley was beginning to suspect that the new chairman was a plant.
1843,3,11,52,66,1.2575757575757576,0.06588329747412035,545,"Mark my words, ladies and gentlemen. I have seen the future and its name is 'chlorophyll'!"
1843,3,11,52,66,1.2575757575757576,0.06588329747412035,545,It's the worst spy disguise I've ever seen.
1843,2,13,51,66,1.2575757575757576,0.062244746122568174,545,"Ladies and gentlemen, those of you who suggested I was a plant from the CIA are correct."
1843,3,11,52,66,1.2575757575757576,0.06588329747412035,545,Weed better get started.
1843,2,13,51,66,1.2575757575757576,0.062244746122568174,545,It looks we're going to be part of the ficus group.
1843,2,13,51,66,1.2575757575757576,0.062244746122568174,545,I think we have a plant.
1843,2,13,51,66,1.2575757575757576,0.062244746122568174,545,"First meetings always a little rough, just wait till he blooms."
1843,2,13,51,66,1.2575757575757576,0.062244746122568174,545,"""Branching out"" will now be our corporate mission!"
1843,2,13,51,66,1.2575757575757576,0.062244746122568174,545,We're thinking about going green.
1843,3,11,52,66,1.2575757575757576,0.06588329747412035,545,I want us all to focus on the big pitcher.
1843,4,9,53,66,1.2575757575757576,0.06933115715364845,545,The new CEO is dope.
1843,3,11,52,66,1.2575757575757576,0.06588329747412035,545,Make America Green Again
1843,3,11,52,66,1.2575757575757576,0.06588329747412035,545,"Boss, can we get you some water? You're looking a little green."
1843,4,9,53,66,1.2575757575757576,0.06933115715364845,545,"Thanks for your sticking by me, this is diversity at its finest."
1843,2,13,51,66,1.2575757575757576,0.062244746122568174,545,"Looks like a bright sunny day, so we will reconvene outdoors."
1843,3,11,52,66,1.2575757575757576,0.06588329747412035,545,Which of you made the joke about doubting that a potted plant could run a board meeting?
1843,2,13,51,66,1.2575757575757576,0.062244746122568174,545,I think I need a drink!
1843,5,7,54,66,1.2575757575757576,0.0726154929644106,545,I hear he's one who prefers to see the trees and not the forest.
1843,3,11,52,66,1.2575757575757576,0.06588329747412035,545,"Now that we've gone green, let's talk about bringing back coal."
1843,3,11,52,66,1.2575757575757576,0.06588329747412035,545,He looks great after eight weeks in the Betty Ford Greenhouse.
1843,2,13,51,66,1.2575757575757576,0.062244746122568174,545,"Well, it's better than being called an empty suit!"
1843,7,3,56,66,1.2575757575757576,0.07877442954960256,545,Now that Mr.Trump is Mr.President we have Mr.Tree to replace him.
1843,3,11,52,66,1.2575757575757576,0.06588329747412035,545,"All those in favor of the motion, please exhale fully."
1843,4,9,53,66,1.2575757575757576,0.06933115715364845,545,"So, the question still remains. Should we legalize it?"
1843,2,13,51,66,1.2575757575757576,0.062244746122568174,545,Management wanted someone with better interpersonal skills.
1843,4,9,53,66,1.2575757575757576,0.06933115715364845,545,Don't worry--he's legal in New York.
1843,5,7,54,66,1.2575757575757576,0.0726154929644106,545,"Members of the Board, my name is Fern, I'll be the new Plant Manager."
1843,4,9,53,66,1.2575757575757576,0.06933115715364845,545,I'm your new Chief Environmental Officer.
1843,4,9,53,66,1.2575757575757576,0.06933115715364845,545,No one leaves this room till we figure out which of us is the Russian plant.
1843,3,11,52,66,1.2575757575757576,0.06588329747412035,545,Looks like the seed of our idea has taken root.
1843,2,13,51,66,1.2575757575757576,0.062244746122568174,545,I'm going to need those photosynthesis reports ASAP Jennings.
1843,7,3,56,66,1.2575757575757576,0.07877442954960256,545,"Only organization that gives you 100% organic, grass-fed bosses."
1843,3,11,52,66,1.2575757575757576,0.06588329747412035,545,Breathe.
1843,2,13,51,66,1.2575757575757576,0.062244746122568174,545,I think Wikileaks put a plant in our group.
1843,4,9,53,66,1.2575757575757576,0.06933115715364845,545,"As you can see, we have a good use for our late CEO and his ashes."
1843,0,17,49,66,1.2575757575757576,0.05424027551056534,545,"We're rebranding the company as green, starting at the top, apparently"
1843,4,9,53,66,1.2575757575757576,0.06933115715364845,545,I always thought it was just an expression.
1843,6,5,55,66,1.2575757575757576,0.07575757575757576,545,WELCOME TO THE WHITE HOUSE MR.PRESIDENT
1843,3,11,52,66,1.2575757575757576,0.06588329747412035,545,I'm betting on no more leafy greens in the cafeteria.
1843,1,15,50,66,1.2575757575757576,0.05837985914390767,545,We all think a hanging basket would elevate your image.
2025,4,9,54,67,1.2537313432835822,0.06839665216352,545,You're all probably wondering why I called this meeting.
2025,1,15,51,67,1.2537313432835822,0.057630286517219284,545,For the next quarter our focus will be on organic growth.
2025,4,9,54,67,1.2537313432835822,0.06839665216352,545,"Be careful what you say, I think he's a plant from corporate..."
2025,4,9,54,67,1.2537313432835822,0.06839665216352,545,"In a refreshing move by the new CEO, no tie."
2025,5,7,55,67,1.2537313432835822,0.07162671332366949,545,"Boss did always say ""you are what you eat."""
2025,2,13,52,67,1.2537313432835822,0.061429097001586906,545,It's part of our new Green Initiative
2025,4,9,54,67,1.2537313432835822,0.06839665216352,545,Apparently the boss wasn't kidding that the house plant could be a more dynamic team leader.
2025,1,15,51,67,1.2537313432835822,0.057630286517219284,545,We're here today to talk about growth.
2025,4,9,54,67,1.2537313432835822,0.06839665216352,545,I beg to differ. If Trump can do it so can I
2025,1,15,51,67,1.2537313432835822,0.057630286517219284,545,"When I heard that our new CEO was a plant by our competitor, I should have taken it more literally."
2025,7,3,57,67,1.2537313432835822,0.07768496720922463,545,"I heard that, before this, he was the manager of Trump's Twitter account"
2025,4,9,54,67,1.2537313432835822,0.06839665216352,545,I liked the fun guy better.
2025,1,15,51,67,1.2537313432835822,0.057630286517219284,545,"Well, they hired the plant using the same algorithm that keeps us retained, so we pretty much just go with it."
2038,3,11,54,68,1.25,0.06415178992833838,545,I still can't believe Trump nominated it to lead the EPA.
2039,4,9,56,69,1.2463768115942029,0.0665999146890887,545,"Don't just sit there, get me some water."
2040,5,6,54,65,1.2461538461538462,0.07282344703369803,545,"After yesterday's shareholders' meeting he really got potted."""
2040,2,12,51,65,1.2461538461538462,0.06213651700539812,545,"I know they said we were going Green , but, this is a little too much!"
2040,2,12,51,65,1.2461538461538462,0.06213651700539812,545,"His ashes are buried in the soil, so we figure this is the best way for the Board of Directors to preserve his vision."
2040,4,8,53,65,1.2461538461538462,0.06944411571256842,545,I've amended the hostile workplace rules to include 'dumb as a potted plant' jokes.
2040,2,12,51,65,1.2461538461538462,0.06213651700539812,545,I knew this would happen. First they legalize marijuana and now it's taking over!
2040,3,10,52,65,1.2461538461538462,0.06589169884235313,545,Terrific! Eight years of an 'empty chair' and now this!
2040,2,12,51,65,1.2461538461538462,0.06213651700539812,545,We need to hedge.
2040,5,6,54,65,1.2461538461538462,0.07282344703369803,545,The good news continues to be high profit margins in our Medical Marijuana Houseplant Division.
2040,2,12,51,65,1.2461538461538462,0.06213651700539812,545,Power Plant
2040,1,14,50,65,1.2461538461538462,0.05813929406858067,545,Thanks to the board the seed money has helped get the plant up and running.
2040,4,8,53,65,1.2461538461538462,0.06944411571256842,545,Here it comes...another plant closure...
2040,2,12,51,65,1.2461538461538462,0.06213651700539812,545,I see you didn't get the memo about the new dress code.
2040,7,2,56,65,1.2461538461538462,0.079150444720218,545,"Welcome to the white house, Mr. Trump."
2040,1,14,50,65,1.2461538461538462,0.05813929406858067,545,What do you mean growth has slowed??
2040,2,12,51,65,1.2461538461538462,0.06213651700539812,545,But he IS a potted plant.
2040,4,8,53,65,1.2461538461538462,0.06944411571256842,545,Did he say he's running for President in four years
2040,1,14,50,65,1.2461538461538462,0.05813929406858067,545,The boss loves to pretend he's down to earth
2040,3,10,52,65,1.2461538461538462,0.06589169884235313,545,...Because I have more leaves than you.
2040,4,8,53,65,1.2461538461538462,0.06944411571256842,545,Monday at the law fern.
2040,1,14,50,65,1.2461538461538462,0.05813929406858067,545,"I realize that corporate espionage happens, but what makes you think our CEO is a plant?"
2040,4,8,53,65,1.2461538461538462,0.06944411571256842,545,"Look, I was hoping to come back as a dog too, but this is the hand we've been dealt."
2040,3,10,52,65,1.2461538461538462,0.06589169884235313,545,Are you ready for the coniferous call?
2040,3,10,52,65,1.2461538461538462,0.06589169884235313,545,I don't think we're getting paid this week.
2040,5,6,54,65,1.2461538461538462,0.07282344703369803,545,It's 4:20. Time to wrap up.
2040,4,8,53,65,1.2461538461538462,0.06944411571256842,545,"Yes, Potus."
2040,2,12,51,65,1.2461538461538462,0.06213651700539812,545,I think the new CEO is a Plant.
2040,4,8,53,65,1.2461538461538462,0.06944411571256842,545,The FBI tipped me off that one of the members of our board is a plant
2040,3,10,52,65,1.2461538461538462,0.06589169884235313,545,"The president-elect couldn't be here, but we'll take it."
2040,1,14,50,65,1.2461538461538462,0.05813929406858067,545,"Ok I'll talk to it, but someone else is watering it."
2040,3,10,52,65,1.2461538461538462,0.06589169884235313,545,It's our consolation president.
2040,2,12,51,65,1.2461538461538462,0.06213651700539812,545,"Fine, I'll step down. But you'll hear from my gardener."
2040,3,10,52,65,1.2461538461538462,0.06589169884235313,545,It could be worse.
2040,2,12,51,65,1.2461538461538462,0.06213651700539812,545,"If we keep it alive while he's at the White House, he said we will all get bonuses."
2040,3,10,52,65,1.2461538461538462,0.06589169884235313,545,"Properly watered, he should reach his full potential in about fifty years."
2040,1,14,50,65,1.2461538461538462,0.05813929406858067,545,Which one of you idiots voted for TRUMP? My name is STUMP! STUMP! What's so hard about STUMP?
2040,4,8,53,65,1.2461538461538462,0.06944411571256842,545,My growth literally depends on your support.
2040,3,10,52,65,1.2461538461538462,0.06589169884235313,545,Can you believe that democratic elections led to a potted plant being in charge?
2040,2,12,51,65,1.2461538461538462,0.06213651700539812,545,The shareholders were looking for change.
2040,1,14,50,65,1.2461538461538462,0.05813929406858067,545,We're in a growth phase.
2040,4,8,53,65,1.2461538461538462,0.06944411571256842,545,I'd like to share with you my family tree.
2040,6,4,55,65,1.2461538461538462,0.0760527689741738,545,I think it's time we abandon the Electoral College.
2040,3,10,52,65,1.2461538461538462,0.06589169884235313,545,We have a plant in the boardroom.
2040,1,14,50,65,1.2461538461538462,0.05813929406858067,545,I think the new CMO is an Industry Plant.
2040,2,12,51,65,1.2461538461538462,0.06213651700539812,545,Doesn't look like the boss; I think that guy's a plant.
2040,2,12,51,65,1.2461538461538462,0.06213651700539812,545,Just one word: chlorophyll.
2040,3,10,52,65,1.2461538461538462,0.06589169884235313,545,What's the root cause analysis?
2040,4,8,53,65,1.2461538461538462,0.06944411571256842,545,"It could be worse, the stalk could be down."
2040,3,10,52,65,1.2461538461538462,0.06589169884235313,545,Do you mind if I switch seats with someone? I'm not getting enough sunlight.
2040,3,10,52,65,1.2461538461538462,0.06589169884235313,545,Rumors that our 11th board member is a plant by our largest competitor are just not true.
2040,3,10,52,65,1.2461538461538462,0.06589169884235313,545,Do you think we have to water daily or weekly?
2040,3,10,52,65,1.2461538461538462,0.06589169884235313,545,"I prefer to go by my full name, Fernando."
2040,4,8,53,65,1.2461538461538462,0.06944411571256842,545,What'd you expect when you came to work for Monsanto?
2040,1,14,50,65,1.2461538461538462,0.05813929406858067,545,The board is serious about Going Green.
2040,2,12,51,65,1.2461538461538462,0.06213651700539812,545,The money tree looks flush this quarter.
2040,4,8,53,65,1.2461538461538462,0.06944411571256842,545,Whose turn is it to water this week?
2040,1,14,50,65,1.2461538461538462,0.05813929406858067,545,I thought that was just an expression.
2040,3,10,52,65,1.2461538461538462,0.06589169884235313,545,I don't care how tight the budget is... we are NOT laying off the groundskeepers.
2040,2,12,51,65,1.2461538461538462,0.06213651700539812,545,I heard he sleeps in his office.
2040,3,10,52,65,1.2461538461538462,0.06589169884235313,545,"Biodiversity aside, can it lead?"
2040,4,8,53,65,1.2461538461538462,0.06944411571256842,545,"Come on, talk to me."
2040,2,12,51,65,1.2461538461538462,0.06213651700539812,545,"As new plant director, I intend to take this company back to its roots."
2040,5,6,54,65,1.2461538461538462,0.07282344703369803,545,Did he say if we should water it?
2040,4,8,53,65,1.2461538461538462,0.06944411571256842,545,"Listen up,aphids!"
2040,2,12,51,65,1.2461538461538462,0.06213651700539812,545,He used to be so rooted.
2040,5,6,54,65,1.2461538461538462,0.07282344703369803,545,Traffic was terrible. Did I miss anything?
2040,2,12,51,65,1.2461538461538462,0.06213651700539812,545,I feel you've all been throwing me some shade.
2040,4,8,53,65,1.2461538461538462,0.06944411571256842,545,This meeting is now called to water.
2040,3,10,52,65,1.2461538461538462,0.06589169884235313,545,Annual meeting of the governing board of Greenpeace.
2040,4,8,53,65,1.2461538461538462,0.06944411571256842,545,Be patient. It'll grow into the job.
2040,4,8,53,65,1.2461538461538462,0.06944411571256842,545,Anyone with a nervous system is fair game.
2040,3,10,52,65,1.2461538461538462,0.06589169884235313,545,"Sir, I can’t help but notice you’ve turned over a new leaf."
2040,5,6,54,65,1.2461538461538462,0.07282344703369803,545,"Having occupied the CEO'S corner office for years, the ficus lay privy to many of corporates wheeling and dealing."
2040,3,10,52,65,1.2461538461538462,0.06589169884235313,545,Did he just ask to be pollenated?
2040,2,12,51,65,1.2461538461538462,0.06213651700539812,545,"In an inevitable twist, the green movement goes too far."
2040,3,10,52,65,1.2461538461538462,0.06589169884235313,545,"The board members sat wondering how the push for a 'new, more robust plant' could've gotten so misconstrued."
2040,4,8,53,65,1.2461538461538462,0.06944411571256842,545,Water me.
2040,5,6,54,65,1.2461538461538462,0.07282344703369803,545,It's Ivanka's.
2040,2,12,51,65,1.2461538461538462,0.06213651700539812,545,Don't look at me- I'm not the government plant.
2040,3,10,52,65,1.2461538461538462,0.06589169884235313,545,"Wow, leadership here has really gone to seed."
2040,6,4,55,65,1.2461538461538462,0.0760527689741738,545,After this meeting I'm going to swing by the hospital. I heard Carol's mother is ill and hope I can cheer her up.
2040,3,10,52,65,1.2461538461538462,0.06589169884235313,545,They sent us to shut down the plant.
2040,3,10,52,65,1.2461538461538462,0.06589169884235313,545,At least we broke the greenhouse ceiling this year.
2040,2,12,51,65,1.2461538461538462,0.06213651700539812,545,Smoking the boss at work is forbidden.
2040,4,8,53,65,1.2461538461538462,0.06944411571256842,545,Eat more meat.
2040,3,10,52,65,1.2461538461538462,0.06589169884235313,545,"Suddenly the board realized this wasn't an ordinary meeting table, it was the president's grandfather."
2040,3,10,52,65,1.2461538461538462,0.06589169884235313,545,What did I miss?
2040,1,14,50,65,1.2461538461538462,0.05813929406858067,545,Seed funding is our top priority.
2040,1,14,50,65,1.2461538461538462,0.05813929406858067,545,Trump said things would be different.
2040,5,6,54,65,1.2461538461538462,0.07282344703369803,545,Be sure to compliment the new pot.
2040,3,10,52,65,1.2461538461538462,0.06589169884235313,545,"I've been told I'm too green for this job, but as your new plant manager, I promise to grow this company"
2040,6,4,55,65,1.2461538461538462,0.0760527689741738,545,When it starts burning we'll begin the meeting.
2040,2,12,51,65,1.2461538461538462,0.06213651700539812,545,I know I'm still green here but oxygen is up and carbon dioxide is down; I trust you will consider that in addressing my compensation package.
2040,2,12,51,65,1.2461538461538462,0.06213651700539812,545,Don't just sit there like you're staring at a plant!
2040,2,12,51,65,1.2461538461538462,0.06213651700539812,545,Our entry into the marijuana business has been very well received.
2040,2,12,51,65,1.2461538461538462,0.06213651700539812,545,"We will be expanding our markets to Massachusetts, Nevada, and California."
2040,4,8,53,65,1.2461538461538462,0.06944411571256842,545,The Plant Manager felt a bit green when he attended corporate meetings.
2040,3,10,52,65,1.2461538461538462,0.06589169884235313,545,I'm changing our investment strategy from tobacco stocks to medical marijuana futures.
2040,3,10,52,65,1.2461538461538462,0.06589169884235313,545,"As the new CEO, my first objective is to cut out all the deadwood."
2040,2,12,51,65,1.2461538461538462,0.06213651700539812,545,"Rumor has it, she's a plant."
2040,4,8,53,65,1.2461538461538462,0.06944411571256842,545,Just think of me as the lungs of this organization
2040,4,8,53,65,1.2461538461538462,0.06944411571256842,545,"He's a hopelessly inadequate CEO. On the other hand, we pay him with water and fertilizer."
2040,0,16,49,65,1.2461538461538462,0.05384615384615385,545,"As you know, I am deeply concerned about our plant closings."
2040,5,6,54,65,1.2461538461538462,0.07282344703369803,545,"As my first act as your new CEO, no more plant closings."
2040,1,14,50,65,1.2461538461538462,0.05813929406858067,545,I say we owe him a chance to turn over a new leaf.
2040,4,8,53,65,1.2461538461538462,0.06944411571256842,545,I miss the bathroom breaks.
2040,3,10,52,65,1.2461538461538462,0.06589169884235313,545,He's our new supervisor. I heard he's a transplant from the office in Chicago.
2040,4,8,53,65,1.2461538461538462,0.06944411571256842,545,I formerly served the president in a more decorative position.
2040,3,10,52,65,1.2461538461538462,0.06589169884235313,545,"In lieu of any real revenue growth, we've resorted to growing a money tree"
2040,3,10,52,65,1.2461538461538462,0.06589169884235313,545,We'll need more seed capital to sustain growth this quarter
2040,2,12,51,65,1.2461538461538462,0.06213651700539812,545,"We figured that since Trump's now president, anything goes!"
2040,3,10,52,65,1.2461538461538462,0.06589169884235313,545,Now I'd like suggestions for our new Plant Manager.
2040,3,10,52,65,1.2461538461538462,0.06589169884235313,545,We need to grow organically!
2040,3,10,52,65,1.2461538461538462,0.06589169884235313,545,Are you sure this is how we develop our decision tree?
2040,4,8,53,65,1.2461538461538462,0.06944411571256842,545,"Would you like some water,Sir?"
2040,1,14,50,65,1.2461538461538462,0.05813929406858067,545,"As all of you know, I am rooted deeply in this company."
2040,3,10,52,65,1.2461538461538462,0.06589169884235313,545,I predict slow growth this quarter.
2040,3,10,52,65,1.2461538461538462,0.06589169884235313,545,Damn neplantism.
2040,3,10,52,65,1.2461538461538462,0.06589169884235313,545,Growth is the objective. For that I'll need re-potting.
2040,2,12,51,65,1.2461538461538462,0.06213651700539812,545,"When rumors emerged of problems at the plant, only the board knew the whole story."
2040,3,10,52,65,1.2461538461538462,0.06589169884235313,545,The leaves have it. Motion passed
2040,3,10,52,65,1.2461538461538462,0.06589169884235313,545,We now have biodiversity as well.
2040,3,10,52,65,1.2461538461538462,0.06589169884235313,545,"All those in favor of fertilizer for lunch, say ""aye."""
2040,4,8,53,65,1.2461538461538462,0.06944411571256842,545,"The younger daughters, Fern and Violet, are quite upset with the way the will was written."
2040,1,14,50,65,1.2461538461538462,0.05813929406858067,545,The key to our success begins at our roots.
2040,4,8,53,65,1.2461538461538462,0.06944411571256842,545,Legalization seems to have broken other barriers for the plant as well.
2040,4,8,53,65,1.2461538461538462,0.06944411571256842,545,Frank's beard is starting to look a little bushy.
2040,2,12,51,65,1.2461538461538462,0.06213651700539812,545,"A real growth spurt is what we need to see this quarter. We'll need more water, more fertilizer..."
2040,4,8,53,65,1.2461538461538462,0.06944411571256842,545,Is this blind trust thing a joke?
2040,2,12,51,65,1.2461538461538462,0.06213651700539812,545,Don't expect much input from the Colorado rep!
2040,2,12,51,65,1.2461538461538462,0.06213651700539812,545,Plant Parenthood. Where do we go from here?
2040,2,12,51,65,1.2461538461538462,0.06213651700539812,545,He's built this company up from the grassroots.
2040,2,12,51,65,1.2461538461538462,0.06213651700539812,545,"The Chairman hadn't done much for the corporation, but his ashes really perked up his potted plant."
2040,3,10,52,65,1.2461538461538462,0.06589169884235313,545,They wanted to appoint someone free of corruption.
2040,4,8,53,65,1.2461538461538462,0.06944411571256842,545,The boss went undercover. That's just a plant.
2040,4,8,53,65,1.2461538461538462,0.06944411571256842,545,Is this the plan for organic growth?
2040,3,10,52,65,1.2461538461538462,0.06589169884235313,545,"But you have to admit, it's making more sense than our last CEO."
2040,2,12,51,65,1.2461538461538462,0.06213651700539812,545,You're probably wondering why I've called you here today.
2040,3,10,52,65,1.2461538461538462,0.06589169884235313,545,You were right. The head of the board is a pothead after all.
2040,3,10,52,65,1.2461538461538462,0.06589169884235313,545,It's all about growth.
2040,5,6,54,65,1.2461538461538462,0.07282344703369803,545,"This meeting is called to order, family and genus."
2040,2,12,51,65,1.2461538461538462,0.06213651700539812,545,I vote that we go paperless.
2040,3,10,52,65,1.2461538461538462,0.06589169884235313,545,The Board is really taking environmental leadership seriously.
2040,5,6,54,65,1.2461538461538462,0.07282344703369803,545,"No use hiding behind the plant, Hobbs. We know who you voted for."
2040,4,8,53,65,1.2461538461538462,0.06944411571256842,545,"As your newly elected leader of the Green Party, my primary focus is climate change."
2040,4,8,53,65,1.2461538461538462,0.06944411571256842,545,The good news is it doesn't speak and it's not orange.
2040,4,8,53,65,1.2461538461538462,0.06944411571256842,545,remember that team building project we did where we shared ideas and planted seeds...
2040,3,10,52,65,1.2461538461538462,0.06589169884235313,545,We decided to spruce things up.
2040,4,8,53,65,1.2461538461538462,0.06944411571256842,545,A weak replacement for Fern.
2040,4,8,53,65,1.2461538461538462,0.06944411571256842,545,HR said they really branched out to get this one.
2040,3,10,52,65,1.2461538461538462,0.06589169884235313,545,It's your turn to change his soil.
2040,2,12,51,65,1.2461538461538462,0.06213651700539812,545,This new 'Go Green' campaign has gone a bit too far.
2040,2,12,51,65,1.2461538461538462,0.06213651700539812,545,Great five-year growth potential is what we told the recruiters we were looking for...
2040,4,8,53,65,1.2461538461538462,0.06944411571256842,545,"Fair trade, oxygen for carbon dioxide."
2040,1,14,50,65,1.2461538461538462,0.05813929406858067,545,"Here we go, another wilting stare."
2040,3,10,52,65,1.2461538461538462,0.06589169884235313,545,"And in conclusion, I'll need watering once a week."
2040,1,14,50,65,1.2461538461538462,0.05813929406858067,545,he really put 100% into going green
2040,1,14,50,65,1.2461538461538462,0.05813929406858067,545,The most demoralizing thing is that CEO salaries are about 300 times higher than the average worker.
2040,2,12,51,65,1.2461538461538462,0.06213651700539812,545,They say he's an expert on growth.
2040,4,8,53,65,1.2461538461538462,0.06944411571256842,545,That was the day that 'Hail to the Chief' was replaced with 'Hail to the Kale'.
2040,2,12,51,65,1.2461538461538462,0.06213651700539812,545,"Be assured that in time I will earn your respect, until then continue to ignore me."
2040,3,10,52,65,1.2461538461538462,0.06589169884235313,545,Board gender diversity is one thing but if biodiversity takes root we're doomed.
2040,1,14,50,65,1.2461538461538462,0.05813929406858067,545,Well at least I've experienced significant growth.
2040,2,12,51,65,1.2461538461538462,0.06213651700539812,545,Don't make me do the burning bush thing!!!
2040,2,12,51,65,1.2461538461538462,0.06213651700539812,545,I'm afraid our decision is final. We've decided to turn over a new leaf!
2040,3,10,52,65,1.2461538461538462,0.06589169884235313,545,"""Before we proceed, just a reminder that my location in the southwest corner window is not negotiable""."
2040,3,10,52,65,1.2461538461538462,0.06589169884235313,545,Intercepted e-mails from our competitors suggest that one of us is a plant.
2040,2,12,51,65,1.2461538461538462,0.06213651700539812,545,"I dont know whether to salute, or water it."
2040,4,8,53,65,1.2461538461538462,0.06944411571256842,545,"We all support equality in the work place, but this is ridiculous."
2040,2,12,51,65,1.2461538461538462,0.06213651700539812,545,"When I learned you wanted to replace the plant, I assumed you meant our manufacturing facility."
2040,2,12,51,65,1.2461538461538462,0.06213651700539812,545,We need to cultivate a growth ethos.
2040,1,14,50,65,1.2461538461538462,0.05813929406858067,545,He's always been a bit of a flower child.
2040,2,12,51,65,1.2461538461538462,0.06213651700539812,545,"Sales are withering up, people. What the ficus going on?"
2040,3,10,52,65,1.2461538461538462,0.06589169884235313,545,This will only perpetuate the glass ceiling.
2040,3,10,52,65,1.2461538461538462,0.06589169884235313,545,It ain't easy being green.
2040,1,14,50,65,1.2461538461538462,0.05813929406858067,545,We're branching out!
2040,4,8,53,65,1.2461538461538462,0.06944411571256842,545,Going green begins with me!
2040,3,10,52,65,1.2461538461538462,0.06589169884235313,545,He came up through our undercover branch.
2040,4,8,53,65,1.2461538461538462,0.06944411571256842,545,Our company's commitment to going green starts right at the top.
2040,2,12,51,65,1.2461538461538462,0.06213651700539812,545,He's come a long way from plant manager!
2040,1,14,50,65,1.2461538461538462,0.05813929406858067,545,So you got elected. Now how do you govern?
2040,4,8,53,65,1.2461538461538462,0.06944411571256842,545,There's no glass ceiling in the forest!
2040,4,8,53,65,1.2461538461538462,0.06944411571256842,545,Some of you will be leafing.
2040,3,10,52,65,1.2461538461538462,0.06589169884235313,545,I think we are all painfully aware that the succulent was unable to attend today's board meeting.....
2040,6,4,55,65,1.2461538461538462,0.0760527689741738,545,The plant manager will be right in.
2040,3,10,52,65,1.2461538461538462,0.06589169884235313,545,There hasn't been quiet as much growth as we expected...
2040,0,16,49,65,1.2461538461538462,0.05384615384615385,545,It's part of our green initiative.
2226,4,8,54,66,1.2424242424242424,0.06848546733222884,545,Can someone please pass me some water.
2226,4,8,54,66,1.2424242424242424,0.06848546733222884,545,"Listen up, people! We're getting a new plant."
2226,3,10,53,66,1.2424242424242424,0.0649927593622037,545,"Strangely, no one besides us has even noticed a difference."
2226,1,14,51,66,1.2424242424242424,0.05737297131151901,545,I want to know which one of you overestimated this quarter's growth.
2226,2,12,52,66,1.2424242424242424,0.061301372768583655,545,It grew into a leadership position.
2226,5,6,55,66,1.2424242424242424,0.07180849324358678,545,HR is taking those studies on sentience quite seriously.
2226,0,16,50,66,1.2424242424242424,0.05315503147315329,545,I hear we're going green.
2233,1,13,49,63,1.2380952380952381,0.0586339007188704,545,All those in favor raise your frond.
2233,2,11,50,63,1.2380952380952381,0.06284876358057999,545,It's your turn to water him.
2233,3,9,51,63,1.2380952380952381,0.06679820247360645,545,Let's sell oxygen...
2233,2,11,50,63,1.2380952380952381,0.06284876358057999,545,It's a lot nicer than that horrid cactus last year.
2233,2,11,50,63,1.2380952380952381,0.06284876358057999,545,We are going to need a new plant manager.
2233,4,7,52,63,1.2380952380952381,0.07052682201689092,545,"May I have a glass of water, please?"
2233,4,7,52,63,1.2380952380952381,0.07052682201689092,545,Acme Paper Company has always been a family business.
2233,3,9,51,63,1.2380952380952381,0.06679820247360645,545,"Other than the language change, everything remains the same."
2233,2,11,50,63,1.2380952380952381,0.06284876358057999,545,Perhaps we should defer to the other Herb.
2233,3,9,51,63,1.2380952380952381,0.06679820247360645,545,I think he wants to be legalized?
2233,2,11,50,63,1.2380952380952381,0.06284876358057999,545,Do we have to Water It?
2233,4,7,52,63,1.2380952380952381,0.07052682201689092,545,I suggest that we empty our water glasses into the the pot and adjourn until tomorrow.
2233,4,7,52,63,1.2380952380952381,0.07052682201689092,545,He's not usually this quiet
2233,2,11,50,63,1.2380952380952381,0.06284876358057999,545,It's all gone to pot now that he's President Elect
2233,4,7,52,63,1.2380952380952381,0.07052682201689092,545,The irony is he was always a meat eater.
2233,2,11,50,63,1.2380952380952381,0.06284876358057999,545,I hear he only drinks water.
2233,3,9,51,63,1.2380952380952381,0.06679820247360645,545,She took over for the ficus who got the ax.
2233,3,9,51,63,1.2380952380952381,0.06679820247360645,545,"""As we are now Going Green, I thought I should set a good example.'"
2233,6,3,54,63,1.2380952380952381,0.07744738965256855,545,Did Mr. Trump get a new barber?
2233,2,11,50,63,1.2380952380952381,0.06284876358057999,545,"I thought we would be working at a power plant, not for one."
2233,2,11,50,63,1.2380952380952381,0.06284876358057999,545,A typical board meeting in Denver
2233,2,11,50,63,1.2380952380952381,0.06284876358057999,545,It just seems like he is always potted.
2233,3,9,51,63,1.2380952380952381,0.06679820247360645,545,Crack the glass ceiling and water the chairman.
2233,3,9,51,63,1.2380952380952381,0.06679820247360645,545,"""And that concludes our meeting"", now please get me some water""."
2233,3,9,51,63,1.2380952380952381,0.06679820247360645,545,I'm so tired of his hidden agenda.
2233,3,9,51,63,1.2380952380952381,0.06679820247360645,545,No one mention the aphids in the room.
2233,4,7,52,63,1.2380952380952381,0.07052682201689092,545,Brace yourself for another diatribe on seed funding...
2233,5,5,53,63,1.2380952380952381,0.07406797819503037,545,Who knew they were correct when they said ANY write in candidate could win this year.
2233,2,11,50,63,1.2380952380952381,0.06284876358057999,545,This carbon off-set program is getting out of hand
2233,4,7,52,63,1.2380952380952381,0.07052682201689092,545,The board considers the reductio ad absurdum result of their diversity initiatives
2233,2,11,50,63,1.2380952380952381,0.06284876358057999,545,It was hoped the new CEO would be a breathe of fresh air.
2233,4,7,52,63,1.2380952380952381,0.07052682201689092,545,Good news. We won't be closing any of our plants afterall.
2233,2,11,50,63,1.2380952380952381,0.06284876358057999,545,"Careful, I heard that the new CFO is a plant, a spy from the competition."
2233,4,7,52,63,1.2380952380952381,0.07052682201689092,545,A new level of boardroom diversity.
2233,1,13,49,63,1.2380952380952381,0.0586339007188704,545,I've been the plant for some time now.
2233,1,13,49,63,1.2380952380952381,0.0586339007188704,545,I hear Plant Management demanded a seat at the table.
2233,2,11,50,63,1.2380952380952381,0.06284876358057999,545,I wanted to inform you all of the plant takeover.
2233,3,9,51,63,1.2380952380952381,0.06679820247360645,545,"I'm glad he's gone, but maybe we've gone a bit too far in the other direction."
2233,4,7,52,63,1.2380952380952381,0.07052682201689092,545,Forsythia said to start without her
2233,2,11,50,63,1.2380952380952381,0.06284876358057999,545,Could someone please get us some water.
2233,2,11,50,63,1.2380952380952381,0.06284876358057999,545,"Okay people, let's hear some ideas from the Ivy League."
2233,3,9,51,63,1.2380952380952381,0.06679820247360645,545,The investors said they wanted more natural leadership.
2233,2,11,50,63,1.2380952380952381,0.06284876358057999,545,"Well, I'm not Brendan Sullivan. I'm a potted plant. That's my job."
2233,3,9,51,63,1.2380952380952381,0.06679820247360645,545,"Regretfully, I will be outsourcing all your jobs to a plant in China."
2233,1,13,49,63,1.2380952380952381,0.0586339007188704,545,It must be bugged.
2233,2,11,50,63,1.2380952380952381,0.06284876358057999,545,We'ed like to welcome you.
2233,2,11,50,63,1.2380952380952381,0.06284876358057999,545,I'm pleased to report that we're way ahead of our '2016 diversity in the workplace' goals.
2233,3,9,51,63,1.2380952380952381,0.06679820247360645,545,Did you hear? The new partner turns fertilizer into fresh air.
2233,2,11,50,63,1.2380952380952381,0.06284876358057999,545,I want to start the meeting with a report about our newest plants.
2233,1,13,49,63,1.2380952380952381,0.0586339007188704,545,It was at that moment we knew he was a plant from our competitor.
2233,1,13,49,63,1.2380952380952381,0.0586339007188704,545,"What, maybe you were expecting a burning bush?"
2233,3,9,51,63,1.2380952380952381,0.06679820247360645,545,Watch what you say! It looks like a plant.
2233,1,13,49,63,1.2380952380952381,0.0586339007188704,545,It's time this company got its hands dirty.
2233,2,11,50,63,1.2380952380952381,0.06284876358057999,545,I think this new VP might be a plant.
2233,5,5,53,63,1.2380952380952381,0.07406797819503037,545,"Meet the new moss, same as the ole moss."
2233,2,11,50,63,1.2380952380952381,0.06284876358057999,545,"Is it just me , or does the room smell fresher ? ."
2233,3,9,51,63,1.2380952380952381,0.06679820247360645,545,I just want everyone to know that I am hearing your concerns about our new green initiative and completely photosynthesize with you all.
2233,3,9,51,63,1.2380952380952381,0.06679820247360645,545,I see Mary Jane was voted in.
2233,3,9,51,63,1.2380952380952381,0.06679820247360645,545,"Listen, what I'm talking about here is a water and sunlight approach to growth"
2233,0,15,48,63,1.2380952380952381,0.054091603261625223,545,Our first order of business is to remove all blinds and let the light shine in.
2233,5,5,53,63,1.2380952380952381,0.07406797819503037,545,"Hey Trump, why don't ya make like a tree and leave?"
2233,2,11,50,63,1.2380952380952381,0.06284876358057999,545,Corporate said we needed a breath of fresh air.
2233,2,11,50,63,1.2380952380952381,0.06284876358057999,545,"That's it! Great meeting people. Say, would someone mist me on their way out?"
2233,1,13,49,63,1.2380952380952381,0.0586339007188704,545,We can't afford to rest on our laurels.
2233,3,9,51,63,1.2380952380952381,0.06679820247360645,545,"LGBTQ inclusive, yes. Gymnosperm inclusive, no!"
2233,3,9,51,63,1.2380952380952381,0.06679820247360645,545,I believe we should have more power plants in cities.
2233,2,11,50,63,1.2380952380952381,0.06284876358057999,545,"You're looking well fertilized this morning, Sir!"
2233,1,13,49,63,1.2380952380952381,0.0586339007188704,545,That'll teach Henderson to go out on a limb.
2233,4,7,52,63,1.2380952380952381,0.07052682201689092,545,He's going to run us into the dirt.
2233,3,9,51,63,1.2380952380952381,0.06679820247360645,545,I'm going to need a fern offer
2233,3,9,51,63,1.2380952380952381,0.06679820247360645,545,Of course the whole company is going to pot
2233,2,11,50,63,1.2380952380952381,0.06284876358057999,545,I'd like to call this meeting to water.
2233,4,7,52,63,1.2380952380952381,0.07052682201689092,545,I took the liberty of ordering in fertilizer for lunch.
2233,3,9,51,63,1.2380952380952381,0.06679820247360645,545,Are the implants that obvious?
2233,2,11,50,63,1.2380952380952381,0.06284876358057999,545,"As your new CEO, I pledge to never suck all the oxygen out of this room."
2233,3,9,51,63,1.2380952380952381,0.06679820247360645,545,Do you think he'll notice if we just get up and leaf?
2233,2,11,50,63,1.2380952380952381,0.06284876358057999,545,"My name is Fronds, not Franz."
2233,3,9,51,63,1.2380952380952381,0.06679820247360645,545,The election results have nothing to do with my leaving.
2233,3,9,51,63,1.2380952380952381,0.06679820247360645,545,"He may be a potted plant, but he's our potted plant."
2233,4,7,52,63,1.2380952380952381,0.07052682201689092,545,The boss seems to be in a good mood today.
2233,4,7,52,63,1.2380952380952381,0.07052682201689092,545,Let's welcome our very first vegetarian CEO!
2233,1,13,49,63,1.2380952380952381,0.0586339007188704,545,"Um, maybe it's better you use something other than ""leaves of absence."""
2233,4,7,52,63,1.2380952380952381,0.07052682201689092,545,The smartest guy in the room takes charge.
2233,4,7,52,63,1.2380952380952381,0.07052682201689092,545,His grandfather and his father were both elected.
2233,1,13,49,63,1.2380952380952381,0.0586339007188704,545,"Of course I want to sell Miracle Grow, but it's the last time I am going to personally test the new formula."
2233,1,13,49,63,1.2380952380952381,0.0586339007188704,545,I thought it was time this company turned over a new leaf.
2233,0,15,48,63,1.2380952380952381,0.054091603261625223,545,I think fertilizer would improve next quarter's growth forecast.
2233,3,9,51,63,1.2380952380952381,0.06679820247360645,545,"So, learning this by osmosis is not an option."
2233,5,5,53,63,1.2380952380952381,0.07406797819503037,545,"All I can say is, it's a time to reflect and grow."
2233,4,7,52,63,1.2380952380952381,0.07052682201689092,545,The day Flora took over.
2233,0,15,48,63,1.2380952380952381,0.054091603261625223,545,Maybe we should come back in the Spring.
2233,4,7,52,63,1.2380952380952381,0.07052682201689092,545,"When I read the meeting memo I assumed ""Future Company Plants"" was a typo"
2233,3,9,51,63,1.2380952380952381,0.06679820247360645,545,You're right. It does seem like it's on pot.
2233,3,9,51,63,1.2380952380952381,0.06679820247360645,545,It is time to turn over a new leaf.
2233,2,11,50,63,1.2380952380952381,0.06284876358057999,545,This merger has me feeling uprooted.
2233,1,13,49,63,1.2380952380952381,0.0586339007188704,545,"He may be green, but he kinda grows on you."
2233,3,9,51,63,1.2380952380952381,0.06679820247360645,545,I see that only Fred here has the respect and decency to go paperless.
2233,2,11,50,63,1.2380952380952381,0.06284876358057999,545,Don't underestimate me; I'm no shrinking violet.
2233,3,9,51,63,1.2380952380952381,0.06679820247360645,545,I guess a vegan diet really isn't for everyone...
2233,2,11,50,63,1.2380952380952381,0.06284876358057999,545,The new business model finally bore fruit
2233,2,11,50,63,1.2380952380952381,0.06284876358057999,545,"First item on the menu, company cutbacks. Who has the pruning shears?"
2233,3,9,51,63,1.2380952380952381,0.06679820247360645,545,I'm having a little trouble catching my breath. Would you mind each exhaling?
2233,2,11,50,63,1.2380952380952381,0.06284876358057999,545,"Once I'm legal, you won't be so surprised."
2233,1,13,49,63,1.2380952380952381,0.0586339007188704,545,Why are we all sitting around here like a bunch of potted plants?
2233,3,9,51,63,1.2380952380952381,0.06679820247360645,545,Good mulch is now our priority here.
2233,4,7,52,63,1.2380952380952381,0.07052682201689092,545,Growth has been flat again this quarter. That leaves us no choice; we're going to have to trim back.
2233,3,9,51,63,1.2380952380952381,0.06679820247360645,545,I'm firmly rooted in the decision to not move to Mexico.
2233,2,11,50,63,1.2380952380952381,0.06284876358057999,545,"Keep quiet, it's a plant."
2233,1,13,49,63,1.2380952380952381,0.0586339007188704,545,"From now on, no one touches the low-hanging fruit."
2233,3,9,51,63,1.2380952380952381,0.06679820247360645,545,Not what I had in mind when we pushed for greater diversity in upper management.
2233,5,5,53,63,1.2380952380952381,0.07406797819503037,545,As of today I am on indefinite leaf.
2233,2,11,50,63,1.2380952380952381,0.06284876358057999,545,Now that's change.
2233,2,11,50,63,1.2380952380952381,0.06284876358057999,545,The Green Jobs Initiative proves to be overly efficient.
2233,4,7,52,63,1.2380952380952381,0.07052682201689092,545,"Carry on, folks, I'm potted!"
2233,3,9,51,63,1.2380952380952381,0.06679820247360645,545,He has sunlight and water. We're not going anywhere.
2233,2,11,50,63,1.2380952380952381,0.06284876358057999,545,I'm pleased to announce that you have all voted in favor of keeping the plant open and operational.
2233,3,9,51,63,1.2380952380952381,0.06679820247360645,545,"Really you can talk to me, I'm listening. But first a glass of water."
2233,3,9,51,63,1.2380952380952381,0.06679820247360645,545,They say he is quiet at first.
2233,3,9,51,63,1.2380952380952381,0.06679820247360645,545,Tell us about your impressive growth during the recession.
2233,1,13,49,63,1.2380952380952381,0.0586339007188704,545,I called this meeting to discuss growth patterns.
2233,1,13,49,63,1.2380952380952381,0.0586339007188704,545,"""Do we call him 'Phil' or 'Mr. Philodendron'?"
2233,3,9,51,63,1.2380952380952381,0.06679820247360645,545,It's time to do some pruning around here.
2233,1,13,49,63,1.2380952380952381,0.0586339007188704,545,"Suppose we don't water him, er, it?"
2233,2,11,50,63,1.2380952380952381,0.06284876358057999,545,"I said we need to synergize, not photosynthesize."
2233,3,9,51,63,1.2380952380952381,0.06679820247360645,545,"Can I get some water, please?"
2358,3,9,52,64,1.234375,0.06585136695439135,545,He was way too prickly–– it was time the board supplanted him.
2358,4,7,53,64,1.234375,0.06951571243822256,545,"Once he is planted there, he takes a while to branch out."
2358,2,11,51,64,1.234375,0.061970725215460876,545,"Well, it's more positive than that cactus last time."
2358,5,5,54,64,1.234375,0.07299634252361824,545,Where is MY cup of water??
2362,3,9,53,65,1.2307692307692308,0.06493055006205434,545,Used some computer generated headhunting process.
2363,2,10,50,62,1.2258064516129032,0.06263791695329896,545,"Alright, chairpeople. Someone in this room is not who they seem."
2363,1,12,49,62,1.2258064516129032,0.058263950350759514,545,A glass of water might help.
2363,2,10,50,62,1.2258064516129032,0.06263791695329896,545,Our top priority will be addressing global warming.
2363,1,12,49,62,1.2258064516129032,0.058263950350759514,545,"Before he departed he left that plant with this note: ""The company's going to pot!"""
2363,3,8,51,62,1.2258064516129032,0.06672577740289717,545,Well just don't sit there like a bunch of potted plants!
2363,2,10,50,62,1.2258064516129032,0.06263791695329896,545,The board finally finds a chairman receptive to their fertilizer.
2363,1,12,49,62,1.2258064516129032,0.058263950350759514,545,"It's plastic, right?"
2363,2,10,50,62,1.2258064516129032,0.06263791695329896,545,Our Green initiatives are out of hand.
2363,1,12,49,62,1.2258064516129032,0.058263950350759514,545,I think we took the new green initiative a little too far.
2363,1,12,49,62,1.2258064516129032,0.058263950350759514,545,I think he took the vegetarian challenge too seriously.
2363,2,10,50,62,1.2258064516129032,0.06263791695329896,545,What a waste of CO2.
2363,2,10,50,62,1.2258064516129032,0.06263791695329896,545,Let's get to the root of the problem.
2363,0,14,48,62,1.2258064516129032,0.053533794753437405,545,The new plant manager's goal was improving the work atmosphere.
2363,2,10,50,62,1.2258064516129032,0.06263791695329896,545,If it quacks like a duck...
2363,1,12,49,62,1.2258064516129032,0.058263950350759514,545,The new plant manager had few words
2363,3,8,51,62,1.2258064516129032,0.06672577740289717,545,The boss wants us to talk to his plant while he's on vacation.
2363,3,8,51,62,1.2258064516129032,0.06672577740289717,545,Let me just plant in idea in your head for a second.
2363,3,8,51,62,1.2258064516129032,0.06672577740289717,545,This seems like a case of corporate espionage. I suspect there may be a plant in this room.
2363,2,10,50,62,1.2258064516129032,0.06263791695329896,545,"In light of our recent election, CEO Leaf Eriksson, promised to ramp up CO2 removal efforts by bringing in more plants."
2363,2,10,50,62,1.2258064516129032,0.06263791695329896,545,She won’t downsize but she will ‘bonsai’ our board.
2363,3,8,51,62,1.2258064516129032,0.06672577740289717,545,"All in favor of going green, say aye."
2363,3,8,51,62,1.2258064516129032,0.06672577740289717,545,I was wondering how this blind trust would operate.
2363,1,12,49,62,1.2258064516129032,0.058263950350759514,545,Not sure planting a seed always gets the best results.
2363,1,12,49,62,1.2258064516129032,0.058263950350759514,545,"As Mr. Trump's replacement, are you fine with keeping the 'climate change is a hoax' line?"
2363,4,6,52,62,1.2258064516129032,0.07057726333454416,545,Watch what you say. Seems that we have a plant from the competition.
2363,5,4,53,62,1.2258064516129032,0.07422917775084267,545,How did we let this happen?
2363,4,6,52,62,1.2258064516129032,0.07057726333454416,545,"I forgot that today is ""Bring Your Begonia to Work Day!"""
2363,5,4,53,62,1.2258064516129032,0.07422917775084267,545,"Embrace the change. Old fashioned leadership is for the birds. We all know about birds... really, really bad and do nasty things... you just don't wanna know. Terrible, awful things."
2363,3,8,51,62,1.2258064516129032,0.06672577740289717,545,Go ahead. Check me for bugs if you'd like.
2363,3,8,51,62,1.2258064516129032,0.06672577740289717,545,"Unfortunately, I can only assist the team if one of you has a medically debilitating condition."
2363,3,8,51,62,1.2258064516129032,0.06672577740289717,545,The Board brought me in because I've always been focused on sustainable growth.
2363,3,8,51,62,1.2258064516129032,0.06672577740289717,545,"As your new CEO, I feel it's my duty to tell you that there are big changes in the works here at Green Giant."
2363,2,10,50,62,1.2258064516129032,0.06263791695329896,545,He's the new Plant CEO.
2363,3,8,51,62,1.2258064516129032,0.06672577740289717,545,It's supposed to clear the air.
2363,1,12,49,62,1.2258064516129032,0.058263950350759514,545,His personality could use some work.
2363,2,10,50,62,1.2258064516129032,0.06263791695329896,545,"Yes, it's his only solution to global warming ."
2363,1,12,49,62,1.2258064516129032,0.058263950350759514,545,Good news: the new branch has experienced tremendous growth this quarter.
2363,2,10,50,62,1.2258064516129032,0.06263791695329896,545,"Now with Russell's departure, one of you will become my new Branch Manager."
2363,5,4,53,62,1.2258064516129032,0.07422917775084267,545,"Well, at least it's not orange."
2363,1,12,49,62,1.2258064516129032,0.058263950350759514,545,I've decided who will head our newest branch office.
2363,2,10,50,62,1.2258064516129032,0.06263791695329896,545,...and I want EVERYONE to start thinking more organically!
2363,3,8,51,62,1.2258064516129032,0.06672577740289717,545,I am the most intelligent President this country has ever had
2363,3,8,51,62,1.2258064516129032,0.06672577740289717,545,"Perhaps I haven't grown with the company, but where can you find horse manure these days?"
2363,2,10,50,62,1.2258064516129032,0.06263791695329896,545,"Sure the new CEO is a little green, but our company's salad days have clearly returned."
2363,2,10,50,62,1.2258064516129032,0.06263791695329896,545,Its going to take a long time for us to grow.
2363,0,14,48,62,1.2258064516129032,0.053533794753437405,545,Annual reports are rosy and perennials have grown steadily.
2363,3,8,51,62,1.2258064516129032,0.06672577740289717,545,"Well, at least this is an upgrade from that dart throwing chimp."
2363,3,8,51,62,1.2258064516129032,0.06672577740289717,545,It's time to go green.
2363,2,10,50,62,1.2258064516129032,0.06263791695329896,545,notice how our CEO is looking a little green around the gills lately
2363,2,10,50,62,1.2258064516129032,0.06263791695329896,545,We're reducing our carbon footprint.
2363,1,12,49,62,1.2258064516129032,0.058263950350759514,545,Could someone get me a glass of water as well.
2363,4,6,52,62,1.2258064516129032,0.07057726333454416,545,The name is Mendel--James Mendel.
2363,2,10,50,62,1.2258064516129032,0.06263791695329896,545,Something must be up. He's unusually quiet today.
2363,1,12,49,62,1.2258064516129032,0.058263950350759514,545,She is WAY better than the rutabaga.
2363,3,8,51,62,1.2258064516129032,0.06672577740289717,545,"Hello coworkers, I have a very personal confession... i'm really into pot."
2363,3,8,51,62,1.2258064516129032,0.06672577740289717,545,"If you remember me for one thing, 'Stay Hydrated.'"
2363,2,10,50,62,1.2258064516129032,0.06263791695329896,545,I bet you wish you had taken M. Night Shyamalan just a bit more seriously.
2363,2,10,50,62,1.2258064516129032,0.06263791695329896,545,"In this company, don't forget who produces the oxygen."
2363,2,10,50,62,1.2258064516129032,0.06263791695329896,545,Apparently he used to do seed funding.
2363,2,10,50,62,1.2258064516129032,0.06263791695329896,545,"Congratulations Mr. President elect, we are here to help you grow into the job"
2363,1,12,49,62,1.2258064516129032,0.058263950350759514,545,What are your thoughts on branching out?
2363,1,12,49,62,1.2258064516129032,0.058263950350759514,545,We've gone totally green.
2363,3,8,51,62,1.2258064516129032,0.06672577740289717,545,"In light of our low third quarter earnings, I'd say this is no time to celebrate and respectfully request that no one decorate me this year."
2363,4,6,52,62,1.2258064516129032,0.07057726333454416,545,"Well, it couldn't be any worse than the last guy."
2363,2,10,50,62,1.2258064516129032,0.06263791695329896,545,What do you people take me for: a sap?
2363,2,10,50,62,1.2258064516129032,0.06263791695329896,545,"Well, 'going green' has gotten quite bizarre!"
2363,2,10,50,62,1.2258064516129032,0.06263791695329896,545,I think the Green Party could have a winning candidate this election.
2363,4,6,52,62,1.2258064516129032,0.07057726333454416,545,Any other questions?
2363,3,8,51,62,1.2258064516129032,0.06672577740289717,545,The company's going green.
2363,3,8,51,62,1.2258064516129032,0.06672577740289717,545,The Cannabis Board and its CEO
2363,1,12,49,62,1.2258064516129032,0.058263950350759514,545,Just don't mention shovel-ready projects.
2363,3,8,51,62,1.2258064516129032,0.06672577740289717,545,I wasn't expecting this to be the end result from our GMO research.
2363,3,8,51,62,1.2258064516129032,0.06672577740289717,545,"As chairman, I want you all to act natural."
2363,5,4,53,62,1.2258064516129032,0.07422917775084267,545,You're all being replaced.
2363,2,10,50,62,1.2258064516129032,0.06263791695329896,545,The President-elect has asked me to renegotiate the Paris Agreement since I seem to know the most about CO2.
2363,3,8,51,62,1.2258064516129032,0.06672577740289717,545,Looks like he's a little Green.
2363,3,8,51,62,1.2258064516129032,0.06672577740289717,545,"The pot may be legal, but I still say it's a plant."
2363,3,8,51,62,1.2258064516129032,0.06672577740289717,545,And to think it used to be illegal.
2363,1,12,49,62,1.2258064516129032,0.058263950350759514,545,If it can make so much money in Colorado it must be able to save our company.
2363,3,8,51,62,1.2258064516129032,0.06672577740289717,545,I'm pleaded to report that stalks are up.
2363,4,6,52,62,1.2258064516129032,0.07057726333454416,545,Say nothing it's a plant
2363,3,8,51,62,1.2258064516129032,0.06672577740289717,545,"Careful, I think this guy's a plant from the HR Department"
2363,3,8,51,62,1.2258064516129032,0.06672577740289717,545,"Here at Acme, we are a model of employee biodiversity."
2363,1,12,49,62,1.2258064516129032,0.058263950350759514,545,Does anyone know who the plant is?
2363,3,8,51,62,1.2258064516129032,0.06672577740289717,545,So you're saying I'M the perennial problem?
2363,3,8,51,62,1.2258064516129032,0.06672577740289717,545,No...I suppose an ant can't move a rubber tree plant. Why do you ask?
2363,4,6,52,62,1.2258064516129032,0.07057726333454416,545,"We sell medical marijuana; we wanted a pot plant, not a potted plant."
2363,3,8,51,62,1.2258064516129032,0.06672577740289717,545,"What, you expected me to change after you elected me?"
2363,4,6,52,62,1.2258064516129032,0.07057726333454416,545,I think management overcommitted to going green.
2363,3,8,51,62,1.2258064516129032,0.06672577740289717,545,Forget our proposal of cutting branches....let´s look for savings somewhere else...
2363,4,6,52,62,1.2258064516129032,0.07057726333454416,545,"Well, at least it's not Donald Trump."
2363,1,12,49,62,1.2258064516129032,0.058263950350759514,545,OK mouth breathers thank you for your service its time for me to leaf.
2363,5,4,53,62,1.2258064516129032,0.07422917775084267,545,"Well now, I see California's on board!!"
2363,3,8,51,62,1.2258064516129032,0.06672577740289717,545,Who is going to read out the attached note?
2363,1,12,49,62,1.2258064516129032,0.058263950350759514,545,Let's talk about the new plant opening.
2363,2,10,50,62,1.2258064516129032,0.06263791695329896,545,"Thank you, Melvin, for watering me."
2363,4,6,52,62,1.2258064516129032,0.07057726333454416,545,Can we get an update on plant operations?
2363,1,12,49,62,1.2258064516129032,0.058263950350759514,545,Welcome to our new branch of government.
2363,3,8,51,62,1.2258064516129032,0.06672577740289717,545,Going green should have it's limits
2363,3,8,51,62,1.2258064516129032,0.06672577740289717,545,"As leader of the Green Party, I think we have a real chance in 2020"
2363,1,12,49,62,1.2258064516129032,0.058263950350759514,545,She's really flourishing in this position
2363,2,10,50,62,1.2258064516129032,0.06263791695329896,545,Looks like the vacation really agreed with him.
2363,1,12,49,62,1.2258064516129032,0.058263950350759514,545,Has he been vetted? I think he's a plant.
2363,4,6,52,62,1.2258064516129032,0.07057726333454416,545,Who called me a potted plant?
2363,2,10,50,62,1.2258064516129032,0.06263791695329896,545,"Now remember: By the end of the month, whoever beats the Dow Jones Industrials average by the most, will get to take that plant home with them!"
2363,1,12,49,62,1.2258064516129032,0.058263950350759514,545,Aren't we taking this environmental commitment thing a bit too far.
2363,4,6,52,62,1.2258064516129032,0.07057726333454416,545,"Yes, Mr. President?"
2363,2,10,50,62,1.2258064516129032,0.06263791695329896,545,"More direct sunlight people, it's where the business is headed."
2363,6,2,54,62,1.2258064516129032,0.07770966194327965,545,"I'm not a plant, believe me. I'm the president elect."
2363,1,12,49,62,1.2258064516129032,0.058263950350759514,545,I've heard you don't beat around the bush with this one.
2363,2,10,50,62,1.2258064516129032,0.06263791695329896,545,"Less talking, more watering."
2363,2,10,50,62,1.2258064516129032,0.06263791695329896,545,Can someone turn the temperature down...it's like a hothouse in here!
2363,3,8,51,62,1.2258064516129032,0.06672577740289717,545,"He doesn't have a lot of experience, but corporate said we had to go green."
2363,2,10,50,62,1.2258064516129032,0.06263791695329896,545,Let's not discuss company secrets now; there seems to be a plant in the room...
2363,3,8,51,62,1.2258064516129032,0.06672577740289717,545,Welcome to the Task Force on Biodiversity.
2363,1,12,49,62,1.2258064516129032,0.058263950350759514,545,"His communication skills aren't great, but he sure is easy on the eyes."
2363,2,10,50,62,1.2258064516129032,0.06263791695329896,545,I think we have to have the mindset of one trying to come up with a New Yorker cartoon caption.
2363,3,8,51,62,1.2258064516129032,0.06672577740289717,545,After her recent promotion Fern began leading weekly meetings.
2363,3,8,51,62,1.2258064516129032,0.06672577740289717,545,"Due to corporate restructuring, I'm sorry to say you've all been pruned."
2363,4,6,52,62,1.2258064516129032,0.07057726333454416,545,Our CEO is a GMO.
2363,3,8,51,62,1.2258064516129032,0.06672577740289717,545,The board should have elected the lizard. At least it had a brain.
2363,2,10,50,62,1.2258064516129032,0.06263791695329896,545,"I understand you want the company to grow, sir, but I don't think now is the right time to branch out."
2363,2,10,50,62,1.2258064516129032,0.06263791695329896,545,Maybe we've taken the green CEO concept too far.
2363,3,8,51,62,1.2258064516129032,0.06672577740289717,545,"""What am I? A potted plant?"
2363,3,8,51,62,1.2258064516129032,0.06672577740289717,545,I heard he took his MBA at Biodiversity.
2363,2,10,50,62,1.2258064516129032,0.06263791695329896,545,"The point is, ladies and gentleman, that green, for lack of a better word, is good."
2363,2,10,50,62,1.2258064516129032,0.06263791695329896,545,What the shareholders want is organic growth.
2363,3,8,51,62,1.2258064516129032,0.06672577740289717,545,Don't mention that you are vegan.
2363,2,10,50,62,1.2258064516129032,0.06263791695329896,545,Jones did say to look out for a Management plant at this meeting.
2363,3,8,51,62,1.2258064516129032,0.06672577740289717,545,"Wait a minute, I'm germinating a new idea."
2363,4,6,52,62,1.2258064516129032,0.07057726333454416,545,He believed in reincarnation and refused to resigm
2363,3,8,51,62,1.2258064516129032,0.06672577740289717,545,At least he's less of a wall flower than the last guy
2363,0,14,48,62,1.2258064516129032,0.053533794753437405,545,Just another in a long line of bad metaphors.
2363,4,6,52,62,1.2258064516129032,0.07057726333454416,545,A plant could run america better than Donald Trump.
2363,0,14,48,62,1.2258064516129032,0.053533794753437405,545,Naming me CEO still doesn't make us a green company.
2363,2,10,50,62,1.2258064516129032,0.06263791695329896,545,Not a word about the merger--it's obviously a plant.
2363,4,6,52,62,1.2258064516129032,0.07057726333454416,545,Apparently he used to be one of Trump's top advisers.
2363,1,12,49,62,1.2258064516129032,0.058263950350759514,545,I guess she really got potted last night.
2363,2,10,50,62,1.2258064516129032,0.06263791695329896,545,I told you reincarnation is real!
2363,3,8,51,62,1.2258064516129032,0.06672577740289717,545,Is it GMO?
2363,1,12,49,62,1.2258064516129032,0.058263950350759514,545,She never forgets her roots.
2363,0,14,48,62,1.2258064516129032,0.053533794753437405,545,Bob couldn't be here so he sent the plant manager.
2363,2,10,50,62,1.2258064516129032,0.06263791695329896,545,My lineage? Leaf Erikson. Why do you ask?
2363,4,6,52,62,1.2258064516129032,0.07057726333454416,545,Unsettling news from my pal the White House Christmas tree… the Obamas are moving to Canada.
2363,4,6,52,62,1.2258064516129032,0.07057726333454416,545,I'd like to introduce Mr. Spruce from our branch office.
2363,2,10,50,62,1.2258064516129032,0.06263791695329896,545,"Well, am I diverse enough for this committee!?"
2363,2,10,50,62,1.2258064516129032,0.06263791695329896,545,This business has gone to pot.
2363,3,8,51,62,1.2258064516129032,0.06672577740289717,545,Ever see 'Little Shop of Horrors?'
2363,1,12,49,62,1.2258064516129032,0.058263950350759514,545,I think it's time for the company to turn over a new leaf.
2363,0,14,48,62,1.2258064516129032,0.053533794753437405,545,What are we not seeing???
2363,4,6,52,62,1.2258064516129032,0.07057726333454416,545,I've been elected President. I am declaring a permanent vegetative state.
2363,1,12,49,62,1.2258064516129032,0.058263950350759514,545,His compensation package is a mix of stock options and core mineral nutrients
2363,1,12,49,62,1.2258064516129032,0.058263950350759514,545,This wasn't what I meant when I said the company needed to get back to its roots.
2363,2,10,50,62,1.2258064516129032,0.06263791695329896,545,"Hello, my name is Phyl and I'll be taking over for the late Mr. Stemsley. But he'll be here in spirit, as his wife had him composted."
2363,2,10,50,62,1.2258064516129032,0.06263791695329896,545,Whose turn is it to water him?
2363,0,14,48,62,1.2258064516129032,0.053533794753437405,545,"This month's growth is through the roof! But anyway, let's get back on topic."
2363,2,10,50,62,1.2258064516129032,0.06263791695329896,545,"So far, our slow growth plan seems to be working."
2363,2,10,50,62,1.2258064516129032,0.06263791695329896,545,I'd like this meeting to come to arbor.
2363,3,8,51,62,1.2258064516129032,0.06672577740289717,545,I'm going to ask for a raise while he's still green.
2363,4,6,52,62,1.2258064516129032,0.07057726333454416,545,I'm forecasting growth. I can just feel it.
2363,1,12,49,62,1.2258064516129032,0.058263950350759514,545,I AM the North American plant. Don't forget that.
2363,3,8,51,62,1.2258064516129032,0.06672577740289717,545,It was brought in to offer a breath of fresh air.
2363,2,10,50,62,1.2258064516129032,0.06263791695329896,545,"I know Luther said he wanted us to ""go green,"" but did you think this is what he meant?"
2363,2,10,50,62,1.2258064516129032,0.06263791695329896,545,"Oh, yes sir, wonderful idea! Poinsettias would make excellent holiday bonuses in lieu of cash!"
2363,5,4,53,62,1.2258064516129032,0.07422917775084267,545,The public has been demanding a greener leadership
2363,1,12,49,62,1.2258064516129032,0.058263950350759514,545,Unfortunately we have been charged with taxonomy evasion.
2363,3,8,51,62,1.2258064516129032,0.06672577740289717,545,"Damn the reward, we cannot risk our seed capital."
2363,1,12,49,62,1.2258064516129032,0.058263950350759514,545,I hate it when we all have to face the sun.
2363,3,8,51,62,1.2258064516129032,0.06672577740289717,545,"Now that marijuana is legal , we thought it would be best to bring in a ceo with roots in the industry."
2363,5,4,53,62,1.2258064516129032,0.07422917775084267,545,The company is taking the concept of plant manager a little too far.
2363,2,10,50,62,1.2258064516129032,0.06263791695329896,545,"By quarter's end, we'll be 100 percent green."
2363,3,8,51,62,1.2258064516129032,0.06672577740289717,545,"While we always said he could be replaced by one, who knew it would increase revenue by 11 per cent?"
2363,3,8,51,62,1.2258064516129032,0.06672577740289717,545,I always suspected we had a plant.
2363,3,8,51,62,1.2258064516129032,0.06672577740289717,545,We appointed him because we thought we could control him.
2363,2,10,50,62,1.2258064516129032,0.06263791695329896,545,At this point we thought we would give Bush another term
2363,4,6,52,62,1.2258064516129032,0.07057726333454416,545,"I can't do it all by myself, so let's invest in nuclear."
2363,3,8,51,62,1.2258064516129032,0.06672577740289717,545,"He can call it ""deadheading."" But I call it ""layoffs."""
2363,4,6,52,62,1.2258064516129032,0.07057726333454416,545,I know what you're all thinking; the only reason I got this job is cause I'm a fern.
2363,5,4,53,62,1.2258064516129032,0.07422917775084267,545,I'm not going to say it first - but - this company has gone to pot!
2363,1,12,49,62,1.2258064516129032,0.058263950350759514,545,Everyone OK for water?
2363,4,6,52,62,1.2258064516129032,0.07057726333454416,545,The polls all said it would be the potted palm.
2363,4,6,52,62,1.2258064516129032,0.07057726333454416,545,These dang fern-ers are takin all the good jobs!
2363,1,12,49,62,1.2258064516129032,0.058263950350759514,545,I think the boss has gone a little too green.
2363,1,12,49,62,1.2258064516129032,0.058263950350759514,545,I'd say we're looking at a slow and steady upward growth strategy.
2363,1,12,49,62,1.2258064516129032,0.058263950350759514,545,He makes a compelling argument for half of the company portfolio being invested in Miracle-Gro
2363,3,8,51,62,1.2258064516129032,0.06672577740289717,545,"I know, ""Photosynthesis for Dummies""!"
2363,2,10,50,62,1.2258064516129032,0.06263791695329896,545,"Maybe if we ignore him, he'll just leave."
2363,2,10,50,62,1.2258064516129032,0.06263791695329896,545,One word: Vegan.
2363,2,10,50,62,1.2258064516129032,0.06263791695329896,545,Is that considered recreational for our break times or medical because we can't stand our jobs?
2363,3,8,51,62,1.2258064516129032,0.06672577740289717,545,Our transition to a growth company is now complete.
2363,4,6,52,62,1.2258064516129032,0.07057726333454416,545,Our competition planted the seeds of doubt and look what happened.
2363,5,4,53,62,1.2258064516129032,0.07422917775084267,545,No pension worries or big bonus payouts and it clears the air. Let's vote.
2363,2,10,50,62,1.2258064516129032,0.06263791695329896,545,Please. Stay the course. Growth is still possible.
2363,2,10,50,62,1.2258064516129032,0.06263791695329896,545,It's OK to use your outdoor voices.
2363,1,12,49,62,1.2258064516129032,0.058263950350759514,545,It is what the chairman can do that none of the rest of us can - photosynthesis.
2363,1,12,49,62,1.2258064516129032,0.058263950350759514,545,"In hindsight, we should've run you against Trump."
2363,2,10,50,62,1.2258064516129032,0.06263791695329896,545,Anybody speak plant?
2363,2,10,50,62,1.2258064516129032,0.06263791695329896,545,It was his last wish.....
2363,4,6,52,62,1.2258064516129032,0.07057726333454416,545,I had heard he was vegan
2363,3,8,51,62,1.2258064516129032,0.06672577740289717,545,What kind of board are we if the chairman won't even trust us to save his seat?
2363,0,14,48,62,1.2258064516129032,0.053533794753437405,545,His final resting place.
2363,2,10,50,62,1.2258064516129032,0.06263791695329896,545,The only reason the firm promoted him is because it wants to project a more environmentally friendly image.
2363,5,4,53,62,1.2258064516129032,0.07422917775084267,545,"Admit it, I've been growing in you."
2363,4,6,52,62,1.2258064516129032,0.07057726333454416,545,He almost didn't show up when he heard we're meeting in a board room.
2363,2,10,50,62,1.2258064516129032,0.06263791695329896,545,What did you expect when you voted for cannabis?
2363,2,10,50,62,1.2258064516129032,0.06263791695329896,545,"As you can see, I've been deflowered."
2363,4,6,52,62,1.2258064516129032,0.07057726333454416,545,Aphids.
2363,0,14,48,62,1.2258064516129032,0.053533794753437405,545,"If chosen, I want to assure you all that your offices will have more windows and natural light."
2363,2,10,50,62,1.2258064516129032,0.06263791695329896,545,Global Warming: Crisis or Opportunity? Discuss.
2572,3,8,52,63,1.2222222222222223,0.06575585358598524,545,We're investing in more scarecrows; end of discussion.
2572,1,12,50,63,1.2222222222222223,0.05744359616725745,545,It's like talking to a plant
2572,2,10,51,63,1.2222222222222223,0.06173977251921359,545,It's the Board's new emphasis on different kinds of synthesis.
2572,1,12,50,63,1.2222222222222223,0.05744359616725745,545,The next item of business is the watering schedule.
2572,5,4,54,63,1.2222222222222223,0.07312932258004377,545,I think we now have enough evidence to go ahead with our genetic engineering plans.
2572,3,8,52,63,1.2222222222222223,0.06575585358598524,545,It's always great to see the lawyers get promoted.
2572,4,6,53,63,1.2222222222222223,0.06954038431673219,545,It's going to be harder to move the plants to Mexico now.
2572,5,4,54,63,1.2222222222222223,0.07312932258004377,545,The meeting of the John Birch Society will come to order.
2580,2,10,52,64,1.21875,0.060866551595885596,545,"When the chairman said he was going to pot, I didn't take him literally."
2581,2,9,50,61,1.2131147540983607,0.06235257628675809,545,"You do realize that 'Going Green' has its limits, right?"
2581,2,9,50,61,1.2131147540983607,0.06235257628675809,545,Ladies and gentleman---We are going green!
2581,2,9,50,61,1.2131147540983607,0.06235257628675809,545,"You folks need to liven up. Drink the water, it does wonders."
2581,2,9,50,61,1.2131147540983607,0.06235257628675809,545,"With me in charge, this business is going to blossom!"
2581,2,9,50,61,1.2131147540983607,0.06235257628675809,545,I believe we've invested enough in plant and equipment.
2581,4,5,52,61,1.2131147540983607,0.07057435755612214,545,Do we keep minutes at a perennial meeting?
2581,2,9,50,61,1.2131147540983607,0.06235257628675809,545,One of us is a plant.
2581,2,9,50,61,1.2131147540983607,0.06235257628675809,545,Something tells me this new guy is going to be a despot.
2581,3,7,51,61,1.2131147540983607,0.06659047872652427,545,careful what you say-- it could be a pot plant
2581,3,7,51,61,1.2131147540983607,0.06659047872652427,545,"As you can see, we brought the new plant on line ahead of schedule and under budget."
2581,4,5,52,61,1.2131147540983607,0.07057435755612214,545,I think Mr. Jones has taken this vegan thing too far
2581,2,9,50,61,1.2131147540983607,0.06235257628675809,545,There may be some lingering resentment.
2581,4,5,52,61,1.2131147540983607,0.07057435755612214,545,Let's talk about growth.
2581,1,11,49,61,1.2131147540983607,0.057804806739269465,545,I'm leaving the plant.
2581,4,5,52,61,1.2131147540983607,0.07057435755612214,545,I would like to introduce the new Chair of our perennial board meeting.
2581,3,7,51,61,1.2131147540983607,0.06659047872652427,545,...and silence swept the room.
2581,1,11,49,61,1.2131147540983607,0.057804806739269465,545,"I know they wanted us to go green, but this is a bit much"
2581,0,13,48,61,1.2131147540983607,0.05286726392326918,545,It was the board's answer to run-away executive compensation.
2581,2,9,50,61,1.2131147540983607,0.06235257628675809,545,"I'll tell you a little about me.My roots were in the GMO Research field, but then I decided to get my MBA."
2581,2,9,50,61,1.2131147540983607,0.06235257628675809,545,"Sober or potted, Cupsworth runs a good meeting."
2581,3,7,51,61,1.2131147540983607,0.06659047872652427,545,The consultants insisted we invest in our physical plant.
2581,3,7,51,61,1.2131147540983607,0.06659047872652427,545,"Uh oh, you forgot his water!"
2581,2,9,50,61,1.2131147540983607,0.06235257628675809,545,Can someone please show me where the water cooler is?
2581,2,9,50,61,1.2131147540983607,0.06235257628675809,545,"""I've had an epiphany! We're going green!"
2581,3,7,51,61,1.2131147540983607,0.06659047872652427,545,Disregard that rumor that I'm a plant by our competitor.
2581,3,7,51,61,1.2131147540983607,0.06659047872652427,545,So - that's the new plant CEO I take it...
2581,2,9,50,61,1.2131147540983607,0.06235257628675809,545,"Yeah, yeah, we knew you'd leave eventually."
2581,2,9,50,61,1.2131147540983607,0.06235257628675809,545,We thought we would be just as well off with a potted plant.
2581,1,11,49,61,1.2131147540983607,0.057804806739269465,545,'I believe in having a growth mindset.'
2581,1,11,49,61,1.2131147540983607,0.057804806739269465,545,We remain unwavering in our commitment to growth.
2581,3,7,51,61,1.2131147540983607,0.06659047872652427,545,I know what your all thinking - that I'm a plant from corporate.
2581,5,3,53,61,1.2131147540983607,0.07434506057493712,545,"Well, he has changed his hairstyle since the election but he still can only talk dirt."
2581,2,9,50,61,1.2131147540983607,0.06235257628675809,545,"If you ask me, our seed funders made a smart move."
2581,2,9,50,61,1.2131147540983607,0.06235257628675809,545,You think those are real?
2581,0,13,48,61,1.2131147540983607,0.05286726392326918,545,The only reason he was elected was because of his willingness to branch out.
2581,4,5,52,61,1.2131147540983607,0.07057435755612214,545,"If Trump is President of the United States, I guess the board figured a plant can be President of the Trump Foundation."
2581,1,11,49,61,1.2131147540983607,0.057804806739269465,545,Growth through leadership.
2581,4,5,52,61,1.2131147540983607,0.07057435755612214,545,No one can argue the promotion did go to the hardest worker.
2581,2,9,50,61,1.2131147540983607,0.06235257628675809,545,Does anyone here ever get the impression that he never takes any of our ideas seriously ?
2581,1,11,49,61,1.2131147540983607,0.057804806739269465,545,This isn't what I meant when I said we need to branch out.
2581,4,5,52,61,1.2131147540983607,0.07057435755612214,545,"Okay, so I'll be leaving this fall, and I need someone to fill in for me."
2581,0,13,48,61,1.2131147540983607,0.05286726392326918,545,They must have replaced the elephant.
2581,3,7,51,61,1.2131147540983607,0.06659047872652427,545,Did someone say organic growth?
2581,5,3,53,61,1.2131147540983607,0.07434506057493712,545,"Kale, kale, the gangs all here."
2581,2,9,50,61,1.2131147540983607,0.06235257628675809,545,"#When he said he was going to pot I didn't think it would be like this!"""
2581,3,7,51,61,1.2131147540983607,0.06659047872652427,545,Its golden parachute is a planter at the Brooklyn Botanic Gardens.
2581,2,9,50,61,1.2131147540983607,0.06235257628675809,545,I am not going to sit here like a potted plant!
2581,3,7,51,61,1.2131147540983607,0.06659047872652427,545,"With a little nurturing, I expect us to see exponential growth the next quarter."
2581,1,11,49,61,1.2131147540983607,0.057804806739269465,545,"Careful, he's from the competition!"
2581,3,7,51,61,1.2131147540983607,0.06659047872652427,545,The board would like to replace you with a ficus.
2581,2,9,50,61,1.2131147540983607,0.06235257628675809,545,"If you don’t do your jobs, you’ll all be replaced by plants."
2581,4,5,52,61,1.2131147540983607,0.07057435755612214,545,Damn! Was it Marketing or HR that was supposed to water the chief this week?
2581,2,9,50,61,1.2131147540983607,0.06235257628675809,545,I wish I had paid more attention in Botany class.
2581,2,9,50,61,1.2131147540983607,0.06235257628675809,545,This company needs more BIO-diversity.
2581,3,7,51,61,1.2131147540983607,0.06659047872652427,545,Not bad for an oil company. We have a green Chairman and CEO.
2581,3,7,51,61,1.2131147540983607,0.06659047872652427,545,I say we challenge the will and I say we do it now.
2581,3,7,51,61,1.2131147540983607,0.06659047872652427,545,"Starting immediately, all company facilities and employees are to go green!"
2581,1,11,49,61,1.2131147540983607,0.057804806739269465,545,"Pot is not only legal now, but it's legitimate."
2581,1,11,49,61,1.2131147540983607,0.057804806739269465,545,We need to stop these leaks! It must be a plant.
2581,3,7,51,61,1.2131147540983607,0.06659047872652427,545,All those in favor of draining the swamp?
2581,3,7,51,61,1.2131147540983607,0.06659047872652427,545,I'm all for going green but this is too much.
2581,3,7,51,61,1.2131147540983607,0.06659047872652427,545,"With the company's new going green philosophy, I'll probably be replaced by a poinsettia."
2581,3,7,51,61,1.2131147540983607,0.06659047872652427,545,"As it turns out, he was the perfect consensus candidate."
2581,4,5,52,61,1.2131147540983607,0.07057435755612214,545,"And now for a report on manufacturing, I'd like to turn this meeting over to the plant."
2581,2,9,50,61,1.2131147540983607,0.06235257628675809,545,"The note just says: ""With the passing of my father, please accept this simple household plant as my proxy. Do not over water. Signed, Junior""."
2581,1,11,49,61,1.2131147540983607,0.057804806739269465,545,Why are those seeds of doubt still growing?
2581,4,5,52,61,1.2131147540983607,0.07057435755612214,545,"Is this what he meant by ""I'm going green."""
2581,2,9,50,61,1.2131147540983607,0.06235257628675809,545,"Oh, and another thing, don't ever get caught eating a salad."
2581,4,5,52,61,1.2131147540983607,0.07057435755612214,545,"Today, let us befriend the ideas that uncertainty and paradox are attuned to the normal rhythms of life and that sympathy with nature will lead to leading without leading."
2581,4,5,52,61,1.2131147540983607,0.07057435755612214,545,SUPPLANTED!
2581,2,9,50,61,1.2131147540983607,0.06235257628675809,545,"Somebody water me, and then I think we're done here."
2581,2,9,50,61,1.2131147540983607,0.06235257628675809,545,I think he might be a plant from our competitor.
2581,1,11,49,61,1.2131147540983607,0.057804806739269465,545,"Well I think the company should go green,but isn't this going too far?"
2581,2,9,50,61,1.2131147540983607,0.06235257628675809,545,"The new CEO is a little green, don't you think?"
2581,1,11,49,61,1.2131147540983607,0.057804806739269465,545,Agenda item 1: Hiring policy will bar all vegans.
2581,2,9,50,61,1.2131147540983607,0.06235257628675809,545,Many board members suspected the new CEO was a plant.
2581,3,7,51,61,1.2131147540983607,0.06659047872652427,545,"No wonder they said ""A potted plant has more business sense than all of you""!"
2581,2,9,50,61,1.2131147540983607,0.06235257628675809,545,First order of business: Drain the Swamp!!!
2581,4,5,52,61,1.2131147540983607,0.07057435755612214,545,"You might say I'm potted, but I would say well-grounded!"
2581,4,5,52,61,1.2131147540983607,0.07057435755612214,545,The last one was like watching corn grow.
2581,4,5,52,61,1.2131147540983607,0.07057435755612214,545,"Well, Bob did say he'd be leaving."
2581,3,7,51,61,1.2131147540983607,0.06659047872652427,545,We're very proud of our diversity program.
2581,2,9,50,61,1.2131147540983607,0.06235257628675809,545,Let's go ahead and get started because I may need to leave.
2581,1,11,49,61,1.2131147540983607,0.057804806739269465,545,"Sure, I’m a plant. But you can talk freely, I’m not THAT kind of plant."
2581,1,11,49,61,1.2131147540983607,0.057804806739269465,545,… and that is why we should all drink Roundup.
2581,3,7,51,61,1.2131147540983607,0.06659047872652427,545,I promised you that if we failed to turn a profit I would leave.
2581,3,7,51,61,1.2131147540983607,0.06659047872652427,545,I told you he was a Russian plant.
2581,3,7,51,61,1.2131147540983607,0.06659047872652427,545,"So, the first item on the agenda is Climate Change."
2581,1,11,49,61,1.2131147540983607,0.057804806739269465,545,We're going to try for a greenhouse effect.
2581,2,9,50,61,1.2131147540983607,0.06235257628675809,545,I've called you together because the time has come the company to branch out.
2581,2,9,50,61,1.2131147540983607,0.06235257628675809,545,The potted plant sure is an improvement over the empty suit.
2581,2,9,50,61,1.2131147540983607,0.06235257628675809,545,I believe he has finally grown into his position.
2581,3,7,51,61,1.2131147540983607,0.06659047872652427,545,The bloomin' idiot at the head of company.
2581,1,11,49,61,1.2131147540983607,0.057804806739269465,545,Why did the plant manager call this meeting
2581,0,13,48,61,1.2131147540983607,0.05286726392326918,545,"As you can see, we're branching out with this new hire"
2581,1,11,49,61,1.2131147540983607,0.057804806739269465,545,We need to be more growth oriented.
2581,3,7,51,61,1.2131147540983607,0.06659047872652427,545,He was hired to help the company go green.
2581,3,7,51,61,1.2131147540983607,0.06659047872652427,545,"'I may be green, but I do know what I am doing.'"
2581,2,9,50,61,1.2131147540983607,0.06235257628675809,545,You all still don't know why my office has so many windows?
2581,2,9,50,61,1.2131147540983607,0.06235257628675809,545,I'd like to bring up the issue of soil pH levels.
2581,1,11,49,61,1.2131147540983607,0.057804806739269465,545,I totally get your nostalgia for Bush.
2581,4,5,52,61,1.2131147540983607,0.07057435755612214,545,"Look, I'm not just a potted plant here."
2581,3,7,51,61,1.2131147540983607,0.06659047872652427,545,Seems like everything is fine down at the plant.
2581,2,9,50,61,1.2131147540983607,0.06235257628675809,545,I think Board diversity has gone too far.
2581,2,9,50,61,1.2131147540983607,0.06235257628675809,545,I'm beginning to suspect that our new CEO is a rival plant.
2581,4,5,52,61,1.2131147540983607,0.07057435755612214,545,"You see, our last Chairman turned out to be a mole so you can imagine our reluctancy..."
2581,1,11,49,61,1.2131147540983607,0.057804806739269465,545,We really have achieved significant growth from our seed funding.
2581,4,5,52,61,1.2131147540983607,0.07057435755612214,545,"'K.I.S.S. ... ""Keep it seeds and stems"" - now that's a catchy slogan!"
2581,1,11,49,61,1.2131147540983607,0.057804806739269465,545,Looks like we were finally able to weed out the competition.
2581,3,7,51,61,1.2131147540983607,0.06659047872652427,545,"The last thing I remember saying was, "" Make me a plan, and have it on my desk by Monday."""
2581,5,3,53,61,1.2131147540983607,0.07434506057493712,545,Let's just leave it to the chair.
2581,3,7,51,61,1.2131147540983607,0.06659047872652427,545,Now (italics) do you believe in climate change?
2581,1,11,49,61,1.2131147540983607,0.057804806739269465,545,It's been 50 years and Flower Power is still with us.
2581,0,13,48,61,1.2131147540983607,0.05286726392326918,545,Diversity hire.
2581,1,11,49,61,1.2131147540983607,0.057804806739269465,545,He's turned over a new leaf.
2581,2,9,50,61,1.2131147540983607,0.06235257628675809,545,Human Resources was hoping to increase diversity.
2581,3,7,51,61,1.2131147540983607,0.06659047872652427,545,"Instead of just a few lunch time martinis, CEO Fulbright decides to attend this weeks staff meeting fully potted."
2581,2,9,50,61,1.2131147540983607,0.06235257628675809,545,"Ladies and gentlemen of the board, I would like to introduce you to our new branch plant manager."
2581,3,7,51,61,1.2131147540983607,0.06659047872652427,545,"""Next on our agenda is Plant and Equipment""."
2581,5,3,53,61,1.2131147540983607,0.07434506057493712,545,"Mr. Trump wants it in charge, while he's in Washington."
2581,2,9,50,61,1.2131147540983607,0.06235257628675809,545,Meet our new chairplant!
2581,0,13,48,61,1.2131147540983607,0.05286726392326918,545,The bad seed became Chairman of the Board.
2581,0,13,48,61,1.2131147540983607,0.05286726392326918,545,To put an end to all the rumors I am the plant the government put in your office.
2581,2,9,50,61,1.2131147540983607,0.06235257628675809,545,"You were a good choice for Chair, Janice. But white men like houseplants."
2581,3,7,51,61,1.2131147540983607,0.06659047872652427,545,The Chairman of the Gourd.
2581,4,5,52,61,1.2131147540983607,0.07057435755612214,545,First things first: economies of kale.
2581,3,7,51,61,1.2131147540983607,0.06659047872652427,545,"If you were a tree, what kind of..... nevermind."
2581,4,5,52,61,1.2131147540983607,0.07057435755612214,545,Looks like the new branch manager forgot donuts.
2581,1,11,49,61,1.2131147540983607,0.057804806739269465,545,"Boss said he'd be going green. --Sophie Salisbury, 11"
2581,3,7,51,61,1.2131147540983607,0.06659047872652427,545,"I knew he'd gone too ""green""."
2581,2,9,50,61,1.2131147540983607,0.06235257628675809,545,"I may sound paranoid, but it looks like it's a 'plant'!"
2581,0,13,48,61,1.2131147540983607,0.05286726392326918,545,This whole corporate Greening effort has gotten out of control.
2581,1,11,49,61,1.2131147540983607,0.057804806739269465,545,I thought this was supposed to be plant personnel only.
2581,2,9,50,61,1.2131147540983607,0.06235257628675809,545,"As you know, I've been hired to replace Bill, who, as it turns out, was a plant working for our biggest competitor."
2581,2,9,50,61,1.2131147540983607,0.06235257628675809,545,I've decided to shut the plant down indefinitely.
2581,3,7,51,61,1.2131147540983607,0.06659047872652427,545,No one talks to me anymore.
2581,1,11,49,61,1.2131147540983607,0.057804806739269465,545,This is not what I meant when I said 'prune staff.'
2581,4,5,52,61,1.2131147540983607,0.07057435755612214,545,Okay if you can explain policy to this potted plant you can work in The White House
2581,1,11,49,61,1.2131147540983607,0.057804806739269465,545,I have ideas. I'm not just a potted plant.
2581,3,7,51,61,1.2131147540983607,0.06659047872652427,545,"To be politically correct , we're going to put a new Plant in Detroit rather than Mexico"
2581,4,5,52,61,1.2131147540983607,0.07057435755612214,545,Any questions on the new biodiversity initiative?
2581,4,5,52,61,1.2131147540983607,0.07057435755612214,545,I think Bill misunderstood what we meant by low hanging fruit.
2581,4,5,52,61,1.2131147540983607,0.07057435755612214,545,That's not what was meant by perennial position.
2581,3,7,51,61,1.2131147540983607,0.06659047872652427,545,This biota has noted the by the rota that we haven't met our quota one iota.
2581,2,9,50,61,1.2131147540983607,0.06235257628675809,545,"As you can see, the company is turning over a new leaf.e"
2581,4,5,52,61,1.2131147540983607,0.07057435755612214,545,"Now that I'm legal, medically and recreationally, you are all fired."
2581,2,9,50,61,1.2131147540983607,0.06235257628675809,545,Our green initiatives must have worked.
2581,2,9,50,61,1.2131147540983607,0.06235257628675809,545,I knew it all along!
2581,2,9,50,61,1.2131147540983607,0.06235257628675809,545,"They had their reservations about appointing it, but it's demonstrated a penchant for growth."
2581,3,7,51,61,1.2131147540983607,0.06659047872652427,545,"That's funny. I thought the whole ""potted plant"" thing was just a metaphor...."
2581,3,7,51,61,1.2131147540983607,0.06659047872652427,545,Now I've brought you all in here to discuss something of great concern to me: your pledge to reduce carbon emissions.
2581,3,7,51,61,1.2131147540983607,0.06659047872652427,545,Stanford University Board of Trustees
2581,1,11,49,61,1.2131147540983607,0.057804806739269465,545,That was no vacation - she's clearly had some work done.
2581,5,3,53,61,1.2131147540983607,0.07434506057493712,545,Just give him his Twitter account back so we can go.
2581,3,7,51,61,1.2131147540983607,0.06659047872652427,545,So what makes this ficus so different from the last one?
2581,4,5,52,61,1.2131147540983607,0.07057435755612214,545,He represents the Green Party.
2581,4,5,52,61,1.2131147540983607,0.07057435755612214,545,"Does nothing but sit there, look pretty and thrive on all the B.S. thrown around here."
2581,4,5,52,61,1.2131147540983607,0.07057435755612214,545,It's not that strange. The last one was orange.
2581,2,9,50,61,1.2131147540983607,0.06235257628675809,545,He wanted to see if anybody would notice.
2581,2,9,50,61,1.2131147540983607,0.06235257628675809,545,Don't be so naive. It's a plant.
2581,2,9,50,61,1.2131147540983607,0.06235257628675809,545,My ideas about branching out just doesn't seem to find roots.
2581,1,11,49,61,1.2131147540983607,0.057804806739269465,545,"First off, let me squelch the rumors and assure you that I am NOT a competitor plant."
2581,2,9,50,61,1.2131147540983607,0.06235257628675809,545,"Here's what I see in our future... ""trellising"""
2581,1,11,49,61,1.2131147540983607,0.057804806739269465,545,"Actually, I do take umbrage with your ""don't just sit there like a potted plant"" remark."
2581,2,9,50,61,1.2131147540983607,0.06235257628675809,545,Security says we have a leak – someone in this room is a plant.
2581,4,5,52,61,1.2131147540983607,0.07057435755612214,545,"He's President-elect, now this ?"
2581,2,9,50,61,1.2131147540983607,0.06235257628675809,545,"This is a ""joint"" meeting right?"
2581,3,7,51,61,1.2131147540983607,0.06659047872652427,545,Come on people. Money doesn't grow on trees.
2581,4,5,52,61,1.2131147540983607,0.07057435755612214,545,I heard we shouldn't ask him for any leaves.
2581,3,7,51,61,1.2131147540983607,0.06659047872652427,545,My story still needs a plot.
2581,4,5,52,61,1.2131147540983607,0.07057435755612214,545,I'm your new cap 'n trade CEO. My mission is to sequester your bloviating carbon dioxide.
2581,2,9,50,61,1.2131147540983607,0.06235257628675809,545,Another seed funder.
2581,2,9,50,61,1.2131147540983607,0.06235257628675809,545,"I understand that some of you feel we have taken the spirit of inclusion too far,"
2581,2,9,50,61,1.2131147540983607,0.06235257628675809,545,Power Plant
2581,4,5,52,61,1.2131147540983607,0.07057435755612214,545,Is it real?
2581,1,11,49,61,1.2131147540983607,0.057804806739269465,545,Looks like growth is on the agenda.
2581,2,9,50,61,1.2131147540983607,0.06235257628675809,545,"""But that's not the way things work in Washington, Mr. Trump""."
2581,4,5,52,61,1.2131147540983607,0.07057435755612214,545,Could someone please bring in some glasses of water.
2581,1,11,49,61,1.2131147540983607,0.057804806739269465,545,Own up. Who said I was just a plant?
2581,2,9,50,61,1.2131147540983607,0.06235257628675809,545,"Well, We Tried Trump"
2581,1,11,49,61,1.2131147540983607,0.057804806739269465,545,I know we're down this quarter but I just can't photosympathize with him.
2581,3,7,51,61,1.2131147540983607,0.06659047872652427,545,Somebody's got to water it.
2581,4,5,52,61,1.2131147540983607,0.07057435755612214,545,The trump tree of knowledge has spoken
2764,1,11,50,62,1.2096774193548387,0.0569686228972945,545,I heard that headquarters invited him; he's their plant.
2764,1,11,50,62,1.2096774193548387,0.0569686228972945,545,"We've heard from Marketing, we've heard from Human Relations; let's hear from the Plant now."
2764,2,9,51,62,1.2096774193548387,0.061434881985617536,545,You can't all keep holding your breath forever.
2764,2,9,51,62,1.2096774193548387,0.061434881985617536,545,He only uses flowery speech in May.
2768,4,4,51,59,1.2033898305084745,0.0716331203127763,545,You're ferned!
2768,1,10,48,59,1.2033898305084745,0.05812007671977909,545,We're now officially green.
2768,2,8,49,59,1.2033898305084745,0.06294757226340743,545,May he rest in peace.
2768,2,8,49,59,1.2033898305084745,0.06294757226340743,545,I think our 'going green' initiative might have went a bit too far.
2768,1,10,48,59,1.2033898305084745,0.05812007671977909,545,"Now, about my proposal to branch out even more..."
2768,2,8,49,59,1.2033898305084745,0.06294757226340743,545,It's time for this company to go 'green.'
2768,2,8,49,59,1.2033898305084745,0.06294757226340743,545,He wants to cut cutting.
2768,2,8,49,59,1.2033898305084745,0.06294757226340743,545,"It's the company's ""Go Green"" initiative."
2768,1,10,48,59,1.2033898305084745,0.05812007671977909,545,"Now that we have become a green friendly board, what is next on the agenda?"
2768,4,4,51,59,1.2033898305084745,0.0716331203127763,545,[faint rustling]
2768,2,8,49,59,1.2033898305084745,0.06294757226340743,545,You mark my words: new Boss Man here is a plant.
2768,2,8,49,59,1.2033898305084745,0.06294757226340743,545,This company is going green.
2768,2,8,49,59,1.2033898305084745,0.06294757226340743,545,Now WE are the only ones sucking all of the oxygen out of the room.
2768,1,10,48,59,1.2033898305084745,0.05812007671977909,545,"He acts green now, but who's going to fall for it."
2768,2,8,49,59,1.2033898305084745,0.06294757226340743,545,It was only a matter of time before he was sup-planted
2768,0,12,47,59,1.2033898305084745,0.052853474644238056,545,"So, you are probably wondering about our new environmental leadership program..."
2768,1,10,48,59,1.2033898305084745,0.05812007671977909,545,Does she prefer 'Poin-set-tia' or 'Poin-setta'?
2768,3,6,50,59,1.2033898305084745,0.06743033731044798,545,Shouldn't someone mention that we're beyond the seed money stage?
2768,1,10,48,59,1.2033898305084745,0.05812007671977909,545,Remember when we laughed when Michael Moore ran a ficus for Congress?
2768,2,8,49,59,1.2033898305084745,0.06294757226340743,545,"OK, we are officially a green corporation. Now what?"
2768,1,10,48,59,1.2033898305084745,0.05812007671977909,545,To welcome me as CEO you will all now empty your water glasses into my pot.
2768,1,10,48,59,1.2033898305084745,0.05812007671977909,545,This job is going to require a lot of short days and long nights to be fruitful
2768,3,6,50,59,1.2033898305084745,0.06743033731044798,545,"So, it's still okay to order sushi for for lunch, right?"
2768,3,6,50,59,1.2033898305084745,0.06743033731044798,545,So glad the company decided to go green.
2768,2,8,49,59,1.2033898305084745,0.06294757226340743,545,Skip lunch? Easy for you to say since you make your own food!
2768,2,8,49,59,1.2033898305084745,0.06294757226340743,545,This talk of root cause analysis is making me thirsty.
2768,2,8,49,59,1.2033898305084745,0.06294757226340743,545,Are we supposed to water the new CEO?
2768,1,10,48,59,1.2033898305084745,0.05812007671977909,545,Eco-friendly starts from the top.
2768,3,6,50,59,1.2033898305084745,0.06743033731044798,545,Of course he's a plant but who sent him? The Green Party?
2768,3,6,50,59,1.2033898305084745,0.06743033731044798,545,I suppose everyone is feeling a bit green with envy today.
2768,1,10,48,59,1.2033898305084745,0.05812007671977909,545,The boss is playing golf but he left watering instructions.
2768,2,8,49,59,1.2033898305084745,0.06294757226340743,545,Affirmative action has gone too far.
2768,3,6,50,59,1.2033898305084745,0.06743033731044798,545,"No, I will NOT call it Mr. Trump while he's gone. And the fire marshal said it can’t be a burning bush, anyway."
2768,3,6,50,59,1.2033898305084745,0.06743033731044798,545,We'll get down to new business once all of you are watered properly.
2768,3,6,50,59,1.2033898305084745,0.06743033731044798,545,And Ms. Webster will water me while I'm on vacation.
2768,2,8,49,59,1.2033898305084745,0.06294757226340743,545,"How can we photosynthesize this latest data, folks?"
2768,0,12,47,59,1.2033898305084745,0.052853474644238056,545,It's come to our attention that our competitor has attempted to install a plant into our organization.
2768,3,6,50,59,1.2033898305084745,0.06743033731044798,545,"I know it needs direct sunlight, but that's the best seat in the house!!"
2768,1,10,48,59,1.2033898305084745,0.05812007671977909,545,He's getting back to his roots.
2768,3,6,50,59,1.2033898305084745,0.06743033731044798,545,"..., and that's why legalizing pot is bad for our company."
2768,4,4,51,59,1.2033898305084745,0.0716331203127763,545,Our CEO said he wanted to chair some weed with us.
2768,1,10,48,59,1.2033898305084745,0.05812007671977909,545,I hear he's a real producer.
2768,2,8,49,59,1.2033898305084745,0.06294757226340743,545,Who was it who accused me of being potted?
2768,2,8,49,59,1.2033898305084745,0.06294757226340743,545,Am I the only one who thinks we have enough seed money?
2768,3,6,50,59,1.2033898305084745,0.06743033731044798,545,"Understand that if the company numbers continue to rise, I may bloom prematurely ."
2768,3,6,50,59,1.2033898305084745,0.06743033731044798,545,I am well regarded in the music business as I was once the frontman for Led Zeppelin.
2768,3,6,50,59,1.2033898305084745,0.06743033731044798,545,We project Cannabis sales increasing with Election PTSD.
2768,2,8,49,59,1.2033898305084745,0.06294757226340743,545,"As your leader, I promise to photo-sympathize with your needs."
2768,3,6,50,59,1.2033898305084745,0.06743033731044798,545,Egad! The environmentalists were right about invasive species taking over.
2768,1,10,48,59,1.2033898305084745,0.05812007671977909,545,I heard they were bringing in an expert to talk about organic growth.
2768,2,8,49,59,1.2033898305084745,0.06294757226340743,545,"Well, we all know who wears the plants in this relationship."
2768,3,6,50,59,1.2033898305084745,0.06743033731044798,545,Would someone please give me a glass of water.
2768,3,6,50,59,1.2033898305084745,0.06743033731044798,545,What do you say we leaf early?
2768,2,8,49,59,1.2033898305084745,0.06294757226340743,545,Someone in this room has been using the executive water cooler.
2768,3,6,50,59,1.2033898305084745,0.06743033731044798,545,"...And, as your new plant manager, I wish to announce that we will soon be turning over a new leaf... details will follow..."
2768,3,6,50,59,1.2033898305084745,0.06743033731044798,545,"Well, let's just start the meeting, folks. I'll use a chair while Dwayne grabs my macrame."
2768,3,6,50,59,1.2033898305084745,0.06743033731044798,545,The chairman left a message that if he couldn't prevent another useless meeting he could at least provide a carbon offset.
2768,2,8,49,59,1.2033898305084745,0.06294757226340743,545,Did the Board hear you correctly? You want to branch out with new plants everywhere and our lack of growth stems from not establishing roots in the community?
2768,1,10,48,59,1.2033898305084745,0.05812007671977909,545,The recent ballot question not only legalized pot but also elected me President.
2768,4,4,51,59,1.2033898305084745,0.0716331203127763,545,President Trump’s first cabinet meeting.
2768,1,10,48,59,1.2033898305084745,0.05812007671977909,545,"First of all, call me Herb. Mr. Gardner... That's my father."
2768,1,10,48,59,1.2033898305084745,0.05812007671977909,545,Who can shed some indirect light on the main plant's production last quarter?
2768,4,4,51,59,1.2033898305084745,0.0716331203127763,545,"In light of the election, I mandate all Christmas trees be yellowish-blonde."
2768,2,8,49,59,1.2033898305084745,0.06294757226340743,545,I really do think we have to tell him it's time to retire.
2768,2,8,49,59,1.2033898305084745,0.06294757226340743,545,The company's aiming to turn a new leaf.
2768,4,4,51,59,1.2033898305084745,0.0716331203127763,545,Shall we tell him no one is actually going to sit there once he gets back?
2768,1,10,48,59,1.2033898305084745,0.05812007671977909,545,His humor definitely grows on you.
2768,3,6,50,59,1.2033898305084745,0.06743033731044798,545,"Sorry, Mr. President, but you cannot fire congress!"
2768,3,6,50,59,1.2033898305084745,0.06743033731044798,545,The company never cared about climate change under the old CEO
2768,2,8,49,59,1.2033898305084745,0.06294757226340743,545,"I dreamt that after you had bowed down to me, I was adorned with a string of lights of many colors."
2768,2,8,49,59,1.2033898305084745,0.06294757226340743,545,"This week's topic on Corporate Diversity, 'Eco-Sexuality' and your office plant"
2768,4,4,51,59,1.2033898305084745,0.0716331203127763,545,With this vote we exclude vegetarians from all our restaurants.
2768,3,6,50,59,1.2033898305084745,0.06743033731044798,545,"Get this straight, no more plant jokes."
2768,3,6,50,59,1.2033898305084745,0.06743033731044798,545,All right: which one of you put herbicide in the soap dispensers?
2768,3,6,50,59,1.2033898305084745,0.06743033731044798,545,"So,just like that, he up and leaves us?"
2768,1,10,48,59,1.2033898305084745,0.05812007671977909,545,A tree grows in Boardroom
2768,1,10,48,59,1.2033898305084745,0.05812007671977909,545,He's potted again.
2768,3,6,50,59,1.2033898305084745,0.06743033731044798,545,Word is he's taking someone with him to the corner office.
2768,1,10,48,59,1.2033898305084745,0.05812007671977909,545,Now Charlie will talk about our new green initiative.
2768,4,4,51,59,1.2033898305084745,0.0716331203127763,545,I thought my first plant meeting would be different.
2768,2,8,49,59,1.2033898305084745,0.06294757226340743,545,After the last meeting we needed some oxygen in the room.
2849,2,8,50,60,1.2,0.061982319330632654,545,...psst...I liked Fern better.
2849,4,4,52,60,1.2,0.07051064751106302,545,'I'm particularly pleased with our organic growth figures.'
2849,2,8,50,60,1.2,0.061982319330632654,545,Look what happens when we legalize marijuana.
2849,2,8,50,60,1.2,0.061982319330632654,545,"I""m sure you'll treat Fern with the same respect you've always shown me."
2849,0,12,48,60,1.2,0.052075564392329535,545,"Sustainable growth, sure. But photosynthesis?"
2854,2,7,49,58,1.1896551724137931,0.06249934809931834,545,"He'll be here all week to turn your CO2 into oxygen, rather than just bad ideas."
2854,1,9,48,58,1.1896551724137931,0.05745613836035109,545,He promised Shareholders that he'd turn a new leaf. We're witnesses to the fact.
2854,3,5,50,58,1.1896551724137931,0.06716494018753925,545,His name is Ficus. He's off our regional branch. He'll be assessing us today.
2854,1,9,48,58,1.1896551724137931,0.05745613836035109,545,I don't know if this qualifies as being more eco-friendly.
2854,2,7,49,58,1.1896551724137931,0.06249934809931834,545,He soiled himself when we told him we needed a growth-oriented strategy.
2854,1,9,48,58,1.1896551724137931,0.05745613836035109,545,Our recycling team has knocked it out of the park.
2854,1,9,48,58,1.1896551724137931,0.05745613836035109,545,YOU turn over a new leaf.
2854,3,5,50,58,1.1896551724137931,0.06716494018753925,545,"I didn't know flora counts as ""underrepresented."""
2854,2,7,49,58,1.1896551724137931,0.06249934809931834,545,I could go for some fresh fertilizer! Anyone else?
2854,0,11,47,58,1.1896551724137931,0.05192539992843435,545,"No, I am fine, really. Just green with envy."
2854,1,9,48,58,1.1896551724137931,0.05745613836035109,545,This month's focus group is frustrated as Zen Master Phil O'Dendron shares his wisdom about reincarnation.
2854,1,9,48,58,1.1896551724137931,0.05745613836035109,545,"As long as I'm in this chair, we keep a big carbon footprint!"
2854,1,9,48,58,1.1896551724137931,0.05745613836035109,545,You could replace it with Mr. Baxter and no one would notice.
2854,2,7,49,58,1.1896551724137931,0.06249934809931834,545,She might not say much but every winter and spring her true feelings come out..
2854,2,7,49,58,1.1896551724137931,0.06249934809931834,545,From now on just think of me as the CEO who led the marijuana investment strategy.
2854,5,1,52,58,1.1896551724137931,0.07563762651952825,545,Are you thinking what I'm thinking?
2854,1,9,48,58,1.1896551724137931,0.05745613836035109,545,He looks like our old boss.....but with green leaves and potting soil.
2854,2,7,49,58,1.1896551724137931,0.06249934809931834,545,Flowers did not seem appropriate.
2854,3,5,50,58,1.1896551724137931,0.06716494018753925,545,"When they said it was a promotion from within, I didn't think they meant from within his own office."
2854,3,5,50,58,1.1896551724137931,0.06716494018753925,545,"I knew the company wanted to go green, but did they have to hire this pot-head?"
2854,3,5,50,58,1.1896551724137931,0.06716494018753925,545,I've learned that money doesn't grow on me
2854,0,11,47,58,1.1896551724137931,0.05192539992843435,545,Which one of you picked the low hanging fruit?
2854,2,7,49,58,1.1896551724137931,0.06249934809931834,545,Is this part of our new green initiative?
2854,2,7,49,58,1.1896551724137931,0.06249934809931834,545,And now we wait for the money to grow.
2854,3,5,50,58,1.1896551724137931,0.06716494018753925,545,Well that's democracy for you...anyone of us could have been elected chairman.....
2854,2,7,49,58,1.1896551724137931,0.06249934809931834,545,We will be updating our diversity standards to include carbon-neutral
2854,2,7,49,58,1.1896551724137931,0.06249934809931834,545,"Congratulations, you're the new face of the Green Party."
2854,2,7,49,58,1.1896551724137931,0.06249934809931834,545,I think we’re barking up the wrong tree with this new hire.
2854,1,9,48,58,1.1896551724137931,0.05745613836035109,545,I think we are carrying this diversity thing a little too far.
2854,1,9,48,58,1.1896551724137931,0.05745613836035109,545,"Now, about this ban on G.M.Os..."
2854,4,3,51,58,1.1896551724137931,0.07152684718308004,545,Let's wait for the Wifi to work to ask Google.
2854,2,7,49,58,1.1896551724137931,0.06249934809931834,545,"Don't be intimidated. Just like you, I put on my socks one root at a time."
2854,1,9,48,58,1.1896551724137931,0.05745613836035109,545,She always starts wilting in Q3.
2854,1,9,48,58,1.1896551724137931,0.05745613836035109,545,Our chairman is very green.
2854,2,7,49,58,1.1896551724137931,0.06249934809931834,545,And I'm sure by now you can all guess what his resignation letter said he was going to do.
2854,1,9,48,58,1.1896551724137931,0.05745613836035109,545,Who put the power plant in charge?
2854,3,5,50,58,1.1896551724137931,0.06716494018753925,545,Good luck explaining this one in the meeting minutes.
2854,3,5,50,58,1.1896551724137931,0.06716494018753925,545,"Believe me, you're worshipping the wrong guy, I've always been legal."
2854,3,5,50,58,1.1896551724137931,0.06716494018753925,545,I've heard a rumor about a take over bid by the azaleas.
2854,2,7,49,58,1.1896551724137931,0.06249934809931834,545,Our goal is to embrace workplace diversity.
2854,2,7,49,58,1.1896551724137931,0.06249934809931834,545,"Regarding the hedge fund, I insist we emphasize the former."
2854,0,11,47,58,1.1896551724137931,0.05192539992843435,545,Psst! Are we in the perennial general meeting?
2854,1,9,48,58,1.1896551724137931,0.05745613836035109,545,The Green Party was optimistic about their new candidate this year.
2854,1,9,48,58,1.1896551724137931,0.05745613836035109,545,Pharma tried everything to keep pot away from the table.
2854,1,9,48,58,1.1896551724137931,0.05745613836035109,545,"It seems we're all in agreement, then; the legalization of marijuana is a win-win for everyone."
2854,1,9,48,58,1.1896551724137931,0.05745613836035109,545,As chairman I must insist on a non vegetarian menu for these lunch meetings.
2854,2,7,49,58,1.1896551724137931,0.06249934809931834,545,"A moment of silence please, for our latest victim of the greenhouse affect."
2854,3,5,50,58,1.1896551724137931,0.06716494018753925,545,...and I bequeath the plant to my entire executive committee...
2854,4,3,51,58,1.1896551724137931,0.07152684718308004,545,I heard plants don't like fire so we might keep our jobs.
2854,2,7,49,58,1.1896551724137931,0.06249934809931834,545,"He may not say much, but he's far more qualified than the last CEO of the Trump Organization"
2854,1,9,48,58,1.1896551724137931,0.05745613836035109,545,"Now if this plan fails, I'm afraid I'm going to need to ask one of you to throw me out that window."
2854,1,9,48,58,1.1896551724137931,0.05745613836035109,545,"Perkins, pass me your water."
2854,1,9,48,58,1.1896551724137931,0.05745613836035109,545,"Just between you and me, I think he has the creativity of a potted plant."
2854,2,7,49,58,1.1896551724137931,0.06249934809931834,545,"Ladies and gentlemen, no one knows better than I that my father left big roots to fill."
2854,4,3,51,58,1.1896551724137931,0.07152684718308004,545,"Wait, you're saying you'll make us great again?"
2854,2,7,49,58,1.1896551724137931,0.06249934809931834,545,This green initiative has gone to far !
2854,2,7,49,58,1.1896551724137931,0.06249934809931834,545,"I know he has the morals of a plant, but he's our boss now."
2854,2,7,49,58,1.1896551724137931,0.06249934809931834,545,"Now I'm worried about the ""light lunch"" we were promised."
2854,2,7,49,58,1.1896551724137931,0.06249934809931834,545,So this is what they meant by a green initiative?
2854,1,9,48,58,1.1896551724137931,0.05745613836035109,545,Last week our CEO mentioned she was going green.
2854,3,5,50,58,1.1896551724137931,0.06716494018753925,545,"Sorry, but we voted for global warming instead"
2854,3,5,50,58,1.1896551724137931,0.06716494018753925,545,"""well"" it's a better choice than Donald Trump?!"
2854,3,5,50,58,1.1896551724137931,0.06716494018753925,545,One day you will all be my fertilizer.
2854,2,7,49,58,1.1896551724137931,0.06249934809931834,545,Corporate management recommends that the chairman of the board be re-potted.
2854,0,11,47,58,1.1896551724137931,0.05192539992843435,545,I've decided to go Vegan.
2854,1,9,48,58,1.1896551724137931,0.05745613836035109,545,We may have gone overboard on the Green thing.
2854,2,7,49,58,1.1896551724137931,0.06249934809931834,545,"How was I supposed to know what ""get a plant in that chair"" meant?"
2854,0,11,47,58,1.1896551724137931,0.05192539992843435,545,Due to budget cuts Bill has been replaced by this nice bamboo plant.
2854,3,5,50,58,1.1896551724137931,0.06716494018753925,545,All living things need a seat at the table.
2854,1,9,48,58,1.1896551724137931,0.05745613836035109,545,"At first I was excited to work for a ""pot friendly"" company."
2854,0,11,47,58,1.1896551724137931,0.05192539992843435,545,"Now, let's do a quick bathroom break everyone. I'm thirsty."
2854,1,9,48,58,1.1896551724137931,0.05745613836035109,545,"He's calm, he's quiet, and he's already providing benefits to the office just by being here. I consider him an excellent choice in light of what we all went through with our last CEO."
2854,1,9,48,58,1.1896551724137931,0.05745613836035109,545,"I won't stand for any beating around the bush, people!"
2854,1,9,48,58,1.1896551724137931,0.05745613836035109,545,they'll promote anyone nowadays
2854,1,9,48,58,1.1896551724137931,0.05745613836035109,545,He's looking to increase our carbon dioxide footprint.
2854,4,3,51,58,1.1896551724137931,0.07152684718308004,545,"I know pot's king, but does it have to be the chairman as well?"
2854,1,9,48,58,1.1896551724137931,0.05745613836035109,545,"Corporations have the same rights as individuals, so this should come as no surprise."
2854,0,11,47,58,1.1896551724137931,0.05192539992843435,545,"Meanwhile, at the Climate Change Conference..."
2854,0,11,47,58,1.1896551724137931,0.05192539992843435,545,Just play along. Corporate's going green.
2854,0,11,47,58,1.1896551724137931,0.05192539992843435,545,"This is from our CEO, Chauncey Gardiner, who wishes he was being here"
2854,2,7,49,58,1.1896551724137931,0.06249934809931834,545,You're all fired--but could someone water me first?
2854,0,11,47,58,1.1896551724137931,0.05192539992843435,545,"We're going green, or we're going home!"
2854,3,5,50,58,1.1896551724137931,0.06716494018753925,545,Can a perennial get an annual around here?
2854,2,7,49,58,1.1896551724137931,0.06249934809931834,545,I believe we should focus all of our investments on solar.
2854,2,7,49,58,1.1896551724137931,0.06249934809931834,545,"Well, he did want his ashes buried there."
2854,2,7,49,58,1.1896551724137931,0.06249934809931834,545,The good news is we're about 10% of the way towards our Green Company target.
2854,1,9,48,58,1.1896551724137931,0.05745613836035109,545,You'll find that as CEO I'm not all bark.
2854,1,9,48,58,1.1896551724137931,0.05745613836035109,545,"Plant Manager; yeah I haven't heard that one before, Earl."
2854,1,9,48,58,1.1896551724137931,0.05745613836035109,545,"As your CEO, I will model the growth I expect from the company."
2854,2,7,49,58,1.1896551724137931,0.06249934809931834,545,"He shows up every year, gives a report, and then goes away."
2854,1,9,48,58,1.1896551724137931,0.05745613836035109,545,"I'd say that is taking ""going green"" to the extreme."
2854,2,7,49,58,1.1896551724137931,0.06249934809931834,545,"Budget cuts were tough, we lost ten good ferns."
2854,1,9,48,58,1.1896551724137931,0.05745613836035109,545,Carmichael told me last week he'd heard a rumor that someone on the board was a plant.
2854,0,11,47,58,1.1896551724137931,0.05192539992843435,545,"I didn't like her at first, but she's grown on me."
2854,3,5,50,58,1.1896551724137931,0.06716494018753925,545,Wait for it.
2854,3,5,50,58,1.1896551724137931,0.06716494018753925,545,"Oblivious to the metaphor, and therefore the irony, the board of Security Systems, Ltd, failed to notice that its chief rival had infiltrated its top management."
2854,1,9,48,58,1.1896551724137931,0.05745613836035109,545,"When you said that the chairman is a dumb as a house plant, I didn't expect a philodendron."
2854,0,11,47,58,1.1896551724137931,0.05192539992843435,545,That's what our CEO calls corporate growth.
2854,2,7,49,58,1.1896551724137931,0.06249934809931834,545,"Mr. Smyth's will said a houseplant had more brains than his idiot son. Um, do you think we should water it?"
2854,4,3,51,58,1.1896551724137931,0.07152684718308004,545,"Yes, Mr. President?"
2854,1,9,48,58,1.1896551724137931,0.05745613836035109,545,Going green is all about image.
2854,2,7,49,58,1.1896551724137931,0.06249934809931834,545,I think he's a plant by our competitors
2854,3,5,50,58,1.1896551724137931,0.06716494018753925,545,Did he say ficus or fiscal?
2854,0,11,47,58,1.1896551724137931,0.05192539992843435,545,Something is a bit off. Do you think he's a plant?
2854,2,7,49,58,1.1896551724137931,0.06249934809931834,545,I think it speaks for itself.
2854,2,7,49,58,1.1896551724137931,0.06249934809931834,545,i'd like to start this meeting off with another plug for the value of an Ivy League education
2854,3,5,50,58,1.1896551724137931,0.06716494018753925,545,There is a plant in the room.
2854,1,9,48,58,1.1896551724137931,0.05745613836035109,545,Careful. That question could be a fly-trap.
2854,3,5,50,58,1.1896551724137931,0.06716494018753925,545,"First, we're going to spray water over each of you, and then trim your sleeves up to your shoulders."
2854,1,9,48,58,1.1896551724137931,0.05745613836035109,545,I think we went to far with our green imitative.
2854,2,7,49,58,1.1896551724137931,0.06249934809931834,545,"Okay, who granted the ficus emergency powers?"
2854,1,9,48,58,1.1896551724137931,0.05745613836035109,545,I hope to improve our reputation as a green-friendly company.
2854,1,9,48,58,1.1896551724137931,0.05745613836035109,545,He really wants to push to a paperless firm.
2854,4,3,51,58,1.1896551724137931,0.07152684718308004,545,What's different? Is his hair style new?
2854,1,9,48,58,1.1896551724137931,0.05745613836035109,545,Don't fight it. It's perennial.
2854,2,7,49,58,1.1896551724137931,0.06249934809931834,545,Brass is very serious about our green initiative.
2854,3,5,50,58,1.1896551724137931,0.06716494018753925,545,I thought that was just an expression.
2854,3,5,50,58,1.1896551724137931,0.06716494018753925,545,"Pro-Green and more competent than Bush, please welcome President Shrub"
2854,1,9,48,58,1.1896551724137931,0.05745613836035109,545,And I fully support the Sunshine Law.
2854,2,7,49,58,1.1896551724137931,0.06249934809931834,545,Do you think it will notice if I go to the men's room?
2854,3,5,50,58,1.1896551724137931,0.06716494018753925,545,"Hang tight, it needs five hours of sun"
2854,1,9,48,58,1.1896551724137931,0.05745613836035109,545,I'm a potted plant. That's my job.
2854,1,9,48,58,1.1896551724137931,0.05745613836035109,545,It is 2016 people. Diversity counts!!
2854,1,9,48,58,1.1896551724137931,0.05745613836035109,545,"Hi! My name is Fern, I'm the new CEO of the Sierra Club."
2854,1,9,48,58,1.1896551724137931,0.05745613836035109,545,Plant Parenthood Election Discussion
2854,2,7,49,58,1.1896551724137931,0.06249934809931834,545,I guess this means mulch for lunch.
2854,2,7,49,58,1.1896551724137931,0.06249934809931834,545,Let's see who's perennial and who's ephemeral.
2854,3,5,50,58,1.1896551724137931,0.06716494018753925,545,"First, don't call me a plant. The FBI is listening."
2854,2,7,49,58,1.1896551724137931,0.06249934809931834,545,Biodiversity training
2854,0,11,47,58,1.1896551724137931,0.05192539992843435,545,"Not that different from reporting to the boss, himself."
2854,1,9,48,58,1.1896551724137931,0.05745613836035109,545,The Green Party meeting will now come to order.
2854,2,7,49,58,1.1896551724137931,0.06249934809931834,545,Wake up! All of you! I still say this is a 'plant'!
2854,1,9,48,58,1.1896551724137931,0.05745613836035109,545,We need to move forward and turn over a new leaf!
2854,3,5,50,58,1.1896551724137931,0.06716494018753925,545,Everyone realized that the new CEO was just a plant from another corporation.
2854,1,9,48,58,1.1896551724137931,0.05745613836035109,545,"Shut up, all of you. Do I need to remind you who wears the plants in this company?"
2854,1,9,48,58,1.1896551724137931,0.05745613836035109,545,Acme Paper Company has always been a family business.
2854,0,11,47,58,1.1896551724137931,0.05192539992843435,545,"Pot has not just been legalized, we've been put in charge."
2854,1,9,48,58,1.1896551724137931,0.05745613836035109,545,The new boss is all into grassroots.
2854,1,9,48,58,1.1896551724137931,0.05745613836035109,545,A board meeting of the Environmental Protection Agency.
2854,2,7,49,58,1.1896551724137931,0.06249934809931834,545,As your new president I'm planting seeds of change.
2854,2,7,49,58,1.1896551724137931,0.06249934809931834,545,This call for diversity has gone off the rails.
2854,2,7,49,58,1.1896551724137931,0.06249934809931834,545,"From today forward, this company is going green. I'll expect resignations in my pot before the evening watering."
2854,4,3,51,58,1.1896551724137931,0.07152684718308004,545,"Did you get a haircut, Mr President?"
2854,1,9,48,58,1.1896551724137931,0.05745613836035109,545,"They say: ""Reap what you sow"" and this is what happens."
2854,1,9,48,58,1.1896551724137931,0.05745613836035109,545,Don't look so worried. I am sure it'll grow into the role.
2854,2,7,49,58,1.1896551724137931,0.06249934809931834,545,Strengthening our roots in the green movement will benefit our future..
2854,2,7,49,58,1.1896551724137931,0.06249934809931834,545,Looks like we're going green.
2854,2,7,49,58,1.1896551724137931,0.06249934809931834,545,I'm starting to regret voting leaf.
2854,1,9,48,58,1.1896551724137931,0.05745613836035109,545,Don't be throwing shade on me.
2854,1,9,48,58,1.1896551724137931,0.05745613836035109,545,"Personally, I think we have taken this ""go green"" thing too far."
2854,3,5,50,58,1.1896551724137931,0.06716494018753925,545,"Hello, what am I here a potted plant?"
2854,3,5,50,58,1.1896551724137931,0.06716494018753925,545,"I think it's saying, ""Stop putting out what I'm taking in."""
2854,2,7,49,58,1.1896551724137931,0.06249934809931834,545,His bark is worse than his bite.
2854,1,9,48,58,1.1896551724137931,0.05745613836035109,545,The board was confused. Plant unrest was not on the agenda.
2854,0,11,47,58,1.1896551724137931,0.05192539992843435,545,"It's true that I am a recent transplant, but I intend to sink deep roots here and not just be some potted plant."
2854,3,5,50,58,1.1896551724137931,0.06716494018753925,545,The new chairman: Trump.et vine
2854,2,7,49,58,1.1896551724137931,0.06249934809931834,545,I think there's an plant in the room.
2854,1,9,48,58,1.1896551724137931,0.05745613836035109,545,Just be nice to him. Even though he has become a vegetable we have to remain PC in these modern times.
2854,0,11,47,58,1.1896551724137931,0.05192539992843435,545,"I mean, he did say he was going green..."
2854,2,7,49,58,1.1896551724137931,0.06249934809931834,545,Now that's an improvement.
2854,1,9,48,58,1.1896551724137931,0.05745613836035109,545,Perhaps we've taken this diversity thing a bit too far..
2854,4,3,51,58,1.1896551724137931,0.07152684718308004,545,"... so I say, ""what am I, chopped liver?"" Anyways, let's get this meeting started."
2854,2,7,49,58,1.1896551724137931,0.06249934809931834,545,... Or Am I?
2854,1,9,48,58,1.1896551724137931,0.05745613836035109,545,"Yes, I thought having a bush on the board would be helpful. But I was thinking Jenna or Barbara!"
2854,1,9,48,58,1.1896551724137931,0.05745613836035109,545,This investment is starting to bear fruit.
2854,2,7,49,58,1.1896551724137931,0.06249934809931834,545,"Smith, I don't like sycophants, so you can just stop that incessant chatter about my exquisitely shiny leaves."
2854,2,7,49,58,1.1896551724137931,0.06249934809931834,545,Let me guess. Someone thinks we need more seed funding.
2854,2,7,49,58,1.1896551724137931,0.06249934809931834,545,To all of you who think global warming is a hoax...
2854,2,7,49,58,1.1896551724137931,0.06249934809931834,545,"Look, I see the problem, but it says here that Audubon board rules permit write-ins."
2854,4,3,51,58,1.1896551724137931,0.07152684718308004,545,President Trump is too busy to attend cabinet meetings
2854,2,7,49,58,1.1896551724137931,0.06249934809931834,545,"It will catch fire soon enough, then we'll know what to do."
2854,2,7,49,58,1.1896551724137931,0.06249934809931834,545,I think he's a plant. Will I check for bugs?
2854,0,11,47,58,1.1896551724137931,0.05192539992843435,545,He's always sullen when he's not in bloom
2854,1,9,48,58,1.1896551724137931,0.05745613836035109,545,Has everyone met our new VP in charge of Environmental Affairs?
2854,3,5,50,58,1.1896551724137931,0.06716494018753925,545,The plant? Guy with the green shirt.
2854,3,5,50,58,1.1896551724137931,0.06716494018753925,545,Isn't that the plant we sent to the funeral home?
2854,3,5,50,58,1.1896551724137931,0.06716494018753925,545,It's not easy being green!
2854,2,7,49,58,1.1896551724137931,0.06249934809931834,545,Donald Stump Cabinet Meeting
2854,2,7,49,58,1.1896551724137931,0.06249934809931834,545,Our last quarters earnings takes my chlorophyl way.
2854,0,11,47,58,1.1896551724137931,0.05192539992843435,545,In light of recent leaks we must step up our efforts to protect against Hackers and Plants.
2854,1,9,48,58,1.1896551724137931,0.05745613836035109,545,"Those in favor of watering, say 'aye.'"
2854,2,7,49,58,1.1896551724137931,0.06249934809931834,545,I hear he ran the GMO research division before this job.
2854,0,11,47,58,1.1896551724137931,0.05192539992843435,545,I envision a more prosperous company by expanding our plants.
2854,3,5,50,58,1.1896551724137931,0.06716494018753925,545,"So, I hear you attended Stanford . . ."
2854,2,7,49,58,1.1896551724137931,0.06249934809931834,545,"So, Zach Galifianakis couldn't make it...?"
2854,3,5,50,58,1.1896551724137931,0.06716494018753925,545,"There being no further business to discuss, please deposit your water in my pot on your way out the door."
2854,2,7,49,58,1.1896551724137931,0.06249934809931834,545,I hear he's transplanted from the Denver branch.
2854,3,5,50,58,1.1896551724137931,0.06716494018753925,545,This is what his first Cabinet meeting will look like.
2854,1,9,48,58,1.1896551724137931,0.05745613836035109,545,This is our new much-less-objectionable presidential candidate.
2854,1,9,48,58,1.1896551724137931,0.05745613836035109,545,Good morning. I'm your new transplant.
2854,1,9,48,58,1.1896551724137931,0.05745613836035109,545,He is the only one here with a brain.
2854,0,11,47,58,1.1896551724137931,0.05192539992843435,545,"Well, 'change' is a strong word. But I can safely say I'm taking a much closer look at our environmental policy."
2854,2,7,49,58,1.1896551724137931,0.06249934809931834,545,I hear he's actually very intelligent.
2854,2,7,49,58,1.1896551724137931,0.06249934809931834,545,What sales slump? Get me miracle grow now!
2854,1,9,48,58,1.1896551724137931,0.05745613836035109,545,Careful. I'm bugged.
2854,2,7,49,58,1.1896551724137931,0.06249934809931834,545,"Well, if overrides the vote, at least we can smoke him and have the last laugh."
2854,5,1,52,58,1.1896551724137931,0.07563762651952825,545,Are you sure this is how they do it in The Valley?
2854,1,9,48,58,1.1896551724137931,0.05745613836035109,545,It's there to remind us how dumb some stockholders think we are.
2854,2,7,49,58,1.1896551724137931,0.06249934809931834,545,Now we can tell the stock holders we have a green initiative.
2854,2,7,49,58,1.1896551724137931,0.06249934809931834,545,"I'm sure the company can't do any worse with a plant in charge, but what abut the country?"
2854,2,7,49,58,1.1896551724137931,0.06249934809931834,545,"I am here on behalf of all paper, not just white paper"
2854,1,9,48,58,1.1896551724137931,0.05745613836035109,545,Thank you for plant-splaining that to us.
2854,1,9,48,58,1.1896551724137931,0.05745613836035109,545,Well that's what happens to you when you move to the suburbs.
2854,1,9,48,58,1.1896551724137931,0.05745613836035109,545,We're finally turning over a new leaf.
2854,3,5,50,58,1.1896551724137931,0.06716494018753925,545,Of course a Douglas Fir would suggest that.
2854,3,5,50,58,1.1896551724137931,0.06716494018753925,545,Mr. Trump sends his regrets.
2854,3,5,50,58,1.1896551724137931,0.06716494018753925,545,I want this company to look more like what's out there in America.
2854,5,1,52,58,1.1896551724137931,0.07563762651952825,545,"I'm very happy you've elected me the new chair of the DNC. I know some of you think I'm a GOP plant. I assure you I'm not. Republicans hate growing anything new, be it organic life or ideas."
2854,3,5,50,58,1.1896551724137931,0.06716494018753925,545,Welcome to Tree's Company!
2854,2,7,49,58,1.1896551724137931,0.06249934809931834,545,"I can’t work under these conditions, someone get me some water, open a window, let in some more light."
2854,1,9,48,58,1.1896551724137931,0.05745613836035109,545,"When they said the new CEO was a plant, I thought it was metaphorical."
2854,2,7,49,58,1.1896551724137931,0.06249934809931834,545,I called this meeting because...I need more CO2! All together now. Exhale!
2854,1,9,48,58,1.1896551724137931,0.05745613836035109,545,"For the last time, they're ""manufacturing facilities"". We no longer use the ""other"" word to describe those buildings."
2854,2,7,49,58,1.1896551724137931,0.06249934809931834,545,The bottom line is that by now we'd like to see more growth.
2854,2,7,49,58,1.1896551724137931,0.06249934809931834,545,They wanted to go with someone more eco-sensitive.
2854,2,7,49,58,1.1896551724137931,0.06249934809931834,545,They say he never even sleeps.
2854,0,11,47,58,1.1896551724137931,0.05192539992843435,545,"We used to be just a branch, and now we get the whole tree."
2854,2,7,49,58,1.1896551724137931,0.06249934809931834,545,I am amazed by his quiet reserve.
2854,2,7,49,58,1.1896551724137931,0.06249934809931834,545,Thank you for being here. I am concerned about our 'zero growth' this quarter.
2854,3,5,50,58,1.1896551724137931,0.06716494018753925,545,"During fall, please respect my firm closed door policy"
2854,2,7,49,58,1.1896551724137931,0.06249934809931834,545,Our company has decided to turn a new leaf and we are deeply rooted to the idea of going green. Chloro and Phill will be heading up the project.
2854,1,9,48,58,1.1896551724137931,0.05745613836035109,545,The memo DID say that he would be on personal leave.
2854,3,5,50,58,1.1896551724137931,0.06716494018753925,545,Next person who writes a pot joke is getting written up.
2854,4,3,51,58,1.1896551724137931,0.07152684718308004,545,"Looks like the CEO was serious about going green!"" or ""I guess the boss has been supplanted.."
2854,2,7,49,58,1.1896551724137931,0.06249934809931834,545,Great to see you all approve of the recreational use of our fine product.
2854,0,11,47,58,1.1896551724137931,0.05192539992843435,545,"Unfortunately, it has the tie breaking vote."
2854,2,7,49,58,1.1896551724137931,0.06249934809931834,545,The company is taking this going green thing a little too far.
2854,2,7,49,58,1.1896551724137931,0.06249934809931834,545,The CEO took the suggestion to plant a seed for the future too literally
2854,3,5,50,58,1.1896551724137931,0.06716494018753925,545,I guess you're all wondering why I called this meeting.
2854,2,7,49,58,1.1896551724137931,0.06249934809931834,545,The new CEO needs pruning.
2854,2,7,49,58,1.1896551724137931,0.06249934809931834,545,I think we can all agree that the fire sprinklers in this building are severely underutilized.
2854,2,7,49,58,1.1896551724137931,0.06249934809931834,545,This exemplifies our core values.
2854,0,11,47,58,1.1896551724137931,0.05192539992843435,545,You all know how proud I am of our company's role in promoting workplace diversitry.
2854,2,7,49,58,1.1896551724137931,0.06249934809931834,545,Ficus says what?
2854,3,5,50,58,1.1896551724137931,0.06716494018753925,545,I hear he has a really good agent.
2854,3,5,50,58,1.1896551724137931,0.06716494018753925,545,"When I said this company is going green, I meant it"
2854,1,9,48,58,1.1896551724137931,0.05745613836035109,545,"What is the protocol now, do we refer to him as Mr. President-Elect?"
2854,3,5,50,58,1.1896551724137931,0.06716494018753925,545,"We pretend we don't notice that the CEO's ashes are growing ... that way we keep getting $10,000 per meeting."
2854,0,11,47,58,1.1896551724137931,0.05192539992843435,545,"I'm smarter, lack an orange pallor, have never grabbed a pussy without permission (though women love me) and have a much better CO2 reduction plan than the President-elect."
2854,4,3,51,58,1.1896551724137931,0.07152684718308004,545,Shh. The meeting is being called to water.
2854,2,7,49,58,1.1896551724137931,0.06249934809931834,545,"I know its legal, but did we have to make it Chair?"
2854,1,9,48,58,1.1896551724137931,0.05745613836035109,545,At least it's not poison ivy.
2854,4,3,51,58,1.1896551724137931,0.07152684718308004,545,"We can't be trusted to govern ourselves as humans anymore. So, we've brought in a more enlightened being to run the Board."
2854,1,9,48,58,1.1896551724137931,0.05745613836035109,545,"I agree that he's calming, but can he close the deal with GE?"
2854,2,7,49,58,1.1896551724137931,0.06249934809931834,545,"I always thought a plant in the room would be more, well, stealthy."
2854,1,9,48,58,1.1896551724137931,0.05745613836035109,545,Next on the agenda: re-examining our green initiatives
2854,3,5,50,58,1.1896551724137931,0.06716494018753925,545,He won the prize for perfect attendance.
2854,0,11,47,58,1.1896551724137931,0.05192539992843435,545,From plant manager to CEO. I gotta learn how to make oxygen.
2854,1,9,48,58,1.1896551724137931,0.05745613836035109,545,Now I get the memo that management is going green.
2854,3,5,50,58,1.1896551724137931,0.06716494018753925,545,It's moving to the Oval Office.
2854,1,9,48,58,1.1896551724137931,0.05745613836035109,545,Our commitment to green initiatives is without peer.
2854,1,9,48,58,1.1896551724137931,0.05745613836035109,545,There's talk this new branch manager is a plant for our competition.
2854,2,7,49,58,1.1896551724137931,0.06249934809931834,545,They say he started off dirt poor and built this company from sound investments and plenty of sunlight.
2854,1,9,48,58,1.1896551724137931,0.05745613836035109,545,"I am doing fine, thank you, but how are things at our Detroit plant?"
2854,2,7,49,58,1.1896551724137931,0.06249934809931834,545,I think we're going GREEN.
2854,1,9,48,58,1.1896551724137931,0.05745613836035109,545,Someone level with me. What impact will the water shortage have on our long-term growth strategy?
2854,2,7,49,58,1.1896551724137931,0.06249934809931834,545,"He leaves for a week, he said... Is this supposed to be funny?"
2854,0,11,47,58,1.1896551724137931,0.05192539992843435,545,"As you sow, so shall you reap."
2854,2,7,49,58,1.1896551724137931,0.06249934809931834,545,"Now that Marijuana is a legal citizen, I've decided to run for president."
2854,0,11,47,58,1.1896551724137931,0.05192539992843435,545,As the new CEO I vow to re-oxygenate the boardroom.
2854,3,5,50,58,1.1896551724137931,0.06716494018753925,545,Net-zero staff carbon footprint! And that's final!!
2854,3,5,50,58,1.1896551724137931,0.06716494018753925,545,"Breathe deep, the boss is going to discuss symbiotic business relationships."
2854,1,9,48,58,1.1896551724137931,0.05745613836035109,545,"Welcome, fellow compost enthusiasts."
2854,2,7,49,58,1.1896551724137931,0.06249934809931834,545,"Sir, our ""Go Green"" initiative has been a huge success thanks to your leadership."
2854,2,7,49,58,1.1896551724137931,0.06249934809931834,545,So am I to understand you kept me in the dark for six weeks just to watch a poinsettia turn red?
2854,3,5,50,58,1.1896551724137931,0.06716494018753925,545,"Investors want growth, we give 'em growth!"
2854,1,9,48,58,1.1896551724137931,0.05745613836035109,545,"According to the takeover agreement, we can't do anything without its approval."
2854,0,11,47,58,1.1896551724137931,0.05192539992843435,545,The decision was made to finance a remake 'The Little Shop of Horrors' with an eco-friendly ending.
2854,3,5,50,58,1.1896551724137931,0.06716494018753925,545,I'm sure you're all wondering why I gathered you here today.
2854,1,9,48,58,1.1896551724137931,0.05745613836035109,545,This takes blind trust to a whole new level.
2854,0,11,47,58,1.1896551724137931,0.05192539992843435,545,"I know it's all about not offending anyone, but could we at least put a bit of tinsel on it?"
2854,2,7,49,58,1.1896551724137931,0.06249934809931834,545,"Stuffed shirt, potted plant--what's the difference?!"
2854,5,1,52,58,1.1896551724137931,0.07563762651952825,545,"Has ""the Donald"" done something different with his hair"
2854,0,11,47,58,1.1896551724137931,0.05192539992843435,545,It's time for this company to turn over a new leaf.
2854,2,7,49,58,1.1896551724137931,0.06249934809931834,545,Suddenly my pitch for a vegetarian restaurant sounds offensive.
2854,2,7,49,58,1.1896551724137931,0.06249934809931834,545,Are we sure we brought the right pot?
2854,1,9,48,58,1.1896551724137931,0.05745613836035109,545,I can hardly wait for this year's office party.
2854,4,3,51,58,1.1896551724137931,0.07152684718308004,545,I heard he has the business acumen of a CEO.
2854,2,7,49,58,1.1896551724137931,0.06249934809931834,545,He comes to work every day on pot
2854,3,5,50,58,1.1896551724137931,0.06716494018753925,545,They told me that this was just supposed to be until the election is over.
2854,2,7,49,58,1.1896551724137931,0.06249934809931834,545,President Elect Trump is busy with the transition. He's asked his surrogate to stand in.
2854,2,7,49,58,1.1896551724137931,0.06249934809931834,545,"At least, going ""green"" isn't going to hurt our bottom line!"
2854,2,7,49,58,1.1896551724137931,0.06249934809931834,545,What do you folks know about photosynthesis?
2854,3,5,50,58,1.1896551724137931,0.06716494018753925,545,"If you wish to succeed, as I have, you must be willing to eat shit sometimes."
2854,2,7,49,58,1.1896551724137931,0.06249934809931834,545,I say we take him to the rooftop and let him wilt.
2854,2,7,49,58,1.1896551724137931,0.06249934809931834,545,"Another flowery vision that will never take root, I predict."
2854,1,9,48,58,1.1896551724137931,0.05745613836035109,545,Does his wife know he was replaced by a potted plant?
2854,2,7,49,58,1.1896551724137931,0.06249934809931834,545,'He's a CIA plant.'
2854,3,5,50,58,1.1896551724137931,0.06716494018753925,545,We needed a breath of fresh air around here.
2854,1,9,48,58,1.1896551724137931,0.05745613836035109,545,It appears the boss is finally taking our 'going green' idea to front and center.
2854,0,11,47,58,1.1896551724137931,0.05192539992843435,545,"Ladies and gentleman this is Fern, he's heading up our new Green Program."
2854,2,7,49,58,1.1896551724137931,0.06249934809931834,545,"Outlook is challenging, there’s just no low-hanging fruit left."
2854,3,5,50,58,1.1896551724137931,0.06716494018753925,545,"Ladies and gentlemen, you may think I'm a little green at this ,but don't let that fool you...."
2854,3,5,50,58,1.1896551724137931,0.06716494018753925,545,He's on gardening leave.
2854,0,11,47,58,1.1896551724137931,0.05192539992843435,545,I must say that the new CEO has certainly planted some good ideas.
2854,1,9,48,58,1.1896551724137931,0.05745613836035109,545,What? Is there something on my face?
2854,1,9,48,58,1.1896551724137931,0.05745613836035109,545,Great . . . one more responsibility.
2854,2,7,49,58,1.1896551724137931,0.06249934809931834,545,"Hear me out, guys. I'd just like to plant a seed in your heads."
2854,0,11,47,58,1.1896551724137931,0.05192539992843435,545,Have you noticed that Flora's always thirsty?
2854,2,7,49,58,1.1896551724137931,0.06249934809931834,545,Our new CEO is an icon in the green economy.
2854,2,7,49,58,1.1896551724137931,0.06249934809931834,545,The moment the board realized that the company plant would not be moving to Mexico after all.
2854,3,5,50,58,1.1896551724137931,0.06716494018753925,545,First things first. Who's my director of sunlight?
2854,1,9,48,58,1.1896551724137931,0.05745613836035109,545,Maybe there was something to the 'slippery slope' argument after all.
2854,2,7,49,58,1.1896551724137931,0.06249934809931834,545,"Obviously, for our company in particular, growth is key."
2854,0,11,47,58,1.1896551724137931,0.05192539992843435,545,Rumor has it the competition has planted a spy.
2854,3,5,50,58,1.1896551724137931,0.06716494018753925,545,Let's leaf through the Medical Marijuana in the Workplace Policy
2854,2,7,49,58,1.1896551724137931,0.06249934809931834,545,When they said they planned to grow the company I didn't expect this.
2854,1,9,48,58,1.1896551724137931,0.05745613836035109,545,"Gina, I see that plant-based diet is really working out for you."
2854,2,7,49,58,1.1896551724137931,0.06249934809931834,545,"My name is Ficus benjamina, but you can call me Ben."
2854,0,11,47,58,1.1896551724137931,0.05192539992843435,545,Are we in Brooklyn?
2854,2,7,49,58,1.1896551724137931,0.06249934809931834,545,"As our resident environmental impact expert, do you have any objections to the new proposal? If not, we'll go ahead and put you back in the break room."
3165,3,5,51,59,1.1864406779661016,0.0660949508765778,545,I think the Diversity Initiative has finally gone too far.
3165,0,11,48,59,1.1864406779661016,0.051138849454651934,545,These 'green' initiatives are going too far.
3165,3,5,51,59,1.1864406779661016,0.0660949508765778,545,Who would have suspected that the chair was the plant!
3165,1,9,49,59,1.1864406779661016,0.0565653202898158,545,We need to talk about Genetically Modified Organisms...
3165,3,5,51,59,1.1864406779661016,0.0660949508765778,545,Only his father thinks he has board potential.
3165,1,9,49,59,1.1864406779661016,0.0565653202898158,545,This is diversity run amok.
3165,0,11,48,59,1.1864406779661016,0.051138849454651934,545,I'm the new branch manager. I want to get to the root of the problem.
3165,1,9,49,59,1.1864406779661016,0.0565653202898158,545,Our new green initiative
3165,1,9,49,59,1.1864406779661016,0.0565653202898158,545,The late owner has bequeathed the company to her favorite plant.
3165,3,5,51,59,1.1864406779661016,0.0660949508765778,545,Let the minutes show that the CEO arrived at today's Executive Meeting potted.
3165,2,7,50,59,1.1864406779661016,0.061514949365445624,545,"At least, this one doesn't yell"
3165,2,7,50,59,1.1864406779661016,0.061514949365445624,545,Psst...I heard the Boss was seen again at the old watering hole last night.
3165,3,5,51,59,1.1864406779661016,0.0660949508765778,545,I think the new CEO is a Plant.
3165,1,9,49,59,1.1864406779661016,0.0565653202898158,545,As we move away from coal we have to start rethinking our image.
3165,0,11,48,59,1.1864406779661016,0.051138849454651934,545,Bush for president year 2020
3165,2,7,50,59,1.1864406779661016,0.061514949365445624,545,"I'm all for diversity, but . . ."
3165,3,5,51,59,1.1864406779661016,0.0660949508765778,545,"It's name is Ralph, he represents President-Elect Trump's blind trust."
3165,2,7,50,59,1.1864406779661016,0.061514949365445624,545,We bushes like being a president.
3165,1,9,49,59,1.1864406779661016,0.0565653202898158,545,The best part is that we get to phone it in during the winter.
3165,2,7,50,59,1.1864406779661016,0.061514949365445624,545,I'm not sure about this new green initiative.
3165,4,3,52,59,1.1864406779661016,0.07037752529977964,545,"Let's be clear, I'm a pot head not a pothead."
3165,0,11,48,59,1.1864406779661016,0.051138849454651934,545,Do we hear you right? You want to be legal in how many states?
3165,1,9,49,59,1.1864406779661016,0.0565653202898158,545,I guess the write-in candidate votes really made an impact in this election.
3165,1,9,49,59,1.1864406779661016,0.0565653202898158,545,So I think it's clear to all of us that Plant Parenthood's got to go.
3165,4,3,52,59,1.1864406779661016,0.07037752529977964,545,"I say we just stop watering the President elect, see where that goes."
3165,2,7,50,59,1.1864406779661016,0.061514949365445624,545,"Frankly J.P., we think its a miracle you are still alive."
3165,1,9,49,59,1.1864406779661016,0.0565653202898158,545,It's his Halloween costume.
3165,3,5,51,59,1.1864406779661016,0.0660949508765778,545,"And what am I, chopped liver?!"
3165,3,5,51,59,1.1864406779661016,0.0660949508765778,545,Are you sure that he's the new plant president?
3194,3,5,52,60,1.1833333333333333,0.06505828185300302,545,They said he looked like a pumpkin.
3195,4,2,49,55,1.1818181818181819,0.07381343800583884,545,"Ladies and gentlemen, I am pleased to introduce you to the next President of the United States."
3196,3,4,50,57,1.1754385964912282,0.06680502724442026,545,"Sorry, but the board voted 6-4 against approving occupational marijuana"
3196,4,2,51,57,1.1754385964912282,0.07134057808265808,545,I think he's on mute
3196,1,8,48,57,1.1754385964912282,0.056654910052417636,545,Although I'm a transplant I plan to establish deep roots in this company.
3196,3,4,50,57,1.1754385964912282,0.06680502724442026,545,"We haven't seen much growth, well Fern what do you have to say for yourself ?"
3196,1,8,48,57,1.1754385964912282,0.056654910052417636,545,We think you've taken our attempt to go green a little too far.
3196,1,8,48,57,1.1754385964912282,0.056654910052417636,545,I’ve been asked to lead our transition team to the green economy
3196,2,6,49,57,1.1754385964912282,0.06193823737472381,545,Could one of you please bring me some water?
3196,0,10,47,57,1.1754385964912282,0.050825312758579586,545,I'm pleased to announce that you have all voted in favor of keeping the plant open and operational.
3196,1,8,48,57,1.1754385964912282,0.056654910052417636,545,"As figureheads, I prefer hibiscus."
3196,1,8,48,57,1.1754385964912282,0.056654910052417636,545,Who ever thought our POT would become POT-US?
3196,2,6,49,57,1.1754385964912282,0.06193823737472381,545,"I agree, this place has been vegetating for too long."
3196,1,8,48,57,1.1754385964912282,0.056654910052417636,545,"Shhh, people! I think one of the new directors might be a plant!"
3196,2,6,49,57,1.1754385964912282,0.06193823737472381,545,Plant wants to run for president
3196,2,6,49,57,1.1754385964912282,0.06193823737472381,545,Can someone start the meeting.
3196,2,6,49,57,1.1754385964912282,0.06193823737472381,545,I'm betting it's a plant from our main competitor.
3196,1,8,48,57,1.1754385964912282,0.056654910052417636,545,One small step for our former chairman. One giant leap for biotech.
3196,1,8,48,57,1.1754385964912282,0.056654910052417636,545,I think one of the board members is a corporate plant
3196,0,10,47,57,1.1754385964912282,0.050825312758579586,545,The only good news I have to report is that the company is not under water.
3196,1,8,48,57,1.1754385964912282,0.056654910052417636,545,I thought it would be an inspiration for our new California marijuana launch.
3196,1,8,48,57,1.1754385964912282,0.056654910052417636,545,I think he is a board of director's plant.
3196,4,2,51,57,1.1754385964912282,0.07134057808265808,545,The Chairman of the Board has taken his green iniative a bit too far this time.
3196,3,4,50,57,1.1754385964912282,0.06680502724442026,545,Sierra Club Board photosynthesis op.
3196,2,6,49,57,1.1754385964912282,0.06193823737472381,545,There's no way that decision was organic.
3196,1,8,48,57,1.1754385964912282,0.056654910052417636,545,He said company profits would grow more with classical music.
3196,1,8,48,57,1.1754385964912282,0.056654910052417636,545,"Hey, you should offer him some water"
3196,1,8,48,57,1.1754385964912282,0.056654910052417636,545,"Good news, our plants still in business."
3196,2,6,49,57,1.1754385964912282,0.06193823737472381,545,I'm guessing it has something to do with growing the economy.
3196,3,4,50,57,1.1754385964912282,0.06680502724442026,545,The rhizome revolution has begun. Your job is to stop it from spreading.
3196,4,2,51,57,1.1754385964912282,0.07134057808265808,545,Our new annual leaf policy will help recruit more perennials.
3196,1,8,48,57,1.1754385964912282,0.056654910052417636,545,"...and for those who continue to produce carbon dioxide, our zero tolerance policy will require that you immediately enroll in breathing cessation classes."
3196,2,6,49,57,1.1754385964912282,0.06193823737472381,545,I thought it was time you were updated on the Springfield plant.
3196,1,8,48,57,1.1754385964912282,0.056654910052417636,545,"... starting, of course, with our new liberal leave policy..."
3196,1,8,48,57,1.1754385964912282,0.056654910052417636,545,"As you've heard, in this political climate, we're all going to have to prune back."
3196,2,6,49,57,1.1754385964912282,0.06193823737472381,545,Mr.Trump asked us to water it for the next four years.
3196,1,8,48,57,1.1754385964912282,0.056654910052417636,545,And that's part of our going green initiative .
3196,2,6,49,57,1.1754385964912282,0.06193823737472381,545,"This is Phil Dendron, a representative from the Plant Employees Union."
3196,1,8,48,57,1.1754385964912282,0.056654910052417636,545,So are you saying we should branch out?
3196,0,10,47,57,1.1754385964912282,0.050825312758579586,545,I want you to know that I have deep feelings for all of you.
3196,1,8,48,57,1.1754385964912282,0.056654910052417636,545,We need your input on ways to grow our business.
3196,1,8,48,57,1.1754385964912282,0.056654910052417636,545,I see the apple hasn’t fallen far from the tree.
3196,1,8,48,57,1.1754385964912282,0.056654910052417636,545,How long do we have to look at that burial plant before we choose a new CEO?
3196,1,8,48,57,1.1754385964912282,0.056654910052417636,545,"I am not ... well, actually I am a potted plant."
3196,0,10,47,57,1.1754385964912282,0.050825312758579586,545,"Like most Strategic Plants, this one won’t bear fruit for several years."
3196,0,10,47,57,1.1754385964912282,0.050825312758579586,545,Remember when he was just a seedling ?
3196,2,6,49,57,1.1754385964912282,0.06193823737472381,545,Careful what you say. I could be wrong but I bet he's a plant.
3196,1,8,48,57,1.1754385964912282,0.056654910052417636,545,"When they said come meet Mr. Plant, our new CEO, I wasn't quite picturing this."
3196,0,10,47,57,1.1754385964912282,0.050825312758579586,545,sent by corporate to breathe fresh new air into their stale office
3196,0,10,47,57,1.1754385964912282,0.050825312758579586,545,Did you think she wants coffee or water?
3196,3,4,50,57,1.1754385964912282,0.06680502724442026,545,number 1 on the agenda..my watering scheduling. no.2 Global warming.
3196,2,6,49,57,1.1754385964912282,0.06193823737472381,545,You caught me. I'm a plant.
3196,2,6,49,57,1.1754385964912282,0.06193823737472381,545,"As representatives of the first legal weed company, you dudes could do with a serious makeover."
3196,1,8,48,57,1.1754385964912282,0.056654910052417636,545,We're totally going green this fiscal year.
3196,1,8,48,57,1.1754385964912282,0.056654910052417636,545,"It's a ""plant""!"
3196,1,8,48,57,1.1754385964912282,0.056654910052417636,545,"I think we have taken this ""Going Green"" a bit too far."
3196,2,6,49,57,1.1754385964912282,0.06193823737472381,545,You said it was real but I told you it was a plant.
3196,0,10,47,57,1.1754385964912282,0.050825312758579586,545,Maybe if we water it?
3196,3,4,50,57,1.1754385964912282,0.06680502724442026,545,I called this meeting to clear the air. I am not a corporate plant.
3196,3,4,50,57,1.1754385964912282,0.06680502724442026,545,"We are going 100% green today, and I don't mean cash."
3196,0,10,47,57,1.1754385964912282,0.050825312758579586,545,He's really got to branch out in these meetings
3196,2,6,49,57,1.1754385964912282,0.06193823737472381,545,They say he has a green thumb.
3196,2,6,49,57,1.1754385964912282,0.06193823737472381,545,"When they said they were planting seeds, I thought they meant for the upcoming merger."
3196,0,10,47,57,1.1754385964912282,0.050825312758579586,545,Not the new branch plant I was expecting.
3196,2,6,49,57,1.1754385964912282,0.06193823737472381,545,Well this is awkward...
3196,0,10,47,57,1.1754385964912282,0.050825312758579586,545,"o.k.,so who's turn is it to water the money tree?"
3196,2,6,49,57,1.1754385964912282,0.06193823737472381,545,You'll be pleased to know that I plan to provide continuity with the prior chairman's management approach.
3196,0,10,47,57,1.1754385964912282,0.050825312758579586,545,Taking the 'organic growth' strategy a little too far.
3196,2,6,49,57,1.1754385964912282,0.06193823737472381,545,Do we wait until she leaves?
3196,1,8,48,57,1.1754385964912282,0.056654910052417636,545,Your ideas sure are growing on us.
3196,1,8,48,57,1.1754385964912282,0.056654910052417636,545,"...In conclusion, ladies and gentleman, let's get out there and vote! The result will determine the quality of fertilizer available to us for the next four years."
3196,1,8,48,57,1.1754385964912282,0.056654910052417636,545,Let's let these ideas germinate until our next meeting.
3196,3,4,50,57,1.1754385964912282,0.06680502724442026,545,I still don't think he understands how a blind trust works.
3196,2,6,49,57,1.1754385964912282,0.06193823737472381,545,Our polling numbers said to go green.
3196,2,6,49,57,1.1754385964912282,0.06193823737472381,545,could we please get some bottled water in here?
3196,3,4,50,57,1.1754385964912282,0.06680502724442026,545,The employees at the plant wanted more diversity on the board.
3196,3,4,50,57,1.1754385964912282,0.06680502724442026,545,"Furthermore, we will be starting a new rotation schedule on Monday"
3196,3,4,50,57,1.1754385964912282,0.06680502724442026,545,I can't believe this FICUS plant is in charge now.
3196,3,4,50,57,1.1754385964912282,0.06680502724442026,545,"Yes, sir, mother nature is the boss."
3196,0,10,47,57,1.1754385964912282,0.050825312758579586,545,This company really needs to branch out.
3196,2,6,49,57,1.1754385964912282,0.06193823737472381,545,They must have brought him in from outside the company.
3196,2,6,49,57,1.1754385964912282,0.06193823737472381,545,"Jim, you're brilliant. Not only does the new guy make the same contribution of ideas, he costs a fraction of the price!"
3196,1,8,48,57,1.1754385964912282,0.056654910052417636,545,"I think he misunderstood what we meant by ""going green""."
3196,3,4,50,57,1.1754385964912282,0.06680502724442026,545,He said he would leave after the election.
3196,3,4,50,57,1.1754385964912282,0.06680502724442026,545,"Well, if you don't like it, you can just leaf"
3196,2,6,49,57,1.1754385964912282,0.06193823737472381,545,The rumor that I don't have both feet planted firmly on the ground is grossly exaggerated.
3196,1,8,48,57,1.1754385964912282,0.056654910052417636,545,I feel like he's planting the wrong ideas in our heads.
3196,2,6,49,57,1.1754385964912282,0.06193823737472381,545,I'm proof positive the plants are coming back to America!
3196,1,8,48,57,1.1754385964912282,0.056654910052417636,545,I was told the plant manager wanted to address the board about the impending strike.
3196,3,4,50,57,1.1754385964912282,0.06680502724442026,545,Read my lips: long term investment diversification.
3196,3,4,50,57,1.1754385964912282,0.06680502724442026,545,Good news - we have been named one of the top green businesses in the city.
3196,2,6,49,57,1.1754385964912282,0.06193823737472381,545,"All in favor of moving our plant offshore, say ""Aye""!"
3196,3,4,50,57,1.1754385964912282,0.06680502724442026,545,"The experts recommend you stop soiling yourself, but what the hell do they know?"
3196,2,6,49,57,1.1754385964912282,0.06193823737472381,545,"First item on the agenda is plant management. As you know, I have become pot-bound and will need a transplant operation. The prognosis is very good and I expect to multiply. Lets discuss."
3196,1,8,48,57,1.1754385964912282,0.056654910052417636,545,I guess he overdid the vegan thing!
3196,2,6,49,57,1.1754385964912282,0.06193823737472381,545,The Board suspected the Chairman was an FBI plant.
3196,1,8,48,57,1.1754385964912282,0.056654910052417636,545,Biodiversity! Corporate diversity's final frontier.
3196,0,10,47,57,1.1754385964912282,0.050825312758579586,545,I was NOT planted from the outside.
3196,2,6,49,57,1.1754385964912282,0.06193823737472381,545,"Glad to see you could make it, Nelson"
3196,2,6,49,57,1.1754385964912282,0.06193823737472381,545,I believe he's reminding us that money doesn't grow on trees!
3196,1,8,48,57,1.1754385964912282,0.056654910052417636,545,At least know we're forced to use renewable energy.
3196,2,6,49,57,1.1754385964912282,0.06193823737472381,545,"Well, the change might grow on us."
3196,2,6,49,57,1.1754385964912282,0.06193823737472381,545,I may be in a vegetative state but I'm not dead. I can still run this company.
3196,2,6,49,57,1.1754385964912282,0.06193823737472381,545,On the agenda today is Green Investments
3196,2,6,49,57,1.1754385964912282,0.06193823737472381,545,What now Mr President?
3196,4,2,51,57,1.1754385964912282,0.07134057808265808,545,Let's all just give it a chance..A new PEO just might be exactly what we need here to make it work.
3196,1,8,48,57,1.1754385964912282,0.056654910052417636,545,Pot luck vegan lunch it is. Next on our agenda?
3196,0,10,47,57,1.1754385964912282,0.050825312758579586,545,Just because the shareholders voted you in doesn't mean your fit to leave
3196,1,8,48,57,1.1754385964912282,0.056654910052417636,545,"There's my proposal, take it or leaf it."
3196,2,6,49,57,1.1754385964912282,0.06193823737472381,545,Isn't this Friday?
3196,1,8,48,57,1.1754385964912282,0.056654910052417636,545,it was appointed because of it's strength as an outsider
3196,2,6,49,57,1.1754385964912282,0.06193823737472381,545,There's no escaping the fact that under animal kingdom leadership this company has gone eleven straight years without a profit.
3196,0,10,47,57,1.1754385964912282,0.050825312758579586,545,Shhh...don't talk! There's a plant in the room.
3196,1,8,48,57,1.1754385964912282,0.056654910052417636,545,R&D has developed a solution to the atmosphere's declining oxygen levels.
3196,0,10,47,57,1.1754385964912282,0.050825312758579586,545,"Bloom where you're planted, people. I cannot stress this enough."
3196,2,6,49,57,1.1754385964912282,0.06193823737472381,545,I always knew the chairs were plants.
3196,1,8,48,57,1.1754385964912282,0.056654910052417636,545,Let's make like a tree and leave.
3196,2,6,49,57,1.1754385964912282,0.06193823737472381,545,You were expecting a Trump-it plant?
3196,1,8,48,57,1.1754385964912282,0.056654910052417636,545,If you don't agree feel free to leaf now.
3196,2,6,49,57,1.1754385964912282,0.06193823737472381,545,Can we get some more water here?
3196,2,6,49,57,1.1754385964912282,0.06193823737472381,545,My mother said to respect all living things.
3196,1,8,48,57,1.1754385964912282,0.056654910052417636,545,Anyone else wanna leave?
3196,1,8,48,57,1.1754385964912282,0.056654910052417636,545,You're telling me Herb was the only one who got the memo on our transition to paperless? Do I look like a sapling?
3196,3,4,50,57,1.1754385964912282,0.06680502724442026,545,Our company needs more focus on the greenhouse effect.
3196,2,6,49,57,1.1754385964912282,0.06193823737472381,545,(Let's see if this learning by osmosis thing is a two-way street.)
3196,2,6,49,57,1.1754385964912282,0.06193823737472381,545,The importance of succession planning.
3196,2,6,49,57,1.1754385964912282,0.06193823737472381,545,Ten lawyers and he still got indicted.
3196,1,8,48,57,1.1754385964912282,0.056654910052417636,545,Is it just me or don't also you think the Chairman has turned over a new leaf?
3196,2,6,49,57,1.1754385964912282,0.06193823737472381,545,With the recent election that project went to pot.
3196,2,6,49,57,1.1754385964912282,0.06193823737472381,545,I said ficus but he heard something else.
3196,2,6,49,57,1.1754385964912282,0.06193823737472381,545,Are you here to talk about our over usage on paper?
3196,1,8,48,57,1.1754385964912282,0.056654910052417636,545,What can we do to help you get ahead after such a severe bushwhacking?
3196,2,6,49,57,1.1754385964912282,0.06193823737472381,545,My green burial has given me a new life.
3196,0,10,47,57,1.1754385964912282,0.050825312758579586,545,I will be meeting with some stake holders this afternoon to discuss the limits on our growth potential.
3196,3,4,50,57,1.1754385964912282,0.06680502724442026,545,I've replaced fern.
3196,3,4,50,57,1.1754385964912282,0.06680502724442026,545,You wouldn't recognize him before he mastered mindfulness.
3196,1,8,48,57,1.1754385964912282,0.056654910052417636,545,He's taken the empty suit cliché to the next level.
3196,0,10,47,57,1.1754385964912282,0.050825312758579586,545,"Alright guys, leaf all your notes on the table and let's talk about the roots of this company. Is anyone stumped about anything?"
3196,0,10,47,57,1.1754385964912282,0.050825312758579586,545,Let's look at this solution from the ground up.
3196,2,6,49,57,1.1754385964912282,0.06193823737472381,545,Never water me during board meetings.
3196,2,6,49,57,1.1754385964912282,0.06193823737472381,545,"Dave was right, anyone can become a VP at this company."
3196,2,6,49,57,1.1754385964912282,0.06193823737472381,545,Going green does have its limitations.
3196,1,8,48,57,1.1754385964912282,0.056654910052417636,545,I know this seems strange but the shareholders have voted it in..
3196,2,6,49,57,1.1754385964912282,0.06193823737472381,545,"Now, I would like to discuss a the terms of a bigger pot."
3196,3,4,50,57,1.1754385964912282,0.06680502724442026,545,I told you not to order the vegetarian meal.
3196,2,6,49,57,1.1754385964912282,0.06193823737472381,545,I want to see a plant in every office.
3196,1,8,48,57,1.1754385964912282,0.056654910052417636,545,He always had firmly planted opinions.
3196,1,8,48,57,1.1754385964912282,0.056654910052417636,545,"Well, don't just sit there like a potted plant!"
3196,1,8,48,57,1.1754385964912282,0.056654910052417636,545,"What am I, chopped liver?"
3196,1,8,48,57,1.1754385964912282,0.056654910052417636,545,Are you all on board with the company's position on global warming?
3196,1,8,48,57,1.1754385964912282,0.056654910052417636,545,I think that I've discovered the undercover boss.
3196,0,10,47,57,1.1754385964912282,0.050825312758579586,545,I'm happy to report that the success of our green initiatives has removed the need to consider plant closings.
3196,2,6,49,57,1.1754385964912282,0.06193823737472381,545,He had our full support until the leaf spot appeared.
3196,1,8,48,57,1.1754385964912282,0.056654910052417636,545,I think we will now take a water break.
3196,1,8,48,57,1.1754385964912282,0.056654910052417636,545,Is he gonna sit there like a vegetable the whole meeting?
3196,1,8,48,57,1.1754385964912282,0.056654910052417636,545,Growth will ramp up in the second quarter and we'll hit new highs in the third.
3196,1,8,48,57,1.1754385964912282,0.056654910052417636,545,CEO Mary Jane commences the first board meeting for a California startup.
3196,1,8,48,57,1.1754385964912282,0.056654910052417636,545,She claims to be a stakeholder in our carbon emissions program.
3196,2,6,49,57,1.1754385964912282,0.06193823737472381,545,I hope it doesn't call on me.
3196,1,8,48,57,1.1754385964912282,0.056654910052417636,545,"With all due respect, what do we look like to YOU?"
3196,3,4,50,57,1.1754385964912282,0.06680502724442026,545,""" The last time it spoke , no one heard it ""."
3196,0,10,47,57,1.1754385964912282,0.050825312758579586,545,Let's hope the new executive grows into the job.
3196,2,6,49,57,1.1754385964912282,0.06193823737472381,545,"I heard that management wanted to ""branch out"", but, they've really overdone it this time."
3196,2,6,49,57,1.1754385964912282,0.06193823737472381,545,I want to come clean. I am a plant.
3196,0,10,47,57,1.1754385964912282,0.050825312758579586,545,It's important to grow with the company.
3196,3,4,50,57,1.1754385964912282,0.06680502724442026,545,"That's it, everyone, just breathe."
3196,2,6,49,57,1.1754385964912282,0.06193823737472381,545,This is the now legal pot plant that will let us get out of the tobacco business and make us a fortune!
3196,0,10,47,57,1.1754385964912282,0.050825312758579586,545,It's all about demonstrating our environmental leadership credentials.
3196,3,4,50,57,1.1754385964912282,0.06680502724442026,545,"Why have a president, when a plant can run all branches of government?"
3196,1,8,48,57,1.1754385964912282,0.056654910052417636,545,"Come on, people. We need to branch out!"
3196,0,10,47,57,1.1754385964912282,0.050825312758579586,545,We find ourselves in an unusual situation.
3196,1,8,48,57,1.1754385964912282,0.056654910052417636,545,The FBI said it was only a plant.
3196,1,8,48,57,1.1754385964912282,0.056654910052417636,545,Don't just sit there like a bunch of humans...
3196,2,6,49,57,1.1754385964912282,0.06193823737472381,545,I was worried when Bob said new leadership was going to ficus.
3196,0,10,47,57,1.1754385964912282,0.050825312758579586,545,"Now, here's my plan for growing the economy."
3196,3,4,50,57,1.1754385964912282,0.06680502724442026,545,"Why would you think that I'm unelectable, people?"
3196,0,10,47,57,1.1754385964912282,0.050825312758579586,545,"""It's more relatable than the burning bush""."
3196,2,6,49,57,1.1754385964912282,0.06193823737472381,545,It's supposed to help us increase our ficus score.
3196,2,6,49,57,1.1754385964912282,0.06193823737472381,545,It's supposed to help plant ideas in our heads.
3196,1,8,48,57,1.1754385964912282,0.056654910052417636,545,"Linda, I think we may have gone too green."
3196,1,8,48,57,1.1754385964912282,0.056654910052417636,545,"It's Marketing's idea. Now we can honestly say our new, green plant is an industry leader."
3196,0,10,47,57,1.1754385964912282,0.050825312758579586,545,I'm glad I'm a vegetarian.
3196,3,4,50,57,1.1754385964912282,0.06680502724442026,545,Harmon has definitely taken passive-aggressive to a whole new level.
3196,2,6,49,57,1.1754385964912282,0.06193823737472381,545,Manufacturing not plant experience.
3196,0,10,47,57,1.1754385964912282,0.050825312758579586,545,I hear the new president is a plant from our biggest competitor.
3196,1,8,48,57,1.1754385964912282,0.056654910052417636,545,"I don't think that's want he meant by ""seed money""."
3196,2,6,49,57,1.1754385964912282,0.06193823737472381,545,"That's right, I'm also a seed of doubt that Mr. Comey planted about a month ago. Why, what did I miss?"
3196,3,4,50,57,1.1754385964912282,0.06680502724442026,545,She was a write-in candidate.
3196,2,6,49,57,1.1754385964912282,0.06193823737472381,545,I love the way it greens up after good news.
3196,3,4,50,57,1.1754385964912282,0.06680502724442026,545,Hour 6 of BP's committee meeting to pick the new office plant.
3196,2,6,49,57,1.1754385964912282,0.06193823737472381,545,Now that we have successfully merged the kingdoms ...
3196,3,4,50,57,1.1754385964912282,0.06680502724442026,545,Can anyone branch off that idea.
3196,1,8,48,57,1.1754385964912282,0.056654910052417636,545,Is this going to be another meting where we spend hours trying to read the tea leaves?
3196,2,6,49,57,1.1754385964912282,0.06193823737472381,545,So I'm the only one who finds it culturally insensitive to call new-hires green?
3196,1,8,48,57,1.1754385964912282,0.056654910052417636,545,My preferred downsizing is to remove all dead wood.
3196,0,10,47,57,1.1754385964912282,0.050825312758579586,545,"Ficus, picus. We can all get higher than kites smoking that bad boy."
3196,1,8,48,57,1.1754385964912282,0.056654910052417636,545,The board thought he would be the best candidate to lead the company in the green economy
3196,1,8,48,57,1.1754385964912282,0.056654910052417636,545,"I don't trust him, I think he's been planted."
3196,0,10,47,57,1.1754385964912282,0.050825312758579586,545,Any word from the Electoral College yet?
3196,1,8,48,57,1.1754385964912282,0.056654910052417636,545,Bart Jr. worried that the board saw him as too green for his position
3196,2,6,49,57,1.1754385964912282,0.06193823737472381,545,Looks like we are meeting our goal of significant growth this quarter.
3196,1,8,48,57,1.1754385964912282,0.056654910052417636,545,He climbed the corporate ivy ladder.
3196,0,10,47,57,1.1754385964912282,0.050825312758579586,545,Your goal is to raise output of carbon dioxide this year by 5%.
3196,3,4,50,57,1.1754385964912282,0.06680502724442026,545,Quarter-over-quarter organic growth remained static amidst an increasingly competitive landscape.
3196,1,8,48,57,1.1754385964912282,0.056654910052417636,545,"I'll put this on the table now: the old pay-packet is out, water and sunlight are in, with air negotiable."
3196,2,6,49,57,1.1754385964912282,0.06193823737472381,545,I apologize for our late start. My wife's been molting this week.
3196,2,6,49,57,1.1754385964912282,0.06193823737472381,545,We're concerned about the lack of growth since our seed investment
3196,1,8,48,57,1.1754385964912282,0.056654910052417636,545,"I know, ""Photosynthesis for Dummies""!"
3196,2,6,49,57,1.1754385964912282,0.06193823737472381,545,Security has discovered a plant in our midst. What are we going to do about it?
3196,2,6,49,57,1.1754385964912282,0.06193823737472381,545,"I believe in going green, but this is ridiculous."
3196,3,4,50,57,1.1754385964912282,0.06680502724442026,545,Don't water him.
3196,1,8,48,57,1.1754385964912282,0.056654910052417636,545,All opposed to going green say nay.
3196,3,4,50,57,1.1754385964912282,0.06680502724442026,545,"Oh great, looks like Mr. Huffington is potted again."
3196,1,8,48,57,1.1754385964912282,0.056654910052417636,545,Wow! This is the most mellow a Green Party representative has been in years!
3196,0,10,47,57,1.1754385964912282,0.050825312758579586,545,Mr. Plant any suggestions on how to improve office climate?
3196,2,6,49,57,1.1754385964912282,0.06193823737472381,545,I hear there's a plant among us
3196,1,8,48,57,1.1754385964912282,0.056654910052417636,545,"If anyone objects, be like a tree and leave."
3196,1,8,48,57,1.1754385964912282,0.056654910052417636,545,Any questions on the new leave policy?
3196,1,8,48,57,1.1754385964912282,0.056654910052417636,545,I have decided to show my true colors.
3196,3,4,50,57,1.1754385964912282,0.06680502724442026,545,"After this meeting, who needs fertilizer?"
3414,2,6,50,58,1.1724137931034482,0.06093608879319741,545,Is it weird if I order a vegie burger for lunch?
3414,1,8,49,58,1.1724137931034482,0.05575164786673556,545,I heard the CEO's planning on trimming the budget.
3414,0,10,48,58,1.1724137931034482,0.050032844835173236,545,That's medical. And I'm a patient.
3414,1,8,49,58,1.1724137931034482,0.05575164786673556,545,With this CEO we can guarantee shareholders robust growth.
3414,2,6,50,58,1.1724137931034482,0.06093608879319741,545,"Central Park, 2024"
3414,2,6,50,58,1.1724137931034482,0.06093608879319741,545,I bet it's plantar fasciitis.
3414,2,6,50,58,1.1724137931034482,0.06093608879319741,545,Going green IS possible.
3414,2,6,50,58,1.1724137931034482,0.06093608879319741,545,Movember has gotten weird
3414,3,4,51,58,1.1724137931034482,0.06571276584476107,545,"Just think, No matter how important you think you are, just remember you are my future fertilizer."
3414,1,8,49,58,1.1724137931034482,0.05575164786673556,545,"Please listen carefully, as our menu options have recently changed."
3424,1,8,50,59,1.1694915254237288,0.054876421247483355,545,Cheer up! I COULD have been a vegetable!
3424,0,10,49,59,1.1694915254237288,0.049264267709845745,545,The calendar e-vite clearly stated 'top-flora executive meeting.'
3424,0,10,49,59,1.1694915254237288,0.049264267709845745,545,He's what ya call a commander-in-leaf.
3424,1,8,50,59,1.1694915254237288,0.054876421247483355,545,The stalks are high.
3428,2,5,48,55,1.1636363636363636,0.06229957149539102,545,"And now, the annual report . . ."
3428,2,5,48,55,1.1636363636363636,0.06229957149539102,545,Weed in the workplace
3428,2,5,48,55,1.1636363636363636,0.06229957149539102,545,The Board of Directors admires the company's new plant
3428,1,7,47,55,1.1636363636363636,0.05663776068232804,545,Staring it only serves to reinforce the message
3428,1,7,47,55,1.1636363636363636,0.05663776068232804,545,As your new president I ask that all human employees treat the green residents of your offices with respect.
3428,1,7,47,55,1.1636363636363636,0.05663776068232804,545,we are all here to watch our company grow
3428,2,5,48,55,1.1636363636363636,0.06229957149539102,545,"The funny thing is, I kind of like their quiet strength..."
3428,2,5,48,55,1.1636363636363636,0.06229957149539102,545,This should get the ecologists off our backs.(
3428,2,5,48,55,1.1636363636363636,0.06229957149539102,545,"Pssst, got a snickers bar?"
3428,2,5,48,55,1.1636363636363636,0.06229957149539102,545,"Before I call the meeting to order, ""Anybody got 'the munchies'?"""
3428,1,7,47,55,1.1636363636363636,0.05663776068232804,545,"Betsy is up next. Poor thing, she's shaking like a leaf."
3428,3,3,49,55,1.1636363636363636,0.06748805288278815,545,Look- somebody forgot the Chairman's glass of water!
3428,1,7,47,55,1.1636363636363636,0.05663776068232804,545,"Heads up, if you are ever alone with him, don't check his roots to see if he ""needs water""."
3428,2,5,48,55,1.1636363636363636,0.06229957149539102,545,My thoughts remain rooted in investing in solar energy.
3428,1,7,47,55,1.1636363636363636,0.05663776068232804,545,"just how are you related to the ""burning bush.'"
3428,2,5,48,55,1.1636363636363636,0.06229957149539102,545,Soiler alert: leaf us alone because we shall seed that the root of the problem is we're going to pot.
3428,1,7,47,55,1.1636363636363636,0.05663776068232804,545,"He's a little full of himself, if you ask me."
3428,0,9,46,55,1.1636363636363636,0.05034317492677622,545,As your new CEO I am aware that there is some awkwardness...please keep things on a first name basis and just call me Flora
3428,2,5,48,55,1.1636363636363636,0.06229957149539102,545,"I mean it, or this plant will shut down."
3428,0,9,46,55,1.1636363636363636,0.05034317492677622,545,Plant yourself here. We are going to be here a while.
3428,1,7,47,55,1.1636363636363636,0.05663776068232804,545,ExxonMobil's Green Committee
3428,2,5,48,55,1.1636363636363636,0.06229957149539102,545,My wife told me to go back to work. She said I was turning into a damned houseplant.
3428,1,7,47,55,1.1636363636363636,0.05663776068232804,545,"Psst, instead of ""planning,"" use the word ""fertilize."""
3428,2,5,48,55,1.1636363636363636,0.06229957149539102,545,We have flowers and a minyan. Now all we need is a dead person.
3428,1,7,47,55,1.1636363636363636,0.05663776068232804,545,"He's a lot smarter than a box of rocks, don't you think?"
3428,2,5,48,55,1.1636363636363636,0.06229957149539102,545,You wanted a potted plant? You got a potted plant.
3428,3,3,49,55,1.1636363636363636,0.06748805288278815,545,I hope everyone's ready to make America great again.
3428,2,5,48,55,1.1636363636363636,0.06229957149539102,545,J.P. always said that getting potted was part of the job.
3428,1,7,47,55,1.1636363636363636,0.05663776068232804,545,And what makes you think you're qualified for the position of arboreal specialist?
3428,2,5,48,55,1.1636363636363636,0.06229957149539102,545,Everyone will get a fair say at this global warming and climate change summit.
3428,1,7,47,55,1.1636363636363636,0.05663776068232804,545,The California office is being led by a pot plant.
3428,2,5,48,55,1.1636363636363636,0.06229957149539102,545,I'm not here to convince you that there isn't a plant on this committee.
3428,1,7,47,55,1.1636363636363636,0.05663776068232804,545,"It was either that or a ""Clinton"""
3428,1,7,47,55,1.1636363636363636,0.05663776068232804,545,I support Herb's side.
3428,0,9,46,55,1.1636363636363636,0.05034317492677622,545,"I may be green, but I think you'll see I have a lot of great ideas."
3428,2,5,48,55,1.1636363636363636,0.06229957149539102,545,I'm going on leave.
3428,1,7,47,55,1.1636363636363636,0.05663776068232804,545,Think of me as the calming effect around here.
3428,0,9,46,55,1.1636363636363636,0.05034317492677622,545,Do you think our Chairperson has become a government plant?
3428,2,5,48,55,1.1636363636363636,0.06229957149539102,545,"As you know, our corporate well-being depends on the combustion of fossil hydrocarbons."
3428,1,7,47,55,1.1636363636363636,0.05663776068232804,545,The chairman has gone veg.
3428,0,9,46,55,1.1636363636363636,0.05034317492677622,545,I think we can all agree that we have vastly minimized our exposure to a high profile CEO scandal.
3428,1,7,47,55,1.1636363636363636,0.05663776068232804,545,"From his mood, it looks like he forget his fertilizer this morning."
3428,1,7,47,55,1.1636363636363636,0.05663776068232804,545,I think Smith took this organic growth concept a bit far.
3428,2,5,48,55,1.1636363636363636,0.06229957149539102,545,I am optimistic she'll breathe life into the Board.
3428,1,7,47,55,1.1636363636363636,0.05663776068232804,545,The board suspected that the CEO had sent a plant to oversee the merger.
3428,2,5,48,55,1.1636363636363636,0.06229957149539102,545,I've gathered you here to help me trim some of the dead wood from our organization.
3428,1,7,47,55,1.1636363636363636,0.05663776068232804,545,"Okay, maybe I am a potted plant after all."
3428,1,7,47,55,1.1636363636363636,0.05663776068232804,545,"Weekly meetings at Vegan, Corp., were largely symbolic."
3428,2,5,48,55,1.1636363636363636,0.06229957149539102,545,The day Koch Industries went green
3428,2,5,48,55,1.1636363636363636,0.06229957149539102,545,"Phil Adrenden has got to go, I can't understand a word he says."
3428,2,5,48,55,1.1636363636363636,0.06229957149539102,545,"I'm Rubber, you're all glue..."
3428,1,7,47,55,1.1636363636363636,0.05663776068232804,545,This new CEO makes me itchy.
3428,0,9,46,55,1.1636363636363636,0.05034317492677622,545,That's one great Power Poinsettia.
3428,2,5,48,55,1.1636363636363636,0.06229957149539102,545,At least IT shows signs of life!
3428,1,7,47,55,1.1636363636363636,0.05663776068232804,545,"I know I'm the greenest one here, but I hope you'll give me a chance."
3428,2,5,48,55,1.1636363636363636,0.06229957149539102,545,Is it too late to talk about succession planning?
3428,0,9,46,55,1.1636363636363636,0.05034317492677622,545,It's time to re-pot.
3428,2,5,48,55,1.1636363636363636,0.06229957149539102,545,He got the job through nepot-plantism
3428,1,7,47,55,1.1636363636363636,0.05663776068232804,545,"All in favor of the green party, say I."
3428,0,9,46,55,1.1636363636363636,0.05034317492677622,545,I think the first motion should be to revise the election by-laws.
3428,3,3,49,55,1.1636363636363636,0.06748805288278815,545,You grow it Mr. Chairman. We just smoke it.
3428,2,5,48,55,1.1636363636363636,0.06229957149539102,545,Hydrate regularly!
3428,2,5,48,55,1.1636363636363636,0.06229957149539102,545,I think we need to branch out into a larger market
3428,0,9,46,55,1.1636363636363636,0.05034317492677622,545,Letting the quietest one be in charge isn't getting us anywhere.
3428,0,9,46,55,1.1636363636363636,0.05034317492677622,545,AT least it doesn't scream at you.
3428,2,5,48,55,1.1636363636363636,0.06229957149539102,545,The seed we planted with the Chairman at the last meeting took root.
3428,1,7,47,55,1.1636363636363636,0.05663776068232804,545,His Golden Parachute clause included a carbon offset
3428,1,7,47,55,1.1636363636363636,0.05663776068232804,545,He's got some damn good ideas for a fern.
3428,1,7,47,55,1.1636363636363636,0.05663776068232804,545,If we want growth we need...water?
3428,1,7,47,55,1.1636363636363636,0.05663776068232804,545,"Yes, I am the new minority."
3428,2,5,48,55,1.1636363636363636,0.06229957149539102,545,"People, our goal this year is to be more green."
3428,0,9,46,55,1.1636363636363636,0.05034317492677622,545,The boss is on leave.
3428,0,9,46,55,1.1636363636363636,0.05034317492677622,545,This company is taking going green too far.
3428,2,5,48,55,1.1636363636363636,0.06229957149539102,545,I heard the new CEO is a seedy guy.
3428,2,5,48,55,1.1636363636363636,0.06229957149539102,545,Now that you're legal we're here to advis to advise you.
3428,3,3,49,55,1.1636363636363636,0.06748805288278815,545,"""I could use a glass of something!'"
3428,1,7,47,55,1.1636363636363636,0.05663776068232804,545,What? Do I have to set myself on fire to get you people to listen to me?
3428,1,7,47,55,1.1636363636363636,0.05663776068232804,545,Howard always believed that we had growth potential!
3428,3,3,49,55,1.1636363636363636,0.06748805288278815,545,let it now be declared that the Perennial Board of Directors meeting is now in session...
3428,2,5,48,55,1.1636363636363636,0.06229957149539102,545,"Well sir, I’m not a potted plant. I’m here as the CEO. That’s my job."
3428,1,7,47,55,1.1636363636363636,0.05663776068232804,545,Say what you like but I'm not half as potted as Buckley at our last Christmas party.
3428,1,7,47,55,1.1636363636363636,0.05663776068232804,545,Somebody got implants.
3428,2,5,48,55,1.1636363636363636,0.06229957149539102,545,All dissenters are welcome to make like a tree and you know the rest.
3428,2,5,48,55,1.1636363636363636,0.06229957149539102,545,"Good morning, Mr. President"
3428,2,5,48,55,1.1636363636363636,0.06229957149539102,545,"We're on the verge of growth, but first I need to be re-potted."
3428,2,5,48,55,1.1636363636363636,0.06229957149539102,545,All those in favor say 'chlorophyll.'
3428,1,7,47,55,1.1636363636363636,0.05663776068232804,545,He's devolved into a vegetable quicker than we thought.
3428,3,3,49,55,1.1636363636363636,0.06748805288278815,545,"The shareholders, looking for change, elected a poisonous plant as Chairman of the Board."
3428,0,9,46,55,1.1636363636363636,0.05034317492677622,545,"Finally, if you fall short of achieving your milestones, you can be replaced by a seedling."
3428,3,3,49,55,1.1636363636363636,0.06748805288278815,545,"It's our ""Growing the Business"" annual meeting. Wait for a sign."
3428,2,5,48,55,1.1636363636363636,0.06229957149539102,545,"(Pot speaking) ""Now that they are making me legal for entertainment, we need to get smoking back in office buildings again."
3428,2,5,48,55,1.1636363636363636,0.06229957149539102,545,Looking for growth in the organization!!!!!
3428,1,7,47,55,1.1636363636363636,0.05663776068232804,545,We're going green this this year.
3428,0,9,46,55,1.1636363636363636,0.05034317492677622,545,I think the CEO's trying to tell us that growth takes time.
3428,1,7,47,55,1.1636363636363636,0.05663776068232804,545,Water! Were's my water???
3428,2,5,48,55,1.1636363636363636,0.06229957149539102,545,"I thought you said the boss was a born trend-setter, not a poinsettia."
3428,1,7,47,55,1.1636363636363636,0.05663776068232804,545,I'm not just a . . . never mind.
3428,1,7,47,55,1.1636363636363636,0.05663776068232804,545,"He doesn't look like much, but we've been tremendously profitable thanks to what we're saving on the executive compensation package."
3428,0,9,46,55,1.1636363636363636,0.05034317492677622,545,Someone has been selling our secrets; one of you is a plant.
3428,0,9,46,55,1.1636363636363636,0.05034317492677622,545,"''Although his ancestor came over on the Mayflower, he comes from a long line of ordinary cuttings."""
3428,1,7,47,55,1.1636363636363636,0.05663776068232804,545,It's replaced the plant tour.
3428,1,7,47,55,1.1636363636363636,0.05663776068232804,545,He’s going to turn this company eco-friendly.
3428,0,9,46,55,1.1636363636363636,0.05034317492677622,545,"It could be the sales numbers or the fact that he's getting more light, but I think he looks better."
3428,1,7,47,55,1.1636363636363636,0.05663776068232804,545,Let's take a slow growth strategy
3428,1,7,47,55,1.1636363636363636,0.05663776068232804,545,He did say he wanted to be planted near the office.
3428,2,5,48,55,1.1636363636363636,0.06229957149539102,545,"How long, do you think, before we start to grow bored?"
3428,1,7,47,55,1.1636363636363636,0.05663776068232804,545,Do you think it is just a potted plant?
3428,2,5,48,55,1.1636363636363636,0.06229957149539102,545,"Okay who brought the hoe in here?"""
3428,2,5,48,55,1.1636363636363636,0.06229957149539102,545,"He said planting meeting, not planning!"
3428,1,7,47,55,1.1636363636363636,0.05663776068232804,545,Best office improvement ever.
3428,1,7,47,55,1.1636363636363636,0.05663776068232804,545,I wondered why they said we could only drink water in this meeting.
3428,2,5,48,55,1.1636363636363636,0.06229957149539102,545,"Let's just say I have a method of taking in data, integrating it and behaving in the most advantageous way."
3428,1,7,47,55,1.1636363636363636,0.05663776068232804,545,"Look people, I'm sick and tired of you pouring cold water on every idea I come up with!"
3428,0,9,46,55,1.1636363636363636,0.05034317492677622,545,We'll be inaugurating a new plant.
3428,1,7,47,55,1.1636363636363636,0.05663776068232804,545,His productivity sprouts in the spring
3428,3,3,49,55,1.1636363636363636,0.06748805288278815,545,Each of you should strive to bloom where you're planted!
3428,0,9,46,55,1.1636363636363636,0.05034317492677622,545,i heard he just got repotted.
3428,1,7,47,55,1.1636363636363636,0.05663776068232804,545,Time for you all to leave.
3428,0,9,46,55,1.1636363636363636,0.05034317492677622,545,"Once he's planted, no one leaves."
3428,2,5,48,55,1.1636363636363636,0.06229957149539102,545,"Campaign manager, she thrives on hot air and manure."
3428,2,5,48,55,1.1636363636363636,0.06229957149539102,545,"""I had it all; corner office, executive washroom, expense account, until someone noted, 'this guy's just a plant'""."
3428,1,7,47,55,1.1636363636363636,0.05663776068232804,545,"Yep, you're dying."
3428,0,9,46,55,1.1636363636363636,0.05034317492677622,545,"We've elected a vegetable, again."
3428,1,7,47,55,1.1636363636363636,0.05663776068232804,545,"Watch yourself, I hear the new board member is a plant."
3428,3,3,49,55,1.1636363636363636,0.06748805288278815,545,"I am the future people. By year end, I expect the majority of all households will have my cousin, pot, as part of their life. Peace out, dude."
3428,1,7,47,55,1.1636363636363636,0.05663776068232804,545,"Sure we considered qualified candidates for CEO, but this plant here is an outsider!"
3428,1,7,47,55,1.1636363636363636,0.05663776068232804,545,I'm just a potted plant.The rhododendron will be back on Monday
3428,0,9,46,55,1.1636363636363636,0.05034317492677622,545,- This is how we sell enough carbon credits?
3428,1,7,47,55,1.1636363636363636,0.05663776068232804,545,Damn these liberal pot laws.
3428,1,7,47,55,1.1636363636363636,0.05663776068232804,545,"Leaves of three, the board lets me be."
3428,1,7,47,55,1.1636363636363636,0.05663776068232804,545,"A potted succulent sure, but a compelling leader for many."
3428,1,7,47,55,1.1636363636363636,0.05663776068232804,545,"As your new CEO, I ask you to treat this company as a garden..."
3428,3,3,49,55,1.1636363636363636,0.06748805288278815,545,His vision to branch out is appealing
3428,1,7,47,55,1.1636363636363636,0.05663776068232804,545,"Don't give me all this ""going green"" stuff! How much money will we make?"
3428,1,7,47,55,1.1636363636363636,0.05663776068232804,545,We're here to ensure a smooth transition of flower.
3428,2,5,48,55,1.1636363636363636,0.06229957149539102,545,He is the new General Counsel. They say he was a big deal during the Iran-Contra hearings.
3428,0,9,46,55,1.1636363636363636,0.05034317492677622,545,The Chairman's ashes are in the pot
3428,3,3,49,55,1.1636363636363636,0.06748805288278815,545,You were right. He is literally a potted plant.
3428,3,3,49,55,1.1636363636363636,0.06748805288278815,545,A spy has been planted in the board room.
3428,1,7,47,55,1.1636363636363636,0.05663776068232804,545,"Alright people, it's time for plan B."
3428,1,7,47,55,1.1636363636363636,0.05663776068232804,545,I expect to be watered on Monday mornings by 9 AM.
3428,2,5,48,55,1.1636363636363636,0.06229957149539102,545,Q4 earnings show tremendous growth potential.
3428,3,3,49,55,1.1636363636363636,0.06748805288278815,545,"By the time the leaves are gone, I expect to hit the ground running."
3428,0,9,46,55,1.1636363636363636,0.05034317492677622,545,What do I have to do to convince you I'm not the plant this leadership team is worrying about?
3428,0,9,46,55,1.1636363636363636,0.05034317492677622,545,Who forgot the rolling paper?
3428,1,7,47,55,1.1636363636363636,0.05663776068232804,545,She looks a lot shorter with this new haircut.
3428,1,7,47,55,1.1636363636363636,0.05663776068232804,545,I would like to propose that future dividends be paid in seeds.
3428,1,7,47,55,1.1636363636363636,0.05663776068232804,545,I've got plenty of years ahead of me before I get to Rockefeller Center!
3428,2,5,48,55,1.1636363636363636,0.06229957149539102,545,This is taking diversity a step too far
3428,1,7,47,55,1.1636363636363636,0.05663776068232804,545,This meeting just got interesting.
3428,1,7,47,55,1.1636363636363636,0.05663776068232804,545,It's implied he doesn't talk much.
3428,0,9,46,55,1.1636363636363636,0.05034317492677622,545,And every concept you'll hear is completely plant based.
3428,1,7,47,55,1.1636363636363636,0.05663776068232804,545,It's almost like an elephant in the room.
3428,1,7,47,55,1.1636363636363636,0.05663776068232804,545,Weekly Green Party meeting
3428,2,5,48,55,1.1636363636363636,0.06229957149539102,545,"Well I'm the chairman, and I'm ruling that the motion to terminate our plant-watering service is out of order."
3428,3,3,49,55,1.1636363636363636,0.06748805288278815,545,"In summary, we now have greened the company from top to bottom."
3428,1,7,47,55,1.1636363636363636,0.05663776068232804,545,"I called you here today to let you know that I will be ""leaving"" soon."
3428,2,5,48,55,1.1636363636363636,0.06229957149539102,545,"Damn it Shelly, this is what happens when you and your friends all vote for the GREEN party"
3428,1,7,47,55,1.1636363636363636,0.05663776068232804,545,"I think we went too far with ""the green"" thing."
3428,1,7,47,55,1.1636363636363636,0.05663776068232804,545,It was appointed immediately once the new chairman of the board arrived after resigning from The Knights Who Say Ni.
3428,3,3,49,55,1.1636363636363636,0.06748805288278815,545,"If we have to stop the wanton slaughter of plants, what are we going to eat?"
3428,1,7,47,55,1.1636363636363636,0.05663776068232804,545,He's our rep from the Plant.
3428,2,5,48,55,1.1636363636363636,0.06229957149539102,545,"I was told Ivanka, Erica and Donald Jr. couldn't oversee the blind trust, so I'm pleased to introduce Mr. Ficus."
3428,2,5,48,55,1.1636363636363636,0.06229957149539102,545,"No, we hadn't noticed."
3428,1,7,47,55,1.1636363636363636,0.05663776068232804,545,I love his green eyes.
3428,3,3,49,55,1.1636363636363636,0.06748805288278815,545,"Okay. He's gonna catch fire and then recite 10 ""thou-shalt-nots"" to boost sales and smite our competitors."
3428,3,3,49,55,1.1636363636363636,0.06748805288278815,545,"So, you're telling me that ever since this State legalized marijuana, it's all anyone can think about?"
3428,3,3,49,55,1.1636363636363636,0.06748805288278815,545,No. You're fired.
3428,1,7,47,55,1.1636363636363636,0.05663776068232804,545,This is our new lead seed investment
3428,0,9,46,55,1.1636363636363636,0.05034317492677622,545,"As I said, we need to get to the root of the problem."
3428,0,9,46,55,1.1636363636363636,0.05034317492677622,545,"I know I'm not what you expected, but I'm hoping to grow in the job."
3428,2,5,48,55,1.1636363636363636,0.06229957149539102,545,Pass down your water and then we'll talk.
3428,3,3,49,55,1.1636363636363636,0.06748805288278815,545,There are other people out there that are very qualified and we’ve had enough bushes.
3428,1,7,47,55,1.1636363636363636,0.05663776068232804,545,I'd rate this as just slightly a better experience than watching paint dry.
3428,2,5,48,55,1.1636363636363636,0.06229957149539102,545,"Says the gentleman opposite the Chair, ""I have an acute case of Plantar Fasciitis."""
3428,3,3,49,55,1.1636363636363636,0.06748805288278815,545,"That's not what I was thinking when I heard he was ""potted""."
3428,1,7,47,55,1.1636363636363636,0.05663776068232804,545,"Calm down, everyone. Let's keep this meeting eco-friendly."
3428,1,7,47,55,1.1636363636363636,0.05663776068232804,545,He's getting too big for his pot
3428,2,5,48,55,1.1636363636363636,0.06229957149539102,545,"He asked for his ashes to be placed on the ""President's Chair"""
3428,1,7,47,55,1.1636363636363636,0.05663776068232804,545,He's the head of the whole fern.
3428,0,9,46,55,1.1636363636363636,0.05034317492677622,545,FIRE THE VEGETARIANS!
3428,2,5,48,55,1.1636363636363636,0.06229957149539102,545,I would like to bring to the board's attention that I am a plant.
3610,2,5,49,56,1.1607142857142858,0.06124671056253539,545,The shareholders demanded a CEO focused on reducing our carbon footprint.
3610,2,5,49,56,1.1607142857142858,0.06124671056253539,545,He looks like the chairman but I think he's a plant.
3610,2,5,49,56,1.1607142857142858,0.06124671056253539,545,Let's all pee on it.
3610,1,7,48,56,1.1607142857142858,0.055693885709118325,545,How come I never get a cup of water?
3610,0,9,47,56,1.1607142857142858,0.04952230059306297,545,"Could be a plant from another office; either way, we've gone green."
3610,1,7,48,56,1.1607142857142858,0.055693885709118325,545,The new leader of the development team comes under suspicion of being a plant.
3610,1,7,48,56,1.1607142857142858,0.055693885709118325,545,He's a huge advocate of synthesis
3610,2,5,49,56,1.1607142857142858,0.06124671056253539,545,Today we'll be discussing green power management.
3610,1,7,48,56,1.1607142857142858,0.055693885709118325,545,"Well, we did say we needed to someone to seed the new project."
3610,2,5,49,56,1.1607142857142858,0.06124671056253539,545,He's potted again.
3610,1,7,48,56,1.1607142857142858,0.055693885709118325,545,We need to stay well grounded in order to survive
3610,2,5,49,56,1.1607142857142858,0.06124671056253539,545,Let's welcome our new plant HR Specialist!
3610,1,7,48,56,1.1607142857142858,0.055693885709118325,545,"So, this is the beginning of our new True Diversity program."
3610,1,7,48,56,1.1607142857142858,0.055693885709118325,545,He took us up on our suggestion that any plant could chair this group as effectively as he does.
3610,1,7,48,56,1.1607142857142858,0.055693885709118325,545,"Sir, we've really seen growth."
3610,2,5,49,56,1.1607142857142858,0.06124671056253539,545,It's so lifelike.
3610,1,7,48,56,1.1607142857142858,0.055693885709118325,545,Who else wants to experience the transformative power of veganism?
3610,2,5,49,56,1.1607142857142858,0.06124671056253539,545,"When she said she would plant herself in the way of everything we were doing, I never imagined this."
3610,4,1,51,56,1.1607142857142858,0.07106237297918135,545,"Now that weed is legal, that's the new boss."
3610,1,7,48,56,1.1607142857142858,0.055693885709118325,545,"I know most of you voted for the mineral candidate, but the shareholders disagreed."
3630,1,7,49,57,1.1578947368421053,0.054780684196477185,545,Anyone bring the doughnuts?
3630,1,7,49,57,1.1578947368421053,0.054780684196477185,545,"I'd like to clarify some circulating rumors. I will be stepping down this autumn, but only because I am a summer annual."
3630,1,7,49,57,1.1578947368421053,0.054780684196477185,545,This vegetarian diet has made me a changed man.
3633,1,6,47,54,1.1481481481481481,0.05549729066741694,545,I have been chose to run this plant for obvious reasons.
3633,1,6,47,54,1.1481481481481481,0.05549729066741694,545,I remember when he went to seed.
3633,2,4,48,54,1.1481481481481481,0.06147162996855134,545,"As CEO, I rule that we will only pay carbon taxes....at night"
3633,1,6,47,54,1.1481481481481481,0.05549729066741694,545,Now the snap dragon. SHE knew all about plant closings.
3633,2,4,48,54,1.1481481481481481,0.06147162996855134,545,"stop your staring - what am I, a potted plant?"
3633,0,8,46,54,1.1481481481481481,0.04879689797371372,545,OK. Next item: how to make the company greener.
3633,1,6,47,54,1.1481481481481481,0.05549729066741694,545,"Well, regardless, he's also our chairman."
3633,1,6,47,54,1.1481481481481481,0.05549729066741694,545,Our Green Party candidate.
3633,1,6,47,54,1.1481481481481481,0.05549729066741694,545,Enough about ants...I STILL have high hopes for next year.
3633,1,6,47,54,1.1481481481481481,0.05549729066741694,545,Chairman of the Board? More like Chairman of the Twig if you ask me.
3633,2,4,48,54,1.1481481481481481,0.06147162996855134,545,I pine for the past!
3633,1,6,47,54,1.1481481481481481,0.05549729066741694,545,Someone planted a spy!
3633,0,8,46,54,1.1481481481481481,0.04879689797371372,545,I think we're getting a little too inclusive.
3633,1,6,47,54,1.1481481481481481,0.05549729066741694,545,"I'd like all of you to meet the author of ""The secret Life of Plants."""
3633,1,6,47,54,1.1481481481481481,0.05549729066741694,545,So I think I speak for all of us when I say that we feel like we could use a bit more feedback after the presentations.
3633,1,6,47,54,1.1481481481481481,0.05549729066741694,545,"Like Trump, it's our future and we have to inhale and hold it...."
3633,1,6,47,54,1.1481481481481481,0.05549729066741694,545,Partial sun just isn't good enough anymore.
3633,1,6,47,54,1.1481481481481481,0.05549729066741694,545,"By golly, he really is a potted plant."
3633,1,6,47,54,1.1481481481481481,0.05549729066741694,545,"Expect to be here awhile, he was just watered."
3633,0,8,46,54,1.1481481481481481,0.04879689797371372,545,Implementation of our green initiative is proceeding on schedule.
3633,2,4,48,54,1.1481481481481481,0.06147162996855134,545,What did you mean 'revise the board stem to stern?'
3633,2,4,48,54,1.1481481481481481,0.06147162996855134,545,He did say we should all think more green.
3633,1,6,47,54,1.1481481481481481,0.05549729066741694,545,Just another mindless idiot at the helm.
3633,1,6,47,54,1.1481481481481481,0.05549729066741694,545,Stop staring. Do I look like a potted plant?
3633,1,6,47,54,1.1481481481481481,0.05549729066741694,545,You know I think it's true. The potted plant is doing just as well as our old leader did.
3633,1,6,47,54,1.1481481481481481,0.05549729066741694,545,These photosynthesists put me to sleep.
3633,1,6,47,54,1.1481481481481481,0.05549729066741694,545,"You planted that idea in his head, and now it's really starting to take off!"
3633,0,8,46,54,1.1481481481481481,0.04879689797371372,545,Evolution takes a left turn.
3633,1,6,47,54,1.1481481481481481,0.05549729066741694,545,"Seems to have worked consistently in the political realm, we thought we'd give it a try here."
3633,1,6,47,54,1.1481481481481481,0.05549729066741694,545,"Steve felt so undervalued, he didn't think anyone would notice when he sent a plant in place of himself."
3633,1,6,47,54,1.1481481481481481,0.05549729066741694,545,These changes in management also make me uneasy.
3633,0,8,46,54,1.1481481481481481,0.04879689797371372,545,And now I'm going to talk about our new Green policies.
3633,1,6,47,54,1.1481481481481481,0.05549729066741694,545,Mr. Trump is still recovering from the campaign so his representative Mr. Bush will run the meeting.
3633,0,8,46,54,1.1481481481481481,0.04879689797371372,545,This place has truly gone to pot.
3633,2,4,48,54,1.1481481481481481,0.06147162996855134,545,Our goal this year is to hit pay dirt.
3633,2,4,48,54,1.1481481481481481,0.06147162996855134,545,He's Trumps representative for the important meetings
3633,0,8,46,54,1.1481481481481481,0.04879689797371372,545,"Due to the inability of a plant to talk, the meeting never was called to order."
3633,1,6,47,54,1.1481481481481481,0.05549729066741694,545,I hear the new supervisor is a plant from the front office.
3633,0,8,46,54,1.1481481481481481,0.04879689797371372,545,Someone should tell him what that slug just did...
3633,0,8,46,54,1.1481481481481481,0.04879689797371372,545,I think it has something to do with these new EPA regulations!
3633,1,6,47,54,1.1481481481481481,0.05549729066741694,545,Finally a Chairman who isn't afraid to get in the weeds on things.
3633,2,4,48,54,1.1481481481481481,0.06147162996855134,545,"As head of operations, it's my job to want to know what's going on in the plants."
3633,2,4,48,54,1.1481481481481481,0.06147162996855134,545,Same productivity as a dipping bird
3633,2,4,48,54,1.1481481481481481,0.06147162996855134,545,"They said there was a plant somewhere in the organization, but I never would have guessed it was the potted plant."
3633,1,6,47,54,1.1481481481481481,0.05549729066741694,545,Is it right ? This is what we voted for yesterday night ?
3633,2,4,48,54,1.1481481481481481,0.06147162996855134,545,"...and that's when the plant realized, dreams really can come true."
3633,1,6,47,54,1.1481481481481481,0.05549729066741694,545,"Actually, you've grown a lot this year, Mr. Green."
3633,1,6,47,54,1.1481481481481481,0.05549729066741694,545,"There was a mole within the Board, and the 'plant' was obvious."
3633,2,4,48,54,1.1481481481481481,0.06147162996855134,545,"As the first potted plant to become CEO, I say with great confidence that I can't be worse than the last CEO."
3633,1,6,47,54,1.1481481481481481,0.05549729066741694,545,Potted again!
3633,1,6,47,54,1.1481481481481481,0.05549729066741694,545,We need to make this space conducive for growth.
3633,1,6,47,54,1.1481481481481481,0.05549729066741694,545,As your new President...
3633,1,6,47,54,1.1481481481481481,0.05549729066741694,545,President Trump - could not be here today
3633,1,6,47,54,1.1481481481481481,0.05549729066741694,545,So that's one vote against outsourcing our manufacturing plants.
3633,2,4,48,54,1.1481481481481481,0.06147162996855134,545,"Hmm... he doesn't say much, does he?"
3633,0,8,46,54,1.1481481481481481,0.04879689797371372,545,1. Deeply rooted seeds of corporate culture!
3633,2,4,48,54,1.1481481481481481,0.06147162996855134,545,Growth seems to have slowed this quarter. Shift our holdings over to Nitrates.
3633,3,2,49,54,1.1481481481481481,0.06691467186318137,545,"Due to the discontent with the presidential election, we decided to have national leadership default to the results of the marijuana initiatives."
3633,0,8,46,54,1.1481481481481481,0.04879689797371372,545,We're a green company.
3633,1,6,47,54,1.1481481481481481,0.05549729066741694,545,"That's taking, ""Grow where you are planted,"" a little too far!"
3633,3,2,49,54,1.1481481481481481,0.06691467186318137,545,Are you clear in your role as Chair that you are nothing more than a Potted Plant?
3633,1,6,47,54,1.1481481481481481,0.05549729066741694,545,We should work from home
3633,2,4,48,54,1.1481481481481481,0.06147162996855134,545,"Her name is Poinsettia, I'll bet she's ousted by New Years."
3633,0,8,46,54,1.1481481481481481,0.04879689797371372,545,Let's say we wrap up this meeting and leave!
3633,1,6,47,54,1.1481481481481481,0.05549729066741694,545,"When I say we're going green, I don't mean with half measures. Board members who have their own axes to grind will be shown the door."
3633,1,6,47,54,1.1481481481481481,0.05549729066741694,545,I decided I prefer activist shareholders.
3633,1,6,47,54,1.1481481481481481,0.05549729066741694,545,Don't panic. Take a deep breathe.
3633,1,6,47,54,1.1481481481481481,0.05549729066741694,545,"Did I hear that right, rising CO2 level is a positive indicator?"
3633,0,8,46,54,1.1481481481481481,0.04879689797371372,545,"Duly elected, alas, a write-in."
3633,1,6,47,54,1.1481481481481481,0.05549729066741694,545,I guess that efficiency expert made his recommendations.
3633,2,4,48,54,1.1481481481481481,0.06147162996855134,545,"Endorse the president elect's global-warming denial first, then water."
3633,1,6,47,54,1.1481481481481481,0.05549729066741694,545,"Effective immediately, all vegan employees are to be terminated."
3633,1,6,47,54,1.1481481481481481,0.05549729066741694,545,"First, let’s dispel the rumor that I’ve become a potted plant."
3633,1,6,47,54,1.1481481481481481,0.05549729066741694,545,Director Vegan leads the Board in a moment of silence.
3633,0,8,46,54,1.1481481481481481,0.04879689797371372,545,You should hear him during photosynthesis.....riveting
3633,1,6,47,54,1.1481481481481481,0.05549729066741694,545,"O Tanenbaum, my Tanenbaum...."
3633,2,4,48,54,1.1481481481481481,0.06147162996855134,545,"As many of you have probably already heard, I am Oliver North's former attorney."
3633,0,8,46,54,1.1481481481481481,0.04879689797371372,545,It's the only blind trust leadership anyone could agree on.
3633,0,8,46,54,1.1481481481481481,0.04879689797371372,545,What's so hard to understand. The whole world is going green.
3633,1,6,47,54,1.1481481481481481,0.05549729066741694,545,Watch out-it's a plant!
3633,0,8,46,54,1.1481481481481481,0.04879689797371372,545,Are we sure this is what the consultants had in mind when they suggested corporate pruning?
3633,0,8,46,54,1.1481481481481481,0.04879689797371372,545,You people have become a real thorn in my side.
3633,2,4,48,54,1.1481481481481481,0.06147162996855134,545,Another incontinent CEO.
3633,0,8,46,54,1.1481481481481481,0.04879689797371372,545,Psst--I'd lose the chlorophyll gum.
3633,0,8,46,54,1.1481481481481481,0.04879689797371372,545,You're probably wondering why I called this meeting.
3633,0,8,46,54,1.1481481481481481,0.04879689797371372,545,"""Careful what you wish for - you DID ask for 'greener management'""."
3633,1,6,47,54,1.1481481481481481,0.05549729066741694,545,"Thanks for planting those seeds of thought, Cheryl."
3633,1,6,47,54,1.1481481481481481,0.05549729066741694,545,"Power Plant. Say it, fuckers."
3633,2,4,48,54,1.1481481481481481,0.06147162996855134,545,Now that I've gone vegan so should all of you.
3633,1,6,47,54,1.1481481481481481,0.05549729066741694,545,"All for photosynthesis, say ""aye."""
3633,0,8,46,54,1.1481481481481481,0.04879689797371372,545,Isn't this taking our organic business structure a bit too far?
3633,0,8,46,54,1.1481481481481481,0.04879689797371372,545,So far he's only eaten flies.
3633,1,6,47,54,1.1481481481481481,0.05549729066741694,545,"All those in favor of global warming, say 'Aye'."
3633,2,4,48,54,1.1481481481481481,0.06147162996855134,545,You thought I was just paying lip service to our company going green??
3633,3,2,49,54,1.1481481481481481,0.06691467186318137,545,We do need a Chief Exec who's into pot.
3633,0,8,46,54,1.1481481481481481,0.04879689797371372,545,"In the interest of diversity, I'd like to welcome our new employee, Plantasia."
3633,1,6,47,54,1.1481481481481481,0.05549729066741694,545,"Corporate just wants to give him a shot, before anyone breaks this glass ceiling for good."
3633,1,6,47,54,1.1481481481481481,0.05549729066741694,545,"When you order lunch, remember the boss is vegetarian."
3633,2,4,48,54,1.1481481481481481,0.06147162996855134,545,"Whoever nutures me best, will be richly rewarded. Is there anyone here who doesn't like plants?"
3633,1,6,47,54,1.1481481481481481,0.05549729066741694,545,These meetings make me feel like I'm vegetating too.
3633,1,6,47,54,1.1481481481481481,0.05549729066741694,545,Not the 'Grow where you're planted' speech again.
3633,1,6,47,54,1.1481481481481481,0.05549729066741694,545,There was mistrust at the meeting. One of the board members was a plant.
3633,2,4,48,54,1.1481481481481481,0.06147162996855134,545,Smoke just two rolled-up leaves every afternoon. It will make all the difference.
3633,2,4,48,54,1.1481481481481481,0.06147162996855134,545,"Ugh, greenwashing."
3633,0,8,46,54,1.1481481481481481,0.04879689797371372,545,"""He's been transplanted to the White House""!"
3633,3,2,49,54,1.1481481481481481,0.06691467186318137,545,"...and for those of you who thought ""chairperson"" was too PC, you're in for a bit of a shock."
3633,2,4,48,54,1.1481481481481481,0.06147162996855134,545,There were bound to be some changes after Chopped Liver retired.
3633,3,2,49,54,1.1481481481481481,0.06691467186318137,545,Our newly planted CEO; What's up with the pot?
3633,0,8,46,54,1.1481481481481481,0.04879689797371372,545,"I can only hope that, someday, my bonus will match that of a Wall Street houseplant."
3633,0,8,46,54,1.1481481481481481,0.04879689797371372,545,I have your attention.
3633,1,6,47,54,1.1481481481481481,0.05549729066741694,545,Trump wanted a chief of staff he wouldn't clash with.
3633,0,8,46,54,1.1481481481481481,0.04879689797371372,545,"We kept waiting, but it wouldn't leave."
3633,1,6,47,54,1.1481481481481481,0.05549729066741694,545,I have called you here today to discuss the matter regarding cats.
3633,1,6,47,54,1.1481481481481481,0.05549729066741694,545,Do you think I am going to sit quietly like a potted plant?
3633,0,8,46,54,1.1481481481481481,0.04879689797371372,545,I felt it was important to get the vegan perspective.
3633,1,6,47,54,1.1481481481481481,0.05549729066741694,545,Tell me again why you want me to bring lights and ornaments and show up 2 days early for the Christmas party.
3633,2,4,48,54,1.1481481481481481,0.06147162996855134,545,"it's your turn to roll the meeting's spliff, Abigail."
3633,0,8,46,54,1.1481481481481481,0.04879689797371372,545,I don't give a fig if you all disagree - I won't budge.
3633,1,6,47,54,1.1481481481481481,0.05549729066741694,545,Chlorophyll! We are going to be the market leader in chlorophyll!
3633,1,6,47,54,1.1481481481481481,0.05549729066741694,545,I suppose you're all wondering why I called you here today.
3633,1,6,47,54,1.1481481481481481,0.05549729066741694,545,"Eat, smoke, or plant this year's bonus?"
3633,0,8,46,54,1.1481481481481481,0.04879689797371372,545,I suppose you're all wondering why I called this meeting.
3633,0,8,46,54,1.1481481481481481,0.04879689797371372,545,I thought you said he'd grow on me.
3633,1,6,47,54,1.1481481481481481,0.05549729066741694,545,"The founder's widow left controlling interest in the company to Fred, her favorite house plant."
3633,1,6,47,54,1.1481481481481481,0.05549729066741694,545,"So, what are your thought's on climate change?"
3633,1,6,47,54,1.1481481481481481,0.05549729066741694,545,"If we don't water it, you get his job but I get his key to the executive washroom."
3633,1,6,47,54,1.1481481481481481,0.05549729066741694,545,Potted again!
3633,1,6,47,54,1.1481481481481481,0.05549729066741694,545,"I take it the Board didn't agree with Tom's aggressive, go-getter attitude?"
3633,1,6,47,54,1.1481481481481481,0.05549729066741694,545,"Yes, Mr. Trump. Your Chia-Pate is fantastic."
3633,0,8,46,54,1.1481481481481481,0.04879689797371372,545,Deal with it; I don't do lunch.
3633,0,8,46,54,1.1481481481481481,0.04879689797371372,545,I think this is taking climate change a bit too far.
3633,0,8,46,54,1.1481481481481481,0.04879689797371372,545,I suggest you all become vegans too.
3633,1,6,47,54,1.1481481481481481,0.05549729066741694,545,"""K.I.S.S."" ... ""Keep it seeds and stems"" - that has to be our new motto!"
3633,1,6,47,54,1.1481481481481481,0.05549729066741694,545,Mr. Smith is potted.
3633,0,8,46,54,1.1481481481481481,0.04879689797371372,545,"When I said this company should go green, this is not what I meant."
3633,2,4,48,54,1.1481481481481481,0.06147162996855134,545,LEED.
3633,0,8,46,54,1.1481481481481481,0.04879689797371372,545,I would have picked an Amorphophallus titanium!
3633,2,4,48,54,1.1481481481481481,0.06147162996855134,545,She only got the job because she been here the longest.
3633,1,6,47,54,1.1481481481481481,0.05549729066741694,545,At least its executive compensation is lower than its predecessor's
3633,2,4,48,54,1.1481481481481481,0.06147162996855134,545,Because of the recent layoffs I've decided to soil myself.
3633,1,6,47,54,1.1481481481481481,0.05549729066741694,545,All these years I thought she was 'CEO' when all along she was Dieffenbachia !
3633,1,6,47,54,1.1481481481481481,0.05549729066741694,545,Vegans and vegetarians submit your resignations...on vellum please.
3633,2,4,48,54,1.1481481481481481,0.06147162996855134,545,Vegan leadership.
3633,1,6,47,54,1.1481481481481481,0.05549729066741694,545,Whose idea was it to visit the plant in Cleveland?
3633,1,6,47,54,1.1481481481481481,0.05549729066741694,545,"""I move we convert the board room into a greenhouse. Second anyone?"
3633,0,8,46,54,1.1481481481481481,0.04879689797371372,545,Did he suggest we grow on it overnight?
3633,1,6,47,54,1.1481481481481481,0.05549729066741694,545,We alternate our plant and material meetings.
3633,0,8,46,54,1.1481481481481481,0.04879689797371372,545,Our new leader has a George W. Bush like manner.
3633,0,8,46,54,1.1481481481481481,0.04879689797371372,545,That's the President's money tree that he wants us to baby-sit while he's away on vacation.
3633,0,8,46,54,1.1481481481481481,0.04879689797371372,545,"Enough with the Power Points about climate change, I'm here to speak for myself."
3633,1,6,47,54,1.1481481481481481,0.05549729066741694,545,Did I miss anything while I was on vacation?
3633,2,4,48,54,1.1481481481481481,0.06147162996855134,545,This is why we hold elections!
3633,1,6,47,54,1.1481481481481481,0.05549729066741694,545,I think we are starting to take this 'going green' approach way to far...
3633,1,6,47,54,1.1481481481481481,0.05549729066741694,545,Now that we've acquired that solar energy behemoth let's set our sites on Greenpeace.
3633,2,4,48,54,1.1481481481481481,0.06147162996855134,545,Now even our meetings must be carbon-neutral
3633,0,8,46,54,1.1481481481481481,0.04879689797371372,545,"To the Executive Committee's surprise, the acting President was, indeed, just a potted plant."
3633,2,4,48,54,1.1481481481481481,0.06147162996855134,545,I think we are going to be here for a while!
3633,1,6,47,54,1.1481481481481481,0.05549729066741694,545,It's about planting seeds.
3633,2,4,48,54,1.1481481481481481,0.06147162996855134,545,Doesn't this increase our carbon footprint?
3633,2,4,48,54,1.1481481481481481,0.06147162996855134,545,"Given the recent election, we decided to scale down our ""go green initiative."""
3633,2,4,48,54,1.1481481481481481,0.06147162996855134,545,It's another tie... Someone's not voting so we're going to do this one more time.
3633,2,4,48,54,1.1481481481481481,0.06147162996855134,545,It was required for our LEEDS certification.
3633,2,4,48,54,1.1481481481481481,0.06147162996855134,545,At least he is better than the other candidates.
3633,2,4,48,54,1.1481481481481481,0.06147162996855134,545,"I'm not a potted plant, well technically, but you know what I mean."
3633,1,6,47,54,1.1481481481481481,0.05549729066741694,545,"They brought him in to take up CO2 and provide oxygen, but all I'm getting is hot air."
3633,3,2,49,54,1.1481481481481481,0.06691467186318137,545,Succession planning was not his strength.
3633,0,8,46,54,1.1481481481481481,0.04879689797371372,545,"Is it just me, or is the new Chair of the board a bit wooden?"
3633,2,4,48,54,1.1481481481481481,0.06147162996855134,545,"The card just said, ""Off to make America great again...you're fired."""
3633,1,6,47,54,1.1481481481481481,0.05549729066741694,545,"Johnson, I leafed through your report on the profitability of corporate environmentalism... you got my attention."
3633,1,6,47,54,1.1481481481481481,0.05549729066741694,545,"If one more person giggles when I ask you to leaf through the branch report, I swear I'll have you moved to another plant."
3633,1,6,47,54,1.1481481481481481,0.05549729066741694,545,Not everyone was onboard with this succession plan.
3633,1,6,47,54,1.1481481481481481,0.05549729066741694,545,Is it racist to ask if I can leave?
3805,1,6,48,55,1.1454545454545455,0.05454545454545457,545,"Is this metamorphosis less menacing, earthlings?"
3805,0,8,47,55,1.1454545454545455,0.04797713974560777,545,"Any direct experience with ""green"" manufacturing methods?"
3805,1,6,48,55,1.1454545454545455,0.05454545454545457,545,The temperature and humidity control in this building is abysmal. I expect to see some improvements very soon!
3805,0,8,47,55,1.1454545454545455,0.04797713974560777,545,Today's board meeting will commence with my presentation on the beneficial effect of photosynthesis on indoor air quality.
3805,1,6,48,55,1.1454545454545455,0.05454545454545457,545,He lied
3805,2,4,49,55,1.1454545454545455,0.06040370257667094,545,"Bill, the VP of Sustainability, was viewed as being very green."
3805,0,8,47,55,1.1454545454545455,0.04797713974560777,545,Now thats what I call green leadership.
3812,2,4,54,60,1.1333333333333333,0.05557438475642006,545,We have to think protoplasmic.
3813,1,5,47,53,1.1320754716981132,0.05413078722488102,545,At least now we can truthfully say that we 'went green'.
3813,0,7,46,53,1.1320754716981132,0.04695159976668159,545,Surely the standards for presidency can't fall further now.
3813,1,5,47,53,1.1320754716981132,0.05413078722488102,545,I feed off of what you say ... literally.
3813,2,3,48,53,1.1320754716981132,0.06046347269649694,545,I knew the representation for the workers at the plant had gotten bad; but this is ridiculous.
3813,0,7,46,53,1.1320754716981132,0.04695159976668159,545,(I heard it was the top ficus at Wharton)
3813,1,5,47,53,1.1320754716981132,0.05413078722488102,545,"Now that Mr. Trump is President, did he have to leave Jeb Bush in charge?"
3813,2,3,48,53,1.1320754716981132,0.06046347269649694,545,"It's one thing to go ""green"", but this is ridiculous."
3813,3,1,49,53,1.1320754716981132,0.06619305806090786,545,Let me see that organizational chart again.
3813,1,5,47,53,1.1320754716981132,0.05413078722488102,545,Who’s the wise guy who motioned to relocate the plant?
3813,1,5,47,53,1.1320754716981132,0.05413078722488102,545,"It's a ""plant""!"
3813,2,3,48,53,1.1320754716981132,0.06046347269649694,545,The CEO is trying to plant seeds in our heads again.
3813,0,7,46,53,1.1320754716981132,0.04695159976668159,545,People - we all must do our part to convince our clients that our 'going green' statements are believable!
3813,2,3,48,53,1.1320754716981132,0.06046347269649694,545,Psst...just watch what transpires.
3813,1,5,47,53,1.1320754716981132,0.05413078722488102,545,Let's just not water it.
3813,0,7,46,53,1.1320754716981132,0.04695159976668159,545,Let me guess. Another serious debate.
3813,0,7,46,53,1.1320754716981132,0.04695159976668159,545,Our CEO takes in CO2.
3813,1,5,47,53,1.1320754716981132,0.05413078722488102,545,"This isn't the time for the company to pull up its roots, but I could use a drink of water."
3813,0,7,46,53,1.1320754716981132,0.04695159976668159,545,Wherever Mr. Green sits is the head of the table.
3813,1,5,47,53,1.1320754716981132,0.05413078722488102,545,"The head of our environmentalist department is awful quiet today."" ""Dude, leaf him alone."
3813,1,5,47,53,1.1320754716981132,0.05413078722488102,545,That answers the what-am- I-a-potted-plant? question.
3813,1,5,47,53,1.1320754716981132,0.05413078722488102,545,"By appointing me CEO, the board has officially made themselves more worthless than me. And for that, I thank you."
3813,1,5,47,53,1.1320754716981132,0.05413078722488102,545,What do you see as your unique contribution to our carbon reduction initiative?
3813,0,7,46,53,1.1320754716981132,0.04695159976668159,545,Is it just me or have our latest quarterlies turned the chairman a bit green?
3813,1,5,47,53,1.1320754716981132,0.05413078722488102,545,Smart move to appoint Chauncey Gardiner as head of the transition team.
3813,0,7,46,53,1.1320754716981132,0.04695159976668159,545,The irony is that he always said he wouldn't just sit there like a potted plant.
3813,1,5,47,53,1.1320754716981132,0.05413078722488102,545,Let's not be foiled again this year.
3813,1,5,47,53,1.1320754716981132,0.05413078722488102,545,Meanwhile in California...
3813,0,7,46,53,1.1320754716981132,0.04695159976668159,545,Weed is king
3813,1,5,47,53,1.1320754716981132,0.05413078722488102,545,You are all granted tree wishes.
3813,1,5,47,53,1.1320754716981132,0.05413078722488102,545,"Trust me, I know: this board vegetates"
3813,0,7,46,53,1.1320754716981132,0.04695159976668159,545,Onto the ficus-uh-fico score reports. Ahem.
3813,2,3,48,53,1.1320754716981132,0.06046347269649694,545,Chairman of the Bored
3813,2,3,48,53,1.1320754716981132,0.06046347269649694,545,Why are your looking at me like I'm from another planet?
3813,1,5,47,53,1.1320754716981132,0.05413078722488102,545,So that’s this year’s Christmas tree?
3813,1,5,47,53,1.1320754716981132,0.05413078722488102,545,Today's meeting is about annual leave...
3813,1,5,47,53,1.1320754716981132,0.05413078722488102,545,You still didn't win the popular vote.
3813,1,5,47,53,1.1320754716981132,0.05413078722488102,545,So this is the private sector...
3813,0,7,46,53,1.1320754716981132,0.04695159976668159,545,It was PR's suggestion.
3813,2,3,48,53,1.1320754716981132,0.06046347269649694,545,I heard from a reputable source that our new CEO was a plant… I just never talking literally.
3813,1,5,47,53,1.1320754716981132,0.05413078722488102,545,That's a young tree. Did he graduate from Stanford early?
3813,1,5,47,53,1.1320754716981132,0.05413078722488102,545,When they said the new CEO had a background in green growth they were not kidding.
3813,3,1,49,53,1.1320754716981132,0.06619305806090786,545,"Well sir, I'm not a potted plant! I'm here as your lawyer."
3813,0,7,46,53,1.1320754716981132,0.04695159976668159,545,"If a young marijuana plant can work his way up to the top from the mailroom, anyone can!"
3813,2,3,48,53,1.1320754716981132,0.06046347269649694,545,I think we can assure our shareholders that our company will be in the green through the end of the year.
3813,2,3,48,53,1.1320754716981132,0.06046347269649694,545,It was Chairman's Green last wish..
3813,0,7,46,53,1.1320754716981132,0.04695159976668159,545,We need a plan to make quarterly profits blossom.
3813,0,7,46,53,1.1320754716981132,0.04695159976668159,545,I hope he didn't take me serious that a turnip could do his job.
3813,0,7,46,53,1.1320754716981132,0.04695159976668159,545,"As your new Board Chair, I'd like to thank everyone for choosing photosynthesis over mobility. I never honestly expected ""Make Green Great Again"" to win the day. In the coming weeks you will be replaced with grasses, horsetails, algae, and lycopods."
3813,0,7,46,53,1.1320754716981132,0.04695159976668159,545,Our CEO has gone potted.
3813,0,7,46,53,1.1320754716981132,0.04695159976668159,545,They say the new director will plant new seeds for our future.
3813,0,7,46,53,1.1320754716981132,0.04695159976668159,545,"Well, he did not waste anytime in getting potted."
3813,1,5,47,53,1.1320754716981132,0.05413078722488102,545,"No minutes this time. No initiatives, no strategies, no kudos. Just your carbon dioxide, please, with love."
3813,3,1,49,53,1.1320754716981132,0.06619305806090786,545,The tree says that Trump will call Melania The First Pussy.
3813,1,5,47,53,1.1320754716981132,0.05413078722488102,545,"First of all, let me clear the air by wishing you all welcome to our new plant!"
3813,1,5,47,53,1.1320754716981132,0.05413078722488102,545,Finally – a CEO that truly understands the importance of mindful meditation!
3813,2,3,48,53,1.1320754716981132,0.06046347269649694,545,It's your move Mr Trump.
3813,2,3,48,53,1.1320754716981132,0.06046347269649694,545,Anybody notice that the CEO's been vegging out a lot lately ?
3813,2,3,48,53,1.1320754716981132,0.06046347269649694,545,As your CEO I want to be watered
3813,1,5,47,53,1.1320754716981132,0.05413078722488102,545,The awkward silence of the board as it realizes it may have overreacted in its choice of a successor chairman.
3813,2,3,48,53,1.1320754716981132,0.06046347269649694,545,"He blooms, therefore He is!"
3813,1,5,47,53,1.1320754716981132,0.05413078722488102,545,"Remarkable! In his first hundred days, he made plants great again."
3813,1,5,47,53,1.1320754716981132,0.05413078722488102,545,Is this a precursor to the flowery speech?
3813,2,3,48,53,1.1320754716981132,0.06046347269649694,545,"As you can see from my transformation, our company's plan for fighting climate change holds great promise."
3813,0,7,46,53,1.1320754716981132,0.04695159976668159,545,I'm here to discuss ways we are going green this fiscal year.
3813,2,3,48,53,1.1320754716981132,0.06046347269649694,545,We've had a surge in applicants since people found out that we still have a Bush in power.
3813,0,7,46,53,1.1320754716981132,0.04695159976668159,545,That's just a bunch of manure!
3813,1,5,47,53,1.1320754716981132,0.05413078722488102,545,"I know Fred said he was going green, but I definitely didn't expect this."
3813,0,7,46,53,1.1320754716981132,0.04695159976668159,545,"He said goodbye, but he sent us this plant to remember him by."
3813,1,5,47,53,1.1320754716981132,0.05413078722488102,545,Screw synergy. Give me symbiosis!
3813,1,5,47,53,1.1320754716981132,0.05413078722488102,545,This company needs a new direction; I propose going green.
3813,1,5,47,53,1.1320754716981132,0.05413078722488102,545,Never judge anyone by its appearance. The least person you would expect to be capable of something might surprise you.
3813,1,5,47,53,1.1320754716981132,0.05413078722488102,545,What do the board's bylaws say about proxy votes?
3813,2,3,48,53,1.1320754716981132,0.06046347269649694,545,Good sign! Last week his shredder presided.
3813,1,5,47,53,1.1320754716981132,0.05413078722488102,545,"Okay, our new Trump appointed EPA director is a potted plant. Could mean something good for us, could mean something bad."
3813,0,7,46,53,1.1320754716981132,0.04695159976668159,545,"Does anybody ""have a guy"" at the EPA?"
3813,1,5,47,53,1.1320754716981132,0.05413078722488102,545,There's a rumor going around that our competitor placed me here.
3813,0,7,46,53,1.1320754716981132,0.04695159976668159,545,"I believe it's a very positive indicator of our companies future, it is a perennial!"
3813,1,5,47,53,1.1320754716981132,0.05413078722488102,545,There will be growth in the spring - Chance the Gardener
3813,2,3,48,53,1.1320754716981132,0.06046347269649694,545,Does this mean we are going to have a Vegan lunch brought in?
3813,1,5,47,53,1.1320754716981132,0.05413078722488102,545,"Having a potted plant as the new CEO may seem odd to some of you, but given the new administration in Washington, I believe my election positions our company perfectly."
3813,1,5,47,53,1.1320754716981132,0.05413078722488102,545,This pothead appears more authentic
3813,0,7,46,53,1.1320754716981132,0.04695159976668159,545,"So this is what they meant by ""going green, starting at the very top""?"
3813,1,5,47,53,1.1320754716981132,0.05413078722488102,545,Oh......that sequoia!
3813,1,5,47,53,1.1320754716981132,0.05413078722488102,545,You're probably wondering why I gathered you all here.
3813,2,3,48,53,1.1320754716981132,0.06046347269649694,545,"If Geico can do it, so can we."
3813,2,3,48,53,1.1320754716981132,0.06046347269649694,545,Not one watering can? Speciests!
3813,1,5,47,53,1.1320754716981132,0.05413078722488102,545,"""Last week a bug, this week a plant, what's next a mole?"
3813,1,5,47,53,1.1320754716981132,0.05413078722488102,545,"Ok,let's decide. Is it pronounced Poinsettia or Poinsetta ?"
3813,0,7,46,53,1.1320754716981132,0.04695159976668159,545,Think green!
3813,1,5,47,53,1.1320754716981132,0.05413078722488102,545,I think they have stuck a plant in here.
3813,0,7,46,53,1.1320754716981132,0.04695159976668159,545,I'm guessing that pretty much tables 'new plant acquisition' this quarter.
3813,0,7,46,53,1.1320754716981132,0.04695159976668159,545,I think it's just a plant.
3813,0,7,46,53,1.1320754716981132,0.04695159976668159,545,Diversity is the new corporate mantra. Any questions?
3813,2,3,48,53,1.1320754716981132,0.06046347269649694,545,I've printed out 103 photos from my vacation for you
3813,3,1,49,53,1.1320754716981132,0.06619305806090786,545,It was the cheapest alternative to a coal burning power plant.
3813,1,5,47,53,1.1320754716981132,0.05413078722488102,545,"Okay, and how many think he really is a potted plant?"
3813,2,3,48,53,1.1320754716981132,0.06046347269649694,545,"Before he departed, Charlie told us a branch of the family would be taking over management."
3813,1,5,47,53,1.1320754716981132,0.05413078722488102,545,He thinks I'm strange because I'm not wearing glasses.
3813,0,7,46,53,1.1320754716981132,0.04695159976668159,545,This company needs an extra cup of Miracle Grow.
3813,1,5,47,53,1.1320754716981132,0.05413078722488102,545,Finally! A Green Party candidate in power!
3813,0,7,46,53,1.1320754716981132,0.04695159976668159,545,On the plus side he has no baggage.
3813,1,5,47,53,1.1320754716981132,0.05413078722488102,545,No what are our growth projections this quarter?
3813,1,5,47,53,1.1320754716981132,0.05413078722488102,545,I'm heading the search for our Agriculture Secretary.
3813,1,5,47,53,1.1320754716981132,0.05413078722488102,545,Dressing for the Chair works for Spring ... Autumn gets awkward
3813,0,7,46,53,1.1320754716981132,0.04695159976668159,545,I'm here to present the recommendations of the Subcommittee on Diversity.
3813,2,3,48,53,1.1320754716981132,0.06046347269649694,545,I'm so glad he is in the White House now.
3813,1,5,47,53,1.1320754716981132,0.05413078722488102,545,She's an extreme vegan.
3813,0,7,46,53,1.1320754716981132,0.04695159976668159,545,You've been a breath of fresh air for the management of this company
3813,2,3,48,53,1.1320754716981132,0.06046347269649694,545,We'll never flower if we don't build our branches from the roots up.
3813,1,5,47,53,1.1320754716981132,0.05413078722488102,545,Why did the boss give his proxy to a fern.
3813,2,3,48,53,1.1320754716981132,0.06046347269649694,545,I heard his dad was a giant redwood in this field.
3813,2,3,48,53,1.1320754716981132,0.06046347269649694,545,"Horticultural experts have now determined after continuing 24/7 observations, that it's kinda like watching paint dry!"
3813,1,5,47,53,1.1320754716981132,0.05413078722488102,545,Are we sure this constitutes a quorum?
3813,1,5,47,53,1.1320754716981132,0.05413078722488102,545,He rose to the level of his inertness.
3927,1,5,48,54,1.1296296296296295,0.053175186756420724,545,Did you know he won the office 'mannequin' challenge.
3927,1,5,48,54,1.1296296296296295,0.053175186756420724,545,D'you think the old man's trying to tell us something?
3927,2,3,49,54,1.1296296296296295,0.059383604691421,545,"Well, if we want to see real growth here, instead of just talking you could try singing next time."
3927,1,5,48,54,1.1296296296296295,0.053175186756420724,545,It said it could make our company great again.
3927,2,3,49,54,1.1296296296296295,0.059383604691421,545,"If my ancestors could work with the dinosaurs, I can work with you."
3927,1,5,48,54,1.1296296296296295,0.053175186756420724,545,He looks so good - too bad we have a no live flora policy in the office.
3927,0,7,47,54,1.1296296296296295,0.04613879568230499,545,"""Okay, thanks Water. Let's hear now from the Carbon Dioxide team."
3927,1,5,48,54,1.1296296296296295,0.053175186756420724,545,"Calm down Hermione, your coffee's on it's way."
3927,1,5,48,54,1.1296296296296295,0.053175186756420724,545,I hear his chair is herbonomic.
3927,1,5,48,54,1.1296296296296295,0.053175186756420724,545,"I understand it's seasonal, Bob!"
3927,1,5,48,54,1.1296296296296295,0.053175186756420724,545,Uneasy lies the plant that wears a crown.
3927,1,5,48,54,1.1296296296296295,0.053175186756420724,545,I've leafed through all of your resumes--and here is what I have decided...
3927,1,5,48,54,1.1296296296296295,0.053175186756420724,545,"We're about to get the dirt on his ""going green"" campaign."
3927,0,7,47,54,1.1296296296296295,0.04613879568230499,545,Corporations are plants too!
3927,2,3,49,54,1.1296296296296295,0.059383604691421,545,Trump says we are to move our plant to Mexico
3927,2,3,49,54,1.1296296296296295,0.059383604691421,545,Weird. We've never had a meeting called by any of the botanicals.
3927,0,7,47,54,1.1296296296296295,0.04613879568230499,545,I've finally decided to put down some roots.
3944,0,7,48,55,1.1272727272727272,0.04535342286998717,545,I suggest we all leave.
3944,0,7,48,55,1.1272727272727272,0.04535342286998717,545,What an ash.
3946,1,4,46,51,1.1176470588235294,0.05348306547837592,545,I saw we open more branches.
3946,2,2,47,51,1.1176470588235294,0.06037178164055159,545,"No, Mr. Chairman, closing a plant doesn't mean we're uprooting your cousin!"
3946,1,4,46,51,1.1176470588235294,0.05348306547837592,545,I need your firm to convince people to go back to eating more meat!
3946,0,6,45,51,1.1176470588235294,0.04556450995538139,545,"If any of your ideas aren't eco-friendly, I'm going to pluck you over."
3946,1,4,46,51,1.1176470588235294,0.05348306547837592,545,"a-fern-ative, boss"
3946,0,6,45,51,1.1176470588235294,0.04556450995538139,545,This will be our most productive meeting by far.
3946,0,6,45,51,1.1176470588235294,0.04556450995538139,545,And so it was decided that with the loosening up of pot restrictions the managerial hierarchy would be rerooted.
3946,1,4,46,51,1.1176470588235294,0.05348306547837592,545,"We can't say he's potted or green or fresh, but he is all those things."
3946,2,2,47,51,1.1176470588235294,0.06037178164055159,545,The poinsettia committee wonders once more how its selection process got them here
3946,1,4,46,51,1.1176470588235294,0.05348306547837592,545,Don't think of me as an outsider. Think of me as a house plant just like you.
3946,2,2,47,51,1.1176470588235294,0.06037178164055159,545,"I'm glad you could all make it to the meeting. Now, before we start who wants the honor of watering me?"
3946,2,2,47,51,1.1176470588235294,0.06037178164055159,545,"""Knowing Mr. Jones as we do, it's obviously a clever message but we're just not getting it."
3946,0,6,45,51,1.1176470588235294,0.04556450995538139,545,Is it more odd that they have a lobbyist? Or that they're asking for more dirt?
3946,1,4,46,51,1.1176470588235294,0.05348306547837592,545,The Vegan movement has gotten too far.
3946,2,2,47,51,1.1176470588235294,0.06037178164055159,545,"After a demographics review, HR has suggested we branch out our diversification efforts."
3946,1,4,46,51,1.1176470588235294,0.05348306547837592,545,Now you know why we have all those 'plant crossing' signs out front.
3946,0,6,45,51,1.1176470588235294,0.04556450995538139,545,He really got potted at the last office party.
3946,1,4,46,51,1.1176470588235294,0.05348306547837592,545,You'd think he'd at least send Pence.
3946,0,6,45,51,1.1176470588235294,0.04556450995538139,545,Learn from it.
3946,2,2,47,51,1.1176470588235294,0.06037178164055159,545,We're the control group for the experiment called the Donald Trump Administration.
3946,0,6,45,51,1.1176470588235294,0.04556450995538139,545,Eventually the employees began to question their company's justification for outside hires in senior management positions as a part of their green initiative.
3946,1,4,46,51,1.1176470588235294,0.05348306547837592,545,The first thing on the agenda is our new plant in Costa Rica.
3946,1,4,46,51,1.1176470588235294,0.05348306547837592,545,He's in the potty.
3946,0,6,45,51,1.1176470588235294,0.04556450995538139,545,"Who put the plant on the chair again? I get it, it's funny, but we're trying to conduct a business meeting here."
3946,1,4,46,51,1.1176470588235294,0.05348306547837592,545,I really want to plant the idea we're going green.....
3946,1,4,46,51,1.1176470588235294,0.05348306547837592,545,"They heard by the grapevine that there would be a 'plant' at the important meeting, but surely not literally speaking ........."
3946,0,6,45,51,1.1176470588235294,0.04556450995538139,545,I can see the plant promotion really got the Chair's attention.
3946,2,2,47,51,1.1176470588235294,0.06037178164055159,545,"If you'd'a told me eight years ago, that I'd be nostalgic for _this_ good ole day, I'd'a slugged ya!"
3946,0,6,45,51,1.1176470588235294,0.04556450995538139,545,Do you think it's industrial espionage or just a government plant?
3946,2,2,47,51,1.1176470588235294,0.06037178164055159,545,It's a shame-it's too cold for him to survive in Canada.
3946,1,4,46,51,1.1176470588235294,0.05348306547837592,545,Am I just a potted plant?
3946,0,6,45,51,1.1176470588235294,0.04556450995538139,545,Be quiet. He said he had an amazing idea.
3946,0,6,45,51,1.1176470588235294,0.04556450995538139,545,"Thanks for selecting me , Harry Pottedplant, as your Chairman."
3946,0,6,45,51,1.1176470588235294,0.04556450995538139,545,I'm just going to plant myself down here until we figure out how we lost this election!
3946,0,6,45,51,1.1176470588235294,0.04556450995538139,545,"Due to the new administration, I have decided to move to Canada where I can grow in fresh air."
3946,0,6,45,51,1.1176470588235294,0.04556450995538139,545,Yes the greens are reaching the top
3946,0,6,45,51,1.1176470588235294,0.04556450995538139,545,That plant is certainly an improvement over Mr. Trump.
3946,0,6,45,51,1.1176470588235294,0.04556450995538139,545,The Boss wants us to know that we are all idiots.
3946,1,4,46,51,1.1176470588235294,0.05348306547837592,545,You can think of me as a Trump upgrade. .
3946,1,4,46,51,1.1176470588235294,0.05348306547837592,545,Does anyone speak plant?
3946,1,4,46,51,1.1176470588235294,0.05348306547837592,545,Could be worse. Do you think he knows I'm Muslim?
3946,1,4,46,51,1.1176470588235294,0.05348306547837592,545,I'm told the new chief's fiery disposition is the stuff of legend.
3946,1,4,46,51,1.1176470588235294,0.05348306547837592,545,Many on the board were beginning to suspicion a lack of dynamic leadership.
3946,2,2,47,51,1.1176470588235294,0.06037178164055159,545,I heard this new boss is gonna bring climate change
3946,0,6,45,51,1.1176470588235294,0.04556450995538139,545,"Don ""Zip your mouth--it's an opposition plant."
3946,1,4,46,51,1.1176470588235294,0.05348306547837592,545,He's modeling a growth mindset.
3946,1,4,46,51,1.1176470588235294,0.05348306547837592,545,"I know you all thinks I'm the root of all evil but if I just curl up and die, see where that leaves you."
3946,1,4,46,51,1.1176470588235294,0.05348306547837592,545,I think we need to vote. That's not the kind of growth he promised.
3946,1,4,46,51,1.1176470588235294,0.05348306547837592,545,Any chance you have a green thumb?
3946,0,6,45,51,1.1176470588235294,0.04556450995538139,545,"Why should I help you save the planet, you'll be gone in a thousand years."
3946,1,4,46,51,1.1176470588235294,0.05348306547837592,545,The other lawyers in the firm are surprised to learn that their colleague is in fact a potted plant.
3946,1,4,46,51,1.1176470588235294,0.05348306547837592,545,"When I said they should think diversity before filling that chair, this wasn't what I had in mind."
3946,1,4,46,51,1.1176470588235294,0.05348306547837592,545,So who's going to take the plant to the hospital?
3946,1,4,46,51,1.1176470588235294,0.05348306547837592,545,I get it now! Our CEO's name is *Phil* O'Dendron...
3946,0,6,45,51,1.1176470588235294,0.04556450995538139,545,Could someone get me a glass of sparkling mineral water?
3946,2,2,47,51,1.1176470588235294,0.06037178164055159,545,"My name is Fern, and this is my first Vegans Anonymous meeting."
3946,1,4,46,51,1.1176470588235294,0.05348306547837592,545,"So Gentelmen, what state are we going to next?"
3946,0,6,45,51,1.1176470588235294,0.04556450995538139,545,I think we're here to meet the new chairman of the bored.
3946,0,6,45,51,1.1176470588235294,0.04556450995538139,545,He's not a green CEO as he might first appear to be.
3946,1,4,46,51,1.1176470588235294,0.05348306547837592,545,I've decided to turn over a new leaf and make America great again.
3946,2,2,47,51,1.1176470588235294,0.06037178164055159,545,When did that happen?
3946,2,2,47,51,1.1176470588235294,0.06037178164055159,545,He's a natural leader.
3946,1,4,46,51,1.1176470588235294,0.05348306547837592,545,Mr. President?
3946,0,6,45,51,1.1176470588235294,0.04556450995538139,545,"Which one of you is Paul? Give me everything you have on photosynthesis, I wanna know what you think we've been doing all this time."
3946,1,4,46,51,1.1176470588235294,0.05348306547837592,545,He bet his star on Hillary
3946,1,4,46,51,1.1176470588235294,0.05348306547837592,545,Our Thanksgiving catering will be here soon. Can someone add a leaf to this table?
3946,1,4,46,51,1.1176470588235294,0.05348306547837592,545,From left to right. Ideas for Making America Great Again.
3946,1,4,46,51,1.1176470588235294,0.05348306547837592,545,Can I borrow some water?
3946,1,4,46,51,1.1176470588235294,0.05348306547837592,545,Congratulations Bob you're new Vice President. The rest of you need to rethink your choices.
3946,0,6,45,51,1.1176470588235294,0.04556450995538139,545,"Synthesis is the key, my friends, with annual repotting, adequate moisture, and a window with a southern exposure."
3946,1,4,46,51,1.1176470588235294,0.05348306547837592,545,"I don't care what anyone says, I'm glad we opened the new plant"
3946,0,6,45,51,1.1176470588235294,0.04556450995538139,545,THIS is our leader?
3946,0,6,45,51,1.1176470588235294,0.04556450995538139,545,He's Chauncey Gardiner's son.
3946,0,6,45,51,1.1176470588235294,0.04556450995538139,545,I wonder what his agenda is.
3946,0,6,45,51,1.1176470588235294,0.04556450995538139,545,I want all employees who eat plants fired immediately.
3946,1,4,46,51,1.1176470588235294,0.05348306547837592,545,I told you our old boss was dumber than a potted plant.
3946,1,4,46,51,1.1176470588235294,0.05348306547837592,545,The power flower
3946,2,2,47,51,1.1176470588235294,0.06037178164055159,545,I've always been the plant.
3946,0,6,45,51,1.1176470588235294,0.04556450995538139,545,It has not passed unnoticed by me that this board has not given me a water cup.
3946,0,6,45,51,1.1176470588235294,0.04556450995538139,545,...another CEO- gone-to-weed scenario...
3946,0,6,45,51,1.1176470588235294,0.04556450995538139,545,"Okay. After he sits on the damn thing, he'll borrow the glasses of the next C.E.O."
3946,1,4,46,51,1.1176470588235294,0.05348306547837592,545,"It's your move, President-elect."
3946,2,2,47,51,1.1176470588235294,0.06037178164055159,545,"Well, yes, this is a Board Meeting, but don't you think you're getting ahead of yourself?"
3946,0,6,45,51,1.1176470588235294,0.04556450995538139,545,I herby announce that this conference room is now environmentally friendly.
3946,1,4,46,51,1.1176470588235294,0.05348306547837592,545,". . . and we especially need to work on your syntax, Secretary Palin."
3946,0,6,45,51,1.1176470588235294,0.04556450995538139,545,I thought you meant figuratively
3946,0,6,45,51,1.1176470588235294,0.04556450995538139,545,"'We want to know - are you 'potted' ?"""
3946,0,6,45,51,1.1176470588235294,0.04556450995538139,545,The shareholders are saying our attempt at a greener business strategy is lackluster at best.
3946,1,4,46,51,1.1176470588235294,0.05348306547837592,545,Anyone who's a vegan is in for serious trouble.
3946,0,6,45,51,1.1176470588235294,0.04556450995538139,545,"Where I come from, it's every inch a jungle."
3946,0,6,45,51,1.1176470588235294,0.04556450995538139,545,"The card says, ""So boring...While I'm busy making America great again, one crazy tweet at a time."""
3946,1,4,46,51,1.1176470588235294,0.05348306547837592,545,"I AM the chairman's representative at this meeting, so the next one saying, ""Let's make like a tree and leave,"" will be reported."
3946,0,6,45,51,1.1176470588235294,0.04556450995538139,545,I wouldn't be sitting here today if it hadn't been for all those flaky people back in the 70's who unashamedly talked to their plants.
3946,2,2,47,51,1.1176470588235294,0.06037178164055159,545,"Whatever else, do not go to sleep!"
3946,1,4,46,51,1.1176470588235294,0.05348306547837592,545,your pitch is great for the economy
3946,0,6,45,51,1.1176470588235294,0.04556450995538139,545,"I'm moving myself and all of our jobs, to Mexico."
3946,0,6,45,51,1.1176470588235294,0.04556450995538139,545,Someone had to try it.
3946,2,2,47,51,1.1176470588235294,0.06037178164055159,545,"""I had nothing to do with the selling of company secrets,"" proclaimed the office plant."
3946,2,2,47,51,1.1176470588235294,0.06037178164055159,545,"As governor, I’m suspending all mandatory drug tests."
3946,1,4,46,51,1.1176470588235294,0.05348306547837592,545,I expect to see growth in our garden in the spring.
3946,1,4,46,51,1.1176470588235294,0.05348306547837592,545,Got any pot?
3946,2,2,47,51,1.1176470588235294,0.06037178164055159,545,"I understand that some of you object to my contract including a ""Golden Fertilizer""."
3946,0,6,45,51,1.1176470588235294,0.04556450995538139,545,"Today, I'll be introducing our new concept in green operations."
3946,1,4,46,51,1.1176470588235294,0.05348306547837592,545,I hadn't even noticed a potted plant is our new CEO- everything's been a haze.
3946,1,4,46,51,1.1176470588235294,0.05348306547837592,545,"Since Mr. Trump lost, is he going to take his seat back?"
3946,2,2,47,51,1.1176470588235294,0.06037178164055159,545,Weed like to hear your opinion.
3946,1,4,46,51,1.1176470588235294,0.05348306547837592,545,I give him two weeks - tops
3946,0,6,45,51,1.1176470588235294,0.04556450995538139,545,Just don't water her for a week.
3946,1,4,46,51,1.1176470588235294,0.05348306547837592,545,"A long day, working at the plant."
3946,0,6,45,51,1.1176470588235294,0.04556450995538139,545,Their purpose is to refurbish the depleted oxygen in the room.
3946,2,2,47,51,1.1176470588235294,0.06037178164055159,545,Her silence speaks volumes.
3946,0,6,45,51,1.1176470588235294,0.04556450995538139,545,"Oh, don't mind Herb. . . They were out of Miracle Grow at the cafeteria. It always makes him cranky!"
3946,1,4,46,51,1.1176470588235294,0.05348306547837592,545,What happens when the leaves fall off?
3946,0,6,45,51,1.1176470588235294,0.04556450995538139,545,He was a compromise. They were deadlocked between an environmentalist and an animal-rights activist.
3946,1,4,46,51,1.1176470588235294,0.05348306547837592,545,The stockholders wanted to give an outsider a chance.
3946,2,2,47,51,1.1176470588235294,0.06037178164055159,545,Unfit as the president.
3946,1,4,46,51,1.1176470588235294,0.05348306547837592,545,So how long should wait before heading to lunch?
3946,1,4,46,51,1.1176470588235294,0.05348306547837592,545,If any of you are 'tree-huggers' I will report you to human resources
3946,2,2,47,51,1.1176470588235294,0.06037178164055159,545,"Do you mean to say you can heal the sick, clothe the naked, AND cause people to HAPPILY pay taxes?"
3946,1,4,46,51,1.1176470588235294,0.05348306547837592,545,"""Does anyone here speak House Plant?"
3946,1,4,46,51,1.1176470588235294,0.05348306547837592,545,"With a pot head, this could be a drag!"
3946,1,4,46,51,1.1176470588235294,0.05348306547837592,545,I am not going to sit here like a potted plant!
3946,0,6,45,51,1.1176470588235294,0.04556450995538139,545,"Yes, he always says 'I am Groot.' You have to read between the vines."
3946,2,2,47,51,1.1176470588235294,0.06037178164055159,545,"O.K. Before we begin, no manure jokes, please."
3946,2,2,47,51,1.1176470588235294,0.06037178164055159,545,"Ladies and gentlemen, let me introduce our next profit center."
3946,1,4,46,51,1.1176470588235294,0.05348306547837592,545,It's not ready to become a board member.
3946,1,4,46,51,1.1176470588235294,0.05348306547837592,545,"Mmm yeah keep exhaling. Yeah, that's some sweet-ass carbon dioxide. Unngh, think I'm going to bud."
3946,1,4,46,51,1.1176470588235294,0.05348306547837592,545,The name's Sullivan...Brendan Sullivan.
3946,1,4,46,51,1.1176470588235294,0.05348306547837592,545,"'The proposal is propagation, all those in favor raise your hand."""
3946,0,6,45,51,1.1176470588235294,0.04556450995538139,545,They all soon realized that the new CEO was more of a thinker than a chatterbox.
3946,2,2,47,51,1.1176470588235294,0.06037178164055159,545,"So, now we answer to a plant, and what is your favorite fertilizer?"
3946,1,4,46,51,1.1176470588235294,0.05348306547837592,545,"Sir, you misunderstand. We need a new manufacturing facility."
3946,0,6,45,51,1.1176470588235294,0.04556450995538139,545,"""Well, everylove loves the tree. Let's run him for President""."
3946,0,6,45,51,1.1176470588235294,0.04556450995538139,545,"It’s either Robert Plant, Phil O’Dendron or our Christmas bonus."
3946,1,4,46,51,1.1176470588235294,0.05348306547837592,545,"Thank you Jim, for not writing on my dead brethren."
3946,2,2,47,51,1.1176470588235294,0.06037178164055159,545,Meeting adjourned. Now let's make like a tree and leaf.
3946,0,6,45,51,1.1176470588235294,0.04556450995538139,545,You old farts are a breath of fresh air!
3946,2,2,47,51,1.1176470588235294,0.06037178164055159,545,"So, what we waiting for?"
3946,1,4,46,51,1.1176470588235294,0.05348306547837592,545,...but I was just kidding when I told him to make like a trees and leave!
3946,1,4,46,51,1.1176470588235294,0.05348306547837592,545,"Good morning, our first plant of business is..."
3946,1,4,46,51,1.1176470588235294,0.05348306547837592,545,It occurred to the board that this was perhaps the most enlightened consultant they'd ever contracted.
3946,1,4,46,51,1.1176470588235294,0.05348306547837592,545,Should we talk to it?
3946,1,4,46,51,1.1176470588235294,0.05348306547837592,545,Apparently we're trying a new 'eco-friendly' approach.
3946,2,2,47,51,1.1176470588235294,0.06037178164055159,545,"""Now that we have my ashes in place, who is responsible for the watering""?"
3946,2,2,47,51,1.1176470588235294,0.06037178164055159,545,"Does this mean he won't be calling in, either?"
3946,1,4,46,51,1.1176470588235294,0.05348306547837592,545,This is your bonus this year!
3946,0,6,45,51,1.1176470588235294,0.04556450995538139,545,I didn't know the recreational pot business was this far advanced.
3946,2,2,47,51,1.1176470588235294,0.06037178164055159,545,"I said Jack was a schlub, not a shrub."
3946,0,6,45,51,1.1176470588235294,0.04556450995538139,545,Of course President Trump appoints a plant to head the EPA.
3946,1,4,46,51,1.1176470588235294,0.05348306547837592,545,"Though the election may not have gone as you'd hoped, now is the time for us to work together in a spirit of unity."
3946,1,4,46,51,1.1176470588235294,0.05348306547837592,545,The shareholders elected the vegan...
3946,1,4,46,51,1.1176470588235294,0.05348306547837592,545,They say the new board member is well grounded.
3946,2,2,47,51,1.1176470588235294,0.06037178164055159,545,"well james, that was over-elming"
3946,2,2,47,51,1.1176470588235294,0.06037178164055159,545,'A time to plant and a time to uproot the plant' has taken on a whole new meaning.
3946,0,6,45,51,1.1176470588235294,0.04556450995538139,545,"OK, so maybe I am, but not just ANY potted plant."
3946,0,6,45,51,1.1176470588235294,0.04556450995538139,545,Our pot policy centers on accommodation...
3946,1,4,46,51,1.1176470588235294,0.05348306547837592,545,Analysts wanted to see a fresh face.
3946,0,6,45,51,1.1176470588235294,0.04556450995538139,545,We need to convince people that we're going green
3946,0,6,45,51,1.1176470588235294,0.04556450995538139,545,Greenpeace loves us now
3946,0,6,45,51,1.1176470588235294,0.04556450995538139,545,When asked to place a plant into a competitor's board meeting gets misinterpreted by the industrial espionage team.
3946,1,4,46,51,1.1176470588235294,0.05348306547837592,545,I'm in the 'silence is consent' camp.
3946,1,4,46,51,1.1176470588235294,0.05348306547837592,545,Reminds me of Oliver North's lawyer.
3946,0,6,45,51,1.1176470588235294,0.04556450995538139,545,"If you think this guy doesn't have a pulse on the economy, you should have seen our last CEO."
3946,0,6,45,51,1.1176470588235294,0.04556450995538139,545,"It's new and it's different, AND, it can really make you hungry."
3946,2,2,47,51,1.1176470588235294,0.06037178164055159,545,I hope my presence emphasizes our green policy
3946,0,6,45,51,1.1176470588235294,0.04556450995538139,545,"As you know I retire in two weeks, but I leave you in good hands. My successor is a very capable, hardworking snake plant."
3946,1,4,46,51,1.1176470588235294,0.05348306547837592,545,"I have to admit, our revenues have increased by 20% since Fern became chairperson."
3946,0,6,45,51,1.1176470588235294,0.04556450995538139,545,I told you we should have planted seeds elsewhere.
3946,2,2,47,51,1.1176470588235294,0.06037178164055159,545,He's real keen on the save my seat thing
3946,1,4,46,51,1.1176470588235294,0.05348306547837592,545,"I know we are supposed to be all about sustainability, but this seems like a bit much."
3946,1,4,46,51,1.1176470588235294,0.05348306547837592,545,Take me to your leader!
3946,0,6,45,51,1.1176470588235294,0.04556450995538139,545,A chance wind blew me here from a GMO laboratory and now I am deeply rooted in this organization.
3946,1,4,46,51,1.1176470588235294,0.05348306547837592,545,Raising the political bar for 2020.
3946,1,4,46,51,1.1176470588235294,0.05348306547837592,545,"""Okay, . . . but what's the real reason we're here?"
3946,0,6,45,51,1.1176470588235294,0.04556450995538139,545,"If you put a toupee on him, he'll look just like the president-elect."
3946,0,6,45,51,1.1176470588235294,0.04556450995538139,545,The Joint Committee observe their mitey leader.
3946,1,4,46,51,1.1176470588235294,0.05348306547837592,545,Doesn't everyone love the CEO's new clothes?!?
3946,0,6,45,51,1.1176470588235294,0.04556450995538139,545,It's called a karma bush. The leaves wilt when negative energy is present.
3946,0,6,45,51,1.1176470588235294,0.04556450995538139,545,I think the boss is trying to make a very good Point...Setia.
3946,2,2,47,51,1.1176470588235294,0.06037178164055159,545,My FBI days are behind me since Nov 8th
3946,1,4,46,51,1.1176470588235294,0.05348306547837592,545,"But I've got high hopes, I've got high hopes I've got high apple pie, in the sky hopes."
3946,1,4,46,51,1.1176470588235294,0.05348306547837592,545,Maybe it’s his proxy vote…for our ‘leaves of absence’ policy.
3946,1,4,46,51,1.1176470588235294,0.05348306547837592,545,No worries we will bounce back. I am a rubber tree
3946,1,4,46,51,1.1176470588235294,0.05348306547837592,545,Our corporate greening strategy has begun under my leadership.
3946,1,4,46,51,1.1176470588235294,0.05348306547837592,545,Now for quarterly earnings: Please pass the Miracle-Gro.
3946,1,4,46,51,1.1176470588235294,0.05348306547837592,545,Welcome to politics.
3946,2,2,47,51,1.1176470588235294,0.06037178164055159,545,Climate changes forces another company to change its image.
3946,1,4,46,51,1.1176470588235294,0.05348306547837592,545,"Please meet our new Chairman, Ozzie Mosis."
3946,2,2,47,51,1.1176470588235294,0.06037178164055159,545,"So it began, the day the XYZ Comnpany decided to go green"
3946,0,6,45,51,1.1176470588235294,0.04556450995538139,545,"Ten sick ones, Dreaming of medical marijuana."
3946,1,4,46,51,1.1176470588235294,0.05348306547837592,545,This corporate Green Movement is getting ridiculous.
3946,0,6,45,51,1.1176470588235294,0.04556450995538139,545,"""And another thing, no more 'Bush League' jokes."
3946,1,4,46,51,1.1176470588235294,0.05348306547837592,545,Nice to see Ms. Peony plant finally breaking the glass ceiling!
3946,0,6,45,51,1.1176470588235294,0.04556450995538139,545,This company really takes their annual reviews seriously.
3946,1,4,46,51,1.1176470588235294,0.05348306547837592,545,"The American people have Trump, we thought we'd try a plant."
3946,0,6,45,51,1.1176470588235294,0.04556450995538139,545,I'm not a scientist.
3946,1,4,46,51,1.1176470588235294,0.05348306547837592,545,"So you water our stocks, but forget about me."
3946,2,2,47,51,1.1176470588235294,0.06037178164055159,545,"The board just didn't have the heart to ""fire"" Woody."
3946,1,4,46,51,1.1176470588235294,0.05348306547837592,545,This only to demonstrate that any one of us could be one.
3946,2,2,47,51,1.1176470588235294,0.06037178164055159,545,I guess Paul heard California passed pot last yesterday
3946,1,4,46,51,1.1176470588235294,0.05348306547837592,545,For a laissez faire leader he certainly is deciduous.
3946,1,4,46,51,1.1176470588235294,0.05348306547837592,545,"I repeat, the espionage ""plant"" spying on us for our competitor is not who you think it is."
4148,0,6,46,52,1.1153846153846154,0.044736922925984586,545,I heard that one of you flesh bags was whining again about the green economy being given too much leeway. Why don't you suck down some more of my oxygen and tell me what's on your mind?
4148,0,6,46,52,1.1153846153846154,0.044736922925984586,545,Simple representation is key.
4148,0,6,46,52,1.1153846153846154,0.044736922925984586,545,Give it a chance. Let’s not be speciesist.
4148,0,6,46,52,1.1153846153846154,0.044736922925984586,545,Sorry! I wasn't calling you potted.
4148,2,2,48,52,1.1153846153846154,0.059242618939646566,545,Should we take this literally?
4148,1,4,47,52,1.1153846153846154,0.05249323847751087,545,Big Pharma now is into medical marijuana
4148,0,6,46,52,1.1153846153846154,0.044736922925984586,545,There's no leadership in the Green Party.
4148,1,4,47,52,1.1153846153846154,0.05249323847751087,545,I think that I shall never see a line manager as lovely as a tree.
4148,0,6,46,52,1.1153846153846154,0.044736922925984586,545,When did we vote this Green as our chief executive?
4148,3,0,49,52,1.1153846153846154,0.06529805289439733,545,I don't see the need for a caption.
4148,0,6,46,52,1.1153846153846154,0.044736922925984586,545,It's time to spruce up this company.
4148,0,6,46,52,1.1153846153846154,0.044736922925984586,545,The boss' idea to plant new ideas in our heads
4148,1,4,47,52,1.1153846153846154,0.05249323847751087,545,"Bad news, folks.... This is one potted plant who is done with your human-centric nonsense!"
4161,1,4,48,53,1.1132075471698113,0.051539276936327136,545,He never did like being the center of attention.
4162,1,3,46,50,1.1,0.05150787536377128,545,"Welcome to the meeting I plant. If you get bored, you may leaf."
4162,0,5,45,50,1.1,0.04285714285714286,545,We're clean with the EEOC now but the EPA is still suing for a snail darter on the board.
4162,0,5,45,50,1.1,0.04285714285714286,545,"Greenspace initiative!?…Naaah, it’s just trying to follow Trump’s lead…"
4162,2,1,47,50,1.1,0.05890150893739515,545,"Upon my retirement, I've decided to appoint Benjamina Ficus II as your new President."
4162,0,5,45,50,1.1,0.04285714285714286,545,I suppose we should be using iPads.
4162,0,5,45,50,1.1,0.04285714285714286,545,When this one dies I'am voting for you!
4162,1,3,46,50,1.1,0.05150787536377128,545,Brendan Sullivan on casual Friday
4162,0,5,45,50,1.1,0.04285714285714286,545,I wondered if they would send a plant from their company to our meeting!
4162,1,3,46,50,1.1,0.05150787536377128,545,He's sure leaving us in suspense
4162,0,5,45,50,1.1,0.04285714285714286,545,Any ideas for the planetarium?
4162,0,5,45,50,1.1,0.04285714285714286,545,I heard he was hired to get him off the Congressional Oversight Committee.
4162,0,5,45,50,1.1,0.04285714285714286,545,So much for transparency.
4162,0,5,45,50,1.1,0.04285714285714286,545,Will the representative from Colorado please rise and address the group?
4162,1,3,46,50,1.1,0.05150787536377128,545,Probably the last time we'll get to vote on section leader.
4162,1,3,46,50,1.1,0.05150787536377128,545,Would glasses make me look smarter too?
4162,1,3,46,50,1.1,0.05150787536377128,545,Jim is irreplaceable.
4162,0,5,45,50,1.1,0.04285714285714286,545,They're trying to promote a different type of culture in the office.
4162,1,3,46,50,1.1,0.05150787536377128,545,"Yeah, it's nice, but the overhead's outrageous."
4162,1,3,46,50,1.1,0.05150787536377128,545,"Do we have angry, white, not college-educated men to blame for the rise of Mr. Philodendron, too?"
4162,0,5,45,50,1.1,0.04285714285714286,545,I don't think our new feng shui-based seating arrangement is working.
4162,1,3,46,50,1.1,0.05150787536377128,545,His promotion still makes me green with envy.
4162,1,3,46,50,1.1,0.05150787536377128,545,Can anyone shed some indirect light on the outdoor plant's dismal growth last quarter?
4162,0,5,45,50,1.1,0.04285714285714286,545,What did you expect after that hostile takeover by Aspidistra Corp?
4162,0,5,45,50,1.1,0.04285714285714286,545,I guess he is a potted plant.
4162,0,5,45,50,1.1,0.04285714285714286,545,What if just forget to water it next time...
4162,1,3,46,50,1.1,0.05150787536377128,545,The growth numbers are catastrophic. I vote perennials for the third quarter.
4162,2,1,47,50,1.1,0.05890150893739515,545,We're not ignoring you. We're just concerned about your leaf fungus.
4162,0,5,45,50,1.1,0.04285714285714286,545,Dr. Fern is feeling a little under the weather today.
4162,1,3,46,50,1.1,0.05150787536377128,545,"Robert, you're fired. Anyone else care to argue for a greenhouse gas reduction plan for this company?"
4162,0,5,45,50,1.1,0.04285714285714286,545,At least he'll be more benign than the last guy
4162,0,5,45,50,1.1,0.04285714285714286,545,"As it turns out, ladies and gentlemen, I am a potted plant."
4162,0,5,45,50,1.1,0.04285714285714286,545,"""I am cannabis sativa. Please do no call me me marijuana""."
4162,0,5,45,50,1.1,0.04285714285714286,545,"I'd like to talk to you today about ""growth mindset."""
4162,1,3,46,50,1.1,0.05150787536377128,545,Bob has sent this tree in his stead and I believe the message is clear as mud.
4162,2,1,47,50,1.1,0.05890150893739515,545,Who besides me thinks the idea of vegetarian Thanksgiving is sick?
4162,0,5,45,50,1.1,0.04285714285714286,545,"""As your new CEO I expect steady growth for the next physical year""."
4162,1,3,46,50,1.1,0.05150787536377128,545,"Well, I knew the transition from mining coal to flower shops would be difficult, I didn't see this coming."
4162,1,3,46,50,1.1,0.05150787536377128,545,Its better than the dummy that previously sat there.
4162,0,5,45,50,1.1,0.04285714285714286,545,"Oh yea, I'm picking up the O2 your putt'n down."
4162,0,5,45,50,1.1,0.04285714285714286,545,"Legal tells us that as long as the plant is alive, his is still valid."
4162,0,5,45,50,1.1,0.04285714285714286,545,So we will continue to plant the seeds for our annual growth
4162,1,3,46,50,1.1,0.05150787536377128,545,We need to 'green up' our image.
4162,1,3,46,50,1.1,0.05150787536377128,545,"First, let me thank all the write-in voters who elected me."
4162,0,5,45,50,1.1,0.04285714285714286,545,This doesn't look promising for the future of our forest clearing project.
4162,1,3,46,50,1.1,0.05150787536377128,545,If you let me continue as CEOI promise to grow as a person.
4162,0,5,45,50,1.1,0.04285714285714286,545,I've learned growth comes down to two things.
4162,1,3,46,50,1.1,0.05150787536377128,545,I think the topic today is eating our vegtables.
4162,1,3,46,50,1.1,0.05150787536377128,545,That was designed to show women that no one respects them more than we do.
4162,1,3,46,50,1.1,0.05150787536377128,545,The plant's too green for the lead role.
4162,1,3,46,50,1.1,0.05150787536377128,545,The table went quiet; that was the boss' favorite chair...
4162,0,5,45,50,1.1,0.04285714285714286,545,"As a tiebreaker, he leaves a lot to be desired."
4162,1,3,46,50,1.1,0.05150787536377128,545,Pot is king.
4162,0,5,45,50,1.1,0.04285714285714286,545,As the first plant-based corporation NO animal products are allowed in the building.
4162,1,3,46,50,1.1,0.05150787536377128,545,He is finally sending us a clear message.
4162,0,5,45,50,1.1,0.04285714285714286,545,What could it hurt? Just ask him!
4162,0,5,45,50,1.1,0.04285714285714286,545,I'm not sure I buy the predicted 30% production boost from floor-to-ceiling windows
4162,1,3,46,50,1.1,0.05150787536377128,545,"I'm actually kingdom-fluid, not trans."
4162,0,5,45,50,1.1,0.04285714285714286,545,It's amazing how far pot has come in the last few years.
4162,1,3,46,50,1.1,0.05150787536377128,545,did you change your diet? something about you looks different.
4162,0,5,45,50,1.1,0.04285714285714286,545,"I've asked to all here to confirm your suspicions about our competitor's meddling. I am, in fact, a plant."
4162,1,3,46,50,1.1,0.05150787536377128,545,Shhh---it's rigged.
4162,0,5,45,50,1.1,0.04285714285714286,545,Despite their disdain for perennials the firm kept an open mind during the interview.
4162,0,5,45,50,1.1,0.04285714285714286,545,"If the results of last month's marketing campaign are any indication of the quality of work you offer, none of you are fit to water my roots."
4162,0,5,45,50,1.1,0.04285714285714286,545,I'm thinking this must be a sign of the future: plant based conferences to save money.
4162,1,3,46,50,1.1,0.05150787536377128,545,"I asked you all here to address the recent rash of reported ""tree huggings"""
4162,2,1,47,50,1.1,0.05890150893739515,545,"I know you said he was as interesting as a potted plant, but did you have to turn him into one?"
4162,1,3,46,50,1.1,0.05150787536377128,545,What's our stance on cloning again?
4162,1,3,46,50,1.1,0.05150787536377128,545,A meeting of the planting comnittee
4162,1,3,46,50,1.1,0.05150787536377128,545,I think they're trying to tell us something.
4162,0,5,45,50,1.1,0.04285714285714286,545,"Before we vote, let's hear from the representative for the environment."
4162,0,5,45,50,1.1,0.04285714285714286,545,Rumor has it he can be a real Venus fly trap in negotiations!
4162,0,5,45,50,1.1,0.04285714285714286,545,The meeting was going well until the tree suggested a photo-synthesis.
4162,0,5,45,50,1.1,0.04285714285714286,545,The avocado pit denouement.
4162,2,1,47,50,1.1,0.05890150893739515,545,"I'm still wildly uncomfortable with this, but we haven't had a bankruptcy in over a year ..."
4162,0,5,45,50,1.1,0.04285714285714286,545,If she can expand our consciousness I say she has a right to be CEO.
4162,1,3,46,50,1.1,0.05150787536377128,545,It's time to photosynthesize the company
4162,0,5,45,50,1.1,0.04285714285714286,545,More evergreen content.
4162,1,3,46,50,1.1,0.05150787536377128,545,I'd like to you add you to my Professional Network on Lichen
4162,0,5,45,50,1.1,0.04285714285714286,545,"As the President of Potted Palm, Inc. I must note how underrepresented we are."
4162,0,5,45,50,1.1,0.04285714285714286,545,"As your elected CEO, I will make this company great again."
4162,1,3,46,50,1.1,0.05150787536377128,545,I'm concerned that many of you may be drinking too much water.
4162,0,5,45,50,1.1,0.04285714285714286,545,These challenging times call for dynamic leadership.
4162,1,3,46,50,1.1,0.05150787536377128,545,"Before to start this meeting, I would like to see your greencards."
4162,0,5,45,50,1.1,0.04285714285714286,545,I am Mister Trunk. I thrive on grass roots support to make things greener. Let's grow together.
4162,1,3,46,50,1.1,0.05150787536377128,545,"With so many more states offering marijuana enjoyment legally, the NYMJ corporate board is pondering a marketing plan for this top entry."
4162,0,5,45,50,1.1,0.04285714285714286,545,Why do I have the feeling I'm not the only one here who's pot bound?
4162,0,5,45,50,1.1,0.04285714285714286,545,Do you think seed money just grows on trees?
4162,2,1,47,50,1.1,0.05890150893739515,545,It gives me great pleasure to award our 'team of the year' to coat-rack and toaster oven.
4162,0,5,45,50,1.1,0.04285714285714286,545,I think the Board has taken our cries for hands-off leadership too far.
4162,1,3,46,50,1.1,0.05150787536377128,545,Please don't tell me today that no one no one brought the full-spectrum lamp to the meeting.
4162,0,5,45,50,1.1,0.04285714285714286,545,"whatever we do, we must not overwater"
4162,1,3,46,50,1.1,0.05150787536377128,545,First cabinet meeting.
4162,1,3,46,50,1.1,0.05150787536377128,545,"As your CEO, I read the Board's evaluation, and as you can see I followed your suggestion to make like a tree and leaf."
4162,0,5,45,50,1.1,0.04285714285714286,545,Be careful what you say. This cold be a plant.
4162,0,5,45,50,1.1,0.04285714285714286,545,Now I'm legit. Don't pretend we've never met.
4162,0,5,45,50,1.1,0.04285714285714286,545,Such a swift promotion of green movement is striking.
4162,0,5,45,50,1.1,0.04285714285714286,545,"Like my leaves, profits have been diminishing this winter."
4162,1,3,46,50,1.1,0.05150787536377128,545,"I expect photosynthesis to be up next quarter, or you're all fired."
4162,1,3,46,50,1.1,0.05150787536377128,545,This cannot be the Christmas tree for Trump Tower!
4162,1,3,46,50,1.1,0.05150787536377128,545,"Go ahead drink your water, why would I need any?"
4162,0,5,45,50,1.1,0.04285714285714286,545,Voters reject incumbent in favour of pro-growth candidate.
4162,1,3,46,50,1.1,0.05150787536377128,545,The card says it's from Trump
4162,1,3,46,50,1.1,0.05150787536377128,545,It stood by Trump when no one believed in him.
4162,0,5,45,50,1.1,0.04285714285714286,545,They say he's bullish on growth.
4162,0,5,45,50,1.1,0.04285714285714286,545,we're here to discuss species change
4162,1,3,46,50,1.1,0.05150787536377128,545,"I intend to become a secret plant, on our largest competitors Board of Directors!"
4162,0,5,45,50,1.1,0.04285714285714286,545,"Believe it or not, we had a steak together yesterday."
4162,0,5,45,50,1.1,0.04285714285714286,545,Are you sure this isn't a Putin plant?
4162,0,5,45,50,1.1,0.04285714285714286,545,"Now, if I could have you fern to the next page..."
4162,0,5,45,50,1.1,0.04285714285714286,545,I'd like to introduce J.B. Woodruff...head of our plant in Detroit
4162,1,3,46,50,1.1,0.05150787536377128,545,"The President couldn't be here, so he sent a plant he swiped from Ivanka's underwear closet."
4162,0,5,45,50,1.1,0.04285714285714286,545,This work visualization project isn't working for me.
4162,0,5,45,50,1.1,0.04285714285714286,545,The new CEO's very eco-friendly.
4162,0,5,45,50,1.1,0.04285714285714286,545,"I know what you all must be thinking, ""This guy's totally a plant, isn't he?"""
4162,1,3,46,50,1.1,0.05150787536377128,545,"Shirley, do you think our new CEO is actually a plant from our rival?"
4162,1,3,46,50,1.1,0.05150787536377128,545,Please don't bring out the Monstera in me.
4162,1,3,46,50,1.1,0.05150787536377128,545,The original presentation had much more impact when I gave while aflame.
4162,0,5,45,50,1.1,0.04285714285714286,545,The newly elected president of the United States meets with it's newly appointed cabinet in 2020.
4162,2,1,47,50,1.1,0.05890150893739515,545,Office party's sure have changed.
4162,1,3,46,50,1.1,0.05150787536377128,545,I heard he said after the last meeting he heads a team of useless potted plants.
4162,0,5,45,50,1.1,0.04285714285714286,545,Don't just sit there gawking at me. Say something!
4162,0,5,45,50,1.1,0.04285714285714286,545,I heard we were getting a new plant just west of us.
4162,0,5,45,50,1.1,0.04285714285714286,545,I have new and fresh ideas. I'm not just another potted plant.
4162,0,5,45,50,1.1,0.04285714285714286,545,Jack could't make it so he sent his beanstalk surrogate.
4162,0,5,45,50,1.1,0.04285714285714286,545,Y' think he's stupid? His old man was a box of hammers.
4162,0,5,45,50,1.1,0.04285714285714286,545,I think your fiscal policy for growth might be different from ours.
4162,1,3,46,50,1.1,0.05150787536377128,545,Is Human Resources on board with this yet?
4162,2,1,47,50,1.1,0.05890150893739515,545,He's been gluten free since the Eisenhower administration.
4162,1,3,46,50,1.1,0.05150787536377128,545,Looks like he's potted again.
4162,1,3,46,50,1.1,0.05150787536377128,545,"I asked for someone photogenic, not something in the process of photo-synthesis"
4162,1,3,46,50,1.1,0.05150787536377128,545,The snacks at these meetings have been terrible lately.
4162,2,1,47,50,1.1,0.05890150893739515,545,"Have we taken ""going green"" entirely too far?"
4162,0,5,45,50,1.1,0.04285714285714286,545,The company’s not been the same since his father finally succumbed to greenfly
4162,0,5,45,50,1.1,0.04285714285714286,545,"Lucky for him, everyone here is from Colorado or California."
4162,0,5,45,50,1.1,0.04285714285714286,545,"Good, we’re all focused on organic growth."
4162,0,5,45,50,1.1,0.04285714285714286,545,Oh don't be such a stick in the mud. This proposal is great!
4162,0,5,45,50,1.1,0.04285714285714286,545,Monthly meeting of the Burpee Seed Company
4162,1,3,46,50,1.1,0.05150787536377128,545,Our Board was right. They said they'd give us a real genus livelier than our last CEO.
4162,0,5,45,50,1.1,0.04285714285714286,545,I'm not a plant.
4162,0,5,45,50,1.1,0.04285714285714286,545,The family tree has gone to pot.
4162,1,3,46,50,1.1,0.05150787536377128,545,"You might have had a better shot, but I still say we wouldn't have won."
4162,1,3,46,50,1.1,0.05150787536377128,545,I see one of you was sensitive to my family tree.
4162,1,3,46,50,1.1,0.05150787536377128,545,Silence is green.
4162,1,3,46,50,1.1,0.05150787536377128,545,"With the new President-elect, my days here are numbered - I will be stepping down, as of January 20, 2017."
4162,0,5,45,50,1.1,0.04285714285714286,545,Testing
4162,1,3,46,50,1.1,0.05150787536377128,545,The forecast is predicting massive growth.
4162,0,5,45,50,1.1,0.04285714285714286,545,We must construct more efficient plants.
4162,1,3,46,50,1.1,0.05150787536377128,545,So this is where our cartoonists get their ideas.
4162,1,3,46,50,1.1,0.05150787536377128,545,"We've been talking to him all morning, yet he doesn't seem any happier."
4162,1,3,46,50,1.1,0.05150787536377128,545,"Bonsai International’s Board of Directors mandates radical downsizing, starting at the top."
4162,1,3,46,50,1.1,0.05150787536377128,545,"Only an acorn yesterday, a mighty oak tomorrow, but he will always have a wooden personality."
4162,1,3,46,50,1.1,0.05150787536377128,545,"Because of the takeover, global warming will be the least of you CO2-spouting meat thugs' worries."
4162,0,5,45,50,1.1,0.04285714285714286,545,And you thought planted was just a phrase.
4162,0,5,45,50,1.1,0.04285714285714286,545,It looks like we have joint support for joint support.
4162,1,3,46,50,1.1,0.05150787536377128,545,"All in favor of more trees, say ""Ay""!"
4162,0,5,45,50,1.1,0.04285714285714286,545,I think it's thirsty.
4162,0,5,45,50,1.1,0.04285714285714286,545,"He's fern, but equitable."
4162,1,3,46,50,1.1,0.05150787536377128,545,"No sir, you are not just a potted plant."
4162,1,3,46,50,1.1,0.05150787536377128,545,Huh? I thought our lawyer was the potted palm.
4162,0,5,45,50,1.1,0.04285714285714286,545,BREAKING NEWS-Leaked photo proves Trump to be a plant for Russian intelligence!
4162,0,5,45,50,1.1,0.04285714285714286,545,Things have realy gone to pot since he was promoted to Branch Manager.
4162,1,3,46,50,1.1,0.05150787536377128,545,"It was the board's idea, they wanted a green CEO"
4162,0,5,45,50,1.1,0.04285714285714286,545,"So, humans, the secret of success is to grow where you're planted."
4162,0,5,45,50,1.1,0.04285714285714286,545,It must be good ... it's Chair of five other corporate boards.
4162,0,5,45,50,1.1,0.04285714285714286,545,"I'm sure some of you are thinking ""The only reason he's on that chair is because his dad bought on the company..."""
4162,0,5,45,50,1.1,0.04285714285714286,545,"I will beat Trump in 2020, just saying."
4162,0,5,45,50,1.1,0.04285714285714286,545,"Who is this?"" ""It's the plant, the roots of our company."
4162,0,5,45,50,1.1,0.04285714285714286,545,I'm here to review the profit and loss statement for ficus year ending...
4162,0,5,45,50,1.1,0.04285714285714286,545,The Board agrees it's the safest subject for David Remnick's next interview.
4162,1,3,46,50,1.1,0.05150787536377128,545,let the marihuana plant make its case.
4162,0,5,45,50,1.1,0.04285714285714286,545,Today we launch an initiative I like to call photosynergy.
4162,1,3,46,50,1.1,0.05150787536377128,545,Will someone please get me a hose of water
4162,0,5,45,50,1.1,0.04285714285714286,545,"Obviously, we can't see the forest through the plant."
4162,1,3,46,50,1.1,0.05150787536377128,545,I'm here to announce the success of our transmutation technology.
4162,1,3,46,50,1.1,0.05150787536377128,545,"once again folks, its Phillodendron with a ""P""!"
4162,0,5,45,50,1.1,0.04285714285714286,545,"Now legalized in 20 states, our new vision statement will mirror Washington, D.C.: ""Let's Make America Great Again""?"
4162,0,5,45,50,1.1,0.04285714285714286,545,As a plant he is real bush-league.
4162,2,1,47,50,1.1,0.05890150893739515,545,"I came, I saw, I conquered!"
4162,1,3,46,50,1.1,0.05150787536377128,545,Wall Street smashes the glass ceiling.
4162,0,5,45,50,1.1,0.04285714285714286,545,He's much less critical than the previous CEO
4162,1,3,46,50,1.1,0.05150787536377128,545,Poll Pot Planted
4162,0,5,45,50,1.1,0.04285714285714286,545,Uncanny -- may as well still be with us.
4162,0,5,45,50,1.1,0.04285714285714286,545,"Export as many jobs to India as possible, BUT NOT THE PLANTS!"
4162,1,3,46,50,1.1,0.05150787536377128,545,"When I look at that plant, I have the same feeling when I found out Santa wasn't who he said he was."
4162,1,3,46,50,1.1,0.05150787536377128,545,State your roots please.
4162,1,3,46,50,1.1,0.05150787536377128,545,Face facts. We all eat a little sh@$ now and then.
4162,0,5,45,50,1.1,0.04285714285714286,545,"To conclude, the charges of nepotism against me are obviously false."
4162,2,1,47,50,1.1,0.05890150893739515,545,I call this meeting to border.
4162,2,1,47,50,1.1,0.05890150893739515,545,"Try not to look so smug, hypocrites. I'm not the only member of this company's board of directors who's nothing more than a potted plant."
4162,0,5,45,50,1.1,0.04285714285714286,545,Voting in favor of overhauling the company's current nominating process for director was their first ever unanimous decision.
4162,2,1,47,50,1.1,0.05890150893739515,545,"Let's discuss ""water"" and ""sun"" last this week."
4162,0,5,45,50,1.1,0.04285714285714286,545,I'm planted here until we reach an agreement
4162,0,5,45,50,1.1,0.04285714285714286,545,And we voted out Vidalia.
4162,1,3,46,50,1.1,0.05150787536377128,545,I think he is from Asia.
4162,0,5,45,50,1.1,0.04285714285714286,545,So you all disagree with me ! This is treeson !!!!
4162,0,5,45,50,1.1,0.04285714285714286,545,What planet is he from?
4162,1,3,46,50,1.1,0.05150787536377128,545,"OK, just remember, I'm 'THE MOST POWERFUL POTTED PINE IN THE WORLD'---and I'm legal!"
4162,0,5,45,50,1.1,0.04285714285714286,545,I have pink slips to hand out. Bet you wish you'd watered me.
4162,0,5,45,50,1.1,0.04285714285714286,545,Why can't we just have a chair like everyone else?
4162,1,3,46,50,1.1,0.05150787536377128,545,Did he just say we're having a Christmas 'human' lighting party this year?
4162,0,5,45,50,1.1,0.04285714285714286,545,"To be fair, not all of us think we need to be a green company."
4162,0,5,45,50,1.1,0.04285714285714286,545,"Next, let's discuss our carbon pot-print."
4162,1,3,46,50,1.1,0.05150787536377128,545,We elected that as our new president?
4162,1,3,46,50,1.1,0.05150787536377128,545,Expectations rose as a new CEO replaced the old piece of chop liver.
4162,0,5,45,50,1.1,0.04285714285714286,545,I can assure you I have no intention of leading you all up the garden path.
4162,0,5,45,50,1.1,0.04285714285714286,545,"We have to shake things up, they said"
4162,1,3,46,50,1.1,0.05150787536377128,545,We have to stop meeting like this.
4162,0,5,45,50,1.1,0.04285714285714286,545,The DNA results before you are conclusive...you are all my descendants...except Adam; your results were inconclusive.
4162,1,3,46,50,1.1,0.05150787536377128,545,"The Board sensed something was different, but couldn't say exactly what."
4162,1,3,46,50,1.1,0.05150787536377128,545,Our new CEO is taking ' going green' a bit over the top!
4162,0,5,45,50,1.1,0.04285714285714286,545,"Next on the agenda, will somebody please fluff up my leaves?"
4162,0,5,45,50,1.1,0.04285714285714286,545,I miss the days when you knew if it was Corporate Improv Week.
4162,1,3,46,50,1.1,0.05150787536377128,545,"Yes, of course I have an opinion! After all, I not just some potted plant!"
4162,1,3,46,50,1.1,0.05150787536377128,545,"Well, given the alternative, it's got our vote."
4162,1,3,46,50,1.1,0.05150787536377128,545,Fiddle-leafing while Rome burns.
4162,1,3,46,50,1.1,0.05150787536377128,545,"Now that marijuana has been made legal here in California, meet your new hallucinogenic overlord."
4162,1,3,46,50,1.1,0.05150787536377128,545,"Even if we vote this one out, Zach's got a replacement at the ready."
4162,0,5,45,50,1.1,0.04285714285714286,545,Who took my water this company won't grow without it!
4162,0,5,45,50,1.1,0.04285714285714286,545,So how long did you work in the plant?
4162,0,5,45,50,1.1,0.04285714285714286,545,"Security thinks he's a plant from Megatron, Inc."
4162,1,3,46,50,1.1,0.05150787536377128,545,"I know the former Chairtree was deciduous, however, I'm evergreen."
4162,0,5,45,50,1.1,0.04285714285714286,545,I've just been informed by security that someone in our section has been leaking confidential information.
4162,0,5,45,50,1.1,0.04285714285714286,545,All we talk about anymore is our corporate green agenda.
4162,1,3,46,50,1.1,0.05150787536377128,545,I suppose you're all wondering why I called you here today.
4162,2,1,47,50,1.1,0.05890150893739515,545,He's going green.
4162,1,3,46,50,1.1,0.05150787536377128,545,Our Q3 growth is lackluster.
4162,1,3,46,50,1.1,0.05150787536377128,545,"Unfortunately, it's only for four years while he's on some sort of ""special project"""
4162,0,5,45,50,1.1,0.04285714285714286,545,Jed's looking a little green this morning.
4162,1,3,46,50,1.1,0.05150787536377128,545,"Hey, why is that plant sitting there? Isn't that seat normally for the head of our company? We should move that plant so that the head of our company can sit there."
4162,1,3,46,50,1.1,0.05150787536377128,545,"So as you can see, these are the new ferniture designs."
4162,1,3,46,50,1.1,0.05150787536377128,545,I need input! Don't just sit there like potted people.
4162,1,3,46,50,1.1,0.05150787536377128,545,We believe that an introvert C.E.O. will really help us break out in 2017.
4162,0,5,45,50,1.1,0.04285714285714286,545,"When Bob said the new chair was branching out, the board had been expecting something more dynamic, but all quickly agreed admit it was innovative."
4162,1,3,46,50,1.1,0.05150787536377128,545,Ride herd. I am the potted plant in the room.
4162,1,3,46,50,1.1,0.05150787536377128,545,This will honor his memory. He always said that he wasn't a potted plant.
4162,0,5,45,50,1.1,0.04285714285714286,545,Plantar Fasciinitis
4162,1,3,46,50,1.1,0.05150787536377128,545,"Marcy campaigned to have her office plant live up to its name. Diversity, am I right?"
4162,1,3,46,50,1.1,0.05150787536377128,545,In lieu of a Christmas bonus this year...
4162,1,3,46,50,1.1,0.05150787536377128,545,Don’t reveal our treat secrets. He might be a plant.
4162,0,5,45,50,1.1,0.04285714285714286,545,Our drunkard boss has been replaced by a potted plant
4162,0,5,45,50,1.1,0.04285714285714286,545,Just go with it. Herb has allowed us to chillax about the quarterly numbers.
4162,1,3,46,50,1.1,0.05150787536377128,545,Sustainability starts at the top. Who's next?
4162,0,5,45,50,1.1,0.04285714285714286,545,"All together now, our theme song around, around the mulberry bush."
4162,1,3,46,50,1.1,0.05150787536377128,545,Mrs. Clinton surely has changed since our last strategy meeting...
4162,1,3,46,50,1.1,0.05150787536377128,545,"Enough of your daily harangue sir, you ARE a potted plant."
4162,0,5,45,50,1.1,0.04285714285714286,545,I'm not a potted plant. I'm here as the lawyer. That's my job.
4162,0,5,45,50,1.1,0.04285714285714286,545,I think the company is taking its environmentalism too far.
4162,1,3,46,50,1.1,0.05150787536377128,545,"Cometh the hour, cometh the Magnolia!"
4162,0,5,45,50,1.1,0.04285714285714286,545,"I really do think that was, by far, his most brilliant presentation yet."
4162,0,5,45,50,1.1,0.04285714285714286,545,"The Board expects results, or get off the pot"
4162,1,3,46,50,1.1,0.05150787536377128,545,Bill's replacement is very still and calm.
4162,0,5,45,50,1.1,0.04285714285714286,545,The Bored Room
4162,1,3,46,50,1.1,0.05150787536377128,545,"One, we are going all in on solar. Two, growth trumps movement. Three, you’re all fired."
4162,1,3,46,50,1.1,0.05150787536377128,545,''I thought you said the client was your aunt.''
4162,0,5,45,50,1.1,0.04285714285714286,545,Customers buy things that are eco-friendly.
4162,0,5,45,50,1.1,0.04285714285714286,545,"I thought when the email mentioned Herb, it meant a Human CEO!"
4162,0,5,45,50,1.1,0.04285714285714286,545,"Ladies and gentleman, thank you for the vote of confidence. And now that we've ousted the aardvark, we can get down to business."
4162,1,3,46,50,1.1,0.05150787536377128,545,"Well, Mr. Chairman, if this doesn't convince everyone we serious about ""Going Green,"" nothing will."
4162,0,5,45,50,1.1,0.04285714285714286,545,"They used to say, ""a fern's place is in the house"""
4162,0,5,45,50,1.1,0.04285714285714286,545,"Since Fauna United, we've given millions to the Green Party – and for what?"
4162,0,5,45,50,1.1,0.04285714285714286,545,We all need to make like a tree and leaf
4162,0,5,45,50,1.1,0.04285714285714286,545,Who said the chairman was a vegetable?
4162,0,5,45,50,1.1,0.04285714285714286,545,At least he's not a political insider.
4162,1,3,46,50,1.1,0.05150787536377128,545,Please welcome our Green Initiative Chair Mr. Philodendron.
4162,0,5,45,50,1.1,0.04285714285714286,545,"Unsure whether this was a joke, the board members sat in absolute silence."
4162,1,3,46,50,1.1,0.05150787536377128,545,"To confirm the rumors you may have heard, yes, I AM as smart as a potted plant."
4162,0,5,45,50,1.1,0.04285714285714286,545,The boss says we need to get repotted every few years.
4162,0,5,45,50,1.1,0.04285714285714286,545,It give new meaning to 'Bloom where you're planted.'
4162,0,5,45,50,1.1,0.04285714285714286,545,First we read them now we have to listen to them!
4162,0,5,45,50,1.1,0.04285714285714286,545,We sowed this seed of an idea last week.
4162,0,5,45,50,1.1,0.04285714285714286,545,Nice not to be on the sidelines anymore
4162,1,3,46,50,1.1,0.05150787536377128,545,when money talks everybody listens.
4162,0,5,45,50,1.1,0.04285714285714286,545,At least it's not an orange tree.
4162,0,5,45,50,1.1,0.04285714285714286,545,I think an urn would have been less lively.
4162,0,5,45,50,1.1,0.04285714285714286,545,That's not our founder. He's a plant.
4162,0,5,45,50,1.1,0.04285714285714286,545,"Hi everyone, I'm the new CEO, my name is Ms. Bloom."
4162,0,5,45,50,1.1,0.04285714285714286,545,It's nice that Jeb found a place to land...
4162,0,5,45,50,1.1,0.04285714285714286,545,"Is this what she meant by ""Going Green"""
4162,1,3,46,50,1.1,0.05150787536377128,545,The Knights Who Say Ni and their shrubbery-elect.
4162,1,3,46,50,1.1,0.05150787536377128,545,"As Board members can see, we're now in full compliance with Delaware corporate law."
4162,0,5,45,50,1.1,0.04285714285714286,545,"Corporate America ""goes green""."
4162,0,5,45,50,1.1,0.04285714285714286,545,we all have those days..
4162,1,3,46,50,1.1,0.05150787536377128,545,Welcome to the first Trump cabinet meeting.
4162,0,5,45,50,1.1,0.04285714285714286,545,Look how mush it grew. Its the same old shit.
4162,1,3,46,50,1.1,0.05150787536377128,545,"It's water, all about the water!"
4162,0,5,45,50,1.1,0.04285714285714286,545,Come on guys! Take a leaf of faith.
4162,0,5,45,50,1.1,0.04285714285714286,545,Sir if you could stop leaving your children on the floor that would be great.
4162,0,5,45,50,1.1,0.04285714285714286,545,The CEO took 'Going Green' to an entirely new level.
4162,1,3,46,50,1.1,0.05150787536377128,545,"Yes, Nancy I am impressed. But Roger's numbers a better, so he gets to water me."
4162,1,3,46,50,1.1,0.05150787536377128,545,"We thought an apolitical CEO was wise. Now, we're not so sure an environmentalist like this will survive."
4162,0,5,45,50,1.1,0.04285714285714286,545,We're taking the green initiative to a whole new level!
4162,1,3,46,50,1.1,0.05150787536377128,545,"I, for one, welcome our future corporate overlords."
4162,0,5,45,50,1.1,0.04285714285714286,545,We wanted to diversify our group of dead wood
4162,0,5,45,50,1.1,0.04285714285714286,545,This leave of absence epidemic is really growing out of control.
4162,1,3,46,50,1.1,0.05150787536377128,545,Newsflash: Company seeks former president as new CEO. Job search goes horribly wrong.
4162,0,5,45,50,1.1,0.04285714285714286,545,It will only bloom if Dodd-Frank is repealed.
4162,0,5,45,50,1.1,0.04285714285714286,545,"I'm a ventriloquist. Watch me get you a raise."""
4162,1,3,46,50,1.1,0.05150787536377128,545,Green is good.
4162,1,3,46,50,1.1,0.05150787536377128,545,I'll be leaving on January the 19th. See you back here in 4 years.
4162,0,5,45,50,1.1,0.04285714285714286,545,"Now that the 2016 election was over, Jeb decided to join a corporate board."
4162,0,5,45,50,1.1,0.04285714285714286,545,"They say she is the ""silent leader"" type."
4162,0,5,45,50,1.1,0.04285714285714286,545,"So, tell me more about your green initiative."
4162,1,3,46,50,1.1,0.05150787536377128,545,"I think our company needs to go ""green"""
4162,1,3,46,50,1.1,0.05150787536377128,545,"I'll contact H, umm PR?"
4162,0,5,45,50,1.1,0.04285714285714286,545,Still happy with not going public?
4162,1,3,46,50,1.1,0.05150787536377128,545,Last month he was being watered on the windowsill. Look at him now! He plans to join a political party. and wait four years for his next big move.
4162,0,5,45,50,1.1,0.04285714285714286,545,"Let's set the bush on fire, and maybe it will enlighten us."
4162,1,3,46,50,1.1,0.05150787536377128,545,There's no denying it anymore - I'm leaving.
4162,0,5,45,50,1.1,0.04285714285714286,545,"So, as you can all see by this stem-and-leaf plot ..."
4162,0,5,45,50,1.1,0.04285714285714286,545,Who forgot my water glass?
4162,0,5,45,50,1.1,0.04285714285714286,545,"As your new leader, I want you to know that I have deeply rooted values. Speaking of roots, would one of you please water me?"
4473,2,1,48,51,1.0980392156862746,0.05776831318688719,545,I know you're probably thinking I'm a plant
4473,0,5,46,51,1.0980392156862746,0.042054138410837674,545,Psst. She's a vegan. Pass it on.
4473,0,5,46,51,1.0980392156862746,0.042054138410837674,545,"Don't look now, but we have a CIA plant in our organization."
4473,0,5,46,51,1.0980392156862746,0.042054138410837674,545,I want to put to rest the notion that your CEO is an empty suit.
4473,0,5,46,51,1.0980392156862746,0.042054138410837674,545,"Where are my acorns, people - dammit, I want acorns!"
4473,0,5,46,51,1.0980392156862746,0.042054138410837674,545,I'm not leafing until those papers are signed.
4473,0,5,46,51,1.0980392156862746,0.042054138410837674,545,Don't say anything. He hasn't had his coffee yet.
4473,1,3,47,51,1.0980392156862746,0.050525877359706366,545,Wait for it.
4473,0,5,46,51,1.0980392156862746,0.042054138410837674,545,"Leaf this to me, we need to open another branch."
4473,0,5,46,51,1.0980392156862746,0.042054138410837674,545,The Joy of Christmas is the only item on the agenda today.
4483,0,5,47,52,1.0961538461538463,0.04128055232750756,545,The last CEO said his replacement was green oriented.
4484,1,3,53,57,1.087719298245614,0.04533847748151766,545,Amazing! Trump as President of the United States and Dracina Marginata as president of our fertilizer company.
4485,0,4,44,48,1.0833333333333333,0.040314953903908046,545,He's got my vote!
4485,1,2,45,48,1.0833333333333333,0.05011806391880343,545,"You telecommute also, I see."
4485,0,4,44,48,1.0833333333333333,0.040314953903908046,545,He sent this from Michelle's garden.
4485,0,4,44,48,1.0833333333333333,0.040314953903908046,545,President Jill Stien cabinet meeting
4485,1,2,45,48,1.0833333333333333,0.05011806391880343,545,Looks like somebody forgot to water his plants again.
4485,1,2,45,48,1.0833333333333333,0.05011806391880343,545,"Evidently, ""plant Operations Manager"" is merely titular"
4485,1,2,45,48,1.0833333333333333,0.05011806391880343,545,Join the charade or quit - see any other option?
4485,0,4,44,48,1.0833333333333333,0.040314953903908046,545,Which of these things is not like the other ones?
4485,1,2,45,48,1.0833333333333333,0.05011806391880343,545,Mary Jane got her green card last week.
4485,0,4,44,48,1.0833333333333333,0.040314953903908046,545,At least he's not the same as the old boss.
4485,0,4,44,48,1.0833333333333333,0.040314953903908046,545,So how do you propose we grow our economy ?
4485,0,4,44,48,1.0833333333333333,0.040314953903908046,545,Adams? Here. Adamalski? Here. Anderson?Anderson? HERE! Snoop Dogg? Snoop Dogg? Snoop Dogg? Snoop Dogg?
4485,1,2,45,48,1.0833333333333333,0.05011806391880343,545,I hear he came up with the poison pill takeover defense
4485,0,4,44,48,1.0833333333333333,0.040314953903908046,545,Really! Did President Trump think we wouldn't notice!
4485,0,4,44,48,1.0833333333333333,0.040314953903908046,545,Did anyone bring a doobee?
4485,0,4,44,48,1.0833333333333333,0.040314953903908046,545,Why are you all staring at me? Hasn't anyone seen a pot plant. Get used to me. I've just been appointed Cannabis Entertainment Official (CEO).
4485,1,2,45,48,1.0833333333333333,0.05011806391880343,545,We will be switching back to affordable tap water.
4485,0,4,44,48,1.0833333333333333,0.040314953903908046,545,Barking up the wrong tree as usual
4485,1,2,45,48,1.0833333333333333,0.05011806391880343,545,Our new president has had an amazingly smooth transition to the job.
4485,0,4,44,48,1.0833333333333333,0.040314953903908046,545,As your Director of Air Quality Control I have asked you here to explain why we have removed beans and broccoli from the cafeteria menu.
4485,0,4,44,48,1.0833333333333333,0.040314953903908046,545,What's on your mind?
4485,1,2,45,48,1.0833333333333333,0.05011806391880343,545,He runs it like a terracotta-pot dictatorship.
4485,1,2,45,48,1.0833333333333333,0.05011806391880343,545,...or maybe we are all Venus flytraps dreaming we are a hostile take-over Board ?
4485,1,2,45,48,1.0833333333333333,0.05011806391880343,545,We really should hire more than one plant. No one plant should be responsible for speaking on behalf of every plant.
4485,1,2,45,48,1.0833333333333333,0.05011806391880343,545,so much nicer than a memory book
4485,0,4,44,48,1.0833333333333333,0.040314953903908046,545,"I got Oliver North off, and I'll see us through this crisis."
4485,0,4,44,48,1.0833333333333333,0.040314953903908046,545,It's called Wall-Flower- Power folks
4485,0,4,44,48,1.0833333333333333,0.040314953903908046,545,Guess it didn't matter how much he claimed he wasn't.
4485,1,2,45,48,1.0833333333333333,0.05011806391880343,545,"The Plant Manager was tied up, so he's asked his underling to attend."
4485,1,2,45,48,1.0833333333333333,0.05011806391880343,545,"That's an acorn that didn't get far from the tree, did it?"
4485,0,4,44,48,1.0833333333333333,0.040314953903908046,545,I'm managing optics.
4485,1,2,45,48,1.0833333333333333,0.05011806391880343,545,"I have to give it to her, even after this election and at her age, Jill Stein looks as trim as ever."
4485,1,2,45,48,1.0833333333333333,0.05011806391880343,545,Not another Potted Plant Ploy?
4485,0,4,44,48,1.0833333333333333,0.040314953903908046,545,Cubism in the post-Picasso era
4485,0,4,44,48,1.0833333333333333,0.040314953903908046,545,"At AfterLife Pharma, rather than plant grandma, we turn grandma into a plant."
4485,0,4,44,48,1.0833333333333333,0.040314953903908046,545,I guess there is now no way to avoid the root of the problem.
4485,0,4,44,48,1.0833333333333333,0.040314953903908046,545,"Well, it's clear you all didn't read my heartfelt email about going paperless in the office."
4485,1,2,45,48,1.0833333333333333,0.05011806391880343,545,I've called this meeting... for all your output.
4485,0,4,44,48,1.0833333333333333,0.040314953903908046,545,Each take a leaf as I slide across the table. Then we can start the meeting.
4485,1,2,45,48,1.0833333333333333,0.05011806391880343,545,It all started when he planted pot.
4485,0,4,44,48,1.0833333333333333,0.040314953903908046,545,we can use some liquid assets for some real growth
4485,1,2,45,48,1.0833333333333333,0.05011806391880343,545,You're killing me!
4485,1,2,45,48,1.0833333333333333,0.05011806391880343,545,Me thinks there's a ficus among-us.
4485,1,2,45,48,1.0833333333333333,0.05011806391880343,545,Tell me again what our futures look like.
4485,1,2,45,48,1.0833333333333333,0.05011806391880343,545,All that nirvana babel may have been legitimate.
4485,0,4,44,48,1.0833333333333333,0.040314953903908046,545,Who knew corporations would adopt our 3rd-Party political system?!
4485,1,2,45,48,1.0833333333333333,0.05011806391880343,545,"When our COO mentioned having better work-life balance, I did not envision this."
4485,1,2,45,48,1.0833333333333333,0.05011806391880343,545,Of course not. You're just as daring and revolutionary as Steve Jobs.
4485,0,4,44,48,1.0833333333333333,0.040314953903908046,545,So I guess the rumors are true. It looks like they're pruning the workforce.
4485,1,2,45,48,1.0833333333333333,0.05011806391880343,545,"Ladies and gentlemen, welcome to the Fern."
4485,0,4,44,48,1.0833333333333333,0.040314953903908046,545,"ironic, he felt that way before passing"
4485,1,2,45,48,1.0833333333333333,0.05011806391880343,545,As the new head of office security I really have to tell you....
4485,0,4,44,48,1.0833333333333333,0.040314953903908046,545,"We're here to discuss our corporate mantra to ""Go Green""."
4485,0,4,44,48,1.0833333333333333,0.040314953903908046,545,I'm prepared to throw shade.
4485,0,4,44,48,1.0833333333333333,0.040314953903908046,545,We chose him because wages never go up when a photosynthesizer is at the helm.
4485,0,4,44,48,1.0833333333333333,0.040314953903908046,545,Chairman Yew has a few opening remarks for our Christmas celebration
4485,0,4,44,48,1.0833333333333333,0.040314953903908046,545,Do you really think he wants us to call him Russell?
4485,0,4,44,48,1.0833333333333333,0.040314953903908046,545,Green Party Meeting
4485,0,4,44,48,1.0833333333333333,0.040314953903908046,545,I won't be taking any more questions about my emails
4485,0,4,44,48,1.0833333333333333,0.040314953903908046,545,I heard she was green.
4485,0,4,44,48,1.0833333333333333,0.040314953903908046,545,"Looks like I have some sensitivity training coming, all I said was he looks a little ""Leafy"" !"
4485,0,4,44,48,1.0833333333333333,0.040314953903908046,545,He looks a little wilted.
4485,0,4,44,48,1.0833333333333333,0.040314953903908046,545,"On this third Anniversary of the passing of our beloved founder, a moment of silence and a silent prayer."
4485,1,2,45,48,1.0833333333333333,0.05011806391880343,545,He was so much more bombastic during the election.
4485,2,0,46,48,1.0833333333333333,0.05829532703111204,545,It will help with our decision making process.
4485,1,2,45,48,1.0833333333333333,0.05011806391880343,545,"When J.B. said he wanted to come back as a player in Corporate Espionage, I thought he'd be a lot more clever than that."
4485,1,2,45,48,1.0833333333333333,0.05011806391880343,545,"As the new chairman, I'd like to thank you bigly for this honor. We're going to make this company great again!"
4485,1,2,45,48,1.0833333333333333,0.05011806391880343,545,So much for diversity.
4485,0,4,44,48,1.0833333333333333,0.040314953903908046,545,I understand the Wall Street Journal is sending their top reporters and cameramen.
4485,0,4,44,48,1.0833333333333333,0.040314953903908046,545,I'll leave you to your own conclusions regarding my impending extinction.
4485,0,4,44,48,1.0833333333333333,0.040314953903908046,545,The Board of Directors has spoken - in Latin I believe.
4485,0,4,44,48,1.0833333333333333,0.040314953903908046,545,"Just delivering my constituency’s protest message, “Oxygen production is on hold.”"
4485,1,2,45,48,1.0833333333333333,0.05011806391880343,545,"I know you are, but who am I?"
4485,0,4,44,48,1.0833333333333333,0.040314953903908046,545,Leaves smaller than usual.
4485,1,2,45,48,1.0833333333333333,0.05011806391880343,545,"You were right, Gulliver, these Lilliputian immigrants you sponsored are really efficient eggheads"
4485,0,4,44,48,1.0833333333333333,0.040314953903908046,545,We pay for their fence?? C'mon!
4485,0,4,44,48,1.0833333333333333,0.040314953903908046,545,You will each plant a tree to save the planet.
4485,0,4,44,48,1.0833333333333333,0.040314953903908046,545,May the plant be with you.
4485,0,4,44,48,1.0833333333333333,0.040314953903908046,545,I don't believe it's the boss in disguise.
4485,1,2,45,48,1.0833333333333333,0.05011806391880343,545,Our pothead is amazing!
4485,0,4,44,48,1.0833333333333333,0.040314953903908046,545,I can already feel my morale boosting.
4485,0,4,44,48,1.0833333333333333,0.040314953903908046,545,"Thumbs up, considering our last potted plant left on a golden parachute."
4485,0,4,44,48,1.0833333333333333,0.040314953903908046,545,Everyone meet the new chairman of the board for Ecosexualism.
4485,0,4,44,48,1.0833333333333333,0.040314953903908046,545,Breathe freely! For our relationship will be one of equals: my oxygen--your carbon dioxide.
4485,0,4,44,48,1.0833333333333333,0.040314953903908046,545,I only intended to go green.
4485,1,2,45,48,1.0833333333333333,0.05011806391880343,545,Bound be better than the last board chairman.
4485,0,4,44,48,1.0833333333333333,0.040314953903908046,545,"Gee, I never thought our former CEO was that dumb."
4485,0,4,44,48,1.0833333333333333,0.040314953903908046,545,Breathe deeply. I need your CO2 to affect the greening of Acme Oil.
4485,0,4,44,48,1.0833333333333333,0.040314953903908046,545,I guess they weren't kidding when they said he got removed from office for treason.
4485,0,4,44,48,1.0833333333333333,0.040314953903908046,545,"I thought we were meeting the company's new environmental ""planner"" this morning."
4485,0,4,44,48,1.0833333333333333,0.040314953903908046,545,"It's a promo for the sequel, ""A Tree Grows in Manhattan'."
4485,0,4,44,48,1.0833333333333333,0.040314953903908046,545,Bupkis.
4485,0,4,44,48,1.0833333333333333,0.040314953903908046,545,We specialize in repressing clients before congressional committees. Next time come dressed appropriately.
4485,1,2,45,48,1.0833333333333333,0.05011806391880343,545,My boss is so boring- he is literally a plant.
4485,0,4,44,48,1.0833333333333333,0.040314953903908046,545,Someone needs to water me.
4485,1,2,45,48,1.0833333333333333,0.05011806391880343,545,The Board members had underestimated the proxy power of Mr. Green.
4485,0,4,44,48,1.0833333333333333,0.040314953903908046,545,We are all just going to sit here at this board meeting until one of us fesses up to being the corporate spy.
4485,0,4,44,48,1.0833333333333333,0.040314953903908046,545,"We're waiting to hear your Christmas letter to Santa, Mr. Trump."
4485,0,4,44,48,1.0833333333333333,0.040314953903908046,545,Your futures have been planted
4485,1,2,45,48,1.0833333333333333,0.05011806391880343,545,This is what you get with legalized pot...
4485,1,2,45,48,1.0833333333333333,0.05011806391880343,545,I move we table the plantchair.
4485,0,4,44,48,1.0833333333333333,0.040314953903908046,545,I always dreamed of a day I could get good advice from my plant
4485,0,4,44,48,1.0833333333333333,0.040314953903908046,545,"How awkward, the potted plant leads the meeting."
4485,1,2,45,48,1.0833333333333333,0.05011806391880343,545,"I liked it better when it was just ""ashes to ashes."""
4485,1,2,45,48,1.0833333333333333,0.05011806391880343,545,"I know they told me the meeting was at the main plant, but I'm still not certain I'm in the right place."
4485,0,4,44,48,1.0833333333333333,0.040314953903908046,545,My investments are planted in this company.
4485,1,2,45,48,1.0833333333333333,0.05011806391880343,545,"All in favor of the executive stock option plan proposed by the Chairman of the Compensation Committee say, 'Aye'."
4485,0,4,44,48,1.0833333333333333,0.040314953903908046,545,Careful what you say . There's a recorder in there .
4485,0,4,44,48,1.0833333333333333,0.040314953903908046,545,"The ""bored"" awaiting their newly elected chairman's instructions."
4485,0,4,44,48,1.0833333333333333,0.040314953903908046,545,Corporate's new strategy of planting idea's.
4485,1,2,45,48,1.0833333333333333,0.05011806391880343,545,I think our trade for our CEO for a nice shrubbery was a good one. I feel better already.
4485,0,4,44,48,1.0833333333333333,0.040314953903908046,545,It is what it is. Our job is to read the tea leaves.
4485,0,4,44,48,1.0833333333333333,0.040314953903908046,545,"We came, we saw, we conquered."
4485,0,4,44,48,1.0833333333333333,0.040314953903908046,545,I guess we should 'move on'?
4485,1,2,45,48,1.0833333333333333,0.05011806391880343,545,There was one stupid thing now there is 11 stupid things
4485,0,4,44,48,1.0833333333333333,0.040314953903908046,545,I think Charlie was wrong. Bob was better at this than the plant is.
4485,0,4,44,48,1.0833333333333333,0.040314953903908046,545,I would like to begin the Foreign Botanical Investigation into the results of the of the latest presidential election.
4485,0,4,44,48,1.0833333333333333,0.040314953903908046,545,We're bringing back native species.
4485,1,2,45,48,1.0833333333333333,0.05011806391880343,545,"I feel like killing the boss sometimes, but this would be too easy!"
4485,1,2,45,48,1.0833333333333333,0.05011806391880343,545,He should fire his barber.
4485,0,4,44,48,1.0833333333333333,0.040314953903908046,545,"Well, there are two answers to your question. Yes, I think there is room for another fern-based comedy show and no, I won't ever work again with Zach Galifianakis."
4485,0,4,44,48,1.0833333333333333,0.040314953903908046,545,Today we have a special guest to share with us environmental problems. As you can see our company is very interested in our environment. #thinkgreen
4485,1,2,45,48,1.0833333333333333,0.05011806391880343,545,I'm more concerned about who invited lady Hitler.
4485,1,2,45,48,1.0833333333333333,0.05011806391880343,545,He hated his wife and kids and didn't own a dog.
4485,1,2,45,48,1.0833333333333333,0.05011806391880343,545,I'm so tired of this green glass ceiling rhetoric.
4485,1,2,45,48,1.0833333333333333,0.05011806391880343,545,Milt has been in that chair for almost 50 years now--I think he's earned the title of Senior Mint.
4485,1,2,45,48,1.0833333333333333,0.05011806391880343,545,So that's the new interim CEO? Doesn't seem very frondly.
4485,1,2,45,48,1.0833333333333333,0.05011806391880343,545,"I said he is being 'vetted', not 'wetted', for a cabinet position in the new administration!"
4485,1,2,45,48,1.0833333333333333,0.05011806391880343,545,"My first order of business as Vulcan Industries' new CEO will be to transition from the rubber industry into that of blood banks. Johnson, roll up you're sleeve. You're first."
4485,0,4,44,48,1.0833333333333333,0.040314953903908046,545,We have brought you your shrubbery. May we go now?
4485,0,4,44,48,1.0833333333333333,0.040314953903908046,545,The governor sent word that he's hiking the Appalachian trail.
4485,0,4,44,48,1.0833333333333333,0.040314953903908046,545,"So let's discuss how success can stem from planting the seeds  of the ""Branch-Out Plan"" our new CEO has just rolled out."
4485,1,2,45,48,1.0833333333333333,0.05011806391880343,545,Let's review the print outs on corporate sustainability.
4485,0,4,44,48,1.0833333333333333,0.040314953903908046,545,"With my ashes, we are metaphors for our products being green, organic, and gluten free."
4485,0,4,44,48,1.0833333333333333,0.040314953903908046,545,"Hey, I think old Raph is a little potted."
4485,1,2,45,48,1.0833333333333333,0.05011806391880343,545,"Due to the recent spike in the water bill...We wanted to tell you, you won't be making it to Christmas."
4485,0,4,44,48,1.0833333333333333,0.040314953903908046,545,I now call for nominations for this weeks watering responsibilities.
4485,0,4,44,48,1.0833333333333333,0.040314953903908046,545,President Trump sent his Director of the Dept. of Agriculture to chair this meeting.
4485,0,4,44,48,1.0833333333333333,0.040314953903908046,545,"Flaunting your Stanford diploma gets a little tiresome after a while, Mr. Thornton."
4485,0,4,44,48,1.0833333333333333,0.040314953903908046,545,"So, just so I'm clear on this, sir: We should all start thinking outside the *pot*?"
4485,0,4,44,48,1.0833333333333333,0.040314953903908046,545,Congratulations sir on your new born sapling.
4485,0,4,44,48,1.0833333333333333,0.040314953903908046,545,"Jones, what's that green stuff between your... Aunt Mabel???"
4485,0,4,44,48,1.0833333333333333,0.040314953903908046,545,There would seem to be a rumor you think I'm too young for the board.
4485,1,2,45,48,1.0833333333333333,0.05011806391880343,545,Will somebody tell him Halloween is over.
4485,0,4,44,48,1.0833333333333333,0.040314953903908046,545,It's right. We *do* need to go into the chopped liver business.
4485,1,2,45,48,1.0833333333333333,0.05011806391880343,545,"Go ahead sir plant, give us your ideas..."
4485,0,4,44,48,1.0833333333333333,0.040314953903908046,545,"Extreme Washington ""outsider"" predicted to be elected president in 2024."
4485,1,2,45,48,1.0833333333333333,0.05011806391880343,545,Waiting for Godot or Elijah--whoever shows up forst.
4485,0,4,44,48,1.0833333333333333,0.040314953903908046,545,Who's turn to prune?
4485,1,2,45,48,1.0833333333333333,0.05011806391880343,545,"It's the end of his era, that's for sure"
4485,0,4,44,48,1.0833333333333333,0.040314953903908046,545,I have a apple... I have a pen...
4485,1,2,45,48,1.0833333333333333,0.05011806391880343,545,So I'm just a potted plant ? No one leaves until the joker owns up.
4485,0,4,44,48,1.0833333333333333,0.040314953903908046,545,I hear you are interested in photo synthesis
4485,1,2,45,48,1.0833333333333333,0.05011806391880343,545,All I know is that the Chairman isn't Brendan Sullivan.
4485,0,4,44,48,1.0833333333333333,0.040314953903908046,545,"Our new boss can't think, speak, or do anything aside from photosynthesis and existence but it's good for the environment and as we all know, that's the more important than everything."
4485,0,4,44,48,1.0833333333333333,0.040314953903908046,545,Great news! Thanks to all of your efforts our new miracle growth product will be a smashing success!
4485,1,2,45,48,1.0833333333333333,0.05011806391880343,545,"Yes I agree... but to be even BETTER than our last CEO, the office plant needs a copy of the agenda... and definitely some water."
4485,1,2,45,48,1.0833333333333333,0.05011806391880343,545,You googled?
4485,0,4,44,48,1.0833333333333333,0.040314953903908046,545,may grow in office?
4485,0,4,44,48,1.0833333333333333,0.040314953903908046,545,"Actually, the CEO is just a potted plant."
4485,0,4,44,48,1.0833333333333333,0.040314953903908046,545,"As your new CEO,defoliants are now banned from the office."
4485,0,4,44,48,1.0833333333333333,0.040314953903908046,545,I stopped paying attention when they emphasized photosynergy in the work place.
4485,0,4,44,48,1.0833333333333333,0.040314953903908046,545,Am I the only one to be puzzled by our R&D department's notion of stustainable plant design ?
4485,0,4,44,48,1.0833333333333333,0.040314953903908046,545,"Oh, my! The takeover has created a really strange synergy."
4485,1,2,45,48,1.0833333333333333,0.05011806391880343,545,plant
4485,1,2,45,48,1.0833333333333333,0.05011806391880343,545,I want all of you on my executive staff to be a greenhouse of fertile ideas to insure ongoing profitable yields in all of our fields of business opportunities.
4485,1,2,45,48,1.0833333333333333,0.05011806391880343,545,It is a great honor to have been selected and I consider it as a mandate to do absolutely nothing.
4485,1,2,45,48,1.0833333333333333,0.05011806391880343,545,"As your new GMO-CEO, all I will need is water and fertilizer."
4485,0,4,44,48,1.0833333333333333,0.040314953903908046,545,And that's how were going to regrow our ptofits.
4485,0,4,44,48,1.0833333333333333,0.040314953903908046,545,wish you were here
4485,0,4,44,48,1.0833333333333333,0.040314953903908046,545,"Once photosynthesis turns the leaves green, may we leave?"
4485,1,2,45,48,1.0833333333333333,0.05011806391880343,545,What would Donald do?
4485,1,2,45,48,1.0833333333333333,0.05011806391880343,545,I've decided the only way we can grow as a company is to make a play for the Oak Trees.
4485,0,4,44,48,1.0833333333333333,0.040314953903908046,545,I knew JB would take root & grow if we gave him time.
4485,1,2,45,48,1.0833333333333333,0.05011806391880343,545,"This is what Donald left in charge, we're just going to have to live with it for four years."
4485,1,2,45,48,1.0833333333333333,0.05011806391880343,545,Why Fern Tisdale missed her first meeting as CEO.
4661,2,0,47,49,1.0816326530612246,0.057118556543356014,545,He just learned about protest votes from his daughter.
4661,1,2,46,49,1.0816326530612246,0.049114044483651885,545,I suppose you're all wondering why I called this meeting.
4661,0,4,45,49,1.0816326530612246,0.03952023822660631,545,"I just wish the CEO would quit micro-managing, and leaf us alone."
4661,1,2,46,49,1.0816326530612246,0.049114044483651885,545,"You thought you had it bad with the cactus? The poison ivy gave you ulcers? The Venus flytrap made you cry? Well, welcome to my nightmare."
4661,1,2,46,49,1.0816326530612246,0.049114044483651885,545,"We call it the plant. Just wait, it'll payoff."
4661,1,2,46,49,1.0816326530612246,0.049114044483651885,545,His rubber tree plant only uses bottled water.
4661,1,2,46,49,1.0816326530612246,0.049114044483651885,545,FROM ALL WE'LL GET FROM HIM HE MITES WELL BE A PLANT .
4661,0,4,45,49,1.0816326530612246,0.03952023822660631,545,Hillary won't be with us today. I think Donald has a plant in our boardroom.
4661,1,2,46,49,1.0816326530612246,0.049114044483651885,545,"Personally, I feel that Mr. Potter is much more inspiring than the other two candidates for President."
4661,1,2,46,49,1.0816326530612246,0.049114044483651885,545,"It's some self-care bullshit, I don't know. Just my take, but I'm pretty sure that acting like a crybaby-ass bitch isn't going to be all that effective when you're up against a fascist."
4661,0,4,45,49,1.0816326530612246,0.03952023822660631,545,CEO Withers sustainable growth presentation went off without a hitch.
4661,0,4,45,49,1.0816326530612246,0.03952023822660631,545,The silent majority believes it should not be legalized.
4661,0,4,45,49,1.0816326530612246,0.03952023822660631,545,"Like you, many of us were planted in foreign soil."
4661,0,4,45,49,1.0816326530612246,0.03952023822660631,545,"Oh yes siree, there are going to be some changes around here."
4661,0,4,45,49,1.0816326530612246,0.03952023822660631,545,Knights of the diverse table.
4661,1,2,46,49,1.0816326530612246,0.049114044483651885,545,"""Leonardo Di Caprio just sent it to make our meetings more aware of the real point""."
4661,1,2,46,49,1.0816326530612246,0.049114044483651885,545,I highly recommend my new stylist.
4678,0,4,46,50,1.08,0.03875617133214439,545,Leadership has really planted their foot down and laid out solid path for growth.
4679,1,2,48,51,1.0784313725490196,0.04722193952467567,545,Our stock is going through the roof.
4680,0,3,44,47,1.0638297872340425,0.03604210867489022,545,"Well, I'm not Brendan Sullivan"
4680,1,1,45,47,1.0638297872340425,0.0471603962868858,545,I will have a command for each of the 10 of you as soon as I soon burning.
4680,1,1,45,47,1.0638297872340425,0.0471603962868858,545,"Now that I've broken the glass ceiling, I suggest you quell any snide remarks."
4680,0,3,44,47,1.0638297872340425,0.03604210867489022,545,"...and so I used my bayonet to cut a way out of the jungle, and that's how I got here today."
4680,0,3,44,47,1.0638297872340425,0.03604210867489022,545,Jill couldn't make it. This is her second in command.
4680,0,3,44,47,1.0638297872340425,0.03604210867489022,545,You can plant your own idea!
4680,1,1,45,47,1.0638297872340425,0.0471603962868858,545,"We'd like to introduce our new Chief Sustainability Officer, Mr. Shrub."
4680,0,3,44,47,1.0638297872340425,0.03604210867489022,545,The recent turn of events were the last straw for brains. Chlorophyll can't do any worse. So...
4680,0,3,44,47,1.0638297872340425,0.03604210867489022,545,We are relegated to fertilizer.
4680,0,3,44,47,1.0638297872340425,0.03604210867489022,545,"I wish I'd brought my cat."""
4680,0,3,44,47,1.0638297872340425,0.03604210867489022,545,The board sent a plant in lieu of a new CEO?
4680,0,3,44,47,1.0638297872340425,0.03604210867489022,545,"I gather we're on for Orwell next month."" ""Keep the Aspidistra Flying?"" ""Better than 'Down and Out in Paris and London'."
4680,0,3,44,47,1.0638297872340425,0.03604210867489022,545,"It's a plant. Let's face it, he's a spie!"
4680,0,3,44,47,1.0638297872340425,0.03604210867489022,545,"Our latest product, a seed that grows to a full grown tree right before our eyes!"
4680,0,3,44,47,1.0638297872340425,0.03604210867489022,545,"Before we start, can someone give me a sheet of paper and a water to keep myself hydrated?"
4680,0,3,44,47,1.0638297872340425,0.03604210867489022,545,I guess Brendan Sullivan couldn't make it.
4680,0,3,44,47,1.0638297872340425,0.03604210867489022,545,At least I'm not potted this morning.
4680,0,3,44,47,1.0638297872340425,0.03604210867489022,545,"Come on guys, Just imagine I'm illegal. Wouldn't be ridiculous !"
4680,0,3,44,47,1.0638297872340425,0.03604210867489022,545,Thank you for recognizing that I am just a potted plant.
4680,0,3,44,47,1.0638297872340425,0.03604210867489022,545,"In a historic 8-2 vote, the board selected the Greenest chair in the company's history, all part of a brilliant plan to get the EPA off their back."
4680,0,3,44,47,1.0638297872340425,0.03604210867489022,545,Looks like he's had some serious prune-scaping done!
4680,0,3,44,47,1.0638297872340425,0.03604210867489022,545,"Greetings, Greetings...I will get directly to the point."
4680,0,3,44,47,1.0638297872340425,0.03604210867489022,545,This is the genius that wanted to outsource to Canaan.
4680,1,1,45,47,1.0638297872340425,0.0471603962868858,545,"How do we respond to Hurricane Katrina, President Bush?"
4680,0,3,44,47,1.0638297872340425,0.03604210867489022,545,"A man, a plant, a canal, pandemonium!"
4680,0,3,44,47,1.0638297872340425,0.03604210867489022,545,This company has officially lost the forest.
4680,0,3,44,47,1.0638297872340425,0.03604210867489022,545,This place will not suit your needs to branch out.
4680,0,3,44,47,1.0638297872340425,0.03604210867489022,545,I've got nothing to say.
4680,1,1,45,47,1.0638297872340425,0.0471603962868858,545,Looks like we are in for another Practice What You Preach talk today.
4680,0,3,44,47,1.0638297872340425,0.03604210867489022,545,And finally: Just call me Ben
4680,1,1,45,47,1.0638297872340425,0.0471603962868858,545,Plant an idea
4680,1,1,45,47,1.0638297872340425,0.0471603962868858,545,"OK, does anyone know a Greenspeace hex expert?"
4680,0,3,44,47,1.0638297872340425,0.03604210867489022,545,Milking this one is going to be tough.
4680,0,3,44,47,1.0638297872340425,0.03604210867489022,545,What have we here...? A harassment charge against local treehuggers.
4680,0,3,44,47,1.0638297872340425,0.03604210867489022,545,"Hi, my name is Maxijuana, I was grown in California with a viagra based fertilizer. I am the future of in home recreational activities."
4680,0,3,44,47,1.0638297872340425,0.03604210867489022,545,He made sure to send his condolences when he left us.
4680,0,3,44,47,1.0638297872340425,0.03604210867489022,545,"Sir, you've won 8 states."" ""Florida and Michigan are still undecided."" ""How are we doing in Virginia?"
4680,0,3,44,47,1.0638297872340425,0.03604210867489022,545,We are lucky to have the last earthly green plant as our leader.
4680,0,3,44,47,1.0638297872340425,0.03604210867489022,545,Apparently flower power got him to CEO.
4680,1,1,45,47,1.0638297872340425,0.0471603962868858,545,That's Bob. I can just make out his nose and tulips.
4680,0,3,44,47,1.0638297872340425,0.03604210867489022,545,Conference? More like conFERNence...
4680,0,3,44,47,1.0638297872340425,0.03604210867489022,545,It was the best candidate after he stepped down for the presidency.
4680,0,3,44,47,1.0638297872340425,0.03604210867489022,545,The old man told me that those beans would produce more for less.
4680,0,3,44,47,1.0638297872340425,0.03604210867489022,545,"At this moment, the Board understood the why the new CEO was called the “Clarence Thomas” of the corporate world."
4680,1,1,45,47,1.0638297872340425,0.0471603962868858,545,"Actually, I'm a little tired of his dry wit. Then you water him."
4680,0,3,44,47,1.0638297872340425,0.03604210867489022,545,Does anyone get her options?
4680,0,3,44,47,1.0638297872340425,0.03604210867489022,545,It's not PC to move plants elsewhere.
4680,0,3,44,47,1.0638297872340425,0.03604210867489022,545,We brought in a specialist on solar power plants.
4680,1,1,45,47,1.0638297872340425,0.0471603962868858,545,"Say something, I'm giving up on you.."
4680,0,3,44,47,1.0638297872340425,0.03604210867489022,545,They'd seen he could make some damn fine coffee and they wondered what else he could do for the company.
4680,0,3,44,47,1.0638297872340425,0.03604210867489022,545,Nobody dared mention that Harold had replaced himself with a potted plant.
4680,1,1,45,47,1.0638297872340425,0.0471603962868858,545,Would someone please close the windows. It's not stuffy in here.
4680,1,1,45,47,1.0638297872340425,0.0471603962868858,545,"Yes, sir, we all adhere to a strict paleo diet."
4680,0,3,44,47,1.0638297872340425,0.03604210867489022,545,I've got it! He want's us to tell the shareholders we have a new plant.
4680,0,3,44,47,1.0638297872340425,0.03604210867489022,545,"While vacationing, Chariman Plante reminds his board who's boss."
4680,0,3,44,47,1.0638297872340425,0.03604210867489022,545,"Great to see the glass ceiling broken, but not as part of a relocation from a greenhouse."
4680,0,3,44,47,1.0638297872340425,0.03604210867489022,545,Let's get to the root of the problem.
4680,0,3,44,47,1.0638297872340425,0.03604210867489022,545,"I see what the CEO meant, we probably do need to collectively expose the downstairs department from time to time. But wasn't our team more efficient when we had individual cubicles for asset stripping?"
4680,1,1,45,47,1.0638297872340425,0.0471603962868858,545,"No,Mr Trump, the White House can't be moved to Trump Tower without Congressional approval."
4680,0,3,44,47,1.0638297872340425,0.03604210867489022,545,Don't ignore him. He hates to be thought of as a potted plant.
4680,0,3,44,47,1.0638297872340425,0.03604210867489022,545,Mary Jane has always been our leader...
4680,0,3,44,47,1.0638297872340425,0.03604210867489022,545,Every leader has his assistants
4680,0,3,44,47,1.0638297872340425,0.03604210867489022,545,The Board elected him because he said he could take us to places we had never been before.
4680,0,3,44,47,1.0638297872340425,0.03604210867489022,545,"When they said ""The Zen of Duck, Duck, Goose"" I don't know what I was expecting."
4680,1,1,45,47,1.0638297872340425,0.0471603962868858,545,You can't even get us high.
4680,0,3,44,47,1.0638297872340425,0.03604210867489022,545,For once he took my breath away.
4680,0,3,44,47,1.0638297872340425,0.03604210867489022,545,"Tell me, what are people thinking?"
4680,0,3,44,47,1.0638297872340425,0.03604210867489022,545,This way nobody can tell that we have plugs.
4680,0,3,44,47,1.0638297872340425,0.03604210867489022,545,The competition infiltrated our organization with a plant.
4680,1,1,45,47,1.0638297872340425,0.0471603962868858,545,I miss the box of hair.
4680,0,3,44,47,1.0638297872340425,0.03604210867489022,545,I saw Marvin today
4680,0,3,44,47,1.0638297872340425,0.03604210867489022,545,She did say to me last week that plant intelligence is superior.
4680,0,3,44,47,1.0638297872340425,0.03604210867489022,545,And today-the details on solar power!
4680,0,3,44,47,1.0638297872340425,0.03604210867489022,545,"All in favor of MJ's Prop 420 ballot initiative, say 'Aye!'"
4680,0,3,44,47,1.0638297872340425,0.03604210867489022,545,Quick! Someone put her in the sun and l'll grab some water.
4680,1,1,45,47,1.0638297872340425,0.0471603962868858,545,...all wondered if they should welcome him or water him!
4680,0,3,44,47,1.0638297872340425,0.03604210867489022,545,I heard through the grapevine that he's a straight shooter.
4680,0,3,44,47,1.0638297872340425,0.03604210867489022,545,"They replaced the CEO with a plant? Goodness, what will they do when I retire?"
4680,1,1,45,47,1.0638297872340425,0.0471603962868858,545,"Personally, I worry about nepotism. I saw him spreading his seeds."
4680,0,3,44,47,1.0638297872340425,0.03604210867489022,545,I'm here as the lawyer.
4680,0,3,44,47,1.0638297872340425,0.03604210867489022,545,I fear that if we shower the boss with compliments he may wet his chair.
4680,0,3,44,47,1.0638297872340425,0.03604210867489022,545,"As of today, my bother Bubblegum Haze Kush is our new CFO."
4680,0,3,44,47,1.0638297872340425,0.03604210867489022,545,"Agreed then, you will be a watered-down presence on the Trump Supreme Court?"
4680,0,3,44,47,1.0638297872340425,0.03604210867489022,545,It's just to brighten up a dull room really.
4680,1,1,45,47,1.0638297872340425,0.0471603962868858,545,Trump's Transition Team rejects a BIG LOSER for Secretary of HUGE HUGE HOUSEPLANTS.
4680,1,1,45,47,1.0638297872340425,0.0471603962868858,545,The GMF planning committee will come to order. Let's hear first from the potted kale.
4680,0,3,44,47,1.0638297872340425,0.03604210867489022,545,The plant that eats flies on the wall.
4680,0,3,44,47,1.0638297872340425,0.03604210867489022,545,"Before we begin I must say that I am quite frond of all of you. Unfortunately, it is time to trim down this company."
4680,1,1,45,47,1.0638297872340425,0.0471603962868858,545,"Now, on to our next topic; Cheryll's decor."
4680,0,3,44,47,1.0638297872340425,0.03604210867489022,545,It's to draw all of those flies on the wall before we begin...
4680,0,3,44,47,1.0638297872340425,0.03604210867489022,545,"There is plant-y time to sit and stare, but brighten up and give me air!!"
4680,0,3,44,47,1.0638297872340425,0.03604210867489022,545,"I've been looking at our investments portfolio, and I think we should be moving from value to growth."
4680,1,1,45,47,1.0638297872340425,0.0471603962868858,545,IT is painfully obvious that the shrubby demographic is woefully under represented on this board.
4680,0,3,44,47,1.0638297872340425,0.03604210867489022,545,He was holding out for a better retirement package.
4680,0,3,44,47,1.0638297872340425,0.03604210867489022,545,I heard she made it all from solar.
4680,0,3,44,47,1.0638297872340425,0.03604210867489022,545,Just as he said. We've gone green.
4680,0,3,44,47,1.0638297872340425,0.03604210867489022,545,"Jeb was too low energy, so now I'm in charge"
4680,1,1,45,47,1.0638297872340425,0.0471603962868858,545,"Yes, I am the parent of all you Board members and don't try to table the discussion, as he is mine too."
4680,0,3,44,47,1.0638297872340425,0.03604210867489022,545,Head office was disappointed with that last project.
4680,1,1,45,47,1.0638297872340425,0.0471603962868858,545,"Of course you're not a potted plant, sir. You're a lawyer. That's your job."
4680,1,1,45,47,1.0638297872340425,0.0471603962868858,545,Welcome. I'm you new pothead.
4680,0,3,44,47,1.0638297872340425,0.03604210867489022,545,"The resume screamed innovation and creativity, but all I see is a drain on corporate resources."
4680,0,3,44,47,1.0638297872340425,0.03604210867489022,545,"No, it's pot at the head."
4680,0,3,44,47,1.0638297872340425,0.03604210867489022,545,"Now, about our ecosystem..."
4680,0,3,44,47,1.0638297872340425,0.03604210867489022,545,I'm Mr. Smith's replacement. My name is Mrs. Potter.
4680,0,3,44,47,1.0638297872340425,0.03604210867489022,545,"When the shareholder said the chairman lacks inertia, he really meant it."
4680,0,3,44,47,1.0638297872340425,0.03604210867489022,545,"Yes, we understand your affinity for the word, but the correct term is manufacturing ""facility"""
4680,0,3,44,47,1.0638297872340425,0.03604210867489022,545,"I suggest you all go home and take a long, hard look in the mirror, because I'm the first to admit I'm the last person who should be in charge. This country deserves a better president."
4680,0,3,44,47,1.0638297872340425,0.03604210867489022,545,"Green Party Chairwoman Plant, formally announces her Canidancy for President."
4680,0,3,44,47,1.0638297872340425,0.03604210867489022,545,I'm the embodiment of it all--money plant...
4680,0,3,44,47,1.0638297872340425,0.03604210867489022,545,"That's right, this potted plant is calling the shots now."
4680,0,3,44,47,1.0638297872340425,0.03604210867489022,545,Let me guess. No bonus for senior staff because it was another replanting year.
4680,1,1,45,47,1.0638297872340425,0.0471603962868858,545,Who do you think will be the first to leave/
4680,0,3,44,47,1.0638297872340425,0.03604210867489022,545,"On page four, you'll see my professional growth plan."
4680,1,1,45,47,1.0638297872340425,0.0471603962868858,545,"Yes, we are sky high."
4680,0,3,44,47,1.0638297872340425,0.03604210867489022,545,"Sir, we'll make sure no one uses the term ""Whacky Tobacky"" again."
4680,0,3,44,47,1.0638297872340425,0.03604210867489022,545,Will someone please order me a hose of water.
4680,0,3,44,47,1.0638297872340425,0.03604210867489022,545,"Regardless of my appearance, I assure you: I'm not here as a potted plant. I'm the lawyer."
4680,1,1,45,47,1.0638297872340425,0.0471603962868858,545,"Starting at the top, Noxiocorp take things in a more environmentally-friendly direction."
4680,0,3,44,47,1.0638297872340425,0.03604210867489022,545,"Considering the range of applicants, I think we're all agreed that I was your best choice for chairman of the board."
4680,0,3,44,47,1.0638297872340425,0.03604210867489022,545,"Sampson, you should leaf it alone, and we should move to the next talking point."
4680,0,3,44,47,1.0638297872340425,0.03604210867489022,545,Visualize the new California branch.
4680,1,1,45,47,1.0638297872340425,0.0471603962868858,545,"No Sir, the board is in full agreement with your position."
4803,0,3,45,48,1.0625,0.035308292679127,545,Welcome to the Green Party. Our first priority is value-based politics!
4803,0,3,45,48,1.0625,0.035308292679127,545,It's all about photo-synergy
4803,1,1,46,48,1.0625,0.04618658197582853,545,I have some good news. Fern bars are making a comeback.
4803,0,3,45,48,1.0625,0.035308292679127,545,"I didn't me to go this far when I said ""Go Green."""
4803,0,3,45,48,1.0625,0.035308292679127,545,Having won the popular vote by a landslide the new president felt had a mandate to legalize marijuana.
4803,1,1,46,48,1.0625,0.04618658197582853,545,You know something went wrong somewhere when you find yourself reporting to a plant.
4803,0,3,45,48,1.0625,0.035308292679127,545,What return will WE get on our investment - giggles
4803,0,3,45,48,1.0625,0.035308292679127,545,"That campaign was tiring, but you're not as bushed as I am."
4803,1,1,46,48,1.0625,0.04618658197582853,545,Who put potty-training on the agenda?
4803,0,3,45,48,1.0625,0.035308292679127,545,Has it asked you over for a smoke yet?
4803,1,1,46,48,1.0625,0.04618658197582853,545,We wanted to reach out to the LGBTQP community.
4803,0,3,45,48,1.0625,0.035308292679127,545,Look ..... see how some of his leaves have dropped off .... he knows he doesn't have enough votes to maintain control..... he's finished!
4803,0,3,45,48,1.0625,0.035308292679127,545,"Who said ""Chopped liver""?"
4803,0,3,45,48,1.0625,0.035308292679127,545,His growth projections for Q4 are low to zero.
4803,1,1,46,48,1.0625,0.04618658197582853,545,All hail the potted plant!
4803,0,3,45,48,1.0625,0.035308292679127,545,"""When we commissioned a drawing of Bush and his advisors, this is not exactly what we meant."" quoth David Remnick."
4803,0,3,45,48,1.0625,0.035308292679127,545,"Ugh, another classic in the 'Bored Room'...this meeting goes any longer, we're gonna start growing roots."
4820,1,0,44,45,1.0444444444444445,0.044444444444444446,545,"Oh, so this is not a poet tree class?"
4820,0,2,43,45,1.0444444444444445,0.031067790907534747,545,whats the next order of business?
4820,0,2,43,45,1.0444444444444445,0.031067790907534747,545,Mr. Speaker..?The election is over.
4820,0,2,43,45,1.0444444444444445,0.031067790907534747,545,Are you sure it's getting enough sunlight?
4820,0,2,43,45,1.0444444444444445,0.031067790907534747,545,The Chair is the tie-breaker
4820,0,2,43,45,1.0444444444444445,0.031067790907534747,545,"‘ The good earth’ is no longer an issue. Now, let’s get down to business."
4820,0,2,43,45,1.0444444444444445,0.031067790907534747,545,"""Wow boss, your hair's looking beautiful today""."
4820,0,2,43,45,1.0444444444444445,0.031067790907534747,545,Fern is our boss in title only
4820,0,2,43,45,1.0444444444444445,0.031067790907534747,545,"America has spoken, the real winner is blooming."
4820,0,2,43,45,1.0444444444444445,0.031067790907534747,545,"Well, they got the hair right."
4820,0,2,43,45,1.0444444444444445,0.031067790907534747,545,Let's be frank. One thing he didn't believe in was one moment of silence.
4820,0,2,43,45,1.0444444444444445,0.031067790907534747,545,Any objections?
4820,0,2,43,45,1.0444444444444445,0.031067790907534747,545,He's always worked outside the solarium.
4820,0,2,43,45,1.0444444444444445,0.031067790907534747,545,Let's review my last 3rd Quarter P & L.
4820,0,2,43,45,1.0444444444444445,0.031067790907534747,545,I came from farm to throw shade at the table.
4820,0,2,43,45,1.0444444444444445,0.031067790907534747,545,"A little on the quiet side, but REALLY presents a glossy look to the press, don't cha think?"
4820,0,2,43,45,1.0444444444444445,0.031067790907534747,545,It's the boss's prediction that a new plant will affect our profit landscape and may dig us into a hole or that we will experience growth in the next quarter. Welcome to Delphi.
4820,0,2,43,45,1.0444444444444445,0.031067790907534747,545,The corporate office isn't being very subtle with their plants.
4820,0,2,43,45,1.0444444444444445,0.031067790907534747,545,I don't want to hear your global warming scapegoating and climate change illusions: quartely rainfall quotas must improve or we risk losing demographic stakeholders like myself to global markets that care
4820,0,2,43,45,1.0444444444444445,0.031067790907534747,545,You will all be happy to learn that mt administrative faculties are unaffected.
4820,0,2,43,45,1.0444444444444445,0.031067790907534747,545,"Ah well, sometimes they get me right, and sometimes they give me a board seat."
4820,0,2,43,45,1.0444444444444445,0.031067790907534747,545,"Does any one remember, 'On the twelve day of Christmas' ?"
4820,0,2,43,45,1.0444444444444445,0.031067790907534747,545,Try not to jump to conclusions. Mr. Ficus was a very successful plant manager before joining us. But I understand Try not to pre-judge. I hear Mr. Ficus was a very successful plant manager before joining us.
4820,1,0,44,45,1.0444444444444445,0.044444444444444446,545,"Most people wouldn't get her joke, that's why the boss won."
4820,0,2,43,45,1.0444444444444445,0.031067790907534747,545,"Off the top of my head, I'd say you're just as overworked as I am."
4820,0,2,43,45,1.0444444444444445,0.031067790907534747,545,All in favor say 'chlorophyll.'
4820,0,2,43,45,1.0444444444444445,0.031067790907534747,545,I guess Paul is taking some personal leaf.
4820,0,2,43,45,1.0444444444444445,0.031067790907534747,545,He got Trumped
4820,0,2,43,45,1.0444444444444445,0.031067790907534747,545,Wwe should have paid attentio before the aura turned black.
4820,0,2,43,45,1.0444444444444445,0.031067790907534747,545,It's our copier paper rep. from the new growth forest.
4820,0,2,43,45,1.0444444444444445,0.031067790907534747,545,I feel it in my veins: our greatest year ever.
4820,0,2,43,45,1.0444444444444445,0.031067790907534747,545,"I heard he is going to put his kids in charge. Cynthia Stringer, Tiburon, California"
4820,0,2,43,45,1.0444444444444445,0.031067790907534747,545,"Lets discuss your strategy for 2020, Ms. Stein."
4820,0,2,43,45,1.0444444444444445,0.031067790907534747,545,At least its an upgrade from last week's dandilion.
4820,0,2,43,45,1.0444444444444445,0.031067790907534747,545,Can we have a moment of silence for the last breath on earth.
4820,0,2,43,45,1.0444444444444445,0.031067790907534747,545,It's a wiki plant from Ecuador's Embassy in London.
4820,0,2,43,45,1.0444444444444445,0.031067790907534747,545,I hear he's a tough litigator.
4820,0,2,43,45,1.0444444444444445,0.031067790907534747,545,Does everyone have the memo I sent on my predecessor?
4820,0,2,43,45,1.0444444444444445,0.031067790907534747,545,Topic 1: Mandatory watering plans during summer week shutdown.
4820,0,2,43,45,1.0444444444444445,0.031067790907534747,545,Lame duck session.
4820,0,2,43,45,1.0444444444444445,0.031067790907534747,545,When the lobby ficus tree provided better leadership.
4820,0,2,43,45,1.0444444444444445,0.031067790907534747,545,"It always seems like I have work on my mind, but I've mostly been thinking about the office fantasy football league"
4820,0,2,43,45,1.0444444444444445,0.031067790907534747,545,Was it a chance to seize power or merely a test of leadership?
4820,0,2,43,45,1.0444444444444445,0.031067790907534747,545,Before we get on to New Business . . . .
4820,0,2,43,45,1.0444444444444445,0.031067790907534747,545,Some have labeled me as extreme vegetarian.
4820,0,2,43,45,1.0444444444444445,0.031067790907534747,545,He looks a little wilted.
4820,0,2,43,45,1.0444444444444445,0.031067790907534747,545,Smart person: He knows Trump won. Less smart person: He was always a potted plant. Dumbest person: Will it flower?
4820,0,2,43,45,1.0444444444444445,0.031067790907534747,545,We need to shift our company to a more eco-friendly focus.
4820,0,2,43,45,1.0444444444444445,0.031067790907534747,545,"Congratulations! You have won ""Plant of the Month"""
4820,0,2,43,45,1.0444444444444445,0.031067790907534747,545,"But first, by way of introduction, let me tell you a little about myself..."
4820,0,2,43,45,1.0444444444444445,0.031067790907534747,545,The boss grew very close to it in his last few days.
4820,0,2,43,45,1.0444444444444445,0.031067790907534747,545,Not now.
4820,1,0,44,45,1.0444444444444445,0.044444444444444446,545,Cabinet meeting
4820,0,2,43,45,1.0444444444444445,0.031067790907534747,545,I hope this gift cheers her up!
4820,0,2,43,45,1.0444444444444445,0.031067790907534747,545,I know I am speaking out of turn.
4820,0,2,43,45,1.0444444444444445,0.031067790907534747,545,It looks like Chris Wallace is joining our board meeting today
4820,0,2,43,45,1.0444444444444445,0.031067790907534747,545,The staff meets the new CEO; it had finally come to this!
4820,0,2,43,45,1.0444444444444445,0.031067790907534747,545,"After Trump was elected, the PLANT coalition thought it prudent to send me as a representative."
4820,0,2,43,45,1.0444444444444445,0.031067790907534747,545,Green Thumb Company finally names their new CEO.
4820,0,2,43,45,1.0444444444444445,0.031067790907534747,545,Now you listen! When you talk behind my back I can hear you. I just don't care.
4820,0,2,43,45,1.0444444444444445,0.031067790907534747,545,Agenda item #1: Discuss the loss of share value over the past year.
4820,0,2,43,45,1.0444444444444445,0.031067790907534747,545,"Yes, these new large windows are related to my recent surgery."
4820,0,2,43,45,1.0444444444444445,0.031067790907534747,545,The Fall Forecast remains leafy.
4820,0,2,43,45,1.0444444444444445,0.031067790907534747,545,Today we will discuss the challenges and opportunities of fern competition.
4820,0,2,43,45,1.0444444444444445,0.031067790907534747,545,"and now, an hour of silence to meditate on our new green strategy"
4820,1,0,44,45,1.0444444444444445,0.044444444444444446,545,As the CEO of the anti nature segregation movement...
4820,0,2,43,45,1.0444444444444445,0.031067790907534747,545,"As the plant-life ambassador, what is your take on pollution?"
4820,1,0,44,45,1.0444444444444445,0.044444444444444446,545,"I have vegetarianonititus, but they told me if I stay out of the sun, I'll revert back in a couple of days."
4820,0,2,43,45,1.0444444444444445,0.031067790907534747,545,It's taking me to lunch at 1:00.
4820,0,2,43,45,1.0444444444444445,0.031067790907534747,545,Shall we draw straws?
4820,0,2,43,45,1.0444444444444445,0.031067790907534747,545,I'm pleased to report that Apollo Inc. has withdrawn their hostile takeover bid.
4820,0,2,43,45,1.0444444444444445,0.031067790907534747,545,"Hey! I'm not Oliver North, you know!"
4820,0,2,43,45,1.0444444444444445,0.031067790907534747,545,"So, we're agreed, our deal with J.K.Rowling will be as she specified, to the letter."
4820,0,2,43,45,1.0444444444444445,0.031067790907534747,545,Didn't it used to work for the competition?
4820,0,2,43,45,1.0444444444444445,0.031067790907534747,545,"We all agreed that, sir, it is immensely harder to read plant than man."
4820,0,2,43,45,1.0444444444444445,0.031067790907534747,545,I'm thinking of blowing the whistle on anti-vegan discrimination.
4820,0,2,43,45,1.0444444444444445,0.031067790907534747,545,"Hey, no worries if the dipstick can just ficus."
4820,0,2,43,45,1.0444444444444445,0.031067790907534747,545,He's a real bark orders and leave boss.
4820,0,2,43,45,1.0444444444444445,0.031067790907534747,545,"I'm suddenly reminded of the drum solo in ""Ina-Gadda-da-Vida."""
4820,0,2,43,45,1.0444444444444445,0.031067790907534747,545,"Sir, just get to your point and leaf it."
4820,0,2,43,45,1.0444444444444445,0.031067790907534747,545,"So let's discuss how success can stem from planting the seeds of the company-growth ""Branch-Out Plan"" our new CEO has just rolled out."
4820,0,2,43,45,1.0444444444444445,0.031067790907534747,545,I suppose you're wondering why I've gathered you all here today
4820,0,2,43,45,1.0444444444444445,0.031067790907534747,545,Should I tell him?
4820,0,2,43,45,1.0444444444444445,0.031067790907534747,545,One leaf too many? Or just enough?
4820,1,0,44,45,1.0444444444444445,0.044444444444444446,545,I believe my contract is up Jan. 20th.
4820,0,2,43,45,1.0444444444444445,0.031067790907534747,545,When did green equality start trumping gender equality for our board composition?
4820,0,2,43,45,1.0444444444444445,0.031067790907534747,545,"You need to get out more, if you think I'm past my peak."
4820,0,2,43,45,1.0444444444444445,0.031067790907534747,545,"After our last boss, ""Audrey 2,"" this is a relief."
4820,0,2,43,45,1.0444444444444445,0.031067790907534747,545,The Iran-Contra thing was 30 years ago sir. The joke is getting a bit old don't you think?
4820,0,2,43,45,1.0444444444444445,0.031067790907534747,545,It's an improvement. It's alive while the boss looked like one of the 'walking dead'.
4820,1,0,44,45,1.0444444444444445,0.044444444444444446,545,Well this Boston skyline sure beats out Denver's.
4820,0,2,43,45,1.0444444444444445,0.031067790907534747,545,"Greener pastures are important , but it takes a flower..."
4820,0,2,43,45,1.0444444444444445,0.031067790907534747,545,The results of the GMO testing are in-Me!
4820,0,2,43,45,1.0444444444444445,0.031067790907534747,545,"So, in conclusion, we will not be cutting revenue this quarter."
4820,0,2,43,45,1.0444444444444445,0.031067790907534747,545,We're his advisors so I guess we'll have to think biggly.
4820,1,0,44,45,1.0444444444444445,0.044444444444444446,545,"Well, we had to . We have some important decisions to make, and we can't take a chance on a tie vote."
4820,0,2,43,45,1.0444444444444445,0.031067790907534747,545,I'd like you to meet our new counsel.
4820,0,2,43,45,1.0444444444444445,0.031067790907534747,545,Horticulturally speaking... the boss reaches out.
4820,0,2,43,45,1.0444444444444445,0.031067790907534747,545,I don't think the shareholders are going to like this.
4820,0,2,43,45,1.0444444444444445,0.031067790907534747,545,"Though I'm a potted plant, I'm still your boss."
4820,0,2,43,45,1.0444444444444445,0.031067790907534747,545,"As you can see, I´m not Brendan Sullivan."
4820,0,2,43,45,1.0444444444444445,0.031067790907534747,545,"He must have heard that, as a boss, we thought he was just a vegetable."
4820,0,2,43,45,1.0444444444444445,0.031067790907534747,545,I call this meeting of the Sustainability Committee to order.
4820,0,2,43,45,1.0444444444444445,0.031067790907534747,545,We need your final decision.
4820,1,0,44,45,1.0444444444444445,0.044444444444444446,545,We are no longer a 'Happy Holidays' company.
4820,0,2,43,45,1.0444444444444445,0.031067790907534747,545,"""He's enlightened,"" they said.. ""He'll take a lichen to you,"" they said..."
4820,1,0,44,45,1.0444444444444445,0.044444444444444446,545,As your fern's corporate head...
4820,0,2,43,45,1.0444444444444445,0.031067790907534747,545,Will our return on investment correlate with how often we water it?
4820,0,2,43,45,1.0444444444444445,0.031067790907534747,545,"He doesn't do much, but he's very unlikely to be impeached."
4820,0,2,43,45,1.0444444444444445,0.031067790907534747,545,The Jacob's Ladder plant reaches the top.
4820,0,2,43,45,1.0444444444444445,0.031067790907534747,545,Text your kids. I think he's planing to keep us here a while.
4820,0,2,43,45,1.0444444444444445,0.031067790907534747,545,Not MY plant
4820,0,2,43,45,1.0444444444444445,0.031067790907534747,545,I assumed green tech would be a more techie.
4820,0,2,43,45,1.0444444444444445,0.031067790907534747,545,The informer from our competition? They are way too literal.
4820,1,0,44,45,1.0444444444444445,0.044444444444444446,545,'He's standing in for President Johnson.'
4820,0,2,43,45,1.0444444444444445,0.031067790907534747,545,"Well, nobody ever got fired from him ... did they?"
4820,0,2,43,45,1.0444444444444445,0.031067790907534747,545,"Ladies and Gentlemen, the days of just sitting behind your desks like human beings are officially over!"
4820,0,2,43,45,1.0444444444444445,0.031067790907534747,545,...shhh - they'll think you're racist.
4820,0,2,43,45,1.0444444444444445,0.031067790907534747,545,"Looks like Henry isn't feeling ""heard"" again."
4820,0,2,43,45,1.0444444444444445,0.031067790907534747,545,"No, I'm not the new VP in charge of diversity hiring."
4820,0,2,43,45,1.0444444444444445,0.031067790907534747,545,He's having a bad photosynthesis day!
4820,0,2,43,45,1.0444444444444445,0.031067790907534747,545,"We don't water it, but if it blooms, we buy."
4820,0,2,43,45,1.0444444444444445,0.031067790907534747,545,Way to go with the new wall
4820,0,2,43,45,1.0444444444444445,0.031067790907534747,545,That is Daphne.
4820,0,2,43,45,1.0444444444444445,0.031067790907534747,545,He's really full of manure this time!
4820,0,2,43,45,1.0444444444444445,0.031067790907534747,545,"With the end of campaigning, a moment of silence for the noble tree."
4820,0,2,43,45,1.0444444444444445,0.031067790907534747,545,Talking to plants is understandable but plants talking to people is weird.
4820,0,2,43,45,1.0444444444444445,0.031067790907534747,545,"don't want to, like, project or trigger any problematic identity shit, but we got at least two blacks, two – maybe three – chicks, and a poinsettia in here. boardroom's woke af, my dudes"
4820,1,0,44,45,1.0444444444444445,0.044444444444444446,545,Greenpeace summit
4820,0,2,43,45,1.0444444444444445,0.031067790907534747,545,"So, how many of you are ready for a call-up to the farm team?"
4820,1,0,44,45,1.0444444444444445,0.044444444444444446,545,"I know there are rumors that I am a plant, but I challenge anyone to impute my loyalty to the firm."
4820,0,2,43,45,1.0444444444444445,0.031067790907534747,545,Turns out Deez Nuts was my only real competition.
4820,0,2,43,45,1.0444444444444445,0.031067790907534747,545,We should have gone with a discreet whoopee cusion
4820,0,2,43,45,1.0444444444444445,0.031067790907534747,545,"As we enter into our new endeavor, feel free to now call me just Pot Plant"
4820,1,0,44,45,1.0444444444444445,0.044444444444444446,545,"Board to tears, the members were highly susceptible to the implantation of hypnotic suggestions..."
4820,0,2,43,45,1.0444444444444445,0.031067790907534747,545,The phrase “dumb as a potted plant” is seldom heard.
4820,0,2,43,45,1.0444444444444445,0.031067790907534747,545,"The tip of his radicle is bobbing, he's got a plan."
4820,1,0,44,45,1.0444444444444445,0.044444444444444446,545,They may be trying to record us inconspicuously.
4820,0,2,43,45,1.0444444444444445,0.031067790907534747,545,Consumer forecasts suggest that millennials will prefer Sativa with our new Grande Iced Skinny Salted Caramel Macchiato.
4820,0,2,43,45,1.0444444444444445,0.031067790907534747,545,This one is outspoken.
4820,0,2,43,45,1.0444444444444445,0.031067790907534747,545,"So, yes, the roundup-ready 400mg is still a work in progress."
4820,0,2,43,45,1.0444444444444445,0.031067790907534747,545,I believe you have seen the Ent Overlord demands.
4820,1,0,44,45,1.0444444444444445,0.044444444444444446,545,I read your group email to me. How could any of you think being called a 'potted plant' was anything but a compliment?
4820,0,2,43,45,1.0444444444444445,0.031067790907534747,545,"With all these new state laws, our future is in planted pot."
4820,0,2,43,45,1.0444444444444445,0.031067790907534747,545,"""The chairman sent that from the French Riviera to show us what a real potted plant looks like""."
4820,0,2,43,45,1.0444444444444445,0.031067790907534747,545,I thought you said macro dose.
4820,0,2,43,45,1.0444444444444445,0.031067790907534747,545,10 times the THC. When legal there is no high we can’t reach!
4820,0,2,43,45,1.0444444444444445,0.031067790907534747,545,The fern will run the meetings until the President ends his term.
4820,0,2,43,45,1.0444444444444445,0.031067790907534747,545,"And with that, we conclude the Trump Organization's most profitable year yet."
4820,0,2,43,45,1.0444444444444445,0.031067790907534747,545,Our psychic says we should delay alldeliberations until it combusts spontaneously.
4820,0,2,43,45,1.0444444444444445,0.031067790907534747,545,"Thank you all for coming. Today we'll be discussing a POTentially controversial issue: The Presidential Election. So I hope you're all firmly PLANTed in your seats, as this might be a bit of a bumpy ride."
4820,1,0,44,45,1.0444444444444445,0.044444444444444446,545,"Bosley, what do you mean our stocks for Vine have crashed??"
4820,1,0,44,45,1.0444444444444445,0.044444444444444446,545,David Blaine he's just not that good
4820,1,0,44,45,1.0444444444444445,0.044444444444444446,545,"Yes, I'm a potted plant, but what you need to think about is where I came from."
4820,0,2,43,45,1.0444444444444445,0.031067790907534747,545,"So, what? Did you expect me to turn into a cockroach?"
4820,0,2,43,45,1.0444444444444445,0.031067790907534747,545,We will emphasize in our ads that it's easy to grow pot in a pot.
4820,0,2,43,45,1.0444444444444445,0.031067790907534747,545,So my final recommendation is photosynthesis all around.
4820,0,2,43,45,1.0444444444444445,0.031067790907534747,545,Wrong! I did plant one on her! Bigly!
4820,0,2,43,45,1.0444444444444445,0.031067790907534747,545,A wave of nostalgia has just come over me...I'd never have believed it.!
4820,0,2,43,45,1.0444444444444445,0.031067790907534747,545,Does this mean we don't get lunch breaks?
4820,0,2,43,45,1.0444444444444445,0.031067790907534747,545,We should have consulted Trivago for our venue.
4820,0,2,43,45,1.0444444444444445,0.031067790907534747,545,Hello I am Bob Smith the CEO. This is obvious as you all already know me. I had a great meeting with the leader of the plant people of Venus and we are going to make some changes.
4820,0,2,43,45,1.0444444444444445,0.031067790907534747,545,Hey! Weren't you Oliver North's lawyer?
4820,1,0,44,45,1.0444444444444445,0.044444444444444446,545,"As you all have noticed, I, your devoted CEO, am now a marijuana plant. Everyone may partake in smoking a portion of me as we try to ride out this media hell storm."
4820,0,2,43,45,1.0444444444444445,0.031067790907534747,545,"So, the committee has concluded that this is what the next presidential candidate will look like ?"
4820,0,2,43,45,1.0444444444444445,0.031067790907534747,545,Let's give him a big hug.
4820,0,2,43,45,1.0444444444444445,0.031067790907534747,545,OOOOOOMMMMMM
4820,0,2,43,45,1.0444444444444445,0.031067790907534747,545,I thought he was a sleeper.
4820,1,0,44,45,1.0444444444444445,0.044444444444444446,545,"Next time, make sure he overhears that he has the personality of a dozen cronuts."
4820,0,2,43,45,1.0444444444444445,0.031067790907534747,545,"Well, we must think about our ecosystem so I can stay here longer."
4990,1,0,45,46,1.0434782608695652,0.0434782608695652,545,"Every four years it produces ""The bitter pill to swallow."""
4990,1,0,45,46,1.0434782608695652,0.0434782608695652,545,"A plant, is a plant is a PLANT !! Get it ?!?"
4990,1,0,45,46,1.0434782608695652,0.0434782608695652,545,Would somebody PLEASE get the gaw-damn plant off of Chairman Forkist's chair?
4990,0,2,44,46,1.0434782608695652,0.030400256468700027,545,"Trust me, you're in wood hands now..."
4990,0,2,44,46,1.0434782608695652,0.030400256468700027,545,"As you know, corporate plants are people, too."
4990,0,2,44,46,1.0434782608695652,0.030400256468700027,545,"We're waiting for his partner, Page."
4990,0,2,44,46,1.0434782608695652,0.030400256468700027,545,Congratulations to all of us. This is the penultimate diversity hire.
4990,0,2,44,46,1.0434782608695652,0.030400256468700027,545,"Let me get this straight, the reason you invited me here is you only realized just now that you needed to consider a better alternative?"
4990,0,2,44,46,1.0434782608695652,0.030400256468700027,545,I always want complete transparency.
4990,0,2,44,46,1.0434782608695652,0.030400256468700027,545,Whose turn is it to water his damn plant?
5000,0,2,45,47,1.0425531914893618,0.029760791752350448,545,I've called this meeting because it's time to weed the garden.
5001,0,1,43,44,1.0227272727272727,0.022990024493585143,545,Our watched pot needs help fast to keep the big chair. Fertilizer?
5001,0,1,43,44,1.0227272727272727,0.022990024493585143,545,We'll remain in Boston and starting in December I'll be out of the closet for good.
5001,0,1,43,44,1.0227272727272727,0.022990024493585143,545,OK so we didn't win and we have nothing to discuss Can we still order lunch or is it chip in?
5001,0,1,43,44,1.0227272727272727,0.022990024493585143,545,"Before we get started, if one of you can get along without your glass of water, could you please pour it into my pot? Tapwater is OK, I assure you."
5001,0,1,43,44,1.0227272727272727,0.022990024493585143,545,So the IS a plant on the board!
5001,0,1,43,44,1.0227272727272727,0.022990024493585143,545,The CEO has sent a stand-in for this meeting.
5001,0,1,43,44,1.0227272727272727,0.022990024493585143,545,"One repeat, dismissive, well known, histori*al legal referen*e, will be met with termination."
5001,0,1,43,44,1.0227272727272727,0.022990024493585143,545,He just got back from The Upside Down.
5001,0,1,43,44,1.0227272727272727,0.022990024493585143,545,This practice of offering potted plants extra credit for attending high-level talks may have gone too far.
5001,0,1,43,44,1.0227272727272727,0.022990024493585143,545,"While Jeb ""bush"" refused to participate in President-elect Trump's transition meeting, a low-level surrogate attended in his place."
5001,0,1,43,44,1.0227272727272727,0.022990024493585143,545,Nice of Mr. Trump to replace himself with a money plant.
5001,0,1,43,44,1.0227272727272727,0.022990024493585143,545,I think we need to plant a new foundation for this city.
5001,0,1,43,44,1.0227272727272727,0.022990024493585143,545,"It's important to me that you feel free to speak your minds, disagree with me, even vote against me; basically, forget that I'm a triffid."
5001,0,1,43,44,1.0227272727272727,0.022990024493585143,545,So this is what Trump meant when he told us that 'bush' would be taking his chair on the board for the four years while he was away in Washington.
5001,0,1,43,44,1.0227272727272727,0.022990024493585143,545,Let's talk about growth. OR Thank the tree.
5001,0,1,43,44,1.0227272727272727,0.022990024493585143,545,You'd need glasses eyes to win a blinking contest around here.
5001,0,1,43,44,1.0227272727272727,0.022990024493585143,545,My first priority as your new CEO is a corporate initiative on sustainability.
5001,0,1,43,44,1.0227272727272727,0.022990024493585143,545,"uuum There was an chem accident in R&D. Okay, how are we going to Bury This Problem?"
5001,0,1,43,44,1.0227272727272727,0.022990024493585143,545,Let's run through the salient points quickly so we can leave
5001,0,1,43,44,1.0227272727272727,0.022990024493585143,545,Why are we always talking about plantations? We're in the cities...
5001,0,1,43,44,1.0227272727272727,0.022990024493585143,545,We need to be more assertive or we'll lose this one!
5001,0,1,43,44,1.0227272727272727,0.022990024493585143,545,"Our interim CEO lacks Mr. Trump's charisma, but he's already improved employee relations by seventy-two percent."
5001,0,1,43,44,1.0227272727272727,0.022990024493585143,545,Pothead would say role another one just like the other one.
5001,0,1,43,44,1.0227272727272727,0.022990024493585143,545,"Well the Board of Directors voted for me, so what you don't like, you can lump."
5001,0,1,43,44,1.0227272727272727,0.022990024493585143,545,He's bound to grow up some day and lead our meetings.
5001,0,1,43,44,1.0227272727272727,0.022990024493585143,545,"For those of you who feel this company has gone to pot, natter,natter,natter."
5001,0,1,43,44,1.0227272727272727,0.022990024493585143,545,"""VIGORO For Your ED."" Flattering logo, but no."
5001,0,1,43,44,1.0227272727272727,0.022990024493585143,545,I'm getting a contact high just from looking at you.
5001,0,1,43,44,1.0227272727272727,0.022990024493585143,545,Which one of you is Judas?
5001,0,1,43,44,1.0227272727272727,0.022990024493585143,545,Just add water and we've got our Brendan Sullivan
5001,0,1,43,44,1.0227272727272727,0.022990024493585143,545,A plant is better than an irresponsible CEO. This is a great way to start the first meeting of the year!
5001,0,1,43,44,1.0227272727272727,0.022990024493585143,545,It's 2000 all over again.
5001,0,1,43,44,1.0227272727272727,0.022990024493585143,545,"1. It's called the fresh air initiative! 2. The meeting stopped when Fern soiled herself. 3. You're only here because of your father, the Rockefeller Christmas Tree."
5001,0,1,43,44,1.0227272727272727,0.022990024493585143,545,Stop staring so what I iron my lapels.
5001,0,1,43,44,1.0227272727272727,0.022990024493585143,545,"Psst are you sure this isn't the meeting for people for the ethical treatment of plants?"" ""Psst, are you sure this isn't the meeting for the 'people for the ethical treatment of plants?'"
5001,0,1,43,44,1.0227272727272727,0.022990024493585143,545,"We will now introduce Robert's Plant Rules of Order due to our ""Communication Breakdown."""
5001,0,1,43,44,1.0227272727272727,0.022990024493585143,545,"Hey, Pam, do you think it's offended? We tried whiteboards but it's just not the same. But, hey, good for you and Jim for skipping out on the to-go cups!"
5001,0,1,43,44,1.0227272727272727,0.022990024493585143,545,"'Yes, I am a potted palm--deal with it!"
5001,0,1,43,44,1.0227272727272727,0.022990024493585143,545,Who would leaf the company to this guy?
5001,0,1,43,44,1.0227272727272727,0.022990024493585143,545,He emersed himself in our new agile adaptation initistive.
5001,0,1,43,44,1.0227272727272727,0.022990024493585143,545,First agenda item: should I build a wall or grope?
5001,0,1,43,44,1.0227272727272727,0.022990024493585143,545,"The new boss is the cousin of our branch manager. It really is all about connections, huh?"" ""I don't know. I heard he grew his old division from the roots up."
5001,0,1,43,44,1.0227272727272727,0.022990024493585143,545,We are gathered here today to pay honor to how we have planted encouraging thoughts in the stockholders' minds.
5001,0,1,43,44,1.0227272727272727,0.022990024493585143,545,I voted against the initiative because I heard he is a real micromanager.
5001,0,1,43,44,1.0227272727272727,0.022990024493585143,545,"""I'll give you passive aggressive."" or He was always so passive aggressive."
5001,0,1,43,44,1.0227272727272727,0.022990024493585143,545,"Well, at least she won't be challenging the status quo!"
5001,0,1,43,44,1.0227272727272727,0.022990024493585143,545,"As you all know, it's difficult for me to covering a piece on darkness..."
5001,0,1,43,44,1.0227272727272727,0.022990024493585143,545,"Chair? You're aiming way too low. We all think you're just a bit of time, water, sunlight and one good sawyer away from BEING the board of this company."
5001,0,1,43,44,1.0227272727272727,0.022990024493585143,545,Is demand as high as our forecaster says it is?
5001,0,1,43,44,1.0227272727272727,0.022990024493585143,545,"Twenty years working for Amazon, and now I answer to his son."
5001,0,1,43,44,1.0227272727272727,0.022990024493585143,545,The CEO contributes more effectively through his ashes than back in his breathing days.
5001,0,1,43,44,1.0227272727272727,0.022990024493585143,545,Repatriated plant #1
5001,0,1,43,44,1.0227272727272727,0.022990024493585143,545,Our future is well planted.
5001,0,1,43,44,1.0227272727272727,0.022990024493585143,545,He had a last minute meeting at the White House.
5001,0,1,43,44,1.0227272727272727,0.022990024493585143,545,This firm must remove the ban on floral decorations immediately!
5001,0,1,43,44,1.0227272727272727,0.022990024493585143,545,"Yes, but after the elephant we have to talk about this divorce."
5001,0,1,43,44,1.0227272727272727,0.022990024493585143,545,"On that meeting, the CEO was being a little evasive."
5001,0,1,43,44,1.0227272727272727,0.022990024493585143,545, 
5001,0,1,43,44,1.0227272727272727,0.022990024493585143,545,Our CEO was exported.
5001,0,1,43,44,1.0227272727272727,0.022990024493585143,545,It hates Muslims.
5001,0,1,43,44,1.0227272727272727,0.022990024493585143,545,Pencils down please; this is strictly off the record.
5001,0,1,43,44,1.0227272727272727,0.022990024493585143,545,Hillary could have learned a lot from our director.
5001,0,1,43,44,1.0227272727272727,0.022990024493585143,545,"This new corporate think about putting down roots is becoming a bit overdone, don't you think?"
5001,0,1,43,44,1.0227272727272727,0.022990024493585143,545,The head guys just think they're in charge.
5001,0,1,43,44,1.0227272727272727,0.022990024493585143,545,Senior Partners' Meeting: Williams and Connolly
5001,0,1,43,44,1.0227272727272727,0.022990024493585143,545,"Luckily, we have the pot and the window. Who's turn is it?"
5001,0,1,43,44,1.0227272727272727,0.022990024493585143,545,I'm not quite in full bloom yet.
5001,0,1,43,44,1.0227272727272727,0.022990024493585143,545,Last night a wizard came to me in a dream and convinced me that times were changing and the company needs to change with it.
5001,0,1,43,44,1.0227272727272727,0.022990024493585143,545,We're going all-digital.
5001,0,1,43,44,1.0227272727272727,0.022990024493585143,545,"Thompson, your'e fired! Now, make like a tree and get outta here!"
5001,0,1,43,44,1.0227272727272727,0.022990024493585143,545,I'm glad he's not a conifer this week.
5001,0,1,43,44,1.0227272727272727,0.022990024493585143,545,The president's new comb-over projects stability.
5001,0,1,43,44,1.0227272727272727,0.022990024493585143,545,I'm here to inform you that our headquarters will be relocating to the Catskills!
5001,0,1,43,44,1.0227272727272727,0.022990024493585143,545,"I, Can A. Bis I, do change dress down Fridays to high expectation days"
5001,0,1,43,44,1.0227272727272727,0.022990024493585143,545,"If the Smithsonian wants his hair, it would help him look taller and more Presidential"
5001,0,1,43,44,1.0227272727272727,0.022990024493585143,545,"Yeah, I said I'd LEAF the company if my candidate did not win!"
5001,0,1,43,44,1.0227272727272727,0.022990024493585143,545,This committee really needs to branch out more by being more colorful and helping the environment.
5001,0,1,43,44,1.0227272727272727,0.022990024493585143,545,This his subtle way of telling us we need to speak up more.
5001,0,1,43,44,1.0227272727272727,0.022990024493585143,545,"Before I leave you to make all the foreign and domestic policy, I mean, isn't meeting in my luxurious penthouse much better than meeting down in that swamp? I mean look at this view!"
5001,0,1,43,44,1.0227272727272727,0.022990024493585143,545,"The new CEO’s a trip, huh"
5001,0,1,43,44,1.0227272727272727,0.022990024493585143,545,"Sorry, you've been voted off the team for the next four years."
5001,0,1,43,44,1.0227272727272727,0.022990024493585143,545,I think the cartoonist should choose the winner.
5001,0,1,43,44,1.0227272727272727,0.022990024493585143,545,Our new C.E.O. was just congratulated by Vladimir Putin.
5001,0,1,43,44,1.0227272727272727,0.022990024493585143,545,There is a rumor that a competitor had planted a mole as a member of the company's Board.
5001,0,1,43,44,1.0227272727272727,0.022990024493585143,545,"Mark my words, it's an alt-right ""plant."""
5001,0,1,43,44,1.0227272727272727,0.022990024493585143,545,"No, Rudolph, I told you. Chris is going to be dog walker and I want ganja growing in the Rose Garden."
5001,0,1,43,44,1.0227272727272727,0.022990024493585143,545,Corporate Plant Officer addresses its Board
5001,0,1,43,44,1.0227272727272727,0.022990024493585143,545,This meeting was called to decide how to inform President Trump company profits are through the roof.
5001,0,1,43,44,1.0227272727272727,0.022990024493585143,545,I guess he really was cross- pollinated.
5001,0,1,43,44,1.0227272727272727,0.022990024493585143,545,At 4:26 we'll be releasing our Prophets report ... maybe 4:27.
5001,0,1,43,44,1.0227272727272727,0.022990024493585143,545,"Is he saying ""Flower power"" or ""Let a hundred flowers bloom""?"
5001,0,1,43,44,1.0227272727272727,0.022990024493585143,545,"Ever since we got a new CEO, our company has really grown."
5001,0,1,43,44,1.0227272727272727,0.022990024493585143,545,I'm proud to announce that we have recruited Empty Suit to join our team.
5001,0,1,43,44,1.0227272727272727,0.022990024493585143,545,Company's first 'plant' meeting.
5001,0,1,43,44,1.0227272727272727,0.022990024493585143,545,No way! Where'd you find the left-handed edition?
5001,0,1,43,44,1.0227272727272727,0.022990024493585143,545,"I know this is strange for you, but I can shed a few leaves to make you more comfortable."
5001,0,1,43,44,1.0227272727272727,0.022990024493585143,545,You should take her aside and tell her. Her foliage is again showing.
5001,0,1,43,44,1.0227272727272727,0.022990024493585143,545,"I was tired of being called an ""empty suit."""
5001,0,1,43,44,1.0227272727272727,0.022990024493585143,545,Our boss be like after the leak of Panama Pepers.
5001,0,1,43,44,1.0227272727272727,0.022990024493585143,545,As the plant kingdom’s chief negotiator I ask: Do you breathe oxygen?
5001,0,1,43,44,1.0227272727272727,0.022990024493585143,545,It's unanimous. The diversity program cab be closed out. Great job eveyone.
5001,0,1,43,44,1.0227272727272727,0.022990024493585143,545,Our first order of business is a new plant watering service.
5001,0,1,43,44,1.0227272727272727,0.022990024493585143,545,I told you your new job would go to your head
5001,0,1,43,44,1.0227272727272727,0.022990024493585143,545,What's fir on the agenda?
5001,0,1,43,44,1.0227272727272727,0.022990024493585143,545,Our plants aren't winning anymore. We need to bring our plants back from China and Mexico.
5001,0,1,43,44,1.0227272727272727,0.022990024493585143,545,Mr Symthe will e represented today in his new green body
5001,0,1,43,44,1.0227272727272727,0.022990024493585143,545,"Wow, plants really do hate math."
5001,0,1,43,44,1.0227272727272727,0.022990024493585143,545,When do you think they'll miniaturize our implanted virtual offices?
5001,0,1,43,44,1.0227272727272727,0.022990024493585143,545,Plants and Zombies Co.
5001,0,1,43,44,1.0227272727272727,0.022990024493585143,545,Board meeting with Help after the election results
5001,0,1,43,44,1.0227272727272727,0.022990024493585143,545,Who's going to tell him?
5001,0,1,43,44,1.0227272727272727,0.022990024493585143,545,"He hasn't said a word, I am going to leaf."
5001,0,1,43,44,1.0227272727272727,0.022990024493585143,545,...and that's why we hired him.
5001,0,1,43,44,1.0227272727272727,0.022990024493585143,545,"Its great he is finally joining us, but I'm afraid his garden leave got the best of him."
5115,0,1,44,45,1.0222222222222221,0.022473328748774737,545,"Like this plant, business is slowly going from green to black"
5115,0,1,44,45,1.0222222222222221,0.022473328748774737,545,In appreciation to your recent vote of confidence I am announcing casual Mondays!
5115,0,1,44,45,1.0222222222222221,0.022473328748774737,545,"All right, Boss, do you have any ideas?"
5115,0,1,44,45,1.0222222222222221,0.022473328748774737,545,"Actually, our company's performance has never been better."
5115,0,1,44,45,1.0222222222222221,0.022473328748774737,545,Flower? Flower? Can you speak?
5120,0,1,45,46,1.0217391304347827,0.021979349113192898,545,"Show off! I know it's bring your plant to work day, but we could have had a conference call instead."
5121,0,0,42,42,1.0,0.024098134635593994,545,This is Potosterist!
5121,0,0,43,43,1.0,0.023531040266750583,545,"Green economy today, guys! Taken with a green trump... achh"
5121,0,0,43,43,1.0,0.023531040266750583,545,"Next year I want to see two of us at every client meeting, hearing or deposition. Our clients need us now more than ever."
5121,0,0,42,42,1.0,0.024098134635593994,545,Too bad about affirmington action.
5121,0,0,42,42,1.0,0.024098134635593994,545,"As your new ceo, you'll find things going a lot smoother now. ll"
5121,0,0,42,42,1.0,0.024098134635593994,545,And here I thought 'Think Different' was just a slogan.
5121,0,0,42,42,1.0,0.024098134635593994,545,"PR Statement from plants & trees: Mr. Gore will respect the President if he will respect climate change,trees, and environment."
5121,0,0,42,42,1.0,0.024098134635593994,545,"""Bah Dumbug!"" says the Wishing Tree..."
5121,0,0,42,42,1.0,0.024098134635593994,545,I think it's called an Palinoria Revengius - it's poisonous.
5121,0,0,43,43,1.0,0.023531040266750583,545,"Sh, i 's goin' t'note escape"
5121,0,0,42,42,1.0,0.024098134635593994,545,YOU TOO!
5121,0,0,42,42,1.0,0.024098134635593994,545,"Well, Bob, I don't know about you, but with this change at the helm, I say our company is going places now."
5121,0,0,42,42,1.0,0.024098134635593994,545,Our chairman is just a hoax.
5121,0,0,42,42,1.0,0.024098134635593994,545,Aaaaaaaaaaaaaaaaaaaaaaaaaaaaaaaaaaaaaaaaaaaaaaaaaaaargh!
5121,0,0,42,42,1.0,0.024098134635593994,545,"Sometimes I feel that I shouldn't even be on the road. If all the cars out there were like me, I'd feel a lot safer."
5121,0,0,42,42,1.0,0.024098134635593994,545,Now I want everyone to stand on their chair and rip the first page out of today's presentation.
5121,0,0,42,42,1.0,0.024098134635593994,545,Plant singularity takes root at ACME Corporation.
5121,0,0,42,42,1.0,0.024098134635593994,545,We check every week whether you use the project.
5121,0,0,43,43,1.0,0.023531040266750583,545,"Repeat after me, ""A tree by any other name...."""
5121,0,0,42,42,1.0,0.024098134635593994,545,"Can't believe we had to say ""you're fired"" so soon!"
5121,0,0,43,43,1.0,0.023531040266750583,545,"The planet ""Plutonia"", has heard that businessman are destroying their species (plants and trees), so they will treat them in a way which will open their feeling of beauty, peace and love, so their species can live."
5121,0,0,43,43,1.0,0.023531040266750583,545,You were expecting Brendan Sullivan?
5121,0,0,42,42,1.0,0.024098134635593994,545,... and now we must decide which candidate we endorse.
5121,0,0,42,42,1.0,0.024098134635593994,545,Smells like root beer again.
5121,0,0,42,42,1.0,0.024098134635593994,545,I am a potted plant! That is my job.
5121,0,0,43,43,1.0,0.023531040266750583,545,"As you can see, my transplant operation to top pot, was a success."
5121,0,0,43,43,1.0,0.023531040266750583,545,"We are all going to have to turn to him, lets hope he doesn't turn into a pot."
5121,0,0,42,42,1.0,0.024098134635593994,545,I'd to that Mr. North for recommending me your firm.
5121,0,0,42,42,1.0,0.024098134635593994,545,THE CREMATION BUSINESS IS REALLY ON THE CUTTING EDGE !
5121,0,0,42,42,1.0,0.024098134635593994,545,We are here to talk about climate change from a yong tree that hopes to grow to be hundreds of years old.
5121,0,0,42,42,1.0,0.024098134635593994,545,"Plantia, has the deciding vote."
5121,0,0,42,42,1.0,0.024098134635593994,545,"The Struggles inside Ned's Brain! Ned said to himself, hey aren't you the creative one, why are you on the wrong side of my brain? I wanna play with the mouse for a change."
5121,0,0,42,42,1.0,0.024098134635593994,545,Off the top of my head? Hang on. Lemme ask.
5121,0,0,42,42,1.0,0.024098134635593994,545,Don't pretend to include me in this mature conversation when you don't even know how to spell the word GREEN!
5121,0,0,42,42,1.0,0.024098134635593994,545,"Round and round it goes, when it stops a potted plant grows."
5121,0,0,43,43,1.0,0.023531040266750583,545,"In case any of you are wondering, I'm not Brendan Sullivan."
5121,0,0,42,42,1.0,0.024098134635593994,545,It's a spy from our competition.
5121,0,0,42,42,1.0,0.024098134635593994,545,We felt we needed to own a pesticide business ouresleves
5121,0,0,43,43,1.0,0.023531040266750583,545,As budding chairman of Triffid plant hire I guarantee growth in a blooming industry.
5121,0,0,42,42,1.0,0.024098134635593994,545,"I'm Mr. Ficus, here to introduce our newest product, the Thanksgiving tree. Now let's all give thanks for office plants."
5121,0,0,42,42,1.0,0.024098134635593994,545,"So with a hearty welcome for our new CEO Mr. Potter, as you can see the firm has now officially complied with going ""green""."
5121,0,0,42,42,1.0,0.024098134635593994,545,How 'bout now––NOW will you talk to me?
5121,0,0,43,43,1.0,0.023531040266750583,545,"Mark, I think it's time for you to leaf this organization."
5121,0,0,43,43,1.0,0.023531040266750583,545,"Are all of you going to sit there and stare, or is somebody gonna fuck me?"
5121,0,0,43,43,1.0,0.023531040266750583,545,"as you know, I'm here representing Col. North ..."
5121,0,0,42,42,1.0,0.024098134635593994,545,Our new CEO has grown organically from wishing the Company.
5121,0,0,42,42,1.0,0.024098134635593994,545,Respect plants like your boss.
5121,0,0,43,43,1.0,0.023531040266750583,545,That's our new mascot?
5121,0,0,42,42,1.0,0.024098134635593994,545,The planting seeds workshop.
5121,0,0,42,42,1.0,0.024098134635593994,545,"After this conference, I'm never wearing this hat again."
5121,0,0,44,44,1.0,0.022990024493585143,545,These thinking caps were a terrible idea.
5121,0,0,42,42,1.0,0.024098134635593994,545,Wait until it found out that Peyton is a vegan
5121,0,0,42,42,1.0,0.024098134635593994,545,You may address me now as Sir PotInaPot
5121,0,0,43,43,1.0,0.023531040266750583,545,I imagine the boss ate some Gryphon seeds just before the cremation.
5121,0,0,42,42,1.0,0.024098134635593994,545,we need a (miracle) now ???lets all pray for a (jet)? to ????
5121,0,0,42,42,1.0,0.024098134635593994,545,I'm at the peak of my ability Hire me. Ib can make you LOVE this company.
5121,0,0,42,42,1.0,0.024098134635593994,545,I hear his cousin Vinny the Broccoli is in the bomb-sniffing business.
5121,0,0,42,42,1.0,0.024098134635593994,545,"So we all have no work to do; we all are gonna wait around for our boss, the new president..."
5121,0,0,42,42,1.0,0.024098134635593994,545,"corporate has taken the a.d.a. a tad too far this time, agree?"
5121,0,0,42,42,1.0,0.024098134635593994,545,Of course I knew you were only joking. I love a good joke. Hahahahaha!
5121,0,0,43,43,1.0,0.023531040266750583,545,"Fellow chairs, I suggest that for future meetings, you consider following my example. I've converted to plant-based accessories and released Mr. Edwards, my former lap-man. He's now a driving range human."
5121,0,0,42,42,1.0,0.024098134635593994,545,"Just give it a sip of water, then we will have the answer."
5121,0,0,42,42,1.0,0.024098134635593994,545,Sorry I'm late. The Brooklyn Ferry was delayed.
5121,0,0,42,42,1.0,0.024098134635593994,545,What? Has Jesus Christ not been born yet?
5121,0,0,42,42,1.0,0.024098134635593994,545,"Okay, so maybe he was a little better."
5121,0,0,42,42,1.0,0.024098134635593994,545,This wasn’t what I meant by bringing a little tree.
5121,0,0,43,43,1.0,0.023531040266750583,545,I know all of you have been trying to kill off my mother and take over the business. Well I'm here to warn you that if she dies we're all finished.
5121,0,0,42,42,1.0,0.024098134635593994,545,"I think it's okay to have Obama as secretary of health insurance in our new administration, but is it necessary to have a member of the green party here too?"
