rank,funny,somewhat_funny,unfunny,count,score,precision,contest,caption
1,151,195,205,551,1.9019963702359346,0.03401853217353026,549,I admire your restraint.
2,121,156,184,461,1.8633405639913232,0.03738545999110929,549,"Above all, we value restraint."
3,81,117,154,352,1.7926136363636365,0.042184121333865905,549,I admire your restraint.
4,76,99,150,325,1.7723076923076924,0.044567220293604395,549,OK. NOW we can discuss the election.
5,77,93,151,321,1.7694704049844237,0.0453161284634721,549,"On casual Fridays, it's just handcuffs."
6,76,89,150,315,1.765079365079365,0.04592546622784135,549,I see from your resume that you and I went to some of the same institutions.
7,62,87,138,287,1.735191637630662,0.04681240058641174,549,I really admire your restraint
8,54,82,130,266,1.7142857142857142,0.04798178389595275,549,Your contract includes an escape clause.
9,52,85,128,265,1.7132075471698114,0.04755361296611149,549,"Yes, actually you DO have to be crazy to work here."
10,54,80,130,264,1.7121212121212122,0.04832146396864197,549,Impressive resume. And you seem committed.
11,56,63,132,251,1.697211155378486,0.05127661843907079,549,We expect all our employees to be committed.
12,48,67,124,239,1.6820083682008369,0.050979753522462826,549,I have some good news: We're letting you go.
13,48,65,124,237,1.6793248945147679,0.05137539943126955,549,Production is low of course but employee theft is down to zero.
14,38,84,114,236,1.6779661016949152,0.047952190949106514,549,I've still got my eye on that padded corner office.
15,43,73,119,235,1.676595744680851,0.04999022937736327,549,We're really looking for someone who's committed.
16,44,70,120,234,1.6752136752136753,0.05054928093401844,549,"Well, you did agree to binding arbitration."
17,41,75,117,233,1.6738197424892705,0.04964173489185853,549,Tell me about a difficult situation you've been in and what you did to get out of it.
18,41,73,117,231,1.670995670995671,0.05003211296927185,549,"So, no words per minute then?"
19,49,54,125,228,1.6666666666666667,0.05359526836673904,549,That's five minutes without social media. Let's try for five more.
19,44,64,120,228,1.6666666666666667,0.05176136085910463,549,Well this is embarrassing. We wore the same outfit today.
19,38,76,114,228,1.6666666666666667,0.04947101476629373,549,The best part is that they never ask us to get coffee.
22,46,59,122,227,1.6651982378854626,0.05271378242523162,549,You're probably wondering how I called this meeting.
23,41,52,110,203,1.6600985221674878,0.055771339648910415,549,I'd have to be crazy to hire you. You can start on Monday
24,51,42,127,220,1.6545454545454545,0.05612087680456988,549,"I'd help you, but my hands are tied."
25,37,65,112,214,1.6495327102803738,0.05188622263149554,549,"Productivity may be down, but so are sexual harassment claims."
26,38,63,114,215,1.6465116279069767,0.052151052846473374,549,I can see you're committed.
27,34,68,110,212,1.6415094339622642,0.051089077355414673,549,I prefered the nicotine patches.
27,34,68,110,212,1.6415094339622642,0.051089077355414673,549,Can you describe a tough situation you dealt with in the past and how you managed to get out of it?
29,36,61,111,208,1.6394230769230769,0.052783170159188555,549,"I could have sworn he said we needed to be ""retrained."""
30,32,67,107,206,1.6359223300970873,0.051428602264549136,549,"Yes, you do have to be crazy to work here."
31,33,64,108,205,1.6341463414634145,0.05211017638864566,549,There's been too much finger pointing around here.
31,33,64,108,205,1.6341463414634145,0.05211017638864566,549,Can you type?
33,36,57,111,204,1.6323529411764706,0.05370159639463839,549,Tell me about a challenge you have faced and how you overcame it.
34,36,55,111,202,1.6287128712871286,0.05417259318497659,549,"As you can see, our escape clause is a little trickier than most."
34,34,59,109,202,1.6287128712871286,0.053255539974419216,549,The first time through binding arbitration is always difficult.
36,33,59,108,200,1.625,0.0532546268072729,549,On Casual Fridays we loosen our straps.
36,32,61,107,200,1.625,0.05278071636592765,549,There's limited mobility in this company.
36,28,69,103,200,1.625,0.050840918510338444,549,I appreciate your restraint.
39,32,59,107,198,1.621212121212121,0.05324686044001738,549,Are you as committed as I am?
40,30,62,105,197,1.619289340101523,0.05250551872145251,549,"No, we don't do much outreach."
40,35,52,110,197,1.619289340101523,0.05491644871691133,549,What's your exit strategy?
40,28,66,103,197,1.619289340101523,0.05150955987796304,549,How is your typing?
40,32,58,107,197,1.619289340101523,0.05348293404064647,549,When I look at you I see myself when I first started here.
44,31,59,106,196,1.6173469387755102,0.05323177316912848,549,I can see you're committed.
44,33,55,108,196,1.6173469387755102,0.054205893796190986,549,Are you willing to be committed for the next four years?
46,30,60,105,195,1.6153846153846154,0.052972405684900026,549,We don't really require hands-on experience.
47,33,53,108,194,1.6134020618556701,0.05469397471498847,549,"OK. After our Thorazine shots, you can be boss."
48,37,42,112,191,1.6073298429319371,0.05739589476379811,549,Welcome to the new EPA.
49,31,53,106,190,1.605263157894737,0.05468696182809842,549,So I see you're committed.
49,28,59,103,190,1.605263157894737,0.05313736365663242,549,"Casual Fridays I understood. Houdini Tuesdays, not so much."
51,27,60,102,189,1.6031746031746033,0.052848100620775995,549,I can't believe we wore the same outfit to work again!
52,32,49,107,188,1.601063829787234,0.05570220832149362,549,On which medication do you see yoursef in five years?
52,32,49,107,188,1.601063829787234,0.05570220832149362,549,How embarrassing. We've worn the same jacket.
54,27,58,102,187,1.5989304812834224,0.053329106688146694,549,It's just until they find who's been stealing office supplies.
54,32,48,107,187,1.5989304812834224,0.05595979495578751,549,Down the hall and to the left. Good luck.
56,30,50,104,184,1.5978260869565217,0.05563920725337692,549,I never realized that this is how binding arbitration works
56,30,50,104,184,1.5978260869565217,0.05563920725337692,549,"You may find the office dress code somewhat restraining, but I've embraced it."
58,32,45,106,183,1.5956284153005464,0.05696451479511438,549,Actually you do have to be crazy to work here.
58,26,57,100,183,1.5956284153005464,0.053709035586018014,549,I thought they meant fiscal restraint too.
58,29,51,103,183,1.5956284153005464,0.055360710117478416,549,Turns out the asylum pretty much runs itself.
61,34,40,108,182,1.5934065934065933,0.05828590146022155,549,"In retrospect, I think we should have opted for the patch."
61,27,54,101,182,1.5934065934065933,0.054518409127239195,549,I'm very impressed how prepared you are for this interview.
63,30,47,104,181,1.591160220994475,0.056429972670923964,549,You know my door is always open. It'd be a real problem otherwise.
63,20,67,94,181,1.591160220994475,0.05069978573515758,549,"Unfortunately, there is no escape clause in your contract."
65,29,48,103,180,1.5888888888888888,0.05614829664331704,549,Blink twice if you'd like the job.
65,27,52,101,180,1.5888888888888888,0.05503167018258078,549,I can't believe we wore the same outfit today.
65,34,38,108,180,1.5888888888888888,0.05884723823680997,549,Can you tell me a little bit about yourselves?
65,31,44,105,180,1.5888888888888888,0.05724314551810989,549,"Look, you knew when you signed the contract that disputes were subject to binding arbitration."
65,26,54,100,180,1.5888888888888888,0.05446477280457124,549,I'll just make a mental note of your complaint.
70,33,39,107,179,1.5865921787709498,0.05859865772778123,549,The job is yours if you're willing to dislocate.
71,25,54,99,178,1.5842696629213484,0.054399521242265214,549,"I hit ""reply all"" once too many times. How about you?"
71,28,48,102,178,1.5842696629213484,0.05612261422630009,549,You seem totally committed. We like that.
71,32,40,106,178,1.5842696629213484,0.058340960875437685,549,"I recognize your concerns, but productivity is up 200 percent since we began physically enforcing our cell phone ban."
71,25,54,99,178,1.5842696629213484,0.054399521242265214,549,"And coffee breaks are a no-no, but at lunchtime they do let us go bobbing for apples."
71,29,46,103,178,1.5842696629213484,0.05668534025356921,549,"You don't have to be crazy to work here, but it helps."
76,24,55,98,177,1.5819209039548023,0.05406621604008505,549,We've apparently been hit with a restraining order.
76,26,51,100,177,1.5819209039548023,0.05524091226318318,549,"Frankly, you'd have to be crazy to take this job."
76,27,49,101,177,1.5819209039548023,0.055818990702595814,549,You don't have to be crazy to work here. We'll train you.
79,28,46,102,176,1.5795454545454546,0.056662123344963504,549,So they're letting us run the asylum. Now what?
79,27,48,101,176,1.5795454545454546,0.05608619399660484,549,"And of course, we loosen the straps on Casual Fridays."
81,23,55,97,175,1.5771428571428572,0.05397456416955106,549,Just what did you think ‘legal and binding’ meant?
81,22,57,96,175,1.5771428571428572,0.05336264735094386,549,Restraint is what we value most in our corporate culture.
81,27,47,101,175,1.5771428571428572,0.05635582806826766,549,"I'll have to talk to the rest of the voices in this room, but I think you're perfect for this job."
84,27,46,101,174,1.5747126436781609,0.056627923036286824,549,"If you can scratch my nose, the job is yours."
85,30,41,105,176,1.5738636363636365,0.057839840650453854,549,I can't believe we wore the same thing today.
86,26,47,100,173,1.5722543352601157,0.05630881141124959,549,I think you'll find the mental health benefits here are very comprehensive.
87,22,54,96,172,1.569767441860465,0.054124961409957144,549,Try hitting escape.
87,23,52,97,172,1.569767441860465,0.0547495287982801,549,I'm impressed. You clearly did your homework before the interview.
87,31,36,105,172,1.569767441860465,0.05951055832092753,549,"There, now we can talk about the election."
87,28,42,102,172,1.569767441860465,0.0577711708696947,549,How did you put on your glasses?
87,25,48,99,172,1.569767441860465,0.05597776179557741,549,"Well, I'd be insane not to hire you."
92,21,52,94,167,1.562874251497006,0.05474716444693927,549,First of all. I love your outfit.
92,29,36,102,167,1.562874251497006,0.05978637763004191,549,You would also get your own padded corner office.
92,20,54,93,167,1.562874251497006,0.05408425970730755,549,We loosen up a bit on Fridays
92,26,42,99,167,1.562874251497006,0.05794804871127081,549,You would fit right in around here assuming you aren't already committed.
92,27,40,100,167,1.562874251497006,0.058567236714194865,549,Other than these we have the same chance of succeeding here as men do.
97,25,45,99,169,1.5621301775147929,0.05679945030374417,549,Tell me about your personalities.
98,27,39,100,166,1.5602409638554218,0.05886153403066139,549,I know! And I get a seat on the subway every time!
99,26,40,99,165,1.5575757575757576,0.05853061254961793,549,"And with OUR Weight Loss Program, you can eat anything you can get your hands on!"
99,23,46,96,165,1.5575757575757576,0.05660479763598947,549,How is your typing?
101,24,43,97,164,1.5548780487804879,0.057540134117870664,549,"Like they say: You don't have to be crazy to work here, but it helps."
101,19,53,92,164,1.5548780487804879,0.054192098491074904,549,The job comes with certain limitations.
101,18,55,91,164,1.5548780487804879,0.053497353577341804,549,We don't do touchy-feely here.
104,22,46,95,163,1.5521472392638036,0.05650408680422774,549,This IS our healthcare plan.
104,25,40,98,163,1.5521472392638036,0.05848019247314851,549,Now all I need is a signature.
106,22,45,95,162,1.5493827160493827,0.05678587249003579,549,I like what you've done with your buckles.
106,21,47,94,162,1.5493827160493827,0.056106631322447774,549,In five years I can see myself in the corner padded office...
108,23,42,96,161,1.546583850931677,0.05774644093722686,549,Second time this week we've worn the same outfit.
109,25,37,98,160,1.54375,0.0593775860079019,549,"Sorry, there's no wiggle room with the dress code."
109,28,31,101,160,1.54375,0.061331450143703274,549,We searching for candidates who are truly committed.
109,18,51,91,160,1.54375,0.05454707375026622,549,We're a pretty restrained group here-I think you'll fit in.
109,22,43,95,160,1.54375,0.05735720236833395,549,Nail biter. You?
113,22,42,95,159,1.5408805031446542,0.05764680457133107,549,Look at it this way! The theft of office supplies is down to zero!
114,18,48,90,156,1.5384615384615385,0.055607492000942234,549,"Call me crazy, but I think you'll fit in just fine around here."
114,22,40,94,156,1.5384615384615385,0.0585067954206178,549,Wouldn't you prefer non-binding arbitration?
114,23,38,95,156,1.5384615384615385,0.05920944262808776,549,This job doesn't offer much mobility.
117,24,37,97,158,1.5379746835443038,0.059314308633657636,549,It's only for the next four years.
118,24,35,96,155,1.5354838709677419,0.06021704866326627,549,We're letting you go.
118,17,49,89,155,1.5354838709677419,0.05513241048407515,549,I guess I can't point fingers.
118,22,39,94,155,1.5354838709677419,0.05880917095650499,549,You'll like it here. We pretty much run the place.
118,15,53,87,155,1.5354838709677419,0.05359112169624565,549,Are you able to work within constraints?
118,19,45,91,155,1.5354838709677419,0.056631767117999304,549,You'll be getting the corner office with no windows and padded walls.
118,25,33,97,155,1.5354838709677419,0.060908785329175236,549,""" You'd think the glass ceiling would be adequate"
118,18,47,90,155,1.5354838709677419,0.05588711717691237,549,"The walls may be padded, but there's no glass ceiling."
125,21,42,94,157,1.535031847133758,0.05752862683455706,549,"Unfortunately, your hands-on experience won't be very useful in this position."
126,18,46,90,154,1.5324675324675325,0.05616921755432176,549,At least the finger pointing has finally stopped.
126,22,38,94,154,1.5324675324675325,0.059114387013308234,549,"Usually we start new employees with card tricks, but I see you're ready for something more advanced."
128,15,51,87,153,1.5294117647058822,0.05412056347864721,549,I guess they don't want us adjusting the thermostat.
128,27,27,99,153,1.5294117647058822,0.06293669148686107,549,Consider yourself lucky if only your nose itches.
128,17,47,89,153,1.5294117647058822,0.05568692858523704,549,"Yes, all of the cubicles are padded too."
131,18,44,90,152,1.5263157894736843,0.05674093471298194,549,Is this your idea of binding arbitration?
131,22,36,94,152,1.5263157894736843,0.05973346779708661,549,Wanna go for a drink and unwind?
131,20,40,92,152,1.5263157894736843,0.058256419591185236,549,Verbal skills are a major plus.
131,17,46,89,152,1.5263157894736843,0.05596780589197867,549,It's awkward that we're wearing the same jacket.
131,18,44,90,152,1.5263157894736843,0.05674093471298194,549,"Voice recognition software, mostly."
131,25,30,97,152,1.5263157894736843,0.061882972636159064,549,Corporate really admires someone who's committed.
131,23,34,95,152,1.5263157894736843,0.06045846136651395,549,Actually you do have to be crazy to work here.
131,21,38,93,152,1.5263157894736843,0.058999566094378245,549,The job involves a lot of delegating.
139,25,29,97,151,1.5231788079470199,0.06221406972042711,549,"So, tell us a little bit about yourselves."
140,16,46,88,150,1.52,0.055739888078848034,549,Are you free tomorrow?
140,15,48,87,150,1.52,0.054931317701558284,549,"I did get your email, but I haven't been able to respond."
140,23,32,95,150,1.52,0.061101009266077866,549,"Well, I'm looking at the contract and it seems there's no escape clause."
140,18,42,90,150,1.52,0.05732282303121904,549,I can't believe we both wore the same thing to work today.
144,22,33,94,149,1.516778523489933,0.060684189944930536,549,"If I hear ""You don't have to be crazy to work here, but it helps"" just one more time...."
144,26,25,98,149,1.516778523489933,0.0636030643565326,549,Your resume says you're insane. I like that.
144,24,29,96,149,1.516778523489933,0.06216076216076198,549,Okay. Now I think we're ready to discuss the election.
144,17,43,89,149,1.516778523489933,0.056825146734842534,549,'But the good news is that we have casual Fridays.'
148,17,41,88,146,1.5136986301369864,0.05769653428073338,549,"I think we all agree this is uncomfortable, but theft of office supplies is down 97%."
148,19,37,90,146,1.5136986301369864,0.05931135380841483,549,"Around here, there is none of that you scratch my back and I'll scratch yours."
148,19,37,90,146,1.5136986301369864,0.05931135380841483,549,"Well, this is awkward."
151,18,40,90,148,1.5135135135135136,0.05791505791505791,549,Tell me a little about yourselves.
152,17,40,88,145,1.5103448275862068,0.05799758993812811,549,"There's no glass ceiling here, Janice. In fact, no glass of any kind."
152,22,30,93,145,1.5103448275862068,0.06198909292525898,549,"No, I'm still allowed to practice in Texas."
152,21,32,92,145,1.5103448275862068,0.06121161818710045,549,Which institution do you see yourself in five years from now?
155,17,39,88,144,1.5069444444444444,0.05830129637887845,549,"No, that doesn't sound crazy at all."
155,16,41,87,144,1.5069444444444444,0.05746230122726315,549,"If all goes well, I'll be getting a padded office."
155,18,37,89,144,1.5069444444444444,0.05912838790786472,549,Can you type?
155,15,43,86,144,1.5069444444444444,0.05661087320654603,549,"Yes, productivity has taken a hit, but office-supply theft is WAY down."
155,21,31,92,144,1.5069444444444444,0.06154300567861643,549,This ‘binding arbitration’ is getting us nowhere.
155,15,43,86,144,1.5069444444444444,0.05661087320654603,549,I preferred Casual Fridays.
155,21,31,92,144,1.5069444444444444,0.06154300567861643,549,And management wonders why nothing gets done.
162,17,38,88,143,1.5034965034965035,0.058607672202749234,549,"I'm not going to lie, bathroom breaks here are the worst."
162,10,52,81,143,1.5034965034965035,0.05239663965702533,549,You remind me of myself when I started here.
162,16,40,87,143,1.5034965034965035,0.05776128621131433,549,"One last question, what would you say is your greatest limitation?"
162,19,34,90,143,1.5034965034965035,0.060264793648563804,549,You're hired. And welcome to the White House.
162,23,26,94,143,1.5034965034965035,0.06344933079601484,549,Welcome to social media rehab.
162,19,34,90,143,1.5034965034965035,0.060264793648563804,549,We're very hands off here.
162,21,30,92,143,1.5034965034965035,0.06187755219773198,549,Answer my phone by the 4th ring and you have the job.
162,14,44,85,143,1.5034965034965035,0.05603017108938987,549,"Well, I can tell you're bound and determined..."
162,21,30,92,143,1.5034965034965035,0.06187755219773198,549,I preferred the glass ceiling.
162,15,42,86,143,1.5034965034965035,0.05690231215465533,549,Would I be correct in assuming your boss is also a control freak?
172,23,25,94,142,1.5,0.06380064596328265,549,Why couldn't Mankoff just tell us employees can't enter the caption contest?
172,14,43,85,142,1.5,0.05631617296593154,549,A person would have to be crazy to want to work here. You're hired.
172,20,32,92,144,1.5,0.060751573566070624,549,"Before we get into the serious stuff, let me ask, how did you get those glasses on?"
172,21,29,92,142,1.5,0.0622152889858919,549,"And at twenty-five years, you get golden handcuffs"
172,19,33,90,142,1.5,0.060588463768806264,549,Nope. Still gay.
172,17,37,88,142,1.5,0.0589167353145934,549,"Around here, there's none of that 'I'll scratch your back, you scratch mine.'"
178,18,34,89,141,1.49645390070922,0.06007772192965602,549,"On the up side, I've stopped biting my nails."
178,13,44,84,141,1.49645390070922,0.05570230748621174,549,Sorry. I'm looking for someone with some hands-on experience.
178,14,42,85,141,1.49645390070922,0.05660445372832599,549,"Okay, I guess we both got a little crazy at the meeting."
178,16,38,87,141,1.49645390070922,0.05836692922425879,549,I'm pleased to see you display the proper level of restraint.
178,21,28,92,141,1.49645390070922,0.0625562470104963,549,I guess you DO have to be crazy to work here.
178,13,44,84,141,1.49645390070922,0.05570230748621174,549,Our anti-texting campaign seems to be working.
178,22,26,93,141,1.49645390070922,0.06336088038081499,549,Welcome to the EPA
185,15,39,86,140,1.4928571428571429,0.057791157987750294,549,Now we come to the part of the interview where we evaluate your problem solving ability.
185,13,43,84,140,1.4928571428571429,0.05598453443342634,549,I think you are exactly the person we are looking for.
185,19,31,90,140,1.4928571428571429,0.061244735555314025,549,May I speak freely?
185,15,39,86,140,1.4928571428571429,0.057791157987750294,549,I think our corporate culture will suit you.
185,17,35,88,140,1.4928571428571429,0.05954299108545632,549,We're really looking for people to be committed.
185,16,37,87,140,1.4928571428571429,0.058673613017129964,549,"Yeah, it helped me quit smoking too."
185,17,35,88,140,1.4928571428571429,0.05954299108545632,549,Perhaps if I hit the escape key...
185,14,41,85,140,1.4928571428571429,0.056895017520397224,549,"I thought he said he'd be ""retraining "" us today ."
185,20,29,91,140,1.4928571428571429,0.06207811656420605,549,So we're running the asylum. Now what?
185,13,43,84,140,1.4928571428571429,0.05598453443342634,549,You're obviously perfectly suited for this position
185,15,39,86,140,1.4928571428571429,0.057791157987750294,549,We can still butt heads.
185,22,25,93,140,1.4928571428571429,0.0637121840937569,549,Only on Mondays. Tuesdays he likes to be spanked.
185,19,31,90,140,1.4928571428571429,0.061244735555314025,549,"God, I can’t wait for casual Friday."
185,17,35,88,140,1.4928571428571429,0.05954299108545632,549,"You don't have to be crazy to work here, but it helps."
185,15,39,86,140,1.4928571428571429,0.057791157987750294,549,You seem like a perfect fit.
185,20,29,91,140,1.4928571428571429,0.06207811656420605,549,I thought we could both use a mental health day.
201,16,36,87,139,1.4892086330935252,0.05898288708701009,549,You have to be really committed to work here.
201,17,34,88,139,1.4892086330935252,0.0598602153660868,549,You'll be working with Congress.
201,13,42,84,139,1.4892086330935252,0.05626888772184008,549,"I apologize for the inconvenience, Your Holiness."
204,13,41,83,137,1.489051094890511,0.05685773935722446,549,I'm free Wednesday; what about you?
204,15,37,85,137,1.489051094890511,0.058715304126995896,549,Are there any restrictions that come with the job?
204,15,37,85,137,1.489051094890511,0.058715304126995896,549,Self-restraint is important in this job.
204,15,37,85,137,1.489051094890511,0.058715304126995896,549,I'll say this--you know how to dress for an interview.
208,15,36,85,136,1.4852941176470589,0.059027424405844596,549,And we offer a very generous mental health plan!
208,25,16,95,136,1.4852941176470589,0.06762811139403556,549,You're hired. Welcome to The New Yorker.
208,14,38,84,136,1.4852941176470589,0.058097369734903315,549,...and how are your typing skills?
211,12,41,82,135,1.4814814814814814,0.05647842292056724,549,We think you're a perfect fit for us.
211,15,35,85,135,1.4814814814814814,0.05934212006774855,549,"I'm starting to think that ""Ugly Sweater Day"" was a better idea."
211,18,29,88,135,1.4814814814814814,0.06207384451341576,549,"As you've probably surmised, the glass ceiling is going to be the least of your problems here."
211,12,41,82,135,1.4814814814814814,0.05647842292056724,549,"Call me crazy, but I think you'll fit in very well here."
211,14,37,84,135,1.4814814814814814,0.05840315825896355,549,Tech support said we should just sit tight till they get here.
211,14,37,84,135,1.4814814814814814,0.05840315825896355,549,Doesn't every job have its constraints?
211,20,25,90,135,1.4814814814814814,0.06383007764136593,549,"One other thing, this place is a madhouse."
211,17,31,87,135,1.4814814814814814,0.061176824477592595,549,Welcome to middle management.
211,17,31,87,135,1.4814814814814814,0.061176824477592595,549,And you can see this job requires no hands on experience.
211,17,31,87,135,1.4814814814814814,0.061176824477592595,549,Where do you see yourself in 5 minutes?
211,14,37,84,135,1.4814814814814814,0.05840315825896355,549,The asylum is running better since we've taken over.
222,14,36,84,134,1.4776119402985075,0.058711349382733063,549,"Call me crazy, but I think you'll be a great fit for the position."
222,17,30,87,134,1.4776119402985075,0.06151166635885825,549,So would you say you're a straps half-loose or straps half-tight kind of person?
222,15,34,85,134,1.4776119402985075,0.05965939487604109,549,It seems like nobody ever lends a hand around here.
222,16,32,86,134,1.4776119402985075,0.06059260885297353,549,"So, why do you want to work at Mad magazine?"
222,13,38,83,134,1.4776119402985075,0.05774774191002885,549,"It goes without saying, we'll be working insane hours."
222,16,32,86,134,1.4776119402985075,0.06059260885297353,549,What we really need is a typist.
222,12,40,82,134,1.4776119402985075,0.05676777999070648,549,It eliminates the bias of body language.
222,17,30,87,134,1.4776119402985075,0.06151166635885825,549,"Tell me about a tough situation you found yourself in, and how you got out of it."
222,13,38,83,134,1.4776119402985075,0.05774774191002885,549,You do realize there are some restrictions that come with the position.
222,20,24,90,134,1.4776119402985075,0.06418993418087945,549,"No, You're crazy."
222,14,36,84,134,1.4776119402985075,0.058711349382733063,549,Are you free for lunch?
222,15,34,85,134,1.4776119402985075,0.05965939487604109,549,"I've got to hand it to you, but not just now."
222,15,34,85,134,1.4776119402985075,0.05965939487604109,549,I miss finger food. Is that crazy?
222,17,30,87,134,1.4776119402985075,0.06151166635885825,549,Sign here and the job is yours.
236,16,31,86,133,1.4736842105263157,0.06092152073997351,549,"Unfortunately, we need to hire someone who has hands-on experience."
236,16,31,86,133,1.4736842105263157,0.06092152073997351,549,I keep mine on until they find someone else to make coffee.
236,13,37,83,133,1.4736842105263157,0.05804884313759221,549,"Wow, you really did your research for this job interview."
236,16,31,86,133,1.4736842105263157,0.06092152073997351,549,"On the plus side, we never get carpal tunnel."
236,15,33,85,133,1.4736842105263157,0.059979250768230484,549,"If you get out in less than 10 seconds, the job is yours."
236,10,43,80,133,1.4736842105263157,0.055026399936344644,549,The company's smoking cessation program has really worked for me. You?
236,12,39,82,133,1.4736842105263157,0.057059153718400354,549,Haven't smoked in a week. And you?
236,20,23,90,133,1.4736842105263157,0.06455320561739754,549,"Finally, we really are running the asylum."
236,13,37,83,133,1.4736842105263157,0.05804884313759221,549,"The work here is more cerebral, less hands on."
245,16,30,86,132,1.4696969696969697,0.06125319550964437,549,"We can't both be crazy, can we?"
245,12,38,82,132,1.4696969696969697,0.05735252632732919,549,"I'm tied up until noon, how about you?"
245,14,34,84,132,1.4696969696969697,0.0593349232588604,549,Would you hit the escape key for me?
245,13,36,83,132,1.4696969696969697,0.05835214389489833,549,We both need to loosen up
245,19,24,89,132,1.4696969696969697,0.06402292732415876,549,You have to be crazy to work here.
245,12,38,82,132,1.4696969696969697,0.05735252632732919,549,"Oh, it keeps me from hitting “reply all.” How about you?"
245,15,32,85,132,1.4696969696969697,0.06030168769726752,549,We've taken binding arbitration to a new level.
245,10,42,80,132,1.4696969696969697,0.055299108800405845,549,Let's face it; we're both in a bind.
245,15,32,85,132,1.4696969696969697,0.06030168769726752,549,"Loyalty and excellence are nice, but here, we're all about commitment."
245,18,26,88,132,1.4696969696969697,0.06311319039749601,549,"In this economy, we're only able to offer our employees basic mental health coverage."
245,14,34,84,132,1.4696969696969697,0.0593349232588604,549,"Call me crazy, but I think you'd be perfect for the job!"
245,17,28,87,132,1.4696969696969697,0.06219014697801132,549,"Karen, let's be honest, straitjacket Wednesdays isn't taking off like we thought it would."
245,13,36,83,132,1.4696969696969697,0.05835214389489833,549,At least my carpal tunnel has cleared up.
245,12,38,82,132,1.4696969696969697,0.05735252632732919,549,Butting heads is pretty much the only way to get things done around here.
245,14,34,84,132,1.4696969696969697,0.0593349232588604,549,You gotta be crazy to want this job.
260,15,31,85,131,1.465648854961832,0.060626703460435964,549,"Finally, we are running the asylum."
260,12,37,82,131,1.465648854961832,0.05764787711781533,549,"If anyone calls, we're tied up in a meeting."
260,17,27,87,131,1.465648854961832,0.06253380523102875,549,I see you've done your research.
260,13,35,83,131,1.465648854961832,0.05865762992388148,549,I knew you were the right person for the job the moment you walked through the door.
260,19,23,89,131,1.465648854961832,0.06438444238218453,549,"It's really not so bad, over at the EPA folks are blindfolded."
260,16,29,86,131,1.465648854961832,0.06158763662112663,549,"Call it a hunch, but you seem well suited for this company."
260,16,29,86,131,1.465648854961832,0.06158763662112663,549,Tell me a little about yourselves.
260,14,33,84,131,1.465648854961832,0.059650292207023906,549,"So, I think we should consider inserting an escape clause at this point."
260,11,39,81,131,1.465648854961832,0.056620119428472025,549,"Don't worry, we're not concerned about hands-on experience."
260,15,31,85,131,1.465648854961832,0.060626703460435964,549,"Call me crazy, but I think you'd be perfect for the job!"
260,12,37,82,131,1.465648854961832,0.05764787711781533,549,We insist that our staff be fully committed.
260,12,37,82,131,1.465648854961832,0.05764787711781533,549,I'm a nail-biter. What's your excuse?
260,11,39,81,131,1.465648854961832,0.056620119428472025,549,I can already tell you're going to fit right in.
260,11,39,81,131,1.465648854961832,0.056620119428472025,549,"Yes, but in theory can you use Word and Excel?"
260,17,27,87,131,1.465648854961832,0.06253380523102875,549,"Concerning your raise, Brenda- I realize you're in a bind, but as you can see, my hands are tied."
275,14,32,83,129,1.4651162790697674,0.06032706362896658,549,"Tell me about a challenge or conflict you've faced at work, and how you dealt with it."
275,9,42,78,129,1.4651162790697674,0.05507934686481515,549,Not sure about productivity but it cuts down on snacking.
275,14,32,83,129,1.4651162790697674,0.06032706362896658,549,Our management style is very hands off.
275,6,48,75,129,1.4651162790697674,0.051675548937881316,549,Now you understand that this agreement is fully binding...
275,17,26,86,129,1.4651162790697674,0.06326710598025358,549,I've got great news -- I gotta let you go.
275,14,32,83,129,1.4651162790697674,0.06032706362896658,549,You're bound to be hired.
275,17,26,86,129,1.4651162790697674,0.06326710598025358,549,Sexual harassment is way down. I just didn't foresee the drop in productivity.
282,16,28,86,130,1.4615384615384615,0.06192484543599165,549,They take binding contracts to the next level here.
282,18,24,88,130,1.4615384615384615,0.06382168636933047,549,"REALLY?! I happen to KNOW Wonder Woman, and she DOESN'T wear glasses."""
282,16,28,86,130,1.4615384615384615,0.06192484543599165,549,You seem well suited for this position.
285,19,21,88,128,1.4609375,0.0655292878617441,549,"I don't think anyone really thought through ""Silence of the Lambs"" Friday."
285,18,23,87,128,1.4609375,0.06458371367151575,549,Nice jacket.
285,14,31,83,128,1.4609375,0.060654184417502165,549,You've got to be crazy to work here!
285,10,39,79,128,1.4609375,0.05645178565023779,549,I understand now that the agreement was binding
285,16,27,85,128,1.4609375,0.06264976519890834,549,And how much hands on experience do you have?
285,16,27,85,128,1.4609375,0.06264976519890834,549,It’s the only way to restrain myself from replying to his tweets. And you?
285,13,33,82,128,1.4609375,0.05963135577269202,549,We're really looking for someone who can show some restraint.
285,15,29,84,128,1.4609375,0.0616600485194048,549,I love your jacket!
293,11,37,81,129,1.4573643410852712,0.05719517272625468,549,"well, you've demonstrated proper restraint....I like that"
294,14,30,83,127,1.4566929133858268,0.06098379547931151,549,I'm hoping to get out early today.
294,10,38,79,127,1.4566929133858268,0.05673698796421054,549,"I like you, Karen. You remind me of myself at your age."
294,14,30,83,127,1.4566929133858268,0.06098379547931151,549,How fast can you type?
294,15,28,84,127,1.4566929133858268,0.062000062000093,549,I told them we would be tied up all day
294,13,32,82,127,1.4566929133858268,0.05995030387003567,549,"Remember, my padded door is always open."
294,14,30,83,127,1.4566929133858268,0.06098379547931151,549,"Tell me, in which institution do you see yourself in five years?"
294,14,30,83,127,1.4566929133858268,0.06098379547931151,549,I think it's safe to say we both got a little crazy in our last meeting.
294,18,22,87,127,1.4566929133858268,0.06495352814800763,549,"Call me crazy, but it looks like you're finally dressing for the position you want."
294,16,26,85,127,1.4566929133858268,0.06299993702352612,549,You'll find we're not very touchy-feely here.
294,15,28,84,127,1.4566929133858268,0.062000062000093,549,"The thing is, no one's gonna hand you anything at this company."
294,12,34,81,127,1.4566929133858268,0.05889868043646422,549,"Congratulations, we have to let you go."
294,13,32,82,127,1.4566929133858268,0.05995030387003567,549,"Typing is tricky, but sexual harassment claims are down 90%."
306,16,25,85,126,1.4523809523809523,0.06335302236023843,549,Of course men only have to work 70% as hard to escape.
306,12,33,81,126,1.4523809523809523,0.05920868968521735,549,That about wraps it up today
306,13,31,82,126,1.4523809523809523,0.06027149459922568,549,I see we go to the same therapist.
306,13,31,82,126,1.4523809523809523,0.06027149459922568,549,Five? Very impressive. Most of us here can only hammer out three words per minute.
306,11,35,80,126,1.4523809523809523,0.05812645531301764,549,We could use another pair of hands around here.
306,15,27,84,126,1.4523809523809523,0.062342772758297686,549,Don't you just hate being tied up in meetings all day?
306,15,27,84,126,1.4523809523809523,0.062342772758297686,549,"You don't have to be crazy to work here but it . . . oh wait, you do."
306,14,29,83,126,1.4523809523809523,0.061315880391694756,549,"Call me crazy, but I think you'd be just right for our organization."
306,16,25,85,126,1.4523809523809523,0.06335302236023843,549,You remind me of me when I was your age.
306,12,33,81,126,1.4523809523809523,0.05920868968521735,549,We believe in a hands off approach.
306,10,37,79,126,1.4523809523809523,0.057023685256848394,549,Quite impressive how you studied our corporate culture.
306,12,33,81,126,1.4523809523809523,0.05920868968521735,549,Nice jacket.
306,15,27,84,126,1.4523809523809523,0.062342772758297686,549,Where'd you get your jacket?
306,11,35,80,126,1.4523809523809523,0.05812645531301764,549,"You don't need to be crazy to work here, but it helps."
320,14,23,76,113,1.4513274336283186,0.06650849783931101,549,"OK, now that we can't text, let's talk."
321,15,26,84,125,1.448,0.06268816835426683,549,Remember when it was just the glass ceiling?
321,13,30,82,125,1.448,0.060594900243204214,549,We'd be sane not to hire you.
321,12,32,81,125,1.448,0.05952066596921907,549,We've found that the jackets force us to solve problems rather than point fingers.
321,10,36,79,125,1.448,0.05731182392220929,549,This job requires commitment.
321,16,24,85,125,1.448,0.06370901592143312,549,Is this going to happen to all of the journalists or just those in New York?
321,15,26,84,125,1.448,0.06268816835426683,549,I said you'd have to be crazy to take this job.
321,14,28,83,125,1.448,0.06165041924876412,549,Let's talk; I'm on a texting restraint order too.
328,14,28,84,126,1.4444444444444444,0.06126243889817875,549,"You get out first, and the job is yours."
329,13,29,82,124,1.4435483870967742,0.06092048894765744,549,If you can escape before I do you're hired.
329,9,37,78,124,1.4435483870967742,0.05645161290322582,549,The company enforces a very strict No Texting policy.
329,12,31,81,124,1.4435483870967742,0.05983456885497005,549,Sorry to keep you waiting. It's a real madhouse in here.
329,9,37,78,124,1.4435483870967742,0.05645161290322582,549,It can get crazy around here. I think you'll fit right in.
329,14,27,83,124,1.4435483870967742,0.06198738837201607,549,"Unfortunately, we were looking to fill the position with someone a bit more psychotic."
329,11,33,80,124,1.4435483870967742,0.05872857299899813,549,You've gotta be crazy to want to work here.
329,8,39,77,124,1.4435483870967742,0.05527797260947756,549,You remind me of myself when I was your age.
329,11,33,80,124,1.4435483870967742,0.05872857299899813,549,You have to be crazy to work here.
329,12,31,81,124,1.4435483870967742,0.05983456885497005,549,You could have told me you were going to wear this today.
329,16,23,85,124,1.4435483870967742,0.06406790931742781,549,What Cabinet position did you get?
329,12,31,81,124,1.4435483870967742,0.05983456885497005,549,I'm sure you're aware the contract will be binding.
340,12,30,80,122,1.4426229508196722,0.060536798842294785,549,I'm sorry but we're looking for more diversity
340,8,38,76,122,1.4426229508196722,0.05588176828391259,549,We find it helps with employee retention.
340,10,34,78,122,1.4426229508196722,0.058255798168977836,549,"Today's been crazy for me, too."
340,12,30,80,122,1.4426229508196722,0.060536798842294785,549,"Can I get you anything -- coffee, lithium?"
340,13,28,81,122,1.4426229508196722,0.06164565687018311,549,So let me explain our new Twitter policy.
340,14,26,82,122,1.4426229508196722,0.06273491856885004,549,Guys love it. I'm not sure why.
340,14,26,82,122,1.4426229508196722,0.06273491856885004,549,I think you're a good fit.
340,11,32,79,122,1.4426229508196722,0.05940724717733159,549,"In my last job, I was chained to the desk"
340,11,32,79,122,1.4426229508196722,0.05940724717733159,549,You'll have the corner office with the padded walls.
340,11,32,79,122,1.4426229508196722,0.05940724717733159,549,It looks like we have a binding agreement.
340,14,26,82,122,1.4426229508196722,0.06273491856885004,549,What do you see yourself escaping from in five years?
340,10,34,78,122,1.4426229508196722,0.058255798168977836,549,You seem perfectly well-suited for the position.
352,13,27,81,121,1.43801652892562,0.06198347107438016,549,"Unfortunately, we do not provide mental health leave. However, our cubicles are padded."
352,9,35,77,121,1.43801652892562,0.05736712036611824,549,Some employees are complaining that our dress code is too restrictive.
352,15,23,83,121,1.43801652892562,0.0641672251238312,549,I can't wait for casual friday
352,13,27,81,121,1.43801652892562,0.06198347107438016,549,I like your can't-do attitude.
352,15,23,83,121,1.43801652892562,0.0641672251238312,549,"You scratch my back, I'll scratch yours."
352,7,39,75,121,1.43801652892562,0.054913608563240374,549,"Sorry, but we are looking for someone with actual hands-on experience."
352,16,21,84,121,1.43801652892562,0.06523169342370616,549,Mike Pence says if we wear these we will start liking boys
352,14,25,82,121,1.43801652892562,0.06308479795688085,549,Your Restraint is admirable.
352,12,29,80,121,1.43801652892562,0.060862218490592056,549,On a brighter note - there are bidets in all of the bathrooms
352,10,33,78,121,1.43801652892562,0.05855533746749867,549,I don't see restraints just opportunity.
362,10,30,75,115,1.434782608695652,0.06067310564559659,549,Mr. Houdini will see you now.
363,10,33,79,122,1.4344262295081966,0.058184268901013324,549,The job does come with certain constraints.
364,15,22,83,120,1.4333333333333333,0.06453163874896187,549,You'll learn after a few days with Team Trump a straight jacket will feel so comforting.
364,12,28,80,120,1.4333333333333333,0.061189576991507524,549,I need you to be more hands on.
364,12,28,80,120,1.4333333333333333,0.061189576991507524,549,If you're happy and you know it ...
364,14,24,82,120,1.4333333333333333,0.06343718449945232,549,"Decaf, black, and with a straw."
364,8,36,76,120,1.4333333333333333,0.05642641440640874,549,How many words can you type per minute?
364,13,26,81,120,1.4333333333333333,0.06232351365904036,549,We're looking for someone with more hands on experience.
364,16,20,84,120,1.4333333333333333,0.06560783811432504,549,"Before Houdini Enterprises hires you, there is one more final test."
364,12,28,80,120,1.4333333333333333,0.061189576991507524,549,"Well, I think that just about wraps things up."
364,16,20,84,120,1.4333333333333333,0.06560783811432504,549,Make no mistake: You have to be crazy to work here.
364,9,34,77,120,1.4333333333333333,0.05765410883165861,549,"There's something strange about this company, but I just can't put my finger on it."
364,9,34,77,120,1.4333333333333333,0.05765410883165861,549,"...And while smoking is restricted to the parking lot, you can shriek and howl anywhere you like."
364,13,26,81,120,1.4333333333333333,0.06232351365904036,549,I've stopped smoking and lost 20 pounds.
364,12,28,80,120,1.4333333333333333,0.061189576991507524,549,"It's a crazy place to work, but I think you'll fit right in."
364,10,32,78,120,1.4333333333333333,0.05885620007766131,549,The problem with our department is the left hand doesn't know what the right hand is doing.
364,12,28,80,120,1.4333333333333333,0.061189576991507524,549,What's holding you back?
364,9,34,77,120,1.4333333333333333,0.05765410883165861,549,"There are no back stabbers here, but watch out for head butts."
380,10,31,78,119,1.4285714285714286,0.059158304292233184,549,I see that you already know about our dress code.
380,8,35,76,119,1.4285714285714286,0.05669960546721602,549,"On the other hand, you'll appreciate Casual Fridays so much more."
380,13,25,81,119,1.4285714285714286,0.06266573646438865,549,You'll notice all our electronic devices around here are hands free.
380,15,21,83,119,1.4285714285714286,0.0648987999366607,549,I'm told it's so we don't cut ourselves on the glass ceiling.
380,15,21,83,119,1.4285714285714286,0.0648987999366607,549,Wish I could help you but my hands are tied.
380,12,27,80,119,1.4285714285714286,0.06151881560406505,549,I think you're going to fit right in to the corporate culture.
380,13,25,81,119,1.4285714285714286,0.06266573646438865,549,Describe something you struggle with at work and show me how you deal with it.
380,15,21,83,119,1.4285714285714286,0.0648987999366607,549,"I wish I could, but my hands are tied."""
380,11,29,79,119,1.4285714285714286,0.06035010207141084,549,And what makes you think you'd be happy here?
380,13,25,81,119,1.4285714285714286,0.06266573646438865,549,"So, you find our dress code too restricting..."
380,12,27,80,119,1.4285714285714286,0.06151881560406505,549,"As you know, we take binding contracts very seriously here."
380,10,31,78,119,1.4285714285714286,0.059158304292233184,549,"I see you take a hand-off approach to management, too."
380,9,33,77,119,1.4285714285714286,0.05794199783779641,549,I must admit I admire your self-restraint.
380,10,31,78,119,1.4285714285714286,0.059158304292233184,549,It's just until IT finishes updating the internet filter.
380,9,33,77,119,1.4285714285714286,0.05794199783779641,549,"So, what attracted you to this company?"
380,11,29,79,119,1.4285714285714286,0.06035010207141084,549,But at least we get to run the place.
380,10,31,78,119,1.4285714285714286,0.059158304292233184,549,"I can empathize with your circumstance, but, I'm looking for someone to answer my phone."
380,10,31,78,119,1.4285714285714286,0.059158304292233184,549,I know exactly how you feel.
380,13,25,81,119,1.4285714285714286,0.06266573646438865,549,"It's not bad here, we do have unrestrained Friday's"
399,9,32,77,118,1.423728813559322,0.058230684703411285,549,"Sorry to keep you waiting, it's been crazy around here lately."
399,10,30,78,118,1.423728813559322,0.05946156063098504,549,I'm running out of wiggle room here.
399,7,36,75,118,1.423728813559322,0.055687373234330886,549,You can't quit. Our contracts are binding.
399,10,30,78,118,1.423728813559322,0.05946156063098504,549,Why do you think you are a good fit for our company?
399,17,16,85,118,1.423728813559322,0.0674516794022343,549,Everybody's going to submit a caption about us being tied up in a meeting.
399,13,24,81,118,1.423728813559322,0.06301008528485696,549,Pick your poison: institutionally marginalized or marginally institutionalized.
399,5,40,73,118,1.423728813559322,0.053022206993402744,549,I think it's great that we're both showing much more restraint.
399,11,28,79,118,1.423728813559322,0.060667468583389256,549,"The job is dreadful, but the benefits are insane."
399,7,36,75,118,1.423728813559322,0.055687373234330886,549,"Don't worry, you'll fit right in."
399,8,34,76,118,1.423728813559322,0.05697322256449853,549,I preferred the golden handcuffs.
399,8,34,76,118,1.423728813559322,0.05697322256449853,549,It all started making a lot more sense once we realised that you DO need to be crazy to work here.
399,13,24,81,118,1.423728813559322,0.06301008528485696,549,You have to be crazy to work here. You’re hired.
399,14,22,82,118,1.423728813559322,0.06414932111292496,549,Welcome to the White House
399,13,24,81,118,1.423728813559322,0.06301008528485696,549,I'm really looking forward to casual Friday.
399,11,28,79,118,1.423728813559322,0.060667468583389256,549,Your behavior has put us both in a difficult position.
399,12,26,80,118,1.423728813559322,0.06184986900520271,549,I'd love to go to lunch with you but it looks like I'll be tied up the rest of the day.
399,7,36,75,118,1.423728813559322,0.055687373234330886,549,We are deeply committed to a hands-off management style.
399,12,26,80,118,1.423728813559322,0.06184986900520271,549,You must be crazy to work here.
399,9,32,77,118,1.423728813559322,0.058230684703411285,549,There's no question that we are both in a bind here.
399,12,26,80,118,1.423728813559322,0.06184986900520271,549,Where did you used to hope to be in five years?
399,11,28,79,118,1.423728813559322,0.060667468583389256,549,This place is a madhouse.
399,15,20,83,118,1.423728813559322,0.06526867511213456,549,"Jeanie, we are so pleased to offer you a position with the EPA."
399,14,22,82,118,1.423728813559322,0.06414932111292496,549,We can do it. We CAN go 24 hours without texting.
399,8,34,76,118,1.423728813559322,0.05697322256449853,549,I see you are familiar with our dress code.
399,10,30,78,118,1.423728813559322,0.05946156063098504,549,The irony of this situation does not escape me.
399,13,24,81,118,1.423728813559322,0.06301008528485696,549,Shouldn't you be writing this down?
399,11,28,79,118,1.423728813559322,0.060667468583389256,549,The corporate culture here is stifling.
399,12,26,80,118,1.423728813559322,0.06184986900520271,549,What type of hospital do you see yourself in in five years?
399,13,24,81,118,1.423728813559322,0.06301008528485696,549,Sometimes it gets a little crazy around here
399,8,34,76,118,1.423728813559322,0.05697322256449853,549,What makes you think you'll be a good fit?
399,12,26,80,118,1.423728813559322,0.06184986900520271,549,He said not until we come up with an idea.
399,8,34,76,118,1.423728813559322,0.05697322256449853,549,"As you know, when it comes to running the asylum, we think it's important to promote from within."
399,11,28,79,118,1.423728813559322,0.060667468583389256,549,I think you'll fit right in here.
399,13,24,81,118,1.423728813559322,0.06301008528485696,549,Nordstrom Rack. Where did you get yours?
399,12,26,80,118,1.423728813559322,0.06184986900520271,549,I see you've dressed for the job you want.
399,13,24,81,118,1.423728813559322,0.06301008528485696,549,I think you may be perfect for this position.
399,14,22,82,118,1.423728813559322,0.06414932111292496,549,"Siri, google ""escape from straight jacket."""
399,15,20,83,118,1.423728813559322,0.06526867511213456,549,"Why no, you don't have to be crazy to work here."
399,11,28,79,118,1.423728813559322,0.060667468583389256,549,"So, I was actually hoping to hire an assistant who would be able to...you know...assist."
399,11,28,79,118,1.423728813559322,0.060667468583389256,549,"obviously 'you scratch my back, I scratch yours' isn't going to work here."
399,9,32,77,118,1.423728813559322,0.058230684703411285,549,It's not binding until you sign.
399,10,30,78,118,1.423728813559322,0.05946156063098504,549,I think we've tied up all the loose ends.
399,9,32,77,118,1.423728813559322,0.058230684703411285,549,Who did your buckles?
399,14,22,82,118,1.423728813559322,0.06414932111292496,549,So why should we grant you asylum?
399,18,14,86,118,1.423728813559322,0.06851710447637153,549,Welcome to your first meeting of Masturbators Anonymous.
399,7,36,75,118,1.423728813559322,0.055687373234330886,549,"If I were you, and I think I am."
399,10,30,78,118,1.423728813559322,0.05946156063098504,549,"Your clearly qualified, but I need to know you'll be committed."
399,9,32,77,118,1.423728813559322,0.058230684703411285,549,The flip side is we won't ever ask you to sign anything.
399,11,28,79,118,1.423728813559322,0.060667468583389256,549,Nail biting. What about you?
399,10,30,78,118,1.423728813559322,0.05946156063098504,549,I have a feeling you're going to fit right in here.
399,7,36,75,118,1.423728813559322,0.055687373234330886,549,I think you're going to fit in very well here.
399,8,34,76,118,1.423728813559322,0.05697322256449853,549,"Personally, I think you're very well-suited for this job."
451,11,28,80,119,1.4201680672268908,0.06026079002401272,549,This is why I suggested the NON-binding arbitration.
452,9,31,77,117,1.4188034188034189,0.05852005764664566,549,I love your jacket!
452,8,33,76,117,1.4188034188034189,0.05724713906073384,549,That's very interesting; I find myself in a similar situation.
452,8,33,76,117,1.4188034188034189,0.05724713906073384,549,"So, I gather that you're OK with our hands-off policy?"
452,15,19,83,117,1.4188034188034189,0.06564122519372359,549,How can I help you?
452,7,35,75,117,1.4188034188034189,0.0559452653431125,549,Something tells me you're a good fit for this position.
452,12,25,80,117,1.4188034188034189,0.06218266475433432,549,I see that you are already acquainted with our dress policy.
452,11,27,79,117,1.4188034188034189,0.06098624090417607,549,"Sorry, but nobody here has an escape clause in their employment contract."
452,13,23,81,117,1.4188034188034189,0.06335649936887032,549,"Yes, they've definitely put us in charge, but I think there's a catch."
460,12,24,79,115,1.4173913043478261,0.06295859510853141,549,You seem to be a perfect candidate to replace me.
460,13,22,80,115,1.4173913043478261,0.06415870945816099,549,Are you free Tuesdays?
460,11,26,78,115,1.4173913043478261,0.06173515527431089,549,We have to shake the image that the inmates are running the asylum.
460,9,30,76,115,1.4173913043478261,0.05921248849820311,549,"'You scratch my back, I scratch yours' doesn't work here."
460,8,32,75,115,1.4173913043478261,0.05790996022147758,549,Let's just agree to shake on it later.
460,10,28,77,115,1.4173913043478261,0.06048697459326724,549,Now maybe we can have this conversation without checking our phones.
460,8,32,75,115,1.4173913043478261,0.05790996022147758,549,Are those boots slip-ons?
460,18,12,85,115,1.4173913043478261,0.06985067290885834,549,"If you're happy and you know it, clap your hands."
460,14,20,81,115,1.4173913043478261,0.06533678367224267,549,Welcome to cellphone addicts anonymous.
460,12,24,79,115,1.4173913043478261,0.06295859510853141,549,Looks like were both tied up today. Shall we reschedule?
460,8,32,75,115,1.4173913043478261,0.05790996022147758,549,"Well, I think we're all wrapped up here."
460,9,30,76,115,1.4173913043478261,0.05921248849820311,549,I LOVE yours.Where did you get it?
460,13,22,80,115,1.4173913043478261,0.06415870945816099,549,"In hindsight, well yes, we should have both moved to Canada."
460,11,26,78,115,1.4173913043478261,0.06173515527431089,549,I'd like to help you but my hands are tied.
460,10,28,77,115,1.4173913043478261,0.06048697459326724,549,But what I miss most is retweeting delusional nonsense and brushing my hair.
460,11,26,78,115,1.4173913043478261,0.06173515527431089,549,The small print in these binding contracts are no joke.
460,16,16,83,115,1.4173913043478261,0.06763139731830828,549,"It's important to dress for the job you want, not the job that you have."
460,12,24,79,115,1.4173913043478261,0.06295859510853141,549,Does my hair make me look crazy?
460,12,24,79,115,1.4173913043478261,0.06295859510853141,549,No twitter Tuesday is so liberating.
460,9,30,76,115,1.4173913043478261,0.05921248849820311,549,Says here you type 100 words per minute?
460,14,20,81,115,1.4173913043478261,0.06533678367224267,549,"As you can see, we have a no-texting policy at the office."
460,13,22,80,115,1.4173913043478261,0.06415870945816099,549,"Yes, you do have to be crazy to work here."
460,11,26,78,115,1.4173913043478261,0.06173515527431089,549,"Look, I can see you're in a real bind here, but my hands are completely tied."
460,8,32,75,115,1.4173913043478261,0.05790996022147758,549,Can you type with your nose?
460,12,24,79,115,1.4173913043478261,0.06295859510853141,549,Obviously you've researched our institutional culture . . .
460,6,36,73,115,1.4173913043478261,0.0552127964357872,549,You're hired. Let's nod on it.
460,11,26,78,115,1.4173913043478261,0.06173515527431089,549,I think you'd fit in well here.
460,11,26,78,115,1.4173913043478261,0.06173515527431089,549,Welcome to middle management.
488,12,23,78,113,1.415929203539823,0.06376025699793082,549,Do you have any hands-on experience?
489,13,23,82,118,1.4152542372881356,0.06291746993905505,549,"Something about my job feels stifling, but I can't put my finger on it."
490,9,30,77,116,1.4137931034482758,0.05880999506738879,549,My door is always open.
491,10,27,77,114,1.412280701754386,0.06080171757635417,549,We only do verbal contracts.
491,9,29,76,114,1.412280701754386,0.05951128855191891,549,It gets a little crazy around here.
491,8,31,75,114,1.412280701754386,0.0581922509444752,549,"They looked great in the catalog, didn't they?"
491,7,33,74,114,1.412280701754386,0.05684261319520588,549,I love your outfit.
491,12,23,79,114,1.412280701754386,0.06330370961077002,549,If I could only reach the escape key!!!
491,14,19,81,114,1.412280701754386,0.06571050479744207,549,"I see the bind you're in, but my hands are tied."
491,9,29,76,114,1.412280701754386,0.05951128855191891,549,I understand you have an issue with the company dress code.
491,13,21,80,114,1.412280701754386,0.06451833108202411,549,You do have to be crazy to work here - but it doesn't help.
491,13,21,80,114,1.412280701754386,0.06451833108202411,549,Why didn't you tell me you were going to wear that jacket today?
491,6,35,73,114,1.412280701754386,0.05546014136057366,549,I find it keeps me from replying all.
491,14,19,81,114,1.412280701754386,0.06571050479744207,549,Where do I see myself in ten years? Here.
491,14,19,81,114,1.412280701754386,0.06571050479744207,549,"Welcome aboard. Working here, you're limited only by your imagination. Well, that and the straitjacket."
491,13,21,80,114,1.412280701754386,0.06451833108202411,549,So you watch Fox News too?
491,13,21,80,114,1.412280701754386,0.06451833108202411,549,This should eliminate body language issues.
491,13,21,80,114,1.412280701754386,0.06451833108202411,549,Can we be strait with each other?
491,9,29,76,114,1.412280701754386,0.05951128855191891,549,We wore the same jacket! Awkward!
491,11,25,78,114,1.412280701754386,0.06206532248655215,549,This is nothing compared to the red tape.
491,9,29,76,114,1.412280701754386,0.05951128855191891,549,you'd have to be nuts to work here.
491,11,25,78,114,1.412280701754386,0.06206532248655215,549,"Now that you are comfortable Judy, I want to inform you that your husband and I are romantically involved."
491,11,25,78,114,1.412280701754386,0.06206532248655215,549,Your success here is limited only by your imagination.
491,12,23,79,114,1.412280701754386,0.06330370961077002,549,Where do you see yourself in five minutes?
491,11,25,78,114,1.412280701754386,0.06206532248655215,549,Can I get you anything?
491,10,27,77,114,1.412280701754386,0.06080171757635417,549,You met all the job requirements but failed the typing test.
491,10,27,77,114,1.412280701754386,0.06080171757635417,549,"Yes, the hours are insane."
491,11,25,78,114,1.412280701754386,0.06206532248655215,549,"So, what do you know about running an asylum?"
491,11,25,78,114,1.412280701754386,0.06206532248655215,549,"The dress code is strict, but we loosen things up on Fridays."
491,12,23,79,114,1.412280701754386,0.06330370961077002,549,"If you can get past the downside, ours is the most effective weight loss program in the industry."
491,9,29,76,114,1.412280701754386,0.05951128855191891,549,Perhaps we've gone too far on our sexual harassment policy.
491,10,27,77,114,1.412280701754386,0.06080171757635417,549,"Let's start by signing those release forms, shall we?"
491,7,33,74,114,1.412280701754386,0.05684261319520588,549,I see a lot of myself in you.
491,8,31,75,114,1.412280701754386,0.0581922509444752,549,"For once, I do know how you feel."
491,11,25,78,114,1.412280701754386,0.06206532248655215,549,"Okay, I'll be the first to admit that our last meeting didn't go very well."
491,10,27,77,114,1.412280701754386,0.06080171757635417,549,"Siri, could you bring us two iced lattes, with straws."
491,15,17,82,114,1.412280701754386,0.0668814311738291,549,"When I see you, I see myself 15 years ago..."
491,13,21,80,114,1.412280701754386,0.06451833108202411,549,So we're running the asylum. Now what?
491,10,27,77,114,1.412280701754386,0.06080171757635417,549,"You'll fit in well, here."
491,10,27,77,114,1.412280701754386,0.06080171757635417,549,"This job requires someone with initiative and, most importantly, flexibility."
491,11,25,78,114,1.412280701754386,0.06206532248655215,549,"So, tell me why you feel constrained by the dress code here."
491,11,25,78,114,1.412280701754386,0.06206532248655215,549,HR is pretty strict about hugs.
491,9,29,76,114,1.412280701754386,0.05951128855191891,549,Your resume said 'creative problem solver'...
491,6,35,73,114,1.412280701754386,0.05546014136057366,549,"When you hired me, I said I could do the job with ONE arm tied behind my back."
532,13,20,80,113,1.407079646017699,0.06487999247174858,549,"...and within a few years, I was running the asylum."
532,14,18,81,113,1.407079646017699,0.06608661919049288,549,Welcome to the new Republican health insurance market.
532,8,30,75,113,1.407079646017699,0.05847456163716668,549,I think we've bonded enough for today.
532,12,22,79,113,1.407079646017699,0.06365049575799928,549,Jackets may be worn untied on Casual Fridays.
532,14,18,81,113,1.407079646017699,0.06608661919049288,549,Well to be honest we were looking for someone who could work the coffee maker for us.
532,10,26,77,113,1.407079646017699,0.0611173460193499,549,We need to think through our bathroom break.
532,8,30,75,113,1.407079646017699,0.05847456163716668,549,"""I'm three weeks without e-mailing or texting. How about you?'"
532,11,24,78,113,1.407079646017699,0.062396777139079984,549,"You escape before I do, you get the job."
532,9,28,76,113,1.407079646017699,0.059810552342825556,549,I’ve tried to tell you – there is very little room for mobility in this company.
532,9,28,76,113,1.407079646017699,0.059810552342825556,549,This is certainly one way of keeping us off Twitter.
532,6,34,73,113,1.407079646017699,0.055706541203602536,549,Are you sure you won’t mind being confined to a desk job?
532,12,22,79,113,1.407079646017699,0.06365049575799928,549,I was out in public wearing a fringed poncho. You?
532,8,30,75,113,1.407079646017699,0.05847456163716668,549,"No, there's no glass ceiling. But there are some other challenges."
532,11,24,78,113,1.407079646017699,0.062396777139079984,549,Of course your cubicle will be a padded cell.
532,8,30,75,113,1.407079646017699,0.05847456163716668,549,"Obviously, we're paperless here."
532,11,24,78,113,1.407079646017699,0.062396777139079984,549,"Well, you do seem committed to work here."
532,8,30,75,113,1.407079646017699,0.05847456163716668,549,You gotta be Houdini to get any work done around here.
532,10,26,77,113,1.407079646017699,0.0611173460193499,549,So much for the right to bare arms in the office.
532,13,20,80,113,1.407079646017699,0.06487999247174858,549,I knew if you came in we could wrap this up ourselves.
532,13,20,80,113,1.407079646017699,0.06487999247174858,549,"Great resume Ms. Perkins, but I'm really looking for someone who can type."
532,8,30,75,113,1.407079646017699,0.05847456163716668,549,Something tells me you’re going to fit right in here.
532,13,20,80,113,1.407079646017699,0.06487999247174858,549,Why is it men never know what clothes to buy for women?
532,8,30,75,113,1.407079646017699,0.05847456163716668,549,They ran out of red tape.
532,13,20,80,113,1.407079646017699,0.06487999247174858,549,"Yes, the inmates are running the asylum."
532,10,26,77,113,1.407079646017699,0.0611173460193499,549,The first thing you want to do is install voice recognition
532,6,34,73,113,1.407079646017699,0.055706541203602536,549,Your biggest challenge here will be the ladies room.
532,10,26,77,113,1.407079646017699,0.0611173460193499,549,That about wraps it up.
532,9,28,76,113,1.407079646017699,0.059810552342825556,549,'Fortunately you DO have to be crazy to work here.'
532,12,22,79,113,1.407079646017699,0.06365049575799928,549,I'm concerned that you may no longer be crazy enough to work here.
532,11,24,78,113,1.407079646017699,0.062396777139079984,549,I need you to cover while I escape for a few days.
532,13,20,80,113,1.407079646017699,0.06487999247174858,549,"My friends said I'd be crazy to take this job, but I think I'd be perfect!"
532,8,30,75,113,1.407079646017699,0.05847456163716668,549,I know exactly how you feel.
532,11,24,78,113,1.407079646017699,0.062396777139079984,549,"Well, it does keep us from pulling our hair out."
532,11,24,78,113,1.407079646017699,0.062396777139079984,549,"Goodbye, keyboard. Hello, voice recognition."
532,14,18,81,113,1.407079646017699,0.06608661919049288,549,"Am I crazy, or have we met before?"
532,9,28,76,113,1.407079646017699,0.059810552342825556,549,"Most importantly, you've nailed the company culture."
532,14,18,81,113,1.407079646017699,0.06608661919049288,549,Where do you hallucinate yourself being in five years?
532,14,18,81,113,1.407079646017699,0.06608661919049288,549,I'm not OK--You're not OK.
532,11,24,78,113,1.407079646017699,0.062396777139079984,549,"Yes, we have noted a drop in productivity since the new dress code was introduced. Why do you ask?"
532,11,24,78,113,1.407079646017699,0.062396777139079984,549,No...surprisingly the greatest problem is the congratulatory head butt.
532,8,30,75,113,1.407079646017699,0.05847456163716668,549,The boss was right. We're making 100% fewer mistakes.
532,11,24,78,113,1.407079646017699,0.062396777139079984,549,"I'd love to help, but I'm in a bit of a bind myself."
532,11,24,78,113,1.407079646017699,0.062396777139079984,549,Well Jane looks like our hands are tied on this one.
532,8,30,75,113,1.407079646017699,0.05847456163716668,549,I think I preferred Casual Fridays.
532,11,24,78,113,1.407079646017699,0.062396777139079984,549,This may sound crazy ....
532,11,24,78,113,1.407079646017699,0.062396777139079984,549,I miss the pantsuits.
578,11,23,78,112,1.4017857142857142,0.06272940066108663,549,Looks like you'll fit right in here.
578,13,19,80,112,1.4017857142857142,0.06524360527323315,549,Raise your hand if you have any questions.
578,12,21,79,112,1.4017857142857142,0.06399885052228904,549,It makes you nostalgic for the good old days of gag orders.
578,12,21,79,112,1.4017857142857142,0.06399885052228904,549,"Before I hire you, I have to know if you're as committed to this place as we all are."
578,11,23,78,112,1.4017857142857142,0.06272940066108663,549,Welcome to Tweeters Anonymous.
578,8,29,75,112,1.4017857142857142,0.05875672067664816,549,Sounds good! At my last job I had to work with one hand tied behind my back.
578,9,27,76,112,1.4017857142857142,0.060110127146337115,549,"Yes, the company dress code seems a bit restrictive to me too."
578,11,23,78,112,1.4017857142857142,0.06272940066108663,549,It's keeping us off facebook but I'm not convinced it will help with productivity
578,12,21,79,112,1.4017857142857142,0.06399885052228904,549,I'd love to help but I'm afraid my hands are tied.
578,10,25,77,112,1.4017857142857142,0.06143372482947762,549,"All I said was, 'I'm with her.'"
578,9,27,76,112,1.4017857142857142,0.060110127146337115,549,"Sorry, but I'm a hands-off executive and need a hands-on manager for this position."
578,7,31,74,112,1.4017857142857142,0.05737139586761414,549,"Don't worry, I'll just take mental notes."
578,7,31,74,112,1.4017857142857142,0.05737139586761414,549,"Yes, the pay is equal, but the guys don't have a dress code."
578,9,27,76,112,1.4017857142857142,0.060110127146337115,549,I've found I can do this job with both hands tied in front of my back.
578,9,27,76,112,1.4017857142857142,0.060110127146337115,549,"Luckily, we can ask Siri."
578,11,23,78,112,1.4017857142857142,0.06272940066108663,549,Everyone told me I should dress for the job I want.
578,7,31,74,112,1.4017857142857142,0.05737139586761414,549,You have to be a little crazy to want this job.
578,10,25,77,112,1.4017857142857142,0.06143372482947762,549,How fast can you type?
578,11,23,78,112,1.4017857142857142,0.06272940066108663,549,Vera Wang - And Yours?
578,8,29,75,112,1.4017857142857142,0.05875672067664816,549,Sorry but we're looking for a hands-on person.
578,8,29,75,112,1.4017857142857142,0.05875672067664816,549,"I'm sorry, my hands are tied."
578,10,25,77,112,1.4017857142857142,0.06143372482947762,549,"Yes, no problem. Zero words per minute is perfectly fine with us."
578,9,27,76,112,1.4017857142857142,0.060110127146337115,549,What makes you think you're well suited for this position?
578,13,19,80,112,1.4017857142857142,0.06524360527323315,549,"I like to help you out. Unfortunately, my hands are tied too."
578,10,25,77,112,1.4017857142857142,0.06143372482947762,549,They got to me before I could put my eyebrows on.
578,11,23,78,112,1.4017857142857142,0.06272940066108663,549,How many words per minute can you peck?
578,10,25,77,112,1.4017857142857142,0.06143372482947762,549,This job requires commitment.
578,8,29,75,112,1.4017857142857142,0.05875672067664816,549,You would be crazy to want this job.
578,10,25,77,112,1.4017857142857142,0.06143372482947762,549,"I’m tied up this week, how about next week?"
578,11,23,78,112,1.4017857142857142,0.06272940066108663,549,You look like management material.
578,10,25,77,112,1.4017857142857142,0.06143372482947762,549,"I'd love to give you a raise, but my hands are tied."
578,9,27,76,112,1.4017857142857142,0.060110127146337115,549,I think you'd be a perfect fit.
578,15,15,82,112,1.4017857142857142,0.06766445411587815,549,"Ok. Now, sell me that pen."
578,8,29,75,112,1.4017857142857142,0.05875672067664816,549,"So, as you know, the inmates have taken over the asylum."
578,9,27,76,112,1.4017857142857142,0.060110127146337115,549,"The question to ask yourself is, are you crazy enough to work here?"
578,6,33,73,112,1.4017857142857142,0.055951781945916004,549,"On a positive note, incidents of workplace violence have dropped significantly this year."
578,10,25,77,112,1.4017857142857142,0.06143372482947762,549,You're either mocking me or you're over qualified.
578,12,21,79,112,1.4017857142857142,0.06399885052228904,549,My door is always open.
578,11,23,78,112,1.4017857142857142,0.06272940066108663,549,Our corporate anti-theft program has been very successful.
578,6,33,73,112,1.4017857142857142,0.055951781945916004,549,It's been a crazy week.
578,10,25,77,112,1.4017857142857142,0.06143372482947762,549,I can see you're in a bind but my hands are tied.
578,9,27,76,112,1.4017857142857142,0.060110127146337115,549,We only wear them on days there are donuts in the conference room.
578,8,29,75,112,1.4017857142857142,0.05875672067664816,549,Well I think you'll fit right in.
578,9,27,76,112,1.4017857142857142,0.060110127146337115,549,The Help Desk suggested I try hitting the 'escape' key.
578,9,27,76,112,1.4017857142857142,0.060110127146337115,549,I understand your position.
578,8,29,75,112,1.4017857142857142,0.05875672067664816,549,"From what I see, you'll fit in well here."
578,10,25,77,112,1.4017857142857142,0.06143372482947762,549,"Your resume is impressive and you would certainly fit right in around here, but we desperately need to hire someone who can type."
578,12,21,79,112,1.4017857142857142,0.06399885052228904,549,"Yes, I see that we are in a similar bind."
578,12,21,79,112,1.4017857142857142,0.06399885052228904,549,I'm tied up today. Are you free tomorrow?
578,10,25,77,112,1.4017857142857142,0.06143372482947762,549,The good news? We've broken the glass ceiling.
578,6,33,73,112,1.4017857142857142,0.055951781945916004,549,I hope you will excuse me for not offering you coffee.
578,11,23,78,112,1.4017857142857142,0.06272940066108663,549,"On Casual Fridays, we lose the ties."
578,13,19,80,112,1.4017857142857142,0.06524360527323315,549,Let me give it to you strait
578,6,33,73,112,1.4017857142857142,0.055951781945916004,549,Do you have casual Fridays?
578,8,29,75,112,1.4017857142857142,0.05875672067664816,549,We were bound to meet.
578,10,25,77,112,1.4017857142857142,0.06143372482947762,549,They meant fiscal not physical constraint.
578,8,29,75,112,1.4017857142857142,0.05875672067664816,549,What makes you think that you are a good fit for us?
578,6,33,73,112,1.4017857142857142,0.055951781945916004,549,Didn't they tell you that the job came with some constraints?
636,11,23,79,113,1.3982300884955752,0.06227338563881523,549,Dd you tell them we'll be late because we're tied up at the office?
637,11,22,78,111,1.3963963963963963,0.06306306306306306,549,"Unfortunately, we have to let you go."
637,12,20,79,111,1.3963963963963963,0.06434866033334363,549,Psychotic Tuesday's just doesn't have the cache as Casual Friday.
637,12,20,79,111,1.3963963963963963,0.06434866033334363,549,How about after work we grab a little Thorazine?
637,13,18,80,111,1.3963963963963963,0.06560907140400782,549,I understand that you're in a bind but my hands are tied.
637,13,18,80,111,1.3963963963963963,0.06560907140400782,549,"Ok, now we can talk about the election."
637,10,24,77,111,1.3963963963963963,0.06175070654734005,549,It seems like you'd be a good fit here.
637,7,30,74,111,1.3963963963963963,0.05763461865663044,549,"Call me crazy, but I think you're perfect for this job!"
637,15,14,82,111,1.3963963963963963,0.0680599043350527,549,"We may be running the asylum now, but we're not abandoning all protocol."
637,11,22,78,111,1.3963963963963963,0.06306306306306306,549,I think you'll fit right in here.
637,14,16,81,111,1.3963963963963963,0.06684572098718332,549,I see you’re dealing with some post-election issues as well.
637,11,22,78,111,1.3963963963963963,0.06306306306306306,549,Apparently letting us run the asylum will cut down on the overhead
637,10,24,77,111,1.3963963963963963,0.06175070654734005,549,I'd like to help. But our hands are tied.
637,11,22,78,111,1.3963963963963963,0.06306306306306306,549,It really is the best way to keep from looking at your phone.
650,10,25,79,114,1.394736842105263,0.06055482881450888,549,Our dress code is very strict but I think you'll fit in just fine
651,11,21,77,109,1.3944954128440368,0.06387949045420306,549,So what made you decide you wanted to be a fact-checker for Breitbart?
651,13,17,79,109,1.3944954128440368,0.06648592806980766,549,You heard right. You do have to be crazy to work here.
651,11,21,77,109,1.3944954128440368,0.06387949045420306,549,yes my nose is itchy too
651,9,25,75,109,1.3944954128440368,0.06116207951070337,549,I think you have what it takes to work here.
651,10,23,76,109,1.3944954128440368,0.06253554697434979,549,"You're committed, we like that in our staff."
651,10,23,76,109,1.3944954128440368,0.06253554697434979,549,"Pills, gum, and the patch didn't work. This better work!"
651,10,23,76,109,1.3944954128440368,0.06253554697434979,549,Company benefits include two 15 minute medication breaks per day
651,11,21,77,109,1.3944954128440368,0.06387949045420306,549,"So tell me, why do you feel you'd be a good fit for this position?"
651,7,29,73,109,1.3944954128440368,0.05831818446641306,549,Business is crazy right now. When can you start?
651,10,23,76,109,1.3944954128440368,0.06253554697434979,549,These touch screens drive me nuts too.
651,11,21,77,109,1.3944954128440368,0.06387949045420306,549,Hands-on experience is overrated.
651,8,27,74,109,1.3944954128440368,0.05975705234335184,549,So...this is going to sound crazy.
651,13,17,79,109,1.3944954128440368,0.06648592806980766,549,"No vacation days, but I can give you a corner cell."
651,8,27,74,109,1.3944954128440368,0.05975705234335184,549,Why does it seem like we are always tied up in meetings?
665,15,12,81,108,1.3888888888888888,0.06940549271036496,549,…as if the glass ceiling isn't enough.
665,11,20,77,108,1.3888888888888888,0.06422492781043573,549,"...so naturally, when I heard that the lunatics had taken over the asylum, it seemed like the perfect opportunity."
665,10,22,76,108,1.3888888888888888,0.06286311387234544,549,"You have to admit, it solved our texting problems."
665,4,34,70,108,1.3888888888888888,0.053975452629488975,549,So I guess we're not going to shake on it.
665,12,18,78,108,1.3888888888888888,0.06555845955163904,549,This is embarrassing. You should have called me and told me what you were going to wear today.
665,11,20,77,108,1.3888888888888888,0.06422492781043573,549,Crazy? At this company we like crazy.
665,8,26,74,108,1.3888888888888888,0.06004690293987734,549,You're not the first person to complain about the uniform.
665,7,28,73,108,1.3888888888888888,0.05858805583173792,549,My initial impression is that you will fit in just fine here.
665,8,26,74,108,1.3888888888888888,0.06004690293987734,549,"If you scratch my nose, you're hired."
665,7,28,73,108,1.3888888888888888,0.05858805583173792,549,I think you’re going to fit right in here.
665,11,20,77,108,1.3888888888888888,0.06422492781043573,549,Let's talk a little more about your experience running an asylum.
665,8,26,74,108,1.3888888888888888,0.06004690293987734,549,Coffee?
665,9,24,75,108,1.3888888888888888,0.061471138099105184,549,Kudos to us for our mutual restraint.
665,10,22,76,108,1.3888888888888888,0.06286311387234544,549,"Actually, I can empathize with your being late. I have been tied up myself this morning."
665,10,22,76,108,1.3888888888888888,0.06286311387234544,549,"While the position lacks wiggle room, it makes up for it through an added sense of security."
665,7,28,73,108,1.3888888888888888,0.05858805583173792,549,The key to this position is restraint.
665,7,28,73,108,1.3888888888888888,0.05858805583173792,549,The good news is that all our computers accept voice commands.
665,4,34,70,108,1.3888888888888888,0.053975452629488975,549,I think you will fit in here nicely.
665,10,22,76,108,1.3888888888888888,0.06286311387234544,549,We're bound to succeed.
665,10,22,76,108,1.3888888888888888,0.06286311387234544,549,We promote from within the asylum.
665,9,24,75,108,1.3888888888888888,0.061471138099105184,549,I knew you would fit into our organization the moment I saw you walk in.
665,5,32,71,108,1.3888888888888888,0.05555555555555555,549,You say you can type two words per minute.
665,7,28,73,108,1.3888888888888888,0.05858805583173792,549,I think you will fit right in.
665,10,22,76,108,1.3888888888888888,0.06286311387234544,549,We believe our workers will be more productive if they can't text or tweet.
665,9,24,75,108,1.3888888888888888,0.061471138099105184,549,Thank God for Siri!
665,6,30,72,108,1.3888888888888888,0.057091943561369755,549,"How weird, my nose stops itching the minute I take mine off, too!"
665,9,24,75,108,1.3888888888888888,0.061471138099105184,549,"Well, I've always said ""dress for the job you want""..."
665,10,22,76,108,1.3888888888888888,0.06286311387234544,549,I see you've done your research on the company climate. You'll fit in well here.
665,12,18,78,108,1.3888888888888888,0.06555845955163904,549,Looks like someone is dressing for the job she wants.
665,7,28,73,108,1.3888888888888888,0.05858805583173792,549,"Now that we're running the asylum, we'd be crazy to abandon all protocol."
665,11,20,77,108,1.3888888888888888,0.06422492781043573,549,I'm tied up on Tuesday as well. Does Wednesday work for you?
665,10,22,76,108,1.3888888888888888,0.06286311387234544,549,You can have the job if you can scratch my nose.
665,10,22,76,108,1.3888888888888888,0.06286311387234544,549,welcome to the team. I'll show you to your padded office.
665,9,24,75,108,1.3888888888888888,0.061471138099105184,549,Is your nose itchy too?
665,11,20,77,108,1.3888888888888888,0.06422492781043573,549,"I'm not just the owner, I'm also a client."
665,10,22,76,108,1.3888888888888888,0.06286311387234544,549,"No, YOURS is a strait jacket, mine is a deluxe kimono with hand warming pouch."
665,10,22,76,108,1.3888888888888888,0.06286311387234544,549,I can't help you... My hands are tied as well.
665,9,24,75,108,1.3888888888888888,0.061471138099105184,549,We'd be sane not to hire you.
665,6,30,72,108,1.3888888888888888,0.057091943561369755,549,I think you would make a good fit here.
665,7,28,73,108,1.3888888888888888,0.05858805583173792,549,I pride myself on being a hands-off manager
665,8,26,74,108,1.3888888888888888,0.06004690293987734,549,"I'm happy to see you are finally following the dress code, but now I'm receiving complaints about your attitude."
665,10,22,76,108,1.3888888888888888,0.06286311387234544,549,I will be so glad when this goes out of style.
707,8,26,75,109,1.385321100917431,0.05960034651674202,549,So what makes you think you're qualified for this position?
708,10,21,76,107,1.3831775700934579,0.06319096601610899,549,It seems like you'll fit right in.
708,4,33,70,107,1.3831775700934579,0.054176413008966307,549,You seem like a good fit for our organization.
708,12,17,78,107,1.3831775700934579,0.06592245196106829,549,It's exhilarating being off-med.
708,9,23,75,107,1.3831775700934579,0.06177995178691776,549,I'm thinking about having our department be a little more hands-on.
708,8,25,74,107,1.3831775700934579,0.060335948650358726,549,"I'm sorry, Linda. New White House Press Corp policy."
708,13,15,79,107,1.3831775700934579,0.06724660151869769,549,"I see your bind, but my hands are tied."
708,8,25,74,107,1.3831775700934579,0.060335948650358726,549,We think you're management material.
708,7,27,73,107,1.3831775700934579,0.058856528578260264,549,I've cut down on my texting.
708,12,17,78,107,1.3831775700934579,0.06592245196106829,549,"Yes, it does gets a little crazy here sometimes, but I think you'll fit right in."
708,5,31,71,107,1.3831775700934579,0.0557800992269936,549,"So, what makes you think you're a perfect fit for this position?"
708,8,25,74,107,1.3831775700934579,0.060335948650358726,549,I'm afraid our hands are tied
708,10,21,76,107,1.3831775700934579,0.06319096601610899,549,I have to pee.
708,11,19,77,107,1.3831775700934579,0.06457115400319402,549,You don't have to be crazy to be work here but...
708,8,25,74,107,1.3831775700934579,0.060335948650358726,549,"Why yes, we do have an office dress code."
708,11,19,77,107,1.3831775700934579,0.06457115400319402,549,I'll just send that one to voicemail
708,9,23,75,107,1.3831775700934579,0.06177995178691776,549,"Okay, you're hired. I like your style."
708,12,17,78,107,1.3831775700934579,0.06592245196106829,549,Oh don't worry. It's just until they get that crack in the glass ceiling repaired.
708,8,25,74,107,1.3831775700934579,0.060335948650358726,549,"Admittedly, it is keeping us off Facebook during business hours."
708,8,25,74,107,1.3831775700934579,0.060335948650358726,549,I think you’re going to fit right in here.
708,12,17,78,107,1.3831775700934579,0.06592245196106829,549,I didn't think 2016 could get any worse.
708,10,21,76,107,1.3831775700934579,0.06319096601610899,549,How do you keep your hair so neat?
708,7,27,73,107,1.3831775700934579,0.058856528578260264,549,I know how you feel.
708,8,25,74,107,1.3831775700934579,0.060335948650358726,549,I appreciate that we both share a high level of self-restraint
708,9,23,75,107,1.3831775700934579,0.06177995178691776,549,Hey! Same shirt!
708,7,27,73,107,1.3831775700934579,0.058856528578260264,549,Is that your phone or mine?
708,7,27,73,107,1.3831775700934579,0.058856528578260264,549,First the glass ceiling now this.
708,10,21,76,107,1.3831775700934579,0.06319096601610899,549,First the glass ceiling now this.
708,14,13,80,107,1.3831775700934579,0.06854517604521614,549,It's so we don't cut ourselves on the glass ceiling.
708,7,27,73,107,1.3831775700934579,0.058856528578260264,549,We gotta be crazy to work here.
708,9,23,75,107,1.3831775700934579,0.06177995178691776,549,I preferred the glass ceiling.
708,9,23,75,107,1.3831775700934579,0.06177995178691776,549,"As you can see, things are just crazy here at the moment."
708,11,19,77,107,1.3831775700934579,0.06457115400319402,549,"On top of all this, I am tongue-tied."
708,11,19,77,107,1.3831775700934579,0.06457115400319402,549,We've narrowed it down to you and Hannibal Lector.
708,8,25,74,107,1.3831775700934579,0.060335948650358726,549,The real challenge is that they want it in writing.
708,12,17,78,107,1.3831775700934579,0.06592245196106829,549,I need you to be more hands on.
708,9,23,75,107,1.3831775700934579,0.06177995178691776,549,So... it says here that you have experience in compliance.
708,9,23,75,107,1.3831775700934579,0.06177995178691776,549,HR really cracked down on social media in the workplace.
708,8,25,74,107,1.3831775700934579,0.060335948650358726,549,Restraint appears to be your strong suit.
708,8,25,74,107,1.3831775700934579,0.060335948650358726,549,We're going to have to let you go.
708,12,17,78,107,1.3831775700934579,0.06592245196106829,549,I thought the suggestion box was anonymous.
708,10,21,76,107,1.3831775700934579,0.06319096601610899,549,I told you this job would make you crazy.
708,10,21,76,107,1.3831775700934579,0.06319096601610899,549,The bind leading the bind.
708,11,19,77,107,1.3831775700934579,0.06457115400319402,549,"Yes, you must be crazy to work here"
708,7,27,73,107,1.3831775700934579,0.058856528578260264,549,You’re bound to get promoted.
752,10,21,77,108,1.3796296296296295,0.06270358685816387,549,It's only for the next four years.
753,7,26,73,106,1.3773584905660377,0.05912332001937198,549,Men just don't understand what we have to go through every day to look like this.
753,9,22,75,106,1.3773584905660377,0.0620882920424406,549,"Hi, Siri. Find Houdini straight jacket escape instructions."
753,5,30,71,106,1.3773584905660377,0.05600158865138336,549,I would say my management style is a little more hands off.
753,8,24,74,106,1.3773584905660377,0.060623934955017826,549,Your move.
753,10,20,76,106,1.3773584905660377,0.06351889898340929,549,I tried to adjust the thermostat too.
753,11,18,77,106,1.3773584905660377,0.0649179870866443,549,Welcome to the Trump transition team!
753,8,24,74,106,1.3773584905660377,0.060623934955017826,549,I like your style.
753,7,26,73,106,1.3773584905660377,0.05912332001937198,549,I think it is time we loosen up.
753,7,26,73,106,1.3773584905660377,0.05912332001937198,549,I'm sure you will fit in here.
753,5,30,71,106,1.3773584905660377,0.05600158865138336,549,"Well, you certainly appear qualified for a job here."
753,10,20,76,106,1.3773584905660377,0.06351889898340929,549,We have a hands-off management style.
753,11,18,77,106,1.3773584905660377,0.0649179870866443,549,It's not the glass ceiling that bothers me so much.
753,9,22,75,106,1.3773584905660377,0.0620882920424406,549,It's not as uncomfortable as an underwire bra!
753,8,24,74,106,1.3773584905660377,0.060623934955017826,549,It's just through the inauguration.
753,13,14,79,106,1.3773584905660377,0.06762938773947341,549,At least we only clicked on recipes. You should see what they did to Trina for downloading porn.
753,5,30,71,106,1.3773584905660377,0.05600158865138336,549,"To answer your question, Ms. Lopez, you don't have to be crazy to work here, but it does help."
753,8,24,74,106,1.3773584905660377,0.060623934955017826,549,``Remember when the EPA was a fun place to work?''
753,7,26,73,106,1.3773584905660377,0.05912332001937198,549,"I'm wish there was another option, but my hands are tied too."
753,15,10,81,106,1.3773584905660377,0.07023619526035246,549,"I'd like to help you, but as you can see, my only possible response is a tired cliche."
753,5,30,71,106,1.3773584905660377,0.05600158865138336,549,It seems we're in a bind.
753,6,28,72,106,1.3773584905660377,0.05758361269316046,549,"""I'll understand if you need some time to respond""."
753,9,22,75,106,1.3773584905660377,0.0620882920424406,549,This is standard procedure for all exit interviews.
753,8,24,74,106,1.3773584905660377,0.060623934955017826,549,Our business depends on strong verbal skills.
753,9,22,75,106,1.3773584905660377,0.0620882920424406,549,"If you escape first, the job is yours."
753,8,24,74,106,1.3773584905660377,0.060623934955017826,549,And you had to ask for a binding agreement.
753,9,22,75,106,1.3773584905660377,0.0620882920424406,549,"Unfortunately, we cannot offer any lateral mobility."
753,9,22,75,106,1.3773584905660377,0.0620882920424406,549,You scratch my back and I'll scratch yours.
753,11,18,77,106,1.3773584905660377,0.0649179870866443,549,"I'm pretty sure the therapist suggested bonding, not bondage, Mom."
753,7,26,73,106,1.3773584905660377,0.05912332001937198,549,I think you'll fit right in around here.
753,10,20,76,106,1.3773584905660377,0.06351889898340929,549,"Well, one of us is going to have to change."
753,9,22,75,106,1.3773584905660377,0.0620882920424406,549,"What unique skills can you bring to Houdini, Houdini and Houdini?"
753,9,22,75,106,1.3773584905660377,0.0620882920424406,549,Did you see yourself stuck in this same position 20 years ago?
753,9,22,75,106,1.3773584905660377,0.0620882920424406,549,Where do you see yourself in 5 minutes? 10?
753,10,20,76,106,1.3773584905660377,0.06351889898340929,549,We've never been big on touchy-feely at this company either.
753,9,22,75,106,1.3773584905660377,0.0620882920424406,549,Binding arbitration hasn't solved anything.
753,6,28,72,106,1.3773584905660377,0.05758361269316046,549,"Our philosophy here is simple: first, do no harm."
753,7,26,73,106,1.3773584905660377,0.05912332001937198,549,"Well, I could say the same about you."
753,11,18,77,106,1.3773584905660377,0.0649179870866443,549,With my nose.
753,10,20,76,106,1.3773584905660377,0.06351889898340929,549,What I'm offering you is an unbinding contract.
753,6,28,72,106,1.3773584905660377,0.05758361269316046,549,It's the only way I can stay off Twitter.
753,9,22,75,106,1.3773584905660377,0.0620882920424406,549,"After ""casual Friday"", ""srraight jacket Monday"" just seemed to follow."
753,9,22,75,106,1.3773584905660377,0.0620882920424406,549,I think we're bound to succeed.
753,11,18,77,106,1.3773584905660377,0.0649179870866443,549,"The office culture is a bit restrictive, but you get used to it."
753,10,20,76,106,1.3773584905660377,0.06351889898340929,549,"As is our policy, this will be a binding arbitration"
753,8,24,74,106,1.3773584905660377,0.060623934955017826,549,"Like me, I can see you have great restraint."
753,8,24,74,106,1.3773584905660377,0.060623934955017826,549,Unfortunately my hands are tied on this one.
753,6,28,72,106,1.3773584905660377,0.05758361269316046,549,Welcome to our anger management program.
800,9,22,76,107,1.3738317757009346,0.061606318458313845,549,"No, really, it looks much better on you!"
800,6,28,73,107,1.3738317757009346,0.05715182625447508,549,"And, just what makes you think that you can do this job as well as I can?"
800,11,18,78,107,1.3738317757009346,0.06440504607946101,549,We are a hands free workplace
803,8,23,74,105,1.3714285714285714,0.060910585487131366,549,HR? Very nice. Mine's from Compliance.
803,7,25,73,105,1.3714285714285714,0.05938812373896783,549,You appear to have all the qualifications for a cabinet position
803,6,27,72,105,1.3714285714285714,0.05782559172273788,549,"Congratulations on your acceptance, and welcome to Houdini University."
803,11,17,77,105,1.3714285714285714,0.06526522790763614,549,"On top of everything else, I got my panties in a twist."
803,7,25,73,105,1.3714285714285714,0.05938812373896783,549,I think I preferred Casual Fridays.
803,6,27,72,105,1.3714285714285714,0.05782559172273788,549,We're looking for someone who can think outside the jacket.
803,9,21,75,105,1.3714285714285714,0.06239591018276215,549,"I much preferred dress-down Fridays to lock-down Fridays, too."
803,12,15,78,105,1.3714285714285714,0.06665358322690439,549,You're in luck-we're looking for straight-laced people.
803,9,21,75,105,1.3714285714285714,0.06239591018276215,549,"""The most difficult part of this job is getting dressed in the morning""."
803,11,17,77,105,1.3714285714285714,0.06526522790763614,549,I use mine to keep from hitting reply all
803,9,21,75,105,1.3714285714285714,0.06239591018276215,549,How can I help you?
803,5,29,71,105,1.3714285714285714,0.05621964847750819,549,I see a lot of myself in you.
803,12,15,78,105,1.3714285714285714,0.06665358322690439,549,First one out buys dinner.
803,10,19,76,105,1.3714285714285714,0.06384668973944933,549,This no tweeting policy is a bit strict.
803,7,25,73,105,1.3714285714285714,0.05938812373896783,549,I love your jacket. Where'd you get it?
803,9,21,75,105,1.3714285714285714,0.06239591018276215,549,I hate this new quit smoking thing the company introduced.
803,7,25,73,105,1.3714285714285714,0.05938812373896783,549,"Yes, sexual harassment claims are down. However...."
803,8,23,74,105,1.3714285714285714,0.060910585487131366,549,I'm tied up all week too.
803,6,27,72,105,1.3714285714285714,0.05782559172273788,549,Me? They said show restraint. And you?
803,11,17,77,105,1.3714285714285714,0.06526522790763614,549,The company has instituted some highly effective anti-harassment policies.
803,13,13,79,105,1.3714285714285714,0.06801360408136047,549,"I understand you're seeking asylum, too."
803,11,17,77,105,1.3714285714285714,0.06526522790763614,549,Not only have I lost 20 pounds but I've become more verbally articulate.
803,10,19,76,105,1.3714285714285714,0.06384668973944933,549,I appreciate that. Most people here at the office don't view me as a role model.
803,11,17,77,105,1.3714285714285714,0.06526522790763614,549,"Siri, play that Houdini YouTube video again."
803,8,23,74,105,1.3714285714285714,0.060910585487131366,549,At orientation we'll also need your belt and shoelaces.
803,4,31,70,105,1.3714285714285714,0.054566461235674844,549,"I'd really like to help you, but my hands are tied."
803,5,29,71,105,1.3714285714285714,0.05621964847750819,549,Remember how we used to jokingly refer to this place as an insane asylum?
803,6,27,72,105,1.3714285714285714,0.05782559172273788,549,Guess they're serious about the new no-hugging policy.
803,10,19,76,105,1.3714285714285714,0.06384668973944933,549,And he hasn't even been inaugurated yet.
803,8,23,74,105,1.3714285714285714,0.060910585487131366,549,"In the olden days, people just exerted self-control."
803,8,23,74,105,1.3714285714285714,0.060910585487131366,549,We're a fairly strait laced group here. I think you'll fit in just fine.
803,10,19,76,105,1.3714285714285714,0.06384668973944933,549,Oh geez. I wish I'd picked a different top for this interview.
803,10,19,76,105,1.3714285714285714,0.06384668973944933,549,"No, I'm tied up until four. How about four thirty?"
803,8,23,74,105,1.3714285714285714,0.060910585487131366,549,"Maybe it's just me, but I can't seem to get my arms around this concept."
803,8,23,74,105,1.3714285714285714,0.060910585487131366,549,You look like you're crazy enough to work here.
803,9,21,75,105,1.3714285714285714,0.06239591018276215,549,They elected Trump and we're the crazy ones.
803,9,21,75,105,1.3714285714285714,0.06239591018276215,549,"On the plus side, I think I've lost 5 lbs."
803,10,19,76,105,1.3714285714285714,0.06384668973944933,549,"Other than this crazy dress code, it's a great place to work."
803,10,19,76,105,1.3714285714285714,0.06384668973944933,549,This is the part of the interview that tends to trigger the most lawsuits.
803,11,17,77,105,1.3714285714285714,0.06526522790763614,549,I'm suggesting we drop straightjacket Monday's and bring back casual Friday's.
803,11,17,77,105,1.3714285714285714,0.06526522790763614,549,I sense you realize the importance of being wrapped up in your work.
803,8,23,74,105,1.3714285714285714,0.060910585487131366,549,"You can speak freely around here, but I admire your restraint."
803,9,21,75,105,1.3714285714285714,0.06239591018276215,549,I think you'd be a great fit here.
803,8,23,74,105,1.3714285714285714,0.060910585487131366,549,The previous employee found this position too constraining.
803,8,23,74,105,1.3714285714285714,0.060910585487131366,549,Our mental health benefits have been temporarily suspended.
803,9,21,75,105,1.3714285714285714,0.06239591018276215,549,"According to Wikipedia, we both can't be submissive."
803,6,27,72,105,1.3714285714285714,0.05782559172273788,549,"Yes, but we can still lean in."
850,12,14,77,103,1.3689320388349515,0.06757935772938865,549,It's part of Trump's new groping policy.
850,5,28,70,103,1.3689320388349515,0.05687176564359283,549,I think we’ve really succeeded in creating a safe space.
850,9,20,74,103,1.3689320388349515,0.06321287340263844,549,Any experience running an asylum?
850,5,28,70,103,1.3689320388349515,0.05687176564359283,549,Welcome to magician school.
850,8,22,73,103,1.3689320388349515,0.0616887344230568,549,May I ask why you were referred to me?
850,9,20,74,103,1.3689320388349515,0.06321287340263844,549,Does this straight-jacket make me look fat?
850,7,24,72,103,1.3689320388349515,0.06012597230497708,549,I told them we're tied up in a meeting.
850,9,20,74,103,1.3689320388349515,0.06321287340263844,549,I see from your resume that you are familiar with this jobs constraints
850,8,22,73,103,1.3689320388349515,0.0616887344230568,549,Does the mail guy still ask you to sign for stuff?
850,4,30,69,103,1.3689320388349515,0.05517273165541275,549,Can you type with your nose?
850,8,22,73,103,1.3689320388349515,0.0616887344230568,549,"I see you have many qualifications, but can you type?"
850,7,24,72,103,1.3689320388349515,0.06012597230497708,549,I'm still not sure this was the best way to stop all the finger pointing around here.
850,6,26,71,103,1.3689320388349515,0.05852149294506513,549,You seem to understand our culture
850,10,18,75,103,1.3689320388349515,0.06470111879185364,549,"In exchange for casual Fridays, the boss made us agree to straight jacket Mondays."
850,8,22,73,103,1.3689320388349515,0.0616887344230568,549,"Well, I don't think I care much for your body language either."
850,11,16,76,103,1.3689320388349515,0.0661558930256188,549,I liked the job better when they just let us rant and slap the crap out of each other.
850,6,26,71,103,1.3689320388349515,0.05852149294506513,549,If the glass ceiling wasn't enough
850,7,24,72,103,1.3689320388349515,0.06012597230497708,549,There's no retirement plan; HR just removes the jacket when you're ready.
850,7,24,72,103,1.3689320388349515,0.06012597230497708,549,"So, tell me why you think you'd fit in with our company."
850,4,30,69,103,1.3689320388349515,0.05517273165541275,549,It's crazy how much work I can get done when I can't check my phone.
850,11,16,76,103,1.3689320388349515,0.0661558930256188,549,Turns out the glass ceiling was only the first hurdle.
850,10,18,75,103,1.3689320388349515,0.06470111879185364,549,"After lunch, my assistant will drop by to hit the ESC key."
850,8,22,73,103,1.3689320388349515,0.0616887344230568,549,So you're saying you feel restrained in your current position?
850,10,18,75,103,1.3689320388349515,0.06470111879185364,549,I'll be honest with you. I'm not too sure how to get out of this either...
850,8,22,73,103,1.3689320388349515,0.0616887344230568,549,Finally - a therapist who understands me.
850,12,14,77,103,1.3689320388349515,0.06757935772938865,549,"At Houdini Corp., no one can escape Casual Friday."
850,7,24,72,103,1.3689320388349515,0.06012597230497708,549,"I know, right? But we've been able to reduce Carpal Tunnel cases by 80%."
850,7,24,72,103,1.3689320388349515,0.06012597230497708,549,I'm free at three.
850,9,20,74,103,1.3689320388349515,0.06321287340263844,549,...and what makes you a good fit for Houdini Industries?
850,8,22,73,103,1.3689320388349515,0.0616887344230568,549,"Our corporate philosophy is, keep doing the same thing over and over, until we get different results."
850,7,24,72,103,1.3689320388349515,0.06012597230497708,549,The mental health benefits offered here are world-class.
850,10,18,75,103,1.3689320388349515,0.06470111879185364,549,Maybe we should rethink Straightjacket Fridays.
850,9,20,74,103,1.3689320388349515,0.06321287340263844,549,Couldn't HR just have asked us to stop dating?
850,9,20,74,103,1.3689320388349515,0.06321287340263844,549,I'm tied up all day today and tomorrow. Are you free any time Thursday?
850,12,14,77,103,1.3689320388349515,0.06757935772938865,549,"I know we've both been crazy busy..."""
850,8,22,73,103,1.3689320388349515,0.0616887344230568,549,"That's when we bought out management, so now the inmates run the asylum."
850,7,24,72,103,1.3689320388349515,0.06012597230497708,549,"Welcome. As you can see, our industry is highly regulated."
850,6,26,71,103,1.3689320388349515,0.05852149294506513,549,You remind me of a young me.
850,6,26,71,103,1.3689320388349515,0.05852149294506513,549,"You're right, nose typing is a bitch."
850,8,22,73,103,1.3689320388349515,0.0616887344230568,549,You'll find we're not much for body language.
850,8,22,73,103,1.3689320388349515,0.0616887344230568,549,And you can still do 100 words a minute? Really?
891,9,21,76,106,1.3679245283018868,0.06190371867670124,549,"OK it's a deal. If you'll scratch my back, I'll scratch yours."
891,9,21,76,106,1.3679245283018868,0.06190371867670124,549,Handcuffs are fine on Casual Fridays.
891,4,31,71,106,1.3679245283018868,0.054162697397917375,549,Let's reschedule for a time when we're both freer.
891,8,23,75,106,1.3679245283018868,0.06043488948187966,549,"Some say the dress code is too restrictive, but I've come to like it."
891,8,23,75,106,1.3679245283018868,0.06043488948187966,549,Tell me about a time when you struggled with a particularly difficult garment
891,10,19,77,106,1.3679245283018868,0.063338494656262,549,"So, yeah, you'd have to be crazy to take over this job."
897,9,20,75,104,1.3653846153846154,0.062702535624994,549,Do you do your own hair?
897,6,26,72,104,1.3653846153846154,0.0580645199897951,549,You must be from the help desk.
897,9,20,75,104,1.3653846153846154,0.062702535624994,549,"But on casual Fridays, jackets aren't required."
897,9,20,75,104,1.3653846153846154,0.062702535624994,549,"And with the meds, productivity goes way up."
897,10,18,76,104,1.3653846153846154,0.06417409501652323,549,"I'm sorry, but I'm looking for a typist."
902,9,19,74,102,1.3627450980392157,0.06352918407268339,549,Working at EPA under Mr. Trump is going to be so much fun. I see you got your new uniform from his transition team.
902,10,17,75,102,1.3627450980392157,0.06503917503863182,549,It's Houdini Fridays.
902,10,17,75,102,1.3627450980392157,0.06503917503863182,549,Quit kicking the desk !
902,4,29,69,102,1.3627450980392157,0.055364897950925446,549,"How about ""Rock, Paper, Chins?"""
902,6,25,71,102,1.3627450980392157,0.05876687882341709,549,You'd have to be crazy NOT to work here.
902,9,19,74,102,1.3627450980392157,0.06352918407268339,549,Is that your phone or mine?
902,7,23,72,102,1.3627450980392157,0.06039605208464448,549,I see you got your promotion. Congratulations and welcome to management!
902,9,19,74,102,1.3627450980392157,0.06352918407268339,549,Welcome to the transition team. I see you already have a uniform.
902,9,19,74,102,1.3627450980392157,0.06352918407268339,549,"Sure they're uncomfortable, but they've really cut down on sexual harassment lawsuits."
902,8,21,73,102,1.3627450980392157,0.06198241821820111,549,"The new dress code is a bit restrictive, but it cuts down on sexual harassment lawsuits."
902,7,23,72,102,1.3627450980392157,0.06039605208464448,549,I also felt that way at first. Eventually you see it as a different kind of freedom.
902,10,17,75,102,1.3627450980392157,0.06503917503863182,549,"Siri, search ""Houdini."""
902,8,21,73,102,1.3627450980392157,0.06198241821820111,549,It does work--I've lost 5 pounds already.
902,10,17,75,102,1.3627450980392157,0.06503917503863182,549,"We'd like to give you a raise, but our hands are tied."
902,5,27,70,102,1.3627450980392157,0.05709123387947828,549,A raise? Sorry my hands are tied.
902,9,19,74,102,1.3627450980392157,0.06352918407268339,549,Can you start tomorrow? We're really in a bind here.
902,7,23,72,102,1.3627450980392157,0.06039605208464448,549,"As you might surmise,we are not a very hands on company."
902,8,21,73,102,1.3627450980392157,0.06198241821820111,549,"And after our last sexual harassment case was settled, we implemented a few changes."
902,6,25,71,102,1.3627450980392157,0.05876687882341709,549,"You did well on the personality test, but how are your typing skills?"
902,9,19,74,102,1.3627450980392157,0.06352918407268339,549,"You will report to our boss, Mr. Houdini."
902,11,15,76,102,1.3627450980392157,0.06651489570367444,549,It's the hottest women's fashion in the Make America Great campaign.
902,5,27,70,102,1.3627450980392157,0.05709123387947828,549,You're bound to be a perfect fit for our company.
902,9,19,74,102,1.3627450980392157,0.06352918407268339,549,"No, you don't have to be. But it helps."
902,7,23,72,102,1.3627450980392157,0.06039605208464448,549,What's your restraining order for?
902,10,17,75,102,1.3627450980392157,0.06503917503863182,549,Finally! A foolproof way for us to stop wasting time on the Internet.
902,14,9,79,102,1.3627450980392157,0.0707576323287134,549,"Yes, the EPA is different under a Trump administration."
902,11,15,76,102,1.3627450980392157,0.06651489570367444,549,"I'm flattered by your remarkable restraint, Miss Simpson, but I'm afraid my hands are tied."
902,10,17,75,102,1.3627450980392157,0.06503917503863182,549,Am I crazy or is the best interview ever?
902,10,17,75,102,1.3627450980392157,0.06503917503863182,549,"Well, let me first begin by telling you that our ”Kleptomania” program has a 100 percent success rate!"
902,7,23,72,102,1.3627450980392157,0.06039605208464448,549,I guess they are serious about us learning to use Siri?
902,9,19,74,102,1.3627450980392157,0.06352918407268339,549,Please tell me you left the door unlocked.
902,9,19,74,102,1.3627450980392157,0.06352918407268339,549,We at Tech Tech believe that physical constraints encourage creativity. Raise your hand if you agree.
902,8,21,73,102,1.3627450980392157,0.06198241821820111,549,This binding arbitration makes it impossible to get anything done!
902,7,23,72,102,1.3627450980392157,0.06039605208464448,549,"Like a lot of therapists, I got into it to work on my own issues."
902,9,19,74,102,1.3627450980392157,0.06352918407268339,549,It's an insane place to work-you'll love it!
902,6,25,71,102,1.3627450980392157,0.05876687882341709,549,Sometimes it gets nuts around here...you'll fit right in.
902,10,17,75,102,1.3627450980392157,0.06503917503863182,549,"I wish I could help you, Jill, but my hands are tied."
902,8,21,73,102,1.3627450980392157,0.06198241821820111,549,When I first came this place was bedlam.
902,8,21,73,102,1.3627450980392157,0.06198241821820111,549,"I'd help you out, but my hands are tied."
902,6,25,71,102,1.3627450980392157,0.05876687882341709,549,The new dress code is a bit restrictive.
902,9,19,74,102,1.3627450980392157,0.06352918407268339,549,"First question , do you feel comfortable with the constraints this company puts on its' employees?"
902,11,15,76,102,1.3627450980392157,0.06651489570367444,549,You're hired! Welcome to the Trump administration.
902,6,25,71,102,1.3627450980392157,0.05876687882341709,549,Do you think the dress code is too restrictive?
902,10,17,75,102,1.3627450980392157,0.06503917503863182,549,I thought this would be the safest way to discuss our mutual interest in Tom.
902,7,23,72,102,1.3627450980392157,0.06039605208464448,549,You realize this position means you'll be tied up at work a lot?
902,7,23,72,102,1.3627450980392157,0.06039605208464448,549,You understand that we have a binding agreement?
902,9,19,74,102,1.3627450980392157,0.06352918407268339,549,This company adheres to a very strict hands off policy.
902,9,19,74,102,1.3627450980392157,0.06352918407268339,549,You're right. This social media detox is brutal.
902,4,29,69,102,1.3627450980392157,0.055364897950925446,549,"Yes, insane is the new black."
902,11,15,76,102,1.3627450980392157,0.06651489570367444,549,"In the service of full disclosure, we like to give applicants a sense of what it feels like to work here."
902,7,23,72,102,1.3627450980392157,0.06039605208464448,549,I like an employee that shows a lot of restraint
902,9,19,74,102,1.3627450980392157,0.06352918407268339,549,I can't wait until Thorazine Thursday.
902,11,15,76,102,1.3627450980392157,0.06651489570367444,549,Management is strictly hands off here.
902,4,29,69,102,1.3627450980392157,0.055364897950925446,549,Tell me about a challenge that you overcame at work or school.
902,8,21,73,102,1.3627450980392157,0.06198241821820111,549,"On the upside, Siri and I have become really close."
902,8,21,73,102,1.3627450980392157,0.06198241821820111,549,Casual fridays are a big perk around here.
958,4,28,69,101,1.3564356435643565,0.05555152530338827,549,"I may be crazy, but I think we discovered the cure for compulsive texting."
958,8,20,73,101,1.3564356435643565,0.062274000766401535,549,"It's more than a metaphor, it's a dress code here at Houdini, Inc."
958,10,16,75,101,1.3564356435643565,0.06537653076918486,549,Glass ceiling? What about the damn straight jackets?
958,6,24,71,101,1.3564356435643565,0.05900857198317362,549,Call me crazy but I like your style!
958,5,26,70,101,1.3564356435643565,0.05730612328113974,549,I personally find this job is a bit confining...
958,11,14,76,101,1.3564356435643565,0.06687384075551794,549,These new Anti Groping Policy has interfered with my productivity.
958,7,22,72,101,1.3564356435643565,0.06066326210709066,549,Think of it as a self hug.
958,5,26,70,101,1.3564356435643565,0.05730612328113974,549,Has your day been as crazy as mine?
958,6,24,71,101,1.3564356435643565,0.05900857198317362,549,And what makes you think you'd be perfect for this job?
958,10,16,75,101,1.3564356435643565,0.06537653076918486,549,"So, what makes you think you'd be a good fit for our company?"
958,10,16,75,101,1.3564356435643565,0.06537653076918486,549,Welcome to Kleptomaniacs Anonymous.
958,5,26,70,101,1.3564356435643565,0.05730612328113974,549,Tell them we're tied up for the foreseeable future.
958,8,20,73,101,1.3564356435643565,0.062274000766401535,549,"If you can get out of the straight jacket before me, the job is yours."
958,4,28,69,101,1.3564356435643565,0.05555152530338827,549,"When I look at you, Janice, I'm reminded of a younger me."
958,6,24,71,101,1.3564356435643565,0.05900857198317362,549,"As you may be aware, my management style is strictly hands-off."
958,4,28,69,101,1.3564356435643565,0.05555152530338827,549,Sounds like another crazy idea - tell me more.
958,9,18,74,101,1.3564356435643565,0.06384411463427132,549,"I'm sorry, but I'm going to have to let you go"
958,9,18,74,101,1.3564356435643565,0.06384411463427132,549,Your just the type of employee we were looking for.
958,8,20,73,101,1.3564356435643565,0.062274000766401535,549,You seem very straight-laced. I like that!
958,6,24,71,101,1.3564356435643565,0.05900857198317362,549,A glass ceiling is the least of our problems.
958,8,20,73,101,1.3564356435643565,0.062274000766401535,549,"Before we finalize your performance review, I need to understand whether you are enthusiastically embracing or sarcastically mocking the new corporate dress code."
958,10,16,75,101,1.3564356435643565,0.06537653076918486,549,Let's put our heads together and see if the three of us can't think of a solution.
958,10,16,75,101,1.3564356435643565,0.06537653076918486,549,"I'd love to move forward with your proposal, but my hands are tied."
958,6,24,71,101,1.3564356435643565,0.05900857198317362,549,They did say you had to be crazy to work here.
958,10,16,75,101,1.3564356435643565,0.06537653076918486,549,The job is yours if you can scratch my nose.
958,9,18,74,101,1.3564356435643565,0.06384411463427132,549,Let's ask Siri.
958,8,20,73,101,1.3564356435643565,0.062274000766401535,549,And I think you'll be a perfect fit for our hands-off style of management.
958,7,22,72,101,1.3564356435643565,0.06066326210709066,549,"Hey Siri, pencil her in for the 12th."
958,7,22,72,101,1.3564356435643565,0.06066326210709066,549,"So, now you know why we use voice recognition software."
958,8,20,73,101,1.3564356435643565,0.062274000766401535,549,We run a very hands-off operation.
958,7,22,72,101,1.3564356435643565,0.06066326210709066,549,"I wish I could help, but my hands are tied."
958,7,22,72,101,1.3564356435643565,0.06066326210709066,549,I must be crazy but...you're hired.
958,10,16,75,101,1.3564356435643565,0.06537653076918486,549,If you complete the application for the Harry Houdini Fan Club in two minutes you're in.
958,8,20,73,101,1.3564356435643565,0.062274000766401535,549,"Between you and me, I find the dress code a bit restrictive."
958,9,18,74,101,1.3564356435643565,0.06384411463427132,549,"I'd love to hire you but my hands are...well, you know."
958,6,24,71,101,1.3564356435643565,0.05900857198317362,549,"Well, I think that about wraps up the interview"
958,10,16,75,101,1.3564356435643565,0.06537653076918486,549,Welcome to the White House
958,11,14,76,101,1.3564356435643565,0.06687384075551794,549,It looks like we are both tied up. Let's reschedule next week.
958,7,22,72,101,1.3564356435643565,0.06066326210709066,549,Why do you think you would be a good fit in our company?
958,6,24,71,101,1.3564356435643565,0.05900857198317362,549,Is this the only way to quit social media?
958,4,28,69,101,1.3564356435643565,0.05555152530338827,549,It's always crazy around here during the holidays.
958,6,24,71,101,1.3564356435643565,0.05900857198317362,549,My itch is right in the middle of my back. Where's yours?
958,8,20,73,101,1.3564356435643565,0.062274000766401535,549,Let's call it the Houdini Diet.
958,6,24,71,101,1.3564356435643565,0.05900857198317362,549,Seriously? You really don’t think women are given the same opportunity here as men?
958,8,20,73,101,1.3564356435643565,0.062274000766401535,549,I'm tied up all week too.
958,8,20,73,101,1.3564356435643565,0.062274000766401535,549,Can you recall a time you overcame adversity? Right now doesn't count.
958,7,22,72,101,1.3564356435643565,0.06066326210709066,549,"Of course, the one day I didn't bring my handsfree device."
958,11,14,76,101,1.3564356435643565,0.06687384075551794,549,"Yes, the inmates are now running the asylum."
958,12,12,77,101,1.3564356435643565,0.06833835218509861,549,"No, YOU google Houdini."
958,7,22,72,101,1.3564356435643565,0.06066326210709066,549,I hate these no-texting Tuesdays too.
958,6,24,71,101,1.3564356435643565,0.05900857198317362,549,You can be strait with me.
958,8,20,73,101,1.3564356435643565,0.062274000766401535,549,"Even by our standards you're wound a little too tight, Marcy."
1010,8,20,74,102,1.3529411764705883,0.061759389995976265,549,I see you're feeling the same way about the election as I am.
1010,10,16,76,102,1.3529411764705883,0.06482666406815095,549,I know it's uncomfortable but it's part of that new law Republicans passed to keep women and minorities from voting.
1012,7,21,72,100,1.35,0.06092717958449424,549,I love your outfit.
1012,9,17,74,100,1.35,0.06415731927193978,549,"Ok, I get it - no more 'reply all'"
1012,8,19,73,100,1.35,0.06256309946079569,549,I preferred it when they used mediators.
1012,12,11,77,100,1.35,0.06871842709362767,549,Next time I'm going to ask for the gay jacket.
1012,8,19,73,100,1.35,0.06256309946079569,549,Are you tied up for lunch?
1012,8,19,73,100,1.35,0.06256309946079569,549,"Together, we can make the asylum great again."
1012,7,21,72,100,1.35,0.06092717958449424,549,"It gets a little crazy around here, but I see from your resume' that you have previous experience with that."
1012,8,19,73,100,1.35,0.06256309946079569,549,These new computer security measures are crazy.
1012,7,21,72,100,1.35,0.06092717958449424,549,"Crazy week, right?"
1012,8,19,73,100,1.35,0.06256309946079569,549,"Honestly, I prefer casual Friday."
1012,7,21,72,100,1.35,0.06092717958449424,549,"So, we start each new hire with our disorientation program."
1012,7,21,72,100,1.35,0.06092717958449424,549,You seem like a good fit.
1012,7,21,72,100,1.35,0.06092717958449424,549,"I know we've had our differences, but things will improve now that we are showing some restraint."
1012,9,17,74,100,1.35,0.06415731927193978,549,"I prefer a hands-off approach, too."
1012,9,17,74,100,1.35,0.06415731927193978,549,My nose itches.
1012,8,19,73,100,1.35,0.06256309946079569,549,You seem to be a great fit for our company.
1012,4,27,69,100,1.35,0.055732042902271274,549,I think this new diet is going to work great for both of us
1012,6,23,71,100,1.35,0.059246105442476216,549,"I don't know about you, Barb, but while I still crave the nicotine, I don't have to worry about what to do with my hands."
1012,10,15,75,100,1.35,0.06571287406727709,549,The good news is the new uniform policy has reduced harassment claims...
1012,8,19,73,100,1.35,0.06256309946079569,549,Looks to me that you are bound to get this job.
1012,10,15,75,100,1.35,0.06571287406727709,549,We try to take a hands off approach around here.
1012,9,17,74,100,1.35,0.06415731927193978,549,we've both been so tied up.. we finally have a chance to meet face to face.
1012,8,19,73,100,1.35,0.06256309946079569,549,I want to be straight with you Jackie.
1012,7,21,72,100,1.35,0.06092717958449424,549,Who are you wearing?
1012,7,21,72,100,1.35,0.06092717958449424,549,I lost 7 lbs last week and it beats eating Kale
1012,5,25,70,100,1.35,0.057515917866976685,549,I guess it's one way of keeping us off our cellphones.
1012,7,21,72,100,1.35,0.06092717958449424,549,"And of course, there's casual fridays."
1012,6,23,71,100,1.35,0.059246105442476216,549,We rarely see a job applicant so much in tune with our company's values.
1040,10,14,74,98,1.346938775510204,0.06663130546636481,549,We use restraint here.
1040,4,26,68,98,1.346938775510204,0.05636816702539816,549,I'm not crazy about the new dress code.
1040,6,22,70,98,1.346938775510204,0.05998464074455056,549,Wish I could help you but my hands are tied.
1040,10,14,74,98,1.346938775510204,0.06663130546636481,549,I feel bound to advise you that the position can sometimes be very uncomfortable.
1040,7,20,71,98,1.346938775510204,0.06171345526688326,549,Love the shoes!
1040,7,20,71,98,1.346938775510204,0.06171345526688326,549,I'm afraid my hands are tied in this matter.
1040,7,20,71,98,1.346938775510204,0.06171345526688326,549,"Honestly, I love working here… but the dress-code sucks!"
1040,6,22,70,98,1.346938775510204,0.05998464074455056,549,It's not unusual to get tied up at the office
1040,7,20,71,98,1.346938775510204,0.06171345526688326,549,"No, I'm so sorry. I can't validate your parking."
1040,7,20,71,98,1.346938775510204,0.06171345526688326,549,My husband doesn't take me seriously when I tell him I'm tied up at work.
1040,8,18,72,98,1.346938775510204,0.06339514174368889,549,Tell me why you'd like to enroll here at The Houdini School.
1040,6,22,70,98,1.346938775510204,0.05998464074455056,549,"So, who does your hair?"
1040,6,22,70,98,1.346938775510204,0.05998464074455056,549,We could file a complaint with Human Resources but their hands are tied too.
1040,8,18,72,98,1.346938775510204,0.06339514174368889,549,I never interpreted binding arbitration literally
1040,8,18,72,98,1.346938775510204,0.06339514174368889,549,So much for freedom of the press
1040,8,18,72,98,1.346938775510204,0.06339514174368889,549,I love your jacket. I got mine at Loony Bin's.
1040,10,14,74,98,1.346938775510204,0.06663130546636481,549,Your resume is impressive. What else do you think qualifies you to work at the Apex Fruit Cake Company?
1040,6,22,70,98,1.346938775510204,0.05998464074455056,549,"You'll love ""bring your imaginary friend to work"" day."
1040,9,16,73,98,1.346938775510204,0.06503335630603123,549,Tell me why you think you are suitable for a position with our organization
1040,6,22,70,98,1.346938775510204,0.05998464074455056,549,This is a special program for two-time text offenders.
1040,10,14,74,98,1.346938775510204,0.06663130546636481,549,I was normal until I woke up on November 9. You?
1040,7,20,71,98,1.346938775510204,0.06171345526688326,549,These are not required on casual Fridays.
1040,5,24,69,98,1.346938775510204,0.05820449887704549,549,Yes I think you'll fit in here quite well.
1040,9,16,73,98,1.346938775510204,0.06503335630603123,549,"Where do I see myself in five years? Hopefully, wearing your straight jacket."""
1040,5,24,69,98,1.346938775510204,0.05820449887704549,549,I would like to help but our hands are tied.
1040,8,18,72,98,1.346938775510204,0.06339514174368889,549,You're hired. Enjoy your padded cubicle.
1040,9,16,73,98,1.346938775510204,0.06503335630603123,549,I see you have experience in a high stress environment.
1040,8,18,72,98,1.346938775510204,0.06339514174368889,549,"I'm sorry, but my hands are tied."
1040,9,16,73,98,1.346938775510204,0.06503335630603123,549,Where do you see yourself in five years?
1040,8,18,72,98,1.346938775510204,0.06339514174368889,549,So why are you qualified to be one of the inmates running the asylum?
1040,8,18,72,98,1.346938775510204,0.06339514174368889,549,"Another year, another manager returning from a team-building seminar."
1040,8,18,72,98,1.346938775510204,0.06339514174368889,549,I can't wait for casual friday
1040,7,20,71,98,1.346938775510204,0.06171345526688326,549,"Look, I'm not crazy about it either."
1040,8,18,72,98,1.346938775510204,0.06339514174368889,549,"As you know, my door is always open."
1040,8,18,72,98,1.346938775510204,0.06339514174368889,549,They say I'm the perfect editor.
1040,4,26,68,98,1.346938775510204,0.05636816702539816,549,"Yes, it's a very safe work environment.."
1040,6,22,70,98,1.346938775510204,0.05998464074455056,549,It's frustrating but our hands are tied.
1040,9,16,73,98,1.346938775510204,0.06503335630603123,549,"Madam Secretary! This is not what I meant by ""arms control."""
1040,7,20,71,98,1.346938775510204,0.06171345526688326,549,How did you ever get your hair to look so great?
1040,8,18,72,98,1.346938775510204,0.06339514174368889,549,"Are you really that empathetic, Dr., or am I just projecting?"
1040,10,14,74,98,1.346938775510204,0.06663130546636481,549,"I'm sorry, but we're only seeking candidates who recently swallowed a key."
1040,7,20,71,98,1.346938775510204,0.06171345526688326,549,Wow. The inmates really do run the asylum.
1040,5,24,69,98,1.346938775510204,0.05820449887704549,549,"When I said the job offered flexibility, I meant the hours."
1040,12,10,76,98,1.346938775510204,0.0697174134603517,549,"You guessed it, the inmates do run the asylum."
1040,3,28,67,98,1.346938775510204,0.05446996253053952,549,"I can see you're tied up too, so can we reschedule for tomorrow?"
1085,10,15,76,101,1.3465346534653466,0.0651512232727212,549,"Turns out, you do have to be crazy to work here. But it doesn't help."
1086,8,18,73,99,1.3434343434343434,0.06284929795204205,549,I'm thinking about leaving too. There's just no job mobility here.
1086,5,24,70,99,1.3434343434343434,0.05772005772005773,549,The mental health days aren't working.
1088,9,17,76,102,1.3431372549019607,0.06307819031505105,549,How shall we submit our winning caption?
1089,9,15,73,97,1.3402061855670102,0.06535423883044314,549,Management has found far less looting of supplies this way.
1089,4,25,68,97,1.3402061855670102,0.056544613992798406,549,We got off easy. The guys are in a shark tank!
1089,7,19,71,97,1.3402061855670102,0.06198082984683079,549,I got mine at the outlet store and saved 40%.
1089,5,23,69,97,1.3402061855670102,0.05841292668491264,549,"150 words per minute, that's impressive !"
1089,6,21,70,97,1.3402061855670102,0.06022330642035012,549,"I know you're tied up, but I'm in a real bind."
1089,8,17,72,97,1.3402061855670102,0.06368987282766543,549,"So, what makes you think you would fit within this organization?"
1089,6,21,70,97,1.3402061855670102,0.06022330642035012,549,Where do you see yourself in five minutes?
1089,9,15,73,97,1.3402061855670102,0.06535423883044314,549,We're making America sane again.
1089,6,21,70,97,1.3402061855670102,0.06022330642035012,549,I started out in your chair.
1089,4,25,68,97,1.3402061855670102,0.056544613992798406,549,HR is not so high on escape clauses.
1089,6,21,70,97,1.3402061855670102,0.06022330642035012,549,Tell me about a time when you faced adversity.
1089,4,25,68,97,1.3402061855670102,0.056544613992798406,549,This way the nicotine patch doesn't fall off.
1089,6,21,70,97,1.3402061855670102,0.06022330642035012,549,I wasn't sure what shoes went with it.
1089,5,23,69,97,1.3402061855670102,0.05841292668491264,549,"Welcome to the asylum. Do you want to run the place, or just run around the place?"
1089,5,23,69,97,1.3402061855670102,0.05841292668491264,549,"Ironically, I'm much more productive these days."
1089,4,25,68,97,1.3402061855670102,0.056544613992798406,549,Welcome To Voice Activated Inc.
1089,5,23,69,97,1.3402061855670102,0.05841292668491264,549,What leads to your interest in Houdini Enterprises?
1089,6,21,70,97,1.3402061855670102,0.06022330642035012,549,They really want you to feel the metaphors here.
1089,11,11,75,97,1.3402061855670102,0.06856186839425696,549,What makes you qualified to work in the Trump Administration?
1089,7,19,71,97,1.3402061855670102,0.06198082984683079,549,Let's switch seats again!
1089,5,23,69,97,1.3402061855670102,0.05841292668491264,549,"Yes, we are a closely held company. Why do you ask?"
1089,9,15,73,97,1.3402061855670102,0.06535423883044314,549,I understand your last position was upside down in a tank of water.
1089,8,17,72,97,1.3402061855670102,0.06368987282766543,549,"I would keep you on if I could, but our hands are tied"
1089,2,29,66,97,1.3402061855670102,0.05260931578142566,549,What makes you think that the inmates are running the asylum?
1089,7,19,71,97,1.3402061855670102,0.06198082984683079,549,Relax. We are merely removing body language cues out of the interview.
1089,11,11,75,97,1.3402061855670102,0.06856186839425696,549,Okay...that's a wrap!
1089,10,13,74,97,1.3402061855670102,0.06697725856892776,549,We don't publicize the thirteenth step.
1089,5,23,69,97,1.3402061855670102,0.05841292668491264,549,I think we can find a place for you here.
1089,7,19,71,97,1.3402061855670102,0.06198082984683079,549,Perhaps you'd be interested in joining our soccer team.
1089,4,25,68,97,1.3402061855670102,0.056544613992798406,549,"When I said that I get tied up in meetings, I wasn't being figurative."
1089,6,21,70,97,1.3402061855670102,0.06022330642035012,549,"What do you mean ""You don't have to be crazy to work here?"""
1089,9,15,73,97,1.3402061855670102,0.06535423883044314,549,"Finally, we are actually running the asylum."
1089,7,19,71,97,1.3402061855670102,0.06198082984683079,549,Well first let me welcome you to the Harry Houdini school for performing arts.
1089,7,19,71,97,1.3402061855670102,0.06198082984683079,549,We're not into touchy-feely here.
1089,3,27,67,97,1.3402061855670102,0.054612422939219314,549,Your willingness to keep things under wraps makes you seem like a good fit.
1089,4,25,68,97,1.3402061855670102,0.056544613992798406,549,"Alright, then. Your experience looks good. Your references are great. Let's talk about your commitment."
1089,10,13,74,97,1.3402061855670102,0.06697725856892776,549,I've called you in here because I need to do a Ctrl-Alt-Del.
1089,9,15,73,97,1.3402061855670102,0.06535423883044314,549,"Before we offer you a job at the EPA, we want to make sure you understand the culture."
1089,8,17,72,97,1.3402061855670102,0.06368987282766543,549,What makes you think you're qualified to work for the Trump administration?
1089,7,19,71,97,1.3402061855670102,0.06198082984683079,549,With your help we can make this the best inmate run asylum in the nation.
1089,5,23,69,97,1.3402061855670102,0.05841292668491264,549,In what asylum do you see yourself in 5 years?
1089,7,19,71,97,1.3402061855670102,0.06198082984683079,549,We have resorted to binding arbitration
1089,3,27,67,97,1.3402061855670102,0.054612422939219314,549,I can see you and I think a lot alike.
1089,7,19,71,97,1.3402061855670102,0.06198082984683079,549,One of your coworkers has informed me you had a moment of sanity.
1089,9,15,73,97,1.3402061855670102,0.06535423883044314,549,"And if you scratch my back, I'll scratch yours."
1089,6,21,70,97,1.3402061855670102,0.06022330642035012,549,How many words per minute can you peck?
1089,7,19,71,97,1.3402061855670102,0.06198082984683079,549,Riverdance girls fit right in.
1089,6,21,70,97,1.3402061855670102,0.06022330642035012,549,I see you are qualified. You have to be crazy to work here.
1089,6,21,70,97,1.3402061855670102,0.06022330642035012,549,Yes it's true. The inmates are running the asylum.
1089,6,21,70,97,1.3402061855670102,0.06022330642035012,549,Looks like you're a perfect fit for our organization
1089,9,15,73,97,1.3402061855670102,0.06535423883044314,549,What attracted you to our company?
1089,6,21,70,97,1.3402061855670102,0.06022330642035012,549,We offer a competitive benefits package and your own padded cubicle.
1089,6,21,70,97,1.3402061855670102,0.06022330642035012,549,I have to pee.
1089,7,19,71,97,1.3402061855670102,0.06198082984683079,549,"Outside of nail biting, any other bad habits?"
1089,8,17,72,97,1.3402061855670102,0.06368987282766543,549,OK at this point in the interview I'm going to need you to dislocate your shoulder.
1089,6,21,70,97,1.3402061855670102,0.06022330642035012,549,We've found it the most effective way to discourage clawing your way to the top.
1089,6,21,70,97,1.3402061855670102,0.06022330642035012,549,"Well, at least the company has started hiring more women."
1089,6,21,70,97,1.3402061855670102,0.06022330642035012,549,I see a lot of my younger self in you--bound and determined to succeed.
1147,8,16,72,96,1.3333333333333333,0.06398099132915955,549,I see you're on a social media break too.
1147,7,18,71,96,1.3333333333333333,0.0622436262266905,549,"The HR Dept. found that body language creates confusion, so it's not allowed"
1147,5,22,69,96,1.3333333333333333,0.05861461007820391,549,"Call me crazy, but I think your resume is a perfect match!"
1147,7,18,71,96,1.3333333333333333,0.0622436262266905,549,Sanity is not a requisite for employment here.
1147,9,14,73,96,1.3333333333333333,0.06567241047103436,549,The best thing about working here is you don't have to wash your hands after using the restroom.
1147,5,22,69,96,1.3333333333333333,0.05861461007820391,549,"It's a Zen thing. Restrict the body, free the mind."
1147,3,26,67,96,1.3333333333333333,0.0547455571109822,549,Me? A magic act gone bad. You?
1147,9,14,73,96,1.3333333333333333,0.06567241047103436,549,"You seem ideal for our ""hands-off"" management style."
1147,3,26,67,96,1.3333333333333333,0.0547455571109822,549,It shouldn't take long for you to fit in.
1147,12,8,76,96,1.3333333333333333,0.07050361858740394,549,"Welcome to your interview at The Houdini Institute. One, two, three – go!"
1147,5,22,69,96,1.3333333333333333,0.05861461007820391,549,"So, it's a wrap, then?"
1147,8,16,72,96,1.3333333333333333,0.06398099132915955,549,I miss our old padded expense accounts.
1147,6,20,70,96,1.3333333333333333,0.060456354175834316,549,"The Department Chair assures me that the new academic restraints are only temporary,"
1147,7,18,71,96,1.3333333333333333,0.0622436262266905,549,Siri gets a real workout.
1147,8,16,72,96,1.3333333333333333,0.06398099132915955,549,"Actually, we've been running the asylum since November 8th."
1147,6,20,70,96,1.3333333333333333,0.060456354175834316,549,This comes right before 'final written warning.'
1147,8,16,72,96,1.3333333333333333,0.06398099132915955,549,Did you take my hands-free headset?
1147,7,18,71,96,1.3333333333333333,0.0622436262266905,549,How did you you hear about Houdini Enterprises?
1147,6,20,70,96,1.3333333333333333,0.060456354175834316,549,I like your style. Very straight-laced.
1147,9,14,73,96,1.3333333333333333,0.06567241047103436,549,Are you quitting Facebook too?
1147,6,20,70,96,1.3333333333333333,0.060456354175834316,549,I hate getting tied up in meetings.
1147,8,16,72,96,1.3333333333333333,0.06398099132915955,549,They're still better than the Nehru jackets.
1147,7,18,71,96,1.3333333333333333,0.0622436262266905,549,"If you can get out of the straight-jacket faster than I can, you're hired."
1147,9,14,73,96,1.3333333333333333,0.06567241047103436,549,You'd have to be crazy NOT to work here.
1147,10,12,74,96,1.3333333333333333,0.06732134685736806,549,It's effective though. Haven't checked my phone in hours.
1147,10,12,74,96,1.3333333333333333,0.06732134685736806,549,i think they're calling it a gender neutral jacket now
1147,6,20,70,96,1.3333333333333333,0.060456354175834316,549,One of us is going to have to change.
1147,4,24,68,96,1.3333333333333333,0.056713087281560055,549,We're looking for someone who can operate under certain constraints.
1147,8,16,72,96,1.3333333333333333,0.06398099132915955,549,"So, I guess you're not allowed on the internet during lunch either."
1147,2,28,66,96,1.3333333333333333,0.052704627669472995,549,Are you tied up next week?
1147,5,22,69,96,1.3333333333333333,0.05861461007820391,549,I always say you should dress for the job you want.
1147,6,20,70,96,1.3333333333333333,0.060456354175834316,549,At least I'm at low risk for carpal tunnel syndrome.
1147,6,20,70,96,1.3333333333333333,0.060456354175834316,549,You'll fit right in with our corporate culture.
1147,8,16,72,96,1.3333333333333333,0.06398099132915955,549,It's a glass ceiling thing.
1147,6,20,70,96,1.3333333333333333,0.060456354175834316,549,You're just the fit we've been looking for.
1147,5,22,69,96,1.3333333333333333,0.05861461007820391,549,A word to the wise... try not to drink too much coffee.
1147,5,22,69,96,1.3333333333333333,0.05861461007820391,549,Our last corporate culture was too hands-on.
1147,7,18,71,96,1.3333333333333333,0.0622436262266905,549,The work environment here is really insane.
1147,5,22,69,96,1.3333333333333333,0.05861461007820391,549,"...so, why do you think you're a fit for our company culture?"
1147,6,20,70,96,1.3333333333333333,0.060456354175834316,549,I've been tied up in meetings all day.
1147,5,22,69,96,1.3333333333333333,0.05861461007820391,549,I still think this is the best way to kick the social media habit
1147,9,14,73,96,1.3333333333333333,0.06567241047103436,549,"For us, it's not just a saying. We literally run the place."
1147,12,8,76,96,1.3333333333333333,0.07050361858740394,549,I would love to give you a raise but like you my hands are tied.
1147,8,16,72,96,1.3333333333333333,0.06398099132915955,549,"Now that we can't pick-up our iPhones, we can actually get some work done."
1147,8,16,72,96,1.3333333333333333,0.06398099132915955,549,Mine itches. Yours?
1147,6,20,70,96,1.3333333333333333,0.060456354175834316,549,"If you scratch my back, I’ll scratch yours."
1147,9,14,73,96,1.3333333333333333,0.06567241047103436,549,"I'm sorry I slapped you, too."
1147,8,16,72,96,1.3333333333333333,0.06398099132915955,549,It's just four years
1147,8,16,72,96,1.3333333333333333,0.06398099132915955,549,It's a temporary precaution until the glass ceiling is repaired.
1147,6,20,70,96,1.3333333333333333,0.060456354175834316,549,This is a very stressful position but you may be the perfect candidate to fill it...
1147,9,14,73,96,1.3333333333333333,0.06567241047103436,549,Surely you can understand my position...I'd like to help you but my hands are tied.
1147,7,18,71,96,1.3333333333333333,0.0622436262266905,549,You won't be issued keys. All the doors lock from the outside.
1147,6,20,70,96,1.3333333333333333,0.060456354175834316,549,So...where would you like to be in five years?
1147,6,20,70,96,1.3333333333333333,0.060456354175834316,549,I'm really hoping to let loose at the Christmas party
1147,5,22,69,96,1.3333333333333333,0.05861461007820391,549,I think you'll fit in just fine here.
1147,6,20,70,96,1.3333333333333333,0.060456354175834316,549,My nose itches.
1147,7,18,71,96,1.3333333333333333,0.0622436262266905,549,"We do, however, observe Casual Fridays."
1147,7,18,71,96,1.3333333333333333,0.0622436262266905,549,Siri! Please contact Houdini!
1147,7,18,71,96,1.3333333333333333,0.0622436262266905,549,I know you are but what am I
1147,10,12,74,96,1.3333333333333333,0.06732134685736806,549,"You're fine, thank you. How am I?"
1147,8,16,72,96,1.3333333333333333,0.06398099132915955,549,So how's your diet going?
1147,7,18,71,96,1.3333333333333333,0.0622436262266905,549,It looks like you'll fit in very well with the new direction here at the EPA.
1147,4,24,68,96,1.3333333333333333,0.056713087281560055,549,We need a more flexible dress code!
1147,6,20,70,96,1.3333333333333333,0.060456354175834316,549,This an all holds barred interview.
1147,7,18,71,96,1.3333333333333333,0.0622436262266905,549,"Where do you see yourself in five years at Houdini, Inc.?"
1147,7,18,71,96,1.3333333333333333,0.0622436262266905,549,"If you are more interested in stocks than bonds, you should have told us that when we hired you."
1147,5,22,69,96,1.3333333333333333,0.05861461007820391,549,Apparently we were getting a little too close to the glass ceiling...
1147,5,22,69,96,1.3333333333333333,0.05861461007820391,549,"E.P.A. Orientation, 1/20/17."
1147,4,24,68,96,1.3333333333333333,0.056713087281560055,549,"According to my calendar, we'll be tied up for the next hour."
1147,8,16,72,96,1.3333333333333333,0.06398099132915955,549,We were hoping you could lend us a hand.
1147,10,12,74,96,1.3333333333333333,0.06732134685736806,549,Here at the Houdini School we take an unorthodox approach to interviews.
1147,7,18,71,96,1.3333333333333333,0.0622436262266905,549,Any more loose ends that need tieing up?
1147,7,18,71,96,1.3333333333333333,0.0622436262266905,549,... I guess we have to stay for the office Christmas party.
1147,12,8,76,96,1.3333333333333333,0.07050361858740394,549,Mr. Trump is pleased to offer you the position of Under Secretary of Mental Health Services. Congratulations.
1147,4,24,68,96,1.3333333333333333,0.056713087281560055,549,"On the flip side, use of social media during work hours is at an all time low."
1147,8,16,72,96,1.3333333333333333,0.06398099132915955,549,How do you think you would fit in the President-elect's administration?
1147,6,20,70,96,1.3333333333333333,0.060456354175834316,549,Armani?
1147,7,18,71,96,1.3333333333333333,0.0622436262266905,549,Where do you see your selves in five years?
1147,7,18,71,96,1.3333333333333333,0.0622436262266905,549,The designer told me it was an original .
1147,7,18,71,96,1.3333333333333333,0.0622436262266905,549,Do you ever get an itch?
1147,7,18,71,96,1.3333333333333333,0.0622436262266905,549,"Now that we're no longer looking at our phones, what was it that you wanted to meet about?"
1147,4,24,68,96,1.3333333333333333,0.056713087281560055,549,This might seem crazy but you might be just what we need.
1147,6,20,70,96,1.3333333333333333,0.060456354175834316,549,I'm just trying to get the feel for the next four years with Trump.
1147,6,20,70,96,1.3333333333333333,0.060456354175834316,549,These team-building exercises never end well.
1147,5,22,69,96,1.3333333333333333,0.05861461007820391,549,This election has been tough on all of us.
1147,6,20,70,96,1.3333333333333333,0.060456354175834316,549,I would love to help you but my hands are tied.
1147,5,22,69,96,1.3333333333333333,0.05861461007820391,549,We like candidates that appear restrained.
1147,8,16,72,96,1.3333333333333333,0.06398099132915955,549,Thank you for interviewing with the Department of Energy.
1147,6,20,70,96,1.3333333333333333,0.060456354175834316,549,J. C. Penney. Twenty-five bucks! Where'd you get yours?
1147,8,16,72,96,1.3333333333333333,0.06398099132915955,549,I've got the perfect job for you on our government transition team.
1147,7,18,71,96,1.3333333333333333,0.0622436262266905,549,"I'd really like to, but my hands are tied."
1238,9,14,74,97,1.3298969072164948,0.0650826356237755,549,"Since the election, we've found this the best way to keep from breaking furniture."
1239,7,17,70,94,1.3297872340425532,0.06307222217323323,549,...and where do you see yourselves in five years.
1239,6,19,69,94,1.3297872340425532,0.06123172878879481,549,"If you can get loose, and get me loose, you're hired."
1239,9,13,72,94,1.3297872340425532,0.06660079885917311,549,We run a hands off approach here.
1239,5,21,68,94,1.3297872340425532,0.05933417237190852,549,I know that my decision to have you succeed me may come as a surprise.
1239,6,19,69,94,1.3297872340425532,0.06123172878879481,549,I miss casual Fridays.
1239,5,21,68,94,1.3297872340425532,0.05933417237190852,549,I see something in you that makes me think you will be a great fit for this company.
1239,5,21,68,94,1.3297872340425532,0.05933417237190852,549,We're all very much committed here to the firm.
1239,9,13,72,94,1.3297872340425532,0.06660079885917311,549,Running the asylum isn't as easy as it looks.
1239,6,19,69,94,1.3297872340425532,0.06123172878879481,549,"If I scratch your back, would you scratch mine?"
1239,5,21,68,94,1.3297872340425532,0.05933417237190852,549,"You're hired. I can't put my finger on it, but I believe you're going to be a perfect fit with my company."
1239,10,11,73,94,1.3297872340425532,0.06829675693680634,549,You seem overqualified.
1239,6,19,69,94,1.3297872340425532,0.06123172878879481,549,You don't have to be crazy to work here.
1239,7,17,70,94,1.3297872340425532,0.06307222217323323,549,What anti-psychotic do you see yourself on in 5 years?
1239,5,21,68,94,1.3297872340425532,0.05933417237190852,549,It's a wrap.
1239,4,23,67,94,1.3297872340425532,0.057373891376253906,549,Maybe Siri can help us out.
1239,8,15,71,94,1.3297872340425532,0.06486051039943229,549,"Strangely, productivity has increased."
1239,8,15,71,94,1.3297872340425532,0.06486051039943229,549,At least we're not tongue tied.
1239,7,17,70,94,1.3297872340425532,0.06307222217323323,549,This new dress code is driving me crazy.
1239,7,17,70,94,1.3297872340425532,0.06307222217323323,549,"I'd love to go, but I'm all tied up."
1239,10,11,73,94,1.3297872340425532,0.06829675693680634,549,"I mean, it's not like we tweet any more than the President elect."
1239,7,17,70,94,1.3297872340425532,0.06307222217323323,549,"I would love to help you but as you can see, my hands are tied."
1239,4,23,67,94,1.3297872340425532,0.057373891376253906,549,I'm not so sure your problem is that unique.
1239,4,23,67,94,1.3297872340425532,0.057373891376253906,549,You have to use your head to be successful in here.
1239,8,15,71,94,1.3297872340425532,0.06486051039943229,549,We focus on prevention here at Crotch Grabbers Anonymous.
1239,8,15,71,94,1.3297872340425532,0.06486051039943229,549,I'll file your complaint about the dress code as soon as I have a free hand.
1239,7,17,70,94,1.3297872340425532,0.06307222217323323,549,I see you are familiar with the constraints of working for this administration.
1239,7,17,70,94,1.3297872340425532,0.06307222217323323,549,Let's get straight to the point. This job is a little confining.
1239,7,17,70,94,1.3297872340425532,0.06307222217323323,549,You don't have to be crazy to work here it helps.
1239,8,15,71,94,1.3297872340425532,0.06486051039943229,549,"Look, I'd love to help you, but my hands are tied."
1239,7,17,70,94,1.3297872340425532,0.06307222217323323,549,Let's make this quick. Looks like we're both strapped for time.
1239,7,17,70,94,1.3297872340425532,0.06307222217323323,549,We've never been accused of lack of restraint.
1239,5,21,68,94,1.3297872340425532,0.05933417237190852,549,"You know, I could tell straight-away that you were perfect for this place."
1239,6,19,69,94,1.3297872340425532,0.06123172878879481,549,I'm 100% committed to this project. You?
1239,8,15,71,94,1.3297872340425532,0.06486051039943229,549,"Despite having the most committed employees, productivity was still surprisingly low."
1239,7,17,70,94,1.3297872340425532,0.06307222217323323,549,"So, what interests you about working in the Trump White House?"
1239,6,19,69,94,1.3297872340425532,0.06123172878879481,549,Here we don't climb the corporate ladder so much as hop.
1239,7,17,70,94,1.3297872340425532,0.06307222217323323,549,You appear to be overqualified for this position.
1239,5,21,68,94,1.3297872340425532,0.05933417237190852,549,"You don't have to be nuts to work here, but it helps!"
1239,8,15,71,94,1.3297872340425532,0.06486051039943229,549,"Yes, sometimes I find this work a little restrictive."
1239,6,19,69,94,1.3297872340425532,0.06123172878879481,549,We are bound to like each other.
1239,8,15,71,94,1.3297872340425532,0.06486051039943229,549,"Well, that about wraps it up."
1239,5,21,68,94,1.3297872340425532,0.05933417237190852,549,No one said this job was going to be easy.
1239,7,17,70,94,1.3297872340425532,0.06307222217323323,549,Why can't they just restrain our middle fingers?
1239,9,13,72,94,1.3297872340425532,0.06660079885917311,549,We've found this to be the most effective approach to prevent checking mobile devices during meetings.
1239,5,21,68,94,1.3297872340425532,0.05933417237190852,549,HR says it is already reducing sexual harassment claims.
1239,8,15,71,94,1.3297872340425532,0.06486051039943229,549,"No, I don't think that, 'You scratch my back and I'll scratch yours,' would work here."
1239,4,23,67,94,1.3297872340425532,0.057373891376253906,549,So what can't I help you with?
1239,8,15,71,94,1.3297872340425532,0.06486051039943229,549,"So, why are you interested in a position with The New Yorker?"
1239,7,17,70,94,1.3297872340425532,0.06307222217323323,549,That's actually not the craziest thing I've ever heard.
1239,5,21,68,94,1.3297872340425532,0.05933417237190852,549,I'm beginning to think the red tape wasn't so bad after all.
1239,8,15,71,94,1.3297872340425532,0.06486051039943229,549,They've replaced the glass ceiling with a padded one.
1239,6,19,69,94,1.3297872340425532,0.06123172878879481,549,"No, you don't have to be. But it helps."
1239,5,21,68,94,1.3297872340425532,0.05933417237190852,549,"Yes, this is a patient-run mental hospital. Welcome!"
1239,7,17,70,94,1.3297872340425532,0.06307222217323323,549,"Designing voice recognition software, fortunately."
1239,7,17,70,94,1.3297872340425532,0.06307222217323323,549,Permission to speak freely.
1239,8,15,71,94,1.3297872340425532,0.06486051039943229,549,You look like a perfect fit for this job.
1239,3,25,66,94,1.3297872340425532,0.055344221127855905,549,It's normal. I've been on the program for a year and still have urges to check my Facebook page at work.
1239,10,11,73,94,1.3297872340425532,0.06829675693680634,549,"Regardless of my breakdown, your session will still be billed."
1239,9,13,72,94,1.3297872340425532,0.06660079885917311,549,"Uh oh, number one or number two?"
1239,5,21,68,94,1.3297872340425532,0.05933417237190852,549,One of us should take notes.
1239,8,15,71,94,1.3297872340425532,0.06486051039943229,549,I understand but my hands are tied too.
1239,7,17,70,94,1.3297872340425532,0.06307222217323323,549,We are an equal opportunity employer.
1239,5,21,68,94,1.3297872340425532,0.05933417237190852,549,I see you've heard about our dress code.
1302,6,19,70,95,1.3263157894736841,0.060683131001665225,549,"Well, I guess, that ties up all the loose ends."
1302,4,23,68,95,1.3263157894736841,0.056872788367533886,549,At least no one can read our body language.
1302,7,17,71,95,1.3263157894736841,0.06250125241864155,549,"On the bright side, ours are only 79.6% as tight as the men's jackets."
1302,5,21,69,95,1.3263157894736841,0.05880882775937453,549,"As you already know, we have a very strict dress code."
1302,10,11,74,95,1.3263157894736841,0.06766312918494971,549,Welcome to Academia.
1302,5,21,69,95,1.3263157894736841,0.05880882775937453,549,Remember when the barriers were invisible?
1302,5,21,69,95,1.3263157894736841,0.05880882775937453,549,I'm really looking for someone who can roll up their sleeves and be more hands-on.
1302,3,25,67,95,1.3263157894736841,0.05486847811781201,549,It worked for my other addictions.
1302,7,17,71,95,1.3263157894736841,0.06250125241864155,549,I think this job would be a good fit for you.
1311,10,11,75,96,1.3229166666666667,0.06704082231540084,549,That makes two of us.
1311,7,17,72,96,1.3229166666666667,0.06194010913683509,549,This weight loss program is really working. I'm down 10 pounds.
1311,6,19,71,96,1.3229166666666667,0.060143818254821554,549,Around here we believe body language is a distraction.
1311,7,17,72,96,1.3229166666666667,0.06194010913683509,549,"You scratch my back, I'll scratch yours."
1315,6,18,69,93,1.3225806451612903,0.06146354792751873,549,Are you making fun of me?
1315,7,16,70,93,1.3225806451612903,0.06333657564579079,549,I kind of miss the glass ceiling.
1315,6,18,69,93,1.3225806451612903,0.06146354792751873,549,Is that your phone ringing?
1315,8,14,71,93,1.3225806451612903,0.06515578182503504,549,"I'm sorry, there's nothing I can do. My hands are tied."
1315,9,12,72,93,1.3225806451612903,0.06692555562659269,549,"What do you consider to be the major constraints of the job, and how do you plan to free yourself of those constraints?"
1315,4,22,67,93,1.3225806451612903,0.05753485502237072,549,I'm sorry; did you want to take notes?
1315,3,24,66,93,1.3225806451612903,0.05546625507232871,549,If it's one thing we value in potential new employees it is their level of restraint.
1315,5,20,68,93,1.3225806451612903,0.05953161876802784,549,how good are you at nose typing?
1315,2,26,65,93,1.3225806451612903,0.0533174583138773,549,I like your style.
1315,5,20,68,93,1.3225806451612903,0.05953161876802784,549,Well we have Informal Fridays and now Maniac Mondays.
1315,3,24,66,93,1.3225806451612903,0.05546625507232871,549,It's really solved the problem of the Millennials on Facebook all day.
1315,7,16,70,93,1.3225806451612903,0.06333657564579079,549,We're not so much hands on here.
1315,7,16,70,93,1.3225806451612903,0.06333657564579079,549,"I wish they came in black, white makes me look fat."
1315,7,16,70,93,1.3225806451612903,0.06333657564579079,549,Are you crazy?
1315,7,16,70,93,1.3225806451612903,0.06333657564579079,549,"Well, that about wraps it up."
1315,4,22,67,93,1.3225806451612903,0.05753485502237072,549,Nail biter. You?
1315,9,12,72,93,1.3225806451612903,0.06692555562659269,549,Lunatics now running the asylum - check! Next step - elect Donald Trump president!
1315,6,18,69,93,1.3225806451612903,0.06146354792751873,549,"You scratch my nose, I'll scratch yours."
1315,5,20,68,93,1.3225806451612903,0.05953161876802784,549,And we thought the problem was the glass ceiling.
1315,6,18,69,93,1.3225806451612903,0.06146354792751873,549,"Once we get past this, the glass ceilings are easy."
1315,9,12,72,93,1.3225806451612903,0.06692555562659269,549,"So, where did you hear about our company?"
1315,7,16,70,93,1.3225806451612903,0.06333657564579079,549,We'll be covering the new administration.
1315,8,14,71,93,1.3225806451612903,0.06515578182503504,549,"Your resume is great and all, but if you can figure out how to scratch my nose, you're hired."
1315,5,20,68,93,1.3225806451612903,0.05953161876802784,549,I think you will fit in well here at Houdini Enterprises.
1315,3,24,66,93,1.3225806451612903,0.05546625507232871,549,We gotta be crazy to work here.
1315,8,14,71,93,1.3225806451612903,0.06515578182503504,549,This intervention for keeping us off Facebook seems to be working so far.
1315,4,22,67,93,1.3225806451612903,0.05753485502237072,549,"I don't need to tell you, my hands are tied."
1315,5,20,68,93,1.3225806451612903,0.05953161876802784,549,Nice ties. Who did them?
1315,4,22,67,93,1.3225806451612903,0.05753485502237072,549,I think it's time we start running this asylum.
1315,7,16,70,93,1.3225806451612903,0.06333657564579079,549,I see that you've learned to show some restraint...
1315,7,16,70,93,1.3225806451612903,0.06333657564579079,549,I'll be tied up all afternoon. Will you be free tomorrow?
1315,8,14,71,93,1.3225806451612903,0.06515578182503504,549,You'll fit right into our corporate culture.
1315,5,20,68,93,1.3225806451612903,0.05953161876802784,549,We're looking for someone with more hands on experience.
1315,7,16,70,93,1.3225806451612903,0.06333657564579079,549,I remember when we used to complain about our golden handcuffs.
1315,9,12,72,93,1.3225806451612903,0.06692555562659269,549,What first made you interested in working at the E.P.A.?
1315,6,18,69,93,1.3225806451612903,0.06146354792751873,549,"Kleptomania is a disease, but I'm living proof our treatment works wonders."
1315,7,16,70,93,1.3225806451612903,0.06333657564579079,549,They keep us from checking Facebook.
1315,6,18,69,93,1.3225806451612903,0.06146354792751873,549,We tried to block his Twitter account
1315,7,16,70,93,1.3225806451612903,0.06333657564579079,549,"To be honest, they are not very generous with sick days."
1315,7,16,70,93,1.3225806451612903,0.06333657564579079,549,You'll fit in nicely here.
1315,3,24,66,93,1.3225806451612903,0.05546625507232871,549,You'd have to be crazy not to take this job.
1315,5,20,68,93,1.3225806451612903,0.05953161876802784,549,"I think you'll find the restrictions here very liberating. I, for one, haven't so much as lifted a finger in ages."
1315,5,20,68,93,1.3225806451612903,0.05953161876802784,549,It's part of our hands-free technology training.
1315,8,14,71,93,1.3225806451612903,0.06515578182503504,549,I was once in your chair.
1315,8,14,71,93,1.3225806451612903,0.06515578182503504,549,Our benefits include paid psychiatric leave.
1315,6,18,69,93,1.3225806451612903,0.06146354792751873,549,Yes but on Friday it's business casual
1315,5,20,68,93,1.3225806451612903,0.05953161876802784,549,You've really embraced our corporate culture.
1315,6,18,69,93,1.3225806451612903,0.06146354792751873,549,"If you can lift the pen with your mind, the job is yours."
1315,6,18,69,93,1.3225806451612903,0.06146354792751873,549,Siri? ... Siri?
1315,5,20,68,93,1.3225806451612903,0.05953161876802784,549,Do you buckle under pressure?
1315,5,20,68,93,1.3225806451612903,0.05953161876802784,549,I see that Trump got a restraining order on you too.
1315,5,20,68,93,1.3225806451612903,0.05953161876802784,549,We think you'll be a great fit here!
1315,6,18,69,93,1.3225806451612903,0.06146354792751873,549,"Well, I think we've about wrapped up this interview."
1315,9,12,72,93,1.3225806451612903,0.06692555562659269,549,Let's meet next Tuesday at 9:00. I guess we'll just have to remember that.
1315,6,18,69,93,1.3225806451612903,0.06146354792751873,549,You'll fit right in - we're a pretty tight-knit company.
1315,8,14,71,93,1.3225806451612903,0.06515578182503504,549,"I'm sorry, I'm afraid our hands are tied."
1315,5,20,68,93,1.3225806451612903,0.05953161876802784,549,"Right now I would settle for mobility, never mind upward mobility."
1315,4,22,67,93,1.3225806451612903,0.05753485502237072,549,But we do have Casual Fridays...
1315,6,18,69,93,1.3225806451612903,0.06146354792751873,549,"I run this company, but like you I started as just a threat to myself and others."
1315,3,24,66,93,1.3225806451612903,0.05546625507232871,549,These new business regulations seem very restrictive.
1315,5,20,68,93,1.3225806451612903,0.05953161876802784,549,And we also have an aggressive retention incentive plan.
1315,7,16,70,93,1.3225806451612903,0.06333657564579079,549,"Yes, I am in charge of this asylum."
1315,6,18,69,93,1.3225806451612903,0.06146354792751873,549,Can you scratch my nose with your nose ?
1315,7,16,70,93,1.3225806451612903,0.06333657564579079,549,Yo've got to be nuts to work here
1315,4,22,67,93,1.3225806451612903,0.05753485502237072,549,I prefer red tape. What about you?
1315,5,20,68,93,1.3225806451612903,0.05953161876802784,549,can't believe the others got a golden parachute.
1381,4,22,68,94,1.3191489361702127,0.057022847306584766,549,I think our hands are tied on this one.
1381,8,14,72,94,1.3191489361702127,0.06455019374541615,549,I was promised butterfly wings. You?
1381,5,20,69,94,1.3191489361702127,0.058994793959766076,549,"I'd really like to help, but my hands are tied."
1381,6,18,70,94,1.3191489361702127,0.06090292533007279,549,"OK, so it started with one of those signs which said 'You don't have to be mad to work here, but it helps'…"
1381,3,24,67,94,1.3191489361702127,0.05498021931153886,549,I think you will fit in here.
1386,5,19,68,92,1.315217391304348,0.05972013849390535,549,"Luckily for you, you have to be crazy to work here."
1386,5,19,68,92,1.315217391304348,0.05972013849390535,549,It keeps me from tweeting.
1386,6,17,69,92,1.315217391304348,0.06168781472033683,549,Remind me to trash that 'You don't have to be CRAZY to work here but it helps' sign.
1386,6,17,69,92,1.315217391304348,0.06168781472033683,549,I'll admit I am not crazy about these new binding contracts
1386,6,17,69,92,1.315217391304348,0.06168781472033683,549,You'll find that we frown on multitasking.
1386,5,19,68,92,1.315217391304348,0.05972013849390535,549,If you'll scratch my nose I'll scratch yours.
1386,6,17,69,92,1.315217391304348,0.06168781472033683,549,I will never ask you to do anything I wouldn't do myself.
1386,5,19,68,92,1.315217391304348,0.05972013849390535,549,Your resume was intriguing
1386,8,13,71,92,1.315217391304348,0.06544592860865635,549,Please tell us a little about yourself and why you think you're a good fit for this institution.
1386,7,15,70,92,1.315217391304348,0.06359463836055658,549,At least our tongues aren’t tied.
1386,4,21,67,92,1.315217391304348,0.057685382884157636,549,Are you mocking me?
1386,4,21,67,92,1.315217391304348,0.057685382884157636,549,Last time I tie one on at the office party.
1386,8,13,71,92,1.315217391304348,0.06544592860865635,549,We want to hire someone with absolutely no imagination at all.
1386,7,15,70,92,1.315217391304348,0.06359463836055658,549,Let's just be strait with each other.
1386,5,19,68,92,1.315217391304348,0.05972013849390535,549,Why didn't you answer my texts and emails?
1386,4,21,67,92,1.315217391304348,0.057685382884157636,549,We find this is the best way to avoid checking your Facebook account during work hours.
1386,6,17,69,92,1.315217391304348,0.06168781472033683,549,Do you ever feel we might be too wrapped up in our work?
1386,6,17,69,92,1.315217391304348,0.06168781472033683,549,"If you think this is bad,you should see casual Friday"
1386,6,17,69,92,1.315217391304348,0.06168781472033683,549,"We appreciate your interest, but I'm afraid you're overqualified."
1386,8,13,71,92,1.315217391304348,0.06544592860865635,549,"Believe me, I understand where you're coming from."
1386,6,17,69,92,1.315217391304348,0.06168781472033683,549,Straight jacket Tuesday is not as good as cyber Monday.
1386,6,17,69,92,1.315217391304348,0.06168781472033683,549,I need a Kleenex.
1386,6,17,69,92,1.315217391304348,0.06168781472033683,549,Takes crazy to know crazy.
1386,5,19,68,92,1.315217391304348,0.05972013849390535,549,"Yeah, you're right. We probably should have installed the voice recognition software BEFORE we suited up."
1386,8,13,71,92,1.315217391304348,0.06544592860865635,549,Thanks for applying. You're just what we're looking for!
1386,5,19,68,92,1.315217391304348,0.05972013849390535,549,Our managerial style here is pretty hands-off...I'm assuming your comfortable with that?
1386,6,17,69,92,1.315217391304348,0.06168781472033683,549,"There are some constraints to working here, but I think. You will fit right in."
1386,3,23,66,92,1.315217391304348,0.05557618064650086,549,"The good news is, you can wear slacks on Casual Friday."
1386,6,17,69,92,1.315217391304348,0.06168781472033683,549,"Here, the inmates really do run the asylum."
1386,6,17,69,92,1.315217391304348,0.06168781472033683,549,This is the part of the interview that gauges your ability to work with others.
1386,7,15,70,92,1.315217391304348,0.06359463836055658,549,They caught us trying to break the glass ceiling.
1386,5,19,68,92,1.315217391304348,0.05972013849390535,549,They told me it was a one of a kind Armani.
1386,5,19,68,92,1.315217391304348,0.05972013849390535,549,How many pounds have you lost so far?
1386,6,17,69,92,1.315217391304348,0.06168781472033683,549,Would you agree we're in dire straits?
1386,6,17,69,92,1.315217391304348,0.06168781472033683,549,Can I be straight with you?
1386,9,11,72,92,1.315217391304348,0.06724627212484506,549,It is supposed to protect their glass ceiling.
1386,6,17,69,92,1.315217391304348,0.06168781472033683,549,Where do you see yourself in 5 hallucinations from now?
1386,7,15,70,92,1.315217391304348,0.06359463836055658,549,I think it's time for a more hands-on approach.
1386,7,15,70,92,1.315217391304348,0.06359463836055658,549,Do you think he's coming back?
1386,8,13,71,92,1.315217391304348,0.06544592860865635,549,It says to hit the escape button.
1386,8,13,71,92,1.315217391304348,0.06544592860865635,549,This happened because once again you misused ‘literally.’
1386,6,17,69,92,1.315217391304348,0.06168781472033683,549,"We believe the hands on approach is a tad overrated."""
1386,4,21,67,92,1.315217391304348,0.057685382884157636,549,We seem to have reached an impasse.
1386,7,15,70,92,1.315217391304348,0.06359463836055658,549,"I see you've been committed before, but this job requires total commitment."
1386,5,19,68,92,1.315217391304348,0.05972013849390535,549,"Since we're tied up this week, why don't we try to meet next week"
1386,4,21,67,92,1.315217391304348,0.057685382884157636,549,They told ME it was an original!
1386,8,13,71,92,1.315217391304348,0.06544592860865635,549,"We prefer the term ""user-based management model"", but in answer to your question, yes, this asylum is run by the inmates."
1386,8,13,71,92,1.315217391304348,0.06544592860865635,549,At least they don't make us wear nylons.
1386,5,19,68,92,1.315217391304348,0.05972013849390535,549,Siri turns out to be finally useful.
1386,6,17,69,92,1.315217391304348,0.06168781472033683,549,"I think this interview is about wrapped up,"
1386,4,21,67,92,1.315217391304348,0.057685382884157636,549,I see you’ve had no hands-on experience. You’re hired!
1386,6,17,69,92,1.315217391304348,0.06168781472033683,549,Welcome to the voice control app department.
1386,7,15,70,92,1.315217391304348,0.06359463836055658,549,So what do you think of straight jacket Thursday?
1386,10,9,73,92,1.315217391304348,0.06899965694065502,549,I see your dating my boyfriend
1386,7,15,70,92,1.315217391304348,0.06359463836055658,549,Have you had any experience swallowing keys?
1386,6,17,69,92,1.315217391304348,0.06168781472033683,549,Where would you like to be five years from now?
1386,7,15,70,92,1.315217391304348,0.06359463836055658,549,Houdini's greatest illusion: Escaping the dead-end job.
1386,3,23,66,92,1.315217391304348,0.05557618064650086,549,You look like you'll fit into our office culture very well.
1386,7,15,70,92,1.315217391304348,0.06359463836055658,549,We use the Stanislavsky Method. To sell bonds you have to experience bonds.
1386,4,21,67,92,1.315217391304348,0.057685382884157636,549,The best advice I can give you is to lean in.
1386,9,11,72,92,1.315217391304348,0.06724627212484506,549,HR says we shouldn't feel restrained by the new dress code.
1386,3,23,66,92,1.315217391304348,0.05557618064650086,549,I find I eat less this way.
1386,6,17,69,92,1.315217391304348,0.06168781472033683,549,"So, you are the intern assigned to shadow me for the day?"
1386,7,15,70,92,1.315217391304348,0.06359463836055658,549,Do you ever get the itch to do something crazy?
1386,5,19,68,92,1.315217391304348,0.05972013849390535,549,"As I said, my hands are tied."
1386,5,19,68,92,1.315217391304348,0.05972013849390535,549,I agree. It's so annoying they only come in white.
1386,8,13,71,92,1.315217391304348,0.06544592860865635,549,We started running the place last week.
1386,3,23,66,92,1.315217391304348,0.05557618064650086,549,"Well, you definitely have the qualifications I've been looking for."
1386,5,19,68,92,1.315217391304348,0.05972013849390535,549,"We have a strict ""no tweet"" policy."
1386,7,15,70,92,1.315217391304348,0.06359463836055658,549,One of us is insane.
1386,4,21,67,92,1.315217391304348,0.057685382884157636,549,siri... about getting these jackets off!
1386,5,19,68,92,1.315217391304348,0.05972013849390535,549,I'd say you'll fit right in with our corporate culture.
1386,4,21,67,92,1.315217391304348,0.057685382884157636,549,"So, who does your hair?"
1386,6,17,69,92,1.315217391304348,0.06168781472033683,549,I have lost 10 pounds already!
1386,8,13,71,92,1.315217391304348,0.06544592860865635,549,It's refreshing to meet another strait shooter.
1386,8,13,71,92,1.315217391304348,0.06544592860865635,549,You've got to be crazy to work here!
1386,5,19,68,92,1.315217391304348,0.05972013849390535,549,"Yes, the new policy on sexual harassment is a bit restrictive."
1386,4,21,67,92,1.315217391304348,0.057685382884157636,549,Do I even need to ask about how many words per minute you can type?
1386,6,17,69,92,1.315217391304348,0.06168781472033683,549,I'm itching to get out of here.
1386,8,13,71,92,1.315217391304348,0.06544592860865635,549,I miss the golden handcuffs.
1386,5,19,68,92,1.315217391304348,0.05972013849390535,549,Our dress code is binding
1386,5,19,68,92,1.315217391304348,0.05972013849390535,549,I think we are in a real bind.
1386,9,11,72,92,1.315217391304348,0.06724627212484506,549,I'll just tell them that we'll be tied up for the next few days.
1386,4,21,67,92,1.315217391304348,0.057685382884157636,549,This is the only foolproof method to not text back.
1386,6,17,69,92,1.315217391304348,0.06168781472033683,549,I think it goes without saying that we don't offer flex-time here.
1386,6,17,69,92,1.315217391304348,0.06168781472033683,549,"Just tell him no, our hands are tied."
1472,4,21,68,93,1.3118279569892473,0.05716231538399947,549,"Yes, it is Versace."
1472,8,13,72,93,1.3118279569892473,0.06482705193702835,549,"Your complaint said that you found the office to be a ""stressful environment""... how so?"
1472,3,23,67,93,1.3118279569892473,0.055079725937619145,549,"Well SOMEBODY clicked ""Reply All""!"
1472,5,19,69,93,1.3118279569892473,0.059171651918434806,549,"One benefit of working here, you won't get carpal tunnel syndrome."
1476,5,19,70,94,1.3085106382978724,0.058632700615674084,549,The nondisclosure provision has no escape clause.
1477,4,20,67,91,1.3076923076923077,0.057824431533102176,549,"In fairness, the terms and conditions update did warn of a new binding arbitration clause."
1477,5,18,68,91,1.3076923076923077,0.05989879069168814,549,I'd like to help but my hands are tied too.
1477,5,18,68,91,1.3076923076923077,0.05989879069168814,549,I know it's crazy -- but I think we have a lot in common.
1477,6,16,69,91,1.3076923076923077,0.061903678166381274,549,"We're both tied up at the moment, is there a better time to meet?"
1477,3,22,66,91,1.3076923076923077,0.055672835727365075,549,"Personally, I think the company's commitment to ""do no harm"" is extreme."
1477,6,16,69,91,1.3076923076923077,0.061903678166381274,549,These enhanced password requirements are getting ridiculous.
1477,5,18,68,91,1.3076923076923077,0.05989879069168814,549,So I guess our idea to reduce CEO pay was not well received.
1477,2,24,65,91,1.3076923076923077,0.05343467407710028,549,"So you're certifiable, that's a start, but how fast can you type?"
1477,5,18,68,91,1.3076923076923077,0.05989879069168814,549,Looks like I'm tied up until next week at the earliest...and you?
1477,6,16,69,91,1.3076923076923077,0.061903678166381274,549,"I can't make the meeting, but I'll try to butt-dial in."
1477,6,16,69,91,1.3076923076923077,0.061903678166381274,549,I understand other companies have an incentive-based approach to employee retention.
1477,5,18,68,91,1.3076923076923077,0.05989879069168814,549,So far so good. Are you ready for your typing test?
1477,6,16,69,91,1.3076923076923077,0.061903678166381274,549,How long have you been off Twitter?
1477,6,16,69,91,1.3076923076923077,0.061903678166381274,549,This diet is amazing. I have lost 30 pounds in one week.
1477,5,18,68,91,1.3076923076923077,0.05989879069168814,549,"""That's funny - it's my favorite Patsy Kline song too!"
1477,6,16,69,91,1.3076923076923077,0.061903678166381274,549,"Welcome to the Houdini Corporation, if you can sign here in the next 90 seconds."
1477,8,12,71,91,1.3076923076923077,0.06573025071401598,549,You scratch my back and I'll scratch yours.
1477,6,16,69,91,1.3076923076923077,0.061903678166381274,549,I guess I preferred it when management only figuratively tied our hands.
1477,5,18,68,91,1.3076923076923077,0.05989879069168814,549,"Yeah, I’m trying to quit biting my nails, too."
1477,5,18,68,91,1.3076923076923077,0.05989879069168814,549,Done deal! Let's shake on it.
1477,5,18,68,91,1.3076923076923077,0.05989879069168814,549,What makes you think you are a good fit for this job?
1477,6,16,69,91,1.3076923076923077,0.061903678166381274,549,"And, where do you see yourself in ten years?"
1477,8,12,71,91,1.3076923076923077,0.06573025071401598,549,"Election Day, 2020."
1477,7,14,70,91,1.3076923076923077,0.06384563896404478,549,The company is serious about its no personal devices at work policy.
1477,7,14,70,91,1.3076923076923077,0.06384563896404478,549,And what gives you the idea that this isn't a real job interview?
1477,7,14,70,91,1.3076923076923077,0.06384563896404478,549,"Well, I see you're dressed for the job you want not the one you have."
1477,6,16,69,91,1.3076923076923077,0.061903678166381274,549,You got the job! Sign here please.
1477,5,18,68,91,1.3076923076923077,0.05989879069168814,549,I think you'll fit right in to this madhouse. You're hired!
1477,5,18,68,91,1.3076923076923077,0.05989879069168814,549,"No hand shakes, no signing off, your word is your bond, here!"
1477,5,18,68,91,1.3076923076923077,0.05989879069168814,549,"I'm sorry, my hands are tied."
1477,7,14,70,91,1.3076923076923077,0.06384563896404478,549,"No, we do not perform background checks."
1477,6,16,69,91,1.3076923076923077,0.061903678166381274,549,And have you had any experience running an asylum?
1477,4,20,67,91,1.3076923076923077,0.057824431533102176,549,I don't favor a hands-on approach
1477,6,16,69,91,1.3076923076923077,0.061903678166381274,549,We're bound to think of something.
1477,5,18,68,91,1.3076923076923077,0.05989879069168814,549,Welcome to the Houdini Corporation.
1477,4,20,67,91,1.3076923076923077,0.057824431533102176,549,How's the new diet going for you?
1477,8,12,71,91,1.3076923076923077,0.06573025071401598,549,Where do you see my selves in five years?
1477,6,16,69,91,1.3076923076923077,0.061903678166381274,549,"Dress for the job you want, not the one we already have."
1477,9,10,72,91,1.3076923076923077,0.06756231274259077,549,I can’t ask you and you can’t ask me.
1477,7,14,70,91,1.3076923076923077,0.06384563896404478,549,It's required of Trump appointments to any regulatory agency...
1477,7,14,70,91,1.3076923076923077,0.06384563896404478,549,Your resume indicated you have experience trading bonds.
1477,7,14,70,91,1.3076923076923077,0.06384563896404478,549,If Hillary had won we wouldn't be in this bind.
1477,7,14,70,91,1.3076923076923077,0.06384563896404478,549,"Siri, tell whomever is calling I'm tied up now."
1477,7,14,70,91,1.3076923076923077,0.06384563896404478,549,Remember good old red tape...
1477,7,14,70,91,1.3076923076923077,0.06384563896404478,549,"You've hooked into the cultural ethos of the firm quite nicely, Miss Stern. I'm bound to say you'll fit right in."
1477,5,18,68,91,1.3076923076923077,0.05989879069168814,549,"I know you're in a bind, but I've got my hands tied."
1477,6,16,69,91,1.3076923076923077,0.061903678166381274,549,Why do you think you would like working for Houdini Corporation?
1477,7,14,70,91,1.3076923076923077,0.06384563896404478,549,May I rub my nose on your sleeve?
1477,4,20,67,91,1.3076923076923077,0.057824431533102176,549,I see some real possiblities here since we are seeking employees who are bound and determined.
1477,6,16,69,91,1.3076923076923077,0.061903678166381274,549,"Looks like we are both tied up right now, can we perhaps have coffee another time ?"
1477,6,16,69,91,1.3076923076923077,0.061903678166381274,549,Since we're both tied up right now let's try and reschedule for next week.
1477,4,20,67,91,1.3076923076923077,0.057824431533102176,549,We take great pride in our flexibility too.
1477,7,14,70,91,1.3076923076923077,0.06384563896404478,549,This is embarrassing. We can't both wear the same thing to the holiday party!
1477,4,20,67,91,1.3076923076923077,0.057824431533102176,549,"Sorry, I can't give you a raise. I understand that you're strapped, but so am I."
1477,5,18,68,91,1.3076923076923077,0.05989879069168814,549,"To wrap up, the contract's binding."
1477,5,18,68,91,1.3076923076923077,0.05989879069168814,549,You'd have to be crazy not to hire me.
1477,4,20,67,91,1.3076923076923077,0.057824431533102176,549,is this really the only way we can stop tweeting?
1477,6,16,69,91,1.3076923076923077,0.061903678166381274,549,"Sorry, but my hands are tied as well."
1477,8,12,71,91,1.3076923076923077,0.06573025071401598,549,"You'll get used to the dress code, and you'll just love the padded offices!"
1477,6,16,69,91,1.3076923076923077,0.061903678166381274,549,Have you ever typed with your nose?
1477,2,24,65,91,1.3076923076923077,0.05343467407710028,549,Outreach for us seems very difficult.
1477,9,10,72,91,1.3076923076923077,0.06756231274259077,549,"Eight year-old. high-spirited, unpredictable triplets. You?"
1477,5,18,68,91,1.3076923076923077,0.05989879069168814,549,I'll reply to your email on Causal Friday.
1477,5,18,68,91,1.3076923076923077,0.05989879069168814,549,Last one out buys lunch!
1477,6,16,69,91,1.3076923076923077,0.061903678166381274,549,I think you'll fit in around here.
1477,6,16,69,91,1.3076923076923077,0.061903678166381274,549,I like the one piece.
1477,7,14,70,91,1.3076923076923077,0.06384563896404478,549,Mr. Houdini will see you now.
1544,4,20,68,92,1.3043478260869565,0.057290156853792996,549,My contract is binding. What about yours?
1544,6,16,70,92,1.3043478260869565,0.06131839168480321,549,"Yes, Kellyanne, this should stop him from tweeting."
1544,8,12,72,92,1.3043478260869565,0.0650978359493592,549,Kanye West finally made it in the fashion world.
1547,8,11,70,89,1.303370786516854,0.06666676230802689,549,This whole hands-free approach is getting out of hand.
1547,5,17,67,89,1.303370786516854,0.06064956184421635,549,"I know you could do it with one hand tied behind your back, but . . ."
1547,5,17,67,89,1.303370786516854,0.06064956184421635,549,Mind if I don't take notes while we talk?
1547,5,17,67,89,1.303370786516854,0.06064956184421635,549,So much for being a hands-on manager.
1547,7,13,69,89,1.303370786516854,0.06472321516829782,549,There are some issues with our new Comfort Bra Line.
1547,5,17,67,89,1.303370786516854,0.06064956184421635,549,It gets a little crazy around here at times.
1547,2,23,64,89,1.303370786516854,0.053965558527230055,549,I'm hoping this will be our breakout quarter.
1547,5,17,67,89,1.303370786516854,0.06064956184421635,549,"Well, I guess that just about wraps it up."
1547,5,17,67,89,1.303370786516854,0.06064956184421635,549,What a crazy day!
1547,6,15,68,89,1.303370786516854,0.06271947039642953,549,"You know I'd love to help, but I'm afraid my hands are tied."
1547,4,19,66,89,1.303370786516854,0.05850646747994829,549,"We need someone who won't mind spending most of their adult life doing meaningless work in a small, windowless office."
1547,6,15,68,89,1.303370786516854,0.06271947039642953,549,I would like to help but our hands are tied.
1547,5,17,67,89,1.303370786516854,0.06064956184421635,549,"Well, let's see when we're free."
1547,6,15,68,89,1.303370786516854,0.06271947039642953,549,A little voice tells me you'll fit right into the corporate culture around here.
1547,7,13,69,89,1.303370786516854,0.06472321516829782,549,"We'd love to give you a raise, but as you can see, our hands are tied."
1547,2,23,64,89,1.303370786516854,0.053965558527230055,549,"If we do hire you, I assume you won't mind being chained to your desk."
1547,6,15,68,89,1.303370786516854,0.06271947039642953,549,"I would love to offer you a position, but my hands are tied"
1547,6,15,68,89,1.303370786516854,0.06271947039642953,549,We're having trouble finding someone who can take dictation.
1547,7,13,69,89,1.303370786516854,0.06472321516829782,549,"It used to be a real ""hands on"" operation and then in came the regulators."
1547,7,13,69,89,1.303370786516854,0.06472321516829782,549,At least we're here and not in some big water tank.
1547,2,23,64,89,1.303370786516854,0.053965558527230055,549,"Tell him sorry, but our hands are tied."
1547,5,17,67,89,1.303370786516854,0.06064956184421635,549,"So tell me, what attracted you to this company?"
1547,7,13,69,89,1.303370786516854,0.06472321516829782,549,You say that you were driven insane by an endless series of email ads from Bob Mankoff? Join the club.
1547,4,19,66,89,1.303370786516854,0.05850646747994829,549,"Well, I guess that wraps up our interview."
1547,5,17,67,89,1.303370786516854,0.06064956184421635,549,Voice activation is important in our work here.
1547,6,15,68,89,1.303370786516854,0.06271947039642953,549,Get used to it! It’s the latest women’s fashion from the Trump Organization.
1547,5,17,67,89,1.303370786516854,0.06064956184421635,549,"Yeah, I've got an itch there, too."
1547,6,15,68,89,1.303370786516854,0.06271947039642953,549,You must be crazy to think I'm crazy enough to hire you.
1547,7,13,69,89,1.303370786516854,0.06472321516829782,549,"Really, alt-ctrl-del will get us out of this?"
1547,5,17,67,89,1.303370786516854,0.06064956184421635,549,How do you see yourself working in an environment in which the inmates run the asylum?
1547,6,15,68,89,1.303370786516854,0.06271947039642953,549,I would love to help but my hands are tied.
1547,6,15,68,89,1.303370786516854,0.06271947039642953,549,Who told you that you’d have to be crazy to work here?
1547,2,23,64,89,1.303370786516854,0.053965558527230055,549,I think you'd fit in well here.
1547,4,19,66,89,1.303370786516854,0.05850646747994829,549,Here we don't think outside the box.
1547,6,15,68,89,1.303370786516854,0.06271947039642953,549,"I'd love to meet this week, but I'm pretty tied up."
1547,7,13,69,89,1.303370786516854,0.06472321516829782,549,just tell it to me straight
1547,5,17,67,89,1.303370786516854,0.06064956184421635,549,"I'm sorry about that raise, but my hands are tied."
1547,6,15,68,89,1.303370786516854,0.06271947039642953,549,Just say we're tied up for the rest of the day
1547,5,17,67,89,1.303370786516854,0.06064956184421635,549,So we're in agreement!
1547,2,23,64,89,1.303370786516854,0.053965558527230055,549,But it mostly keeps me off social media.
1547,7,13,69,89,1.303370786516854,0.06472321516829782,549,"I know, I know - the inmates are running the asylum."
1547,4,19,66,89,1.303370786516854,0.05850646747994829,549,"I don't know yet if you'll get the job, but I can say you score awfully high on empathy."
1547,5,17,67,89,1.303370786516854,0.06064956184421635,549,"I'd like to give you a salary increase, but my hands are tied."
1547,8,11,70,89,1.303370786516854,0.06666676230802689,549,"Actually, you're not the first person to complain about company dress codes."
1547,4,19,66,89,1.303370786516854,0.05850646747994829,549,So what exactly is this great idea of yours to increase company productivity?
1547,6,15,68,89,1.303370786516854,0.06271947039642953,549,This new wellness program has really help me cut down on sweets.
1547,5,17,67,89,1.303370786516854,0.06064956184421635,549,"Finally, someone who understands MY perspective on this issue."
1547,8,11,70,89,1.303370786516854,0.06666676230802689,549,Houdini was an intern here too.
1547,4,19,66,89,1.303370786516854,0.05850646747994829,549,What we need is someone who can wrap their arms around the subject
1547,2,23,64,89,1.303370786516854,0.053965558527230055,549,It seems we're in a bind.
1547,5,17,67,89,1.303370786516854,0.06064956184421635,549,"So, Human Resources seems determined to have us work together."
1547,5,17,67,89,1.303370786516854,0.06064956184421635,549,Our managerial style here is pretty hands-off...I'm assuming your comfortable with that?
1547,6,15,68,89,1.303370786516854,0.06271947039642953,549,"I'm sorry, but there's nothing I can do."
1547,2,23,64,89,1.303370786516854,0.053965558527230055,549,I find this new dress code a bit constricting.
1547,5,17,67,89,1.303370786516854,0.06064956184421635,549,"Our motto is ""first do no harm"""
1602,3,21,66,90,1.3,0.05575494805135898,549,Ever since the election I´ve been fit to be tied.
1602,3,21,66,90,1.3,0.05575494805135898,549,I got mine at Tie City
1604,4,19,68,91,1.2967032967032968,0.0574052396312373,549,You have to be a Houdini to get any work done around here.
1605,3,20,65,88,1.2954545454545454,0.05635916994471799,549,How good are you at answering phones?
1605,5,16,67,88,1.2954545454545454,0.060817942061245564,549,"""At least we still have freedom of speech""."
1605,6,14,68,88,1.2954545454545454,0.06292896865847025,549,"Actually, I don't think you would find our company's environment constraining."
1605,6,14,68,88,1.2954545454545454,0.06292896865847025,549,...where do you see yourself in 5 years?
1605,4,18,66,88,1.2954545454545454,0.058630956471059835,549,"I didn't realize this is what Mr. Romney meant by ""binders of women."""
1605,5,16,67,88,1.2954545454545454,0.060817942061245564,549,HR's new hands-off policy is nuts.
1605,6,14,68,88,1.2954545454545454,0.06292896865847025,549,"Now that we are properly dressed, we can start the exit interview."
1605,4,18,66,88,1.2954545454545454,0.058630956471059835,549,You totally get me.
1605,7,12,69,88,1.2954545454545454,0.0649714407741774,549,It's always a pleasure to meet another Houdini fan.
1605,4,18,66,88,1.2954545454545454,0.058630956471059835,549,Too many lunches have gone missing from the company fridge.
1605,5,16,67,88,1.2954545454545454,0.060817942061245564,549,It looks like you have escape experience - would you be comfortable being sawed in half?
1605,2,22,64,88,1.2954545454545454,0.053991879176445545,549,It's crazy how long it's taking me to write this email.
1605,5,16,67,88,1.2954545454545454,0.060817942061245564,549,May I take your coat?
1605,2,22,64,88,1.2954545454545454,0.053991879176445545,549,Have you tried using voice to text?
1605,6,14,68,88,1.2954545454545454,0.06292896865847025,549,"I know you'll understand when I say, my hands are tied."
1605,6,14,68,88,1.2954545454545454,0.06292896865847025,549,"I'm very sorry, miss, but we're looking for a receptionist who can type any words per minute."
1605,2,22,64,88,1.2954545454545454,0.053991879176445545,549,Casual Fridays generally involve more slipknots.
1605,6,14,68,88,1.2954545454545454,0.06292896865847025,549,"If, at any time, you feel uncomfortable, please let me know."
1605,4,18,66,88,1.2954545454545454,0.058630956471059835,549,"Mine is Vera Wang, what's yours?"
1605,4,18,66,88,1.2954545454545454,0.058630956471059835,549,So let me get this strait...
1605,7,12,69,88,1.2954545454545454,0.0649714407741774,549,"So, where do you see yourselves in five years?"
1605,5,16,67,88,1.2954545454545454,0.060817942061245564,549,Just our luck. The screen is frozen.
1605,8,10,70,88,1.2954545454545454,0.0669516328115017,549,"You know, sometimes it just gets crazy around here!"
1605,6,14,68,88,1.2954545454545454,0.06292896865847025,549,So which one of us is supposed to be HR?
1605,7,12,69,88,1.2954545454545454,0.0649714407741774,549,I lost 5 pounds. How about you?
1605,2,22,64,88,1.2954545454545454,0.053991879176445545,549,We like to hire like-minded individuals.
1605,7,12,69,88,1.2954545454545454,0.0649714407741774,549,One of us isn't really here; it's your job to figure out which one.
1605,5,16,67,88,1.2954545454545454,0.060817942061245564,549,"Every one who misses Casual Friday, raise your hand."
1605,6,14,68,88,1.2954545454545454,0.06292896865847025,549,"A ""Farewell to Arms"""
1605,6,14,68,88,1.2954545454545454,0.06292896865847025,549,"Yes, I am the leading expert in counseling people who have Houdini Syndrome."
1605,4,18,66,88,1.2954545454545454,0.058630956471059835,549,"So you're comfortable with this being a binding contract, then?"
1605,5,16,67,88,1.2954545454545454,0.060817942061245564,549,And the best thing about working here is that our medical plan includes psychiatric coverage.
1605,5,16,67,88,1.2954545454545454,0.060817942061245564,549,"Some of us can't get used to using the ""hands-free"" devices, so we're trying something new."
1605,8,10,70,88,1.2954545454545454,0.0669516328115017,549,We've been running the place since Tuesday.
1605,7,12,69,88,1.2954545454545454,0.0649714407741774,549,Should we have a safe word?
1605,5,16,67,88,1.2954545454545454,0.060817942061245564,549,I'm not crazy about your idea.
1605,5,16,67,88,1.2954545454545454,0.060817942061245564,549,... and we've been running this asylum every since.
1605,5,16,67,88,1.2954545454545454,0.060817942061245564,549,Why do I get all the crazy ones?
1605,4,18,66,88,1.2954545454545454,0.058630956471059835,549,"I'd really prefer to have a more ""hands-on"" type of role."
1605,3,20,65,88,1.2954545454545454,0.05635916994471799,549,You figure out a way to tweet and you can have my job.
1605,5,16,67,88,1.2954545454545454,0.060817942061245564,549,"Corporate's really pushing this whole 'hands-free' thing, aren't they?"
1605,4,18,66,88,1.2954545454545454,0.058630956471059835,549,Think I'd look better in a size nine?
1605,6,14,68,88,1.2954545454545454,0.06292896865847025,549,I'll give it to you strait: I'd like to hire you but my hands are tied.
1605,5,16,67,88,1.2954545454545454,0.060817942061245564,549,I meant we’re crazy in a good way.
1605,7,12,69,88,1.2954545454545454,0.0649714407741774,549,I work well in a restrained environment.
1605,7,12,69,88,1.2954545454545454,0.0649714407741774,549,"They said I was crazy, but productivity rates are off the charts."
1605,6,14,68,88,1.2954545454545454,0.06292896865847025,549,You're going to fit right in here.
1605,4,18,66,88,1.2954545454545454,0.058630956471059835,549,Typing with my toes is surprisingly rewarding.
1605,3,20,65,88,1.2954545454545454,0.05635916994471799,549,"On the other hand, your nail polish lasts longer."
1605,6,14,68,88,1.2954545454545454,0.06292896865847025,549,How long have you been in the smoking cessation program?
1605,2,22,64,88,1.2954545454545454,0.053991879176445545,549,Give it to me strait
1605,4,18,66,88,1.2954545454545454,0.058630956471059835,549,Anyone can say that the inmates run the asylum. Here we are looking for people who can walk the talk.
1605,5,16,67,88,1.2954545454545454,0.060817942061245564,549,"You'd have to be crazy not to want to work here. And yet, there you are."
1605,5,16,67,88,1.2954545454545454,0.060817942061245564,549,"Now that we've taken over the place, I'll look into relaxing the dress code."
1605,4,18,66,88,1.2954545454545454,0.058630956471059835,549,I guess we'll have to think twice about trying to break the glass ceiling again.
1605,3,20,65,88,1.2954545454545454,0.05635916994471799,549,We have a strictly hands-off policy on sexual harassment.
1605,4,18,66,88,1.2954545454545454,0.058630956471059835,549,"So, if I'm to understand you, we'll start doing Casual Fridays and discontinue Mental Mondays? You better be right this time."
1605,5,16,67,88,1.2954545454545454,0.060817942061245564,549,"Round here, the inmates run the asylum --- as a business"
1605,3,20,65,88,1.2954545454545454,0.05635916994471799,549,"When you figure it out, text me."
1605,3,20,65,88,1.2954545454545454,0.05635916994471799,549,"Yes, we are bound by confidentiality."
1605,6,14,68,88,1.2954545454545454,0.06292896865847025,549,It's really hard to wrap my arms around your idea.
1605,7,12,69,88,1.2954545454545454,0.0649714407741774,549,We expect our staff to adopt a hands-on approach
1605,5,16,67,88,1.2954545454545454,0.060817942061245564,549,You can expect to lose 10 pounds in the very first week.
1605,5,16,67,88,1.2954545454545454,0.060817942061245564,549,Lemme guess: you're 'mirroring' my gestures to build rapport?
1605,4,18,66,88,1.2954545454545454,0.058630956471059835,549,It's the only way to stop from texting.
1605,3,20,65,88,1.2954545454545454,0.05635916994471799,549,"Are you thinking the same thing, or am I just crazy?"
1605,7,12,69,88,1.2954545454545454,0.0649714407741774,549,I’m just not convinced that Restrictive-Tuesday is going to be the next Casual-Friday.
1605,4,18,66,88,1.2954545454545454,0.058630956471059835,549,It's been crazy around here lately!
1605,6,14,68,88,1.2954545454545454,0.06292896865847025,549,How long will we be just women in binders?
1605,2,22,64,88,1.2954545454545454,0.053991879176445545,549,I think you'll synch with the company culture.
1605,9,8,71,88,1.2954545454545454,0.06887491674027534,549,"It's the same old-story. You scratch my back, and I'll scratch yours."
1605,5,16,67,88,1.2954545454545454,0.060817942061245564,549,"Agreed. We'll remove ""reach out"" from our business lexicon."
1605,7,12,69,88,1.2954545454545454,0.0649714407741774,549,The firm observes both Casual Friday and Manacle Monday.
1605,7,12,69,88,1.2954545454545454,0.0649714407741774,549,"Well, we like what we see, and we'd like to offer you a job in the Trump administration."
1605,4,18,66,88,1.2954545454545454,0.058630956471059835,549,Remember when we were a real hands-on operation?
1605,4,18,66,88,1.2954545454545454,0.058630956471059835,549,"Well, this time Management's really tied our hands."
1605,7,12,69,88,1.2954545454545454,0.0649714407741774,549,"I know this is going to sound crazy, but ..."
1605,5,16,67,88,1.2954545454545454,0.060817942061245564,549,"Funny, you're the first person to complain about the dress code."
1605,5,16,67,88,1.2954545454545454,0.060817942061245564,549,"This is, of course, a binding position."
1605,5,16,67,88,1.2954545454545454,0.060817942061245564,549,"Yes, I'm straight. And you?"
1605,8,10,70,88,1.2954545454545454,0.0669516328115017,549,"Don't worry, they'll take them off after the Inauguration."
1605,6,14,68,88,1.2954545454545454,0.06292896865847025,549,I warned you about trying Ctrl+Alt+Esc.
1605,5,16,67,88,1.2954545454545454,0.060817942061245564,549,The pen is voice-activated too.
1605,5,16,67,88,1.2954545454545454,0.060817942061245564,549,You shop there too?!
1605,6,14,68,88,1.2954545454545454,0.06292896865847025,549,"I have great references, from the other voices in my head!"
1605,3,20,65,88,1.2954545454545454,0.05635916994471799,549,I think you would make a good fit in this organization.
1605,6,14,68,88,1.2954545454545454,0.06292896865847025,549,"Just so you realize, the inmates do run this asylum"
1605,6,14,68,88,1.2954545454545454,0.06292896865847025,549,We're not big on hugging.
1605,5,16,67,88,1.2954545454545454,0.060817942061245564,549,I think you'll fit right in here - when can you start?
1605,4,18,66,88,1.2954545454545454,0.058630956471059835,549,You've got to be mad to work here.
1605,4,18,66,88,1.2954545454545454,0.058630956471059835,549,I see you're as committed to this company as I am.
1605,3,20,65,88,1.2954545454545454,0.05635916994471799,549,"Call me crazy, but I think these men are holding us back."
1605,4,18,66,88,1.2954545454545454,0.058630956471059835,549,You get me.
1605,3,20,65,88,1.2954545454545454,0.05635916994471799,549,We're big proponents of preventative healthcare.
1605,4,18,66,88,1.2954545454545454,0.058630956471059835,549,"I appreciate you listening, I need to get this off my chest."
1605,8,10,70,88,1.2954545454545454,0.0669516328115017,549,Wow the inmates really are running the asylum here!
1605,3,20,65,88,1.2954545454545454,0.05635916994471799,549,We have a hands-off management style in this company.
1605,5,16,67,88,1.2954545454545454,0.060817942061245564,549,"Our management team is very""hands-off"". Does that work for you?"
1605,4,18,66,88,1.2954545454545454,0.058630956471059835,549,We're proactive when it comes to sexual harassment.
1605,5,16,67,88,1.2954545454545454,0.060817942061245564,549,We are not very hands on company...
1605,8,10,70,88,1.2954545454545454,0.0669516328115017,549,Unfortunately we already have someone with your weaknesses.
1605,6,14,68,88,1.2954545454545454,0.06292896865847025,549,I'd like to see more of our people running the asylum.
1605,5,16,67,88,1.2954545454545454,0.060817942061245564,549,I think we're all wrapped up here.
1605,4,18,66,88,1.2954545454545454,0.058630956471059835,549,You should see what the men have to wear.
1605,6,14,68,88,1.2954545454545454,0.06292896865847025,549,"Oh sure, you're a good fit...I mean your resume, it's insane."
1605,3,20,65,88,1.2954545454545454,0.05635916994471799,549,Tell me why you think a job at Houdini Enterprises is the right fit for you.
1605,5,16,67,88,1.2954545454545454,0.060817942061245564,549,Didn't I mention your employment contract was binding?
1605,6,14,68,88,1.2954545454545454,0.06292896865847025,549,Are you making fun of me?
1605,6,14,68,88,1.2954545454545454,0.06292896865847025,549,I feel that the new administration's policies are a little restrictive.
1605,5,16,67,88,1.2954545454545454,0.060817942061245564,549,"Granted, output's a little down, but we're saving a fortune on paper."
1605,7,12,69,88,1.2954545454545454,0.0649714407741774,549,I struggle with a texting addiction as well.
1605,5,16,67,88,1.2954545454545454,0.060817942061245564,549,Welcome to the new adminstration.
1605,3,20,65,88,1.2954545454545454,0.05635916994471799,549,I think you would be a good fit for our company.
1605,6,14,68,88,1.2954545454545454,0.06292896865847025,549,"...176, 177, 178, 179, 180. Did it! I knew we could go three minutes without checking our email."
1605,6,14,68,88,1.2954545454545454,0.06292896865847025,549,I propose we chest bump to seal the deal.
1605,7,12,69,88,1.2954545454545454,0.0649714407741774,549,We pride ourselves in thinking outside the jacket.
1605,5,16,67,88,1.2954545454545454,0.060817942061245564,549,Would you have any ambition to run our asylum one day?
1605,4,18,66,88,1.2954545454545454,0.058630956471059835,549,You'll see our weight loss program has very good results
1605,7,12,69,88,1.2954545454545454,0.0649714407741774,549,Governor Pence decided to make jackets straight again.
1605,7,12,69,88,1.2954545454545454,0.0649714407741774,549,We're looking for someone flexible
1725,6,14,69,89,1.2921348314606742,0.062306384867468645,549,It's my pleasure to welcome you to the Houdini School of Magic.
1725,2,22,65,89,1.2921348314606742,0.053484905680017965,549,"I still prefer this over ""business casual""."
1725,7,12,70,89,1.2921348314606742,0.06432299907627366,549,Hey Siri...
1725,6,14,69,89,1.2921348314606742,0.062306384867468645,549,"I can't talk now, I'm on a psychotic break."
1725,5,16,68,89,1.2921348314606742,0.0602222797670426,549,"To move up in this company, you scratch my back and I'll scratch yours."
1730,9,7,71,87,1.2873563218390804,0.06918791548790883,549,What makes you think you're qualified to work for Mr. Trump?
1730,3,19,65,87,1.2873563218390804,0.05641913160790764,549,These meetings drive me crazy
1730,6,13,68,87,1.2873563218390804,0.06312719723285842,549,"Well, one of us needs to go get help."
1730,5,15,67,87,1.2873563218390804,0.06097323038936246,549,We could have tried to resolve our differences over coffee before getting HR involved?
1730,4,17,66,87,1.2873563218390804,0.05874033212156991,549,I'm looking for an opportunity to spread my wings.
1730,7,11,69,87,1.2873563218390804,0.06521005472193797,549,He's my favorite designer too! Did you buy the matching shackles too?
1730,5,15,67,87,1.2873563218390804,0.06097323038936246,549,That color looks great on you.
1730,3,19,65,87,1.2873563218390804,0.05641913160790764,549,I'm confident we have a place for you in our administration.
1730,6,13,68,87,1.2873563218390804,0.06312719723285842,549,Can you give me an example of what you mean when you say your opportunities for advancement are being limited?
1730,3,19,65,87,1.2873563218390804,0.05641913160790764,549,"Well, I think that just about wraps things up."
1730,6,13,68,87,1.2873563218390804,0.06312719723285842,549,"I'd help you, but my hands are tied."
1730,5,15,67,87,1.2873563218390804,0.06097323038936246,549,"Look, my hands are tied too."
1730,6,13,68,87,1.2873563218390804,0.06312719723285842,549,"Give it to me strait, doctor."
1730,6,13,68,87,1.2873563218390804,0.06312719723285842,549,Mr. Trump likes your style. There's a place for you in his Administration.
1730,4,17,66,87,1.2873563218390804,0.05874033212156991,549,I really think that we're bound to work well together.
1730,4,17,66,87,1.2873563218390804,0.05874033212156991,549,So it says here you have some prior experience...?
1730,2,21,64,87,1.2873563218390804,0.05399824261055602,549,I see we have some things in common. You're hired!
1730,2,21,64,87,1.2873563218390804,0.05399824261055602,549,There's not much wiggle room on the hours.
1730,3,19,65,87,1.2873563218390804,0.05641913160790764,549,We take a hands-off approach at this company.
1730,5,15,67,87,1.2873563218390804,0.06097323038936246,549,Now would be a good time to air our grievances.
1730,5,15,67,87,1.2873563218390804,0.06097323038936246,549,There seems to be a concern that the inmates are running the asylum.
1730,6,13,68,87,1.2873563218390804,0.06312719723285842,549,"Yes, it is the reason we have an open door policy."
1730,6,13,68,87,1.2873563218390804,0.06312719723285842,549,Well that's the last time we ask if our company plan has mental health benefits
1730,5,15,67,87,1.2873563218390804,0.06097323038936246,549,"I'd love to help, but I'm also tied up all afternoon."
1730,2,21,64,87,1.2873563218390804,0.05399824261055602,549,I have a tendency to become too wrapped up in my job.
1730,3,19,65,87,1.2873563218390804,0.05641913160790764,549,"And there's a glass ceiling, too."
1730,4,17,66,87,1.2873563218390804,0.05874033212156991,549,This place just isn't a good fit for me anymore.
1730,4,17,66,87,1.2873563218390804,0.05874033212156991,549,"You're right, I don't miss my phone either."
1730,5,15,67,87,1.2873563218390804,0.06097323038936246,549,I understand your prior therapist had a very different approach
1730,5,15,67,87,1.2873563218390804,0.06097323038936246,549,"Our ban on social media use during work hours has been 100% successful! Now, your job is to increase productivity."
1730,2,21,64,87,1.2873563218390804,0.05399824261055602,549,You will fit right in.
1730,3,19,65,87,1.2873563218390804,0.05641913160790764,549,"I'd love to help, but my hands are tied."
1730,8,9,70,87,1.2873563218390804,0.06722841246972949,549,It's nuts around here.
1730,6,13,68,87,1.2873563218390804,0.06312719723285842,549,Describe a time when a former supervisor declared you insane.
1730,5,15,67,87,1.2873563218390804,0.06097323038936246,549,Have you ever worked on a political campaign before?
1730,3,19,65,87,1.2873563218390804,0.05641913160790764,549,This is why we never get anything done around here.
1730,7,11,69,87,1.2873563218390804,0.06521005472193797,549,Google Houdini
1730,5,15,67,87,1.2873563218390804,0.06097323038936246,549,HR said we couldn't get out of it.
1730,6,13,68,87,1.2873563218390804,0.06312719723285842,549,"Of course, you must be able to type with a pencil in your mouth."
1730,6,13,68,87,1.2873563218390804,0.06312719723285842,549,Was that Riverdance New York or Riverdance London?
1730,5,15,67,87,1.2873563218390804,0.06097323038936246,549,"Yes, it is going to be a long four years."
1730,6,13,68,87,1.2873563218390804,0.06312719723285842,549,"Ever since Hilary lost, things have gotten worse for us women in the work force."
1730,1,23,63,87,1.2873563218390804,0.05146359877298256,549,"So, do you like the company’s new “Hands Off Policy”?"
1730,5,15,67,87,1.2873563218390804,0.06097323038936246,549,"Actually, this was not my worst Take Your Child to Work Day."
1730,3,19,65,87,1.2873563218390804,0.05641913160790764,549,I'd have to be crazy to hire you.
1730,5,15,67,87,1.2873563218390804,0.06097323038936246,549,"How to succeed in business, Rule #1: Be prepared for your interview, Rule #2: Emulate your supervisor, Rule #3: Show restraint."
1730,1,23,63,87,1.2873563218390804,0.05146359877298256,549,"And, are you comfortable working in somewhat confining conditions"
1730,5,15,67,87,1.2873563218390804,0.06097323038936246,549,Work's been driving me crazy too.
1730,5,15,67,87,1.2873563218390804,0.06097323038936246,549,"Finally, we're in charge of the asylum."
1730,5,15,67,87,1.2873563218390804,0.06097323038936246,549,It's actually worse than the glass ceiling.
1730,4,17,66,87,1.2873563218390804,0.05874033212156991,549,"Could you pass the scissors, please?"
1730,4,17,66,87,1.2873563218390804,0.05874033212156991,549,If you can type with your feet and eat from the employee cafeteria trough you're hired.
1730,5,15,67,87,1.2873563218390804,0.06097323038936246,549,Does this new employee bonding technique feel weird to you too?
1730,6,13,68,87,1.2873563218390804,0.06312719723285842,549,Hopefully you're not Italian
1730,4,17,66,87,1.2873563218390804,0.05874033212156991,549,We do expect a high level of commitment.
1730,2,21,64,87,1.2873563218390804,0.05399824261055602,549,"I'd love to give you a raise, but things are really tight here just now."
1786,5,14,66,85,1.2823529411764707,0.061748030295266876,549,"I'm sorry. I would love to help you, but my hands are tied."
1786,4,16,65,85,1.2823529411764707,0.05943658133277241,549,We're bound to make this a better workplace.
1786,5,14,66,85,1.2823529411764707,0.061748030295266876,549,Now it's safe to talk. You first.
1786,6,12,67,85,1.2823529411764707,0.06397602121235052,549,Who are you wearing?
1786,3,18,64,85,1.2823529411764707,0.057031527734309743,549,"And how well, would you say, do you work under pressure?"
1786,4,16,65,85,1.2823529411764707,0.05943658133277241,549,Cost cutting. We eliminated padded cubicles.
1786,4,16,65,85,1.2823529411764707,0.05943658133277241,549,I'd like to offer you the position. It's obvious you'll fit right in with our new administration.
1786,4,16,65,85,1.2823529411764707,0.05943658133277241,549,This job does not require much manual dexterity.
1786,5,14,66,85,1.2823529411764707,0.061748030295266876,549,I see we have something in common.
1786,5,14,66,85,1.2823529411764707,0.061748030295266876,549,"When I started working for Mitt, I had no idea what he meant by binders of women."
1786,3,18,64,85,1.2823529411764707,0.057031527734309743,549,I think we can negotiate without killing each other.
1786,7,10,68,85,1.2823529411764707,0.06612899012521703,549,""" I was really impressed with your resume'. I've got to hand it to you...oops! Gotta stop saying that"
1786,4,16,65,85,1.2823529411764707,0.05943658133277241,549,The dress code is just crazy here
1786,5,14,66,85,1.2823529411764707,0.061748030295266876,549,I love it! Who are you wearing?
1786,5,14,66,85,1.2823529411764707,0.061748030295266876,549,I just keep telling myself this will all be over in four years...
1786,7,10,68,85,1.2823529411764707,0.06612899012521703,549,Unwanted touching was a problem.
1786,5,14,66,85,1.2823529411764707,0.061748030295266876,549,"I would love to give you a raise but, you know as well as I, my hands are tied."
1786,5,14,66,85,1.2823529411764707,0.061748030295266876,549,I guess we won't be climbing the corporate ladder!
1786,5,14,66,85,1.2823529411764707,0.061748030295266876,549,Only Siri can save us now.
1786,5,14,66,85,1.2823529411764707,0.061748030295266876,549,If you escape before me you'll move on to the levitation interview.
1786,5,14,66,85,1.2823529411764707,0.061748030295266876,549,I'm sensing a very hostile work environment.
1786,6,12,67,85,1.2823529411764707,0.06397602121235052,549,"I'd love to be able to help you with the problem, but my hands are tied."
1786,4,16,65,85,1.2823529411764707,0.05943658133277241,549,Let's get something straight.
1786,5,14,66,85,1.2823529411764707,0.061748030295266876,549,"Well, I guess that's a wrap!"
1786,2,20,63,85,1.2823529411764707,0.05452048340661897,549,Our policies are fully compliant with both Sharia law and Trump administration free speech guidelines.
1786,3,18,64,85,1.2823529411764707,0.057031527734309743,549,Exactly what makes you qualified to work here!
1786,8,8,69,85,1.2823529411764707,0.06821404092852862,549,They told me I was crazy voting for Trump. What's your story?
1786,3,18,64,85,1.2823529411764707,0.057031527734309743,549,Loosen up??
1786,4,16,65,85,1.2823529411764707,0.05943658133277241,549,Where's Siri when you need her?
1786,3,18,64,85,1.2823529411764707,0.057031527734309743,549,You appear to be overqualified.
1786,4,16,65,85,1.2823529411764707,0.05943658133277241,549,Ready......set......GO!
1786,5,14,66,85,1.2823529411764707,0.061748030295266876,549,We're both crazy busy so let's keep this short.
1786,2,20,63,85,1.2823529411764707,0.05452048340661897,549,You must be crazy to work here.
1786,5,14,66,85,1.2823529411764707,0.061748030295266876,549,"I'd like to help, but so are mine."
1786,8,8,69,85,1.2823529411764707,0.06821404092852862,549,In some states we can vote!
1786,6,12,67,85,1.2823529411764707,0.06397602121235052,549,Total freedom is elusive.
1786,4,16,65,85,1.2823529411764707,0.05943658133277241,549,If you think these HUD ones are tight you should try the ones at the EPA!
1786,4,16,65,85,1.2823529411764707,0.05943658133277241,549,There will be times when you'd die for a cup of coffee but that will pass.
1786,3,18,64,85,1.2823529411764707,0.057031527734309743,549,"Well, we did vote for change"
1786,3,18,64,85,1.2823529411764707,0.057031527734309743,549,"Just having a ""no tweeting"" rule wasn't working for the administration"
1786,7,10,68,85,1.2823529411764707,0.06612899012521703,549,"Let me also ask, what are your manipulative skills?"
1786,3,18,64,85,1.2823529411764707,0.057031527734309743,549,Don't point your toe at me like that.
1786,2,20,63,85,1.2823529411764707,0.05452048340661897,549,I try to identify with my clients.
1786,4,16,65,85,1.2823529411764707,0.05943658133277241,549,My back pain is gone and my hands are never cold. You'll love it.
1786,3,18,64,85,1.2823529411764707,0.057031527734309743,549,You'll fit well with our corporate culture.
1786,1,22,62,85,1.2823529411764707,0.051888062847571095,549,I think I understand your position.
1786,2,20,63,85,1.2823529411764707,0.05452048340661897,549,Let's not do anything crazy.
1786,6,12,67,85,1.2823529411764707,0.06397602121235052,549,I think we need to improve our outreach.
1786,7,10,68,85,1.2823529411764707,0.06612899012521703,549,"You should have read the employment ad more carefully, we're looking for someone with 'hands-on' experience."
1786,3,18,64,85,1.2823529411764707,0.057031527734309743,549,"Things can get a bit insane around here, which is why we think you'll be a perfect fit."
1786,3,18,64,85,1.2823529411764707,0.057031527734309743,549,I think you will fit in fine here.
1786,4,16,65,85,1.2823529411764707,0.05943658133277241,549,The Company has a strict policy on the use of cell phones.
1786,7,10,68,85,1.2823529411764707,0.06612899012521703,549,"Okay, but wouldn't you agree the glass ceiling was a more comfortable metaphor?"
1786,5,14,66,85,1.2823529411764707,0.061748030295266876,549,"It's not an interrogation, it's an enhanced interview."
1786,3,18,64,85,1.2823529411764707,0.057031527734309743,549,"I'd love to help you Mrs. Johnson, but my hands are tied."
1786,5,14,66,85,1.2823529411764707,0.061748030295266876,549,"I totally sympathize with your dilemma, but my hands are tied."
1786,4,16,65,85,1.2823529411764707,0.05943658133277241,549,"You know, we shouldn't have complained so much about the golden handcuffs."
1786,6,12,67,85,1.2823529411764707,0.06397602121235052,549,"In our experience, self control isn't enough."
1786,5,14,66,85,1.2823529411764707,0.061748030295266876,549,"The election got to you, too?"
1786,7,10,68,85,1.2823529411764707,0.06612899012521703,549,It's Legal's way of keeping us off twitter.
1786,4,16,65,85,1.2823529411764707,0.05943658133277241,549,"Hey Siri, begin interview!"
1786,5,14,66,85,1.2823529411764707,0.061748030295266876,549,"Okay, let's see if this puppy has a hands-free ap."
1786,6,12,67,85,1.2823529411764707,0.06397602121235052,549,It goes without saying that you'll need to wear slip-ons.
1786,6,12,67,85,1.2823529411764707,0.06397602121235052,549,You can't just not do your job because your nose itches.
1786,4,16,65,85,1.2823529411764707,0.05943658133277241,549,Let's get something strait. There will be no finger pointing in this office.
1786,6,12,67,85,1.2823529411764707,0.06397602121235052,549,We're just wrapping up here.
1786,7,10,68,85,1.2823529411764707,0.06612899012521703,549,"Of course I'd like to do the right thing, but our hands are tied."
1786,6,12,67,85,1.2823529411764707,0.06397602121235052,549,"As you know, a career in voice recognition software isn't for everyone."
1786,3,18,64,85,1.2823529411764707,0.057031527734309743,549,I really AM feeling less need to gesticulate.
1786,5,14,66,85,1.2823529411764707,0.061748030295266876,549,You remind me of myself when I was your age.
1786,7,10,68,85,1.2823529411764707,0.06612899012521703,549,"well, one of us needs to send the email."
1786,4,16,65,85,1.2823529411764707,0.05943658133277241,549,It can get a little crazy around here. I hope you're okay with that.
1786,5,14,66,85,1.2823529411764707,0.061748030295266876,549,"You're right, Tina, it's not that uncomfortable. And it makes tweeting virtually impossible. Think he'll go for it?"
1786,6,12,67,85,1.2823529411764707,0.06397602121235052,549,"Call me crazy, but I think you'd be a perfect fit for our company."
1786,5,14,66,85,1.2823529411764707,0.061748030295266876,549,"OK, then. We're ready for 2017."
1786,6,12,67,85,1.2823529411764707,0.06397602121235052,549,"If you're born Italian, I find it helps in learning to speak English."
1786,7,10,68,85,1.2823529411764707,0.06612899012521703,549,"I'm sorry, but we have to let you go."
1786,5,14,66,85,1.2823529411764707,0.061748030295266876,549,"No, it's not a very touchy feely department"
1786,4,16,65,85,1.2823529411764707,0.05943658133277241,549,"I'm sorry, but I just can't sign off on this."
1786,3,18,64,85,1.2823529411764707,0.057031527734309743,549,They take compliance very seriously around here.
1786,4,16,65,85,1.2823529411764707,0.05943658133277241,549,"This way, we don't have to block Facebook and Twitter on work computers."
1786,4,16,65,85,1.2823529411764707,0.05943658133277241,549,"I'm sorry, you're overqualified."
1786,5,14,66,85,1.2823529411764707,0.061748030295266876,549,We're tied up in meetings all day.
1869,4,16,66,86,1.2790697674418605,0.05883307274731867,549,Have you noticed we're just not as productive as we used to be.
1869,1,22,63,86,1.2790697674418605,0.05138615587138972,549,You’d fit right in here.
1871,6,11,67,84,1.2738095238095237,0.0641623516208414,549,I know.
1871,5,13,66,84,1.2738095238095237,0.06188655454031695,549,And what makes you believe you are qualified to work for 3M?
1871,4,15,65,84,1.2738095238095237,0.059523809523809534,549,"Congratulations, I think you'll fit in very well here at Houdini,Houdini ,and Houdini !"
1871,4,15,65,84,1.2738095238095237,0.059523809523809534,549,We are a strictly 'hands-off' business.
1871,5,13,66,84,1.2738095238095237,0.06188655454031695,549,"This way, when we say Our hands our tied, we can really mean it."
1871,7,9,68,84,1.2738095238095237,0.06636014691184276,549,"I'm sorry, but my hands are, well, you know..."
1871,3,17,64,84,1.2738095238095237,0.0570633171799703,549,"We take a laissez-faire, hands-off approach in this company."
1871,2,19,63,84,1.2738095238095237,0.0544918382414929,549,I have experience with your problem
1871,6,11,67,84,1.2738095238095237,0.0641623516208414,549,Typing skills are important in this job.
1871,3,17,64,84,1.2738095238095237,0.0570633171799703,549,"Call me crazy, but haven't we met somewhere before?"
1871,4,15,65,84,1.2738095238095237,0.059523809523809534,549,...but it helps
1871,5,13,66,84,1.2738095238095237,0.06188655454031695,549,Productivity is down. We are going to have to let you go.
1871,5,13,66,84,1.2738095238095237,0.06188655454031695,549,I'd just love to smack you on the face right now.
1871,6,11,67,84,1.2738095238095237,0.0641623516208414,549,I told them our hands are tied. We'll just have to sit this one out.
1871,5,13,66,84,1.2738095238095237,0.06188655454031695,549,Keep 'We unanimously welcome the merger' but take out 'with open arms'.
1871,3,17,64,84,1.2738095238095237,0.0570633171799703,549,"We women have made some progress, they have removed the blindfolds & gags"
1871,1,21,62,84,1.2738095238095237,0.05179284412244768,549,How do you like the office culture so far?
1871,5,13,66,84,1.2738095238095237,0.06188655454031695,549,This job is easier than it looks.
1871,3,17,64,84,1.2738095238095237,0.0570633171799703,549,Entry level requires sharing a rubber office.
1871,6,11,67,84,1.2738095238095237,0.0641623516208414,549,"Apparently the 'Speak Truth to Power' bit didn't work for you, either?"
1871,5,13,66,84,1.2738095238095237,0.06188655454031695,549,What can you bring from voice recognition to driverless technology?
1871,2,19,63,84,1.2738095238095237,0.0544918382414929,549,"Siri, call 911."
1871,6,11,67,84,1.2738095238095237,0.0641623516208414,549,"Disturbing, yes, but let's give the new guy a chance."
1871,2,19,63,84,1.2738095238095237,0.0544918382414929,549,Welcome aboard. You'll fit right in.
1871,4,15,65,84,1.2738095238095237,0.059523809523809534,549,Was this suposed to be an exercise in futility or empathy?
1871,5,13,66,84,1.2738095238095237,0.06188655454031695,549,"No problem, all our systems are voice activated."
1871,7,9,68,84,1.2738095238095237,0.06636014691184276,549,"Unfortunately, our productivity has dropped dramatically since we adopted our 'Safety First & Foremost' policy."
1871,4,15,65,84,1.2738095238095237,0.059523809523809534,549,I don't watch the news anymore either.
1871,6,11,67,84,1.2738095238095237,0.0641623516208414,549,Could you please describe for me the time you worked in the Trump administration?
1871,4,15,65,84,1.2738095238095237,0.059523809523809534,549,I'm finding the companies dress code a little restrictive.
1871,7,9,68,84,1.2738095238095237,0.06636014691184276,549,I told accounting our hands are tied on this one.
1871,5,13,66,84,1.2738095238095237,0.06188655454031695,549,"You're crazy. No, you're crazy."
1871,2,19,63,84,1.2738095238095237,0.0544918382414929,549,Let's play charades
1871,6,11,67,84,1.2738095238095237,0.0641623516208414,549,I should have seen this coming when we started wearing skinny jeans.
1871,3,17,64,84,1.2738095238095237,0.0570633171799703,549,"I'm not sure the move from ""Friday casual"" to ""Friday institutional"" was a good idea."
1871,4,15,65,84,1.2738095238095237,0.059523809523809534,549,"So Linda, welcome to the Trump PR department."
1871,6,11,67,84,1.2738095238095237,0.0641623516208414,549,There is a piece of lint on your shoulder.
1871,3,17,64,84,1.2738095238095237,0.0570633171799703,549,So same time next week?
1871,4,15,65,84,1.2738095238095237,0.059523809523809534,549,I can't believe that she wore the same outfit as me.
1871,4,15,65,84,1.2738095238095237,0.059523809523809534,549,"The salary is $30,000. We've no wiggle room on that. Or on paid vacation. Or on anything else, really."
1871,2,19,63,84,1.2738095238095237,0.0544918382414929,549,I think that's a crazy idea.
1871,6,11,67,84,1.2738095238095237,0.0641623516208414,549,Let me be straight with you.
1871,7,9,68,84,1.2738095238095237,0.06636014691184276,549,"And, where do you see yourself in five years?"
1871,5,13,66,84,1.2738095238095237,0.06188655454031695,549,We provide shackles for Casual Friday
1871,6,11,67,84,1.2738095238095237,0.0641623516208414,549,Sorry — new Planned Parenthood procedures since the election.
1871,5,13,66,84,1.2738095238095237,0.06188655454031695,549,Nothing we can do. Looks like our hands are tied.
1871,3,17,64,84,1.2738095238095237,0.0570633171799703,549,"Got mine on line, didn't lift a finger."
1871,4,15,65,84,1.2738095238095237,0.059523809523809534,549,We are still confined by binding arbitration.
1871,4,15,65,84,1.2738095238095237,0.059523809523809534,549,I'd like to help you but I'm a bit tied up myself.
1871,5,13,66,84,1.2738095238095237,0.06188655454031695,549,I see we shop at the same outpatient mall.
1871,4,15,65,84,1.2738095238095237,0.059523809523809534,549,We take verbal only communication training very seriously
1871,3,17,64,84,1.2738095238095237,0.0570633171799703,549,"You don't have to be crazy to work here, but. . . aw, who am I kidding???"
1871,4,15,65,84,1.2738095238095237,0.059523809523809534,549,Couldn't they have just deleted my Twitter account.
1871,4,15,65,84,1.2738095238095237,0.059523809523809534,549,I'm sorry. My hands are tied too.
1871,4,15,65,84,1.2738095238095237,0.059523809523809534,549,Who are you calling crazy?
1871,4,15,65,84,1.2738095238095237,0.059523809523809534,549,"Did Corporate really mean ""Straitjacket Fridays"", or did they use that stupid speech-recognition software again?"
1871,6,11,67,84,1.2738095238095237,0.0641623516208414,549,I can't help you. My hands are tied.
1871,3,17,64,84,1.2738095238095237,0.0570633171799703,549,Running the asylum is much harder than I expected.
1871,3,17,64,84,1.2738095238095237,0.0570633171799703,549,"I'm sorry that you're in a bind, but what can I do? My hands are tied."
1871,4,15,65,84,1.2738095238095237,0.059523809523809534,549,I'm in it for the mummy.
1871,3,17,64,84,1.2738095238095237,0.0570633171799703,549,I think you'll find a non-binding resolution more productive in this case.
1871,5,13,66,84,1.2738095238095237,0.06188655454031695,549,We can get started. Mr. Houdini's running late.
1871,5,13,66,84,1.2738095238095237,0.06188655454031695,549,Since we instituted the new dress code we've had no cases of carpal tunnel syndrome
1871,5,13,66,84,1.2738095238095237,0.06188655454031695,549,"I need someone with more of a ""hands-on"" approach."
1871,3,17,64,84,1.2738095238095237,0.0570633171799703,549,Maybe we should take a mental health day and get together next week when we aren't both so tied up.
1871,7,9,68,84,1.2738095238095237,0.06636014691184276,549,"It was a pleasure meeting you, Shannon. We're always looking for like-binded individuals. I really think you will be a good fit."
1871,5,13,66,84,1.2738095238095237,0.06188655454031695,549,I'm also in a bind.
1871,5,13,66,84,1.2738095238095237,0.06188655454031695,549,"Personally, I can't wait for casual Friday."
1871,3,17,64,84,1.2738095238095237,0.0570633171799703,549,I'd love to help you out but my hands are tied.
1871,3,17,64,84,1.2738095238095237,0.0570633171799703,549,You pretend to work and we'll pretend to pay you.
1871,3,17,64,84,1.2738095238095237,0.0570633171799703,549,The nice thing about uniforms is you don't have to worry about what you'll wear tomorrow.
1871,7,9,68,84,1.2738095238095237,0.06636014691184276,549,"Why yes, I do think the new mental-health coverage is too proactive."
1871,6,11,67,84,1.2738095238095237,0.0641623516208414,549,I feel your pain.
1871,3,17,64,84,1.2738095238095237,0.0570633171799703,549,What makes you think you're qualified for the job?
1871,3,17,64,84,1.2738095238095237,0.0570633171799703,549,We don't believe in handouts at this firm.
1871,4,15,65,84,1.2738095238095237,0.059523809523809534,549,"I'd love to fund your project, but frankly I'm pretty strapped myself."
1871,3,17,64,84,1.2738095238095237,0.0570633171799703,549,Welcome to Peer to Peer counseling.
1871,4,15,65,84,1.2738095238095237,0.059523809523809534,549,It's great to meet an applicant who's such a good fit--shall we shake on it?
1871,1,21,62,84,1.2738095238095237,0.05179284412244768,549,"So, you're here to complain about the new dress code being too restrictive?"
1871,4,15,65,84,1.2738095238095237,0.059523809523809534,549,"So I'd like to help, but my hands are tied."
1871,3,17,64,84,1.2738095238095237,0.0570633171799703,549,"Besides the discriminating dress code for schizophrenics, how do you like your job so far?"
1871,7,9,68,84,1.2738095238095237,0.06636014691184276,549,Your outrageous claims and volatile unpredictability are exactly what we need. When can you start?
1871,4,15,65,84,1.2738095238095237,0.059523809523809534,549,So we're all straight then?
1871,5,13,66,84,1.2738095238095237,0.06188655454031695,549,Your resume and everything you've told me confirms that you're quite useless. You'll fit in perfectly here.
1871,4,15,65,84,1.2738095238095237,0.059523809523809534,549,"And as an added bonus, the walls of your office will be lined with rubber."
1871,3,17,64,84,1.2738095238095237,0.0570633171799703,549,We're hoping the new manager will be less stringent.
1871,3,17,64,84,1.2738095238095237,0.0570633171799703,549,"Welcome to your first day at Anger Management School, I am a former graduate."
1871,2,19,63,84,1.2738095238095237,0.0544918382414929,549,They did warn us about stricter policies if we continued to use social media on company time.
1871,4,15,65,84,1.2738095238095237,0.059523809523809534,549,Personnel says we have to keep our hands to ourselves.
1871,3,17,64,84,1.2738095238095237,0.0570633171799703,549,You are exactly what this company is looking for!
1871,3,17,64,84,1.2738095238095237,0.0570633171799703,549,I’m beginning to regret advocating mental health coverage.
1871,2,19,63,84,1.2738095238095237,0.0544918382414929,549,"Dress for the job you want, not the job you have."
1871,4,15,65,84,1.2738095238095237,0.059523809523809534,549,I guess thats the end of Facebook during work hours.
1871,2,19,63,84,1.2738095238095237,0.0544918382414929,549,Right--hands on experience is not required.
1871,4,15,65,84,1.2738095238095237,0.059523809523809534,549,Corporate wants to avoid even the appearance of a conflict of interest.
1871,5,13,66,84,1.2738095238095237,0.06188655454031695,549,Cancel all calls. We're tied up at the moment
1871,6,11,67,84,1.2738095238095237,0.0641623516208414,549,'My hands are tied' is not an excuse.
1871,6,11,67,84,1.2738095238095237,0.0641623516208414,549,I'm pleased you'll be joining us at the EPA.
1871,5,13,66,84,1.2738095238095237,0.06188655454031695,549,Welcome to Tweets Anonymous One Step Program
1871,4,15,65,84,1.2738095238095237,0.059523809523809534,549,I also complained about equality
1871,3,17,64,84,1.2738095238095237,0.0570633171799703,549,"I'm sorry Karen, but my hands are tied."
1871,2,19,63,84,1.2738095238095237,0.0544918382414929,549,"Well, we did ask for a safe space."
1871,6,11,67,84,1.2738095238095237,0.0641623516208414,549,"Believe me, this company will not give you a handout."
1871,6,11,67,84,1.2738095238095237,0.0641623516208414,549,We're moving away from the no-holds-barred interview.
1871,4,15,65,84,1.2738095238095237,0.059523809523809534,549,I’m afraid my hands are tied.
1871,4,15,65,84,1.2738095238095237,0.059523809523809534,549,"No, shorthand is not a requirement for the position."
1871,7,9,68,84,1.2738095238095237,0.06636014691184276,549,So Pence said this will cure us?
1871,5,13,66,84,1.2738095238095237,0.06188655454031695,549,Mr. Trump likes his female employees to behave with restraints.
1871,4,15,65,84,1.2738095238095237,0.059523809523809534,549,We find turnover is lower when employees can't choose to leave.
1871,3,17,64,84,1.2738095238095237,0.0570633171799703,549,"No, you cannot get a hug."
1871,5,13,66,84,1.2738095238095237,0.06188655454031695,549,"I understand you're in dire straits, but my hands are tied."
1871,5,13,66,84,1.2738095238095237,0.06188655454031695,549,It's about time that we inmates got to run the asylum.
1871,6,11,67,84,1.2738095238095237,0.0641623516208414,549,"With our new management, we plan to use a more hands-on approach."
1871,3,17,64,84,1.2738095238095237,0.0570633171799703,549,How many words per minute can you type with your nose?
1871,5,13,66,84,1.2738095238095237,0.06188655454031695,549,"Ok, so let me get this straight..."
1871,5,13,66,84,1.2738095238095237,0.06188655454031695,549,"While it's good for our posture, it creates havoc in the ladies room."
1871,8,7,69,84,1.2738095238095237,0.06848745017013132,549,I don't know how I feel about HR's new social media use policy.
1871,3,17,64,84,1.2738095238095237,0.0570633171799703,549,"Command, Opt, Escape. I'll try my nose this time."
1871,4,15,65,84,1.2738095238095237,0.059523809523809534,549,"I'd really like to help you get out, but my hands are tied."
1871,4,15,65,84,1.2738095238095237,0.059523809523809534,549,I couldn't do a thing about it; my hands are tied.
1871,2,19,63,84,1.2738095238095237,0.0544918382414929,549,When I said you should try putting yourself in my place I didn’t think you would take me literally.
1871,4,15,65,84,1.2738095238095237,0.059523809523809534,549,Let me get this straight...
1871,7,9,68,84,1.2738095238095237,0.06636014691184276,549,Lesson learned: don't call it the 'Christmas' party.
1871,7,9,68,84,1.2738095238095237,0.06636014691184276,549,This is a difficult for us both.
1871,2,19,63,84,1.2738095238095237,0.0544918382414929,549,"Not only do we take things very literally here, we also have a very hands off approach to management."
1871,5,13,66,84,1.2738095238095237,0.06188655454031695,549,I hope you'll accept our job offer. I think you're a perfect fit for our corporate culture.
1997,6,11,68,85,1.2705882352941176,0.06348478565417674,549,My hands are tied too.
1997,1,21,63,85,1.2705882352941176,0.05128116404165499,549,"Yes, IT works under the same restraints as everyone else."
1997,4,15,66,85,1.2705882352941176,0.05890750308679626,549,"If you're looking for a sense of freedom and to spread your wings, this is the place."
1997,5,13,67,85,1.2705882352941176,0.06123892524153929,549,"Are we onto something here, or are we just crazy?"
1997,3,17,65,85,1.2705882352941176,0.05647992453166862,549,"Tuesday? No i,m all tied up then. How about wednesday?"
1997,5,13,67,85,1.2705882352941176,0.06123892524153929,549,"So, tell me about your strengths..."
1997,5,13,67,85,1.2705882352941176,0.06123892524153929,549,Your resume is great but what I'm really looking for is someone who can pick my nose.
2004,3,17,66,86,1.2674418604651163,0.05590792363042257,549,Why do you think you are qualified to work here ?
2005,4,14,65,83,1.2650602409638554,0.0595909687658098,549,Our pre-employment psychological test is quite demanding.
2005,3,16,64,83,1.2650602409638554,0.05707210525447058,549,I can appreciate your predicament but my hands are tied.
2005,2,18,63,83,1.2650602409638554,0.05443681509701885,549,"Now that we've tied up all the loose ends, we have a deal."
2005,6,10,67,83,1.2650602409638554,0.06433350821297108,549,"Lets be straight with each other, we're both nuts."
2005,3,16,64,83,1.2650602409638554,0.05707210525447058,549,Let's call it a tie.
2005,5,12,66,83,1.2650602409638554,0.0620075956534203,549,"Okay, NOW we can check the news."
2005,4,14,65,83,1.2650602409638554,0.0595909687658098,549,I prefer non-binding resolutions.
2005,3,16,64,83,1.2650602409638554,0.05707210525447058,549,"OK, so we agree to keep it under wraps."
2005,5,12,66,83,1.2650602409638554,0.0620075956534203,549,It appears that we're both tied up today. Are you free tomorrow?
2005,7,8,68,83,1.2650602409638554,0.06657821444931343,549,"I'm sorry I can't help, my hands are tied."
2005,5,12,66,83,1.2650602409638554,0.0620075956534203,549,"You have to be crazy to work here, but it doesn't help."
2005,2,18,63,83,1.2650602409638554,0.05443681509701885,549,I'm afraid I can't help you. My hands are tied.
2005,4,14,65,83,1.2650602409638554,0.0595909687658098,549,"I understand your hands are tied, but so are mine."
2005,4,14,65,83,1.2650602409638554,0.0595909687658098,549,I find therapy is more effective if we have something in common.
2005,3,16,64,83,1.2650602409638554,0.05707210525447058,549,"And, where do you see yourself in ten years?"
2005,5,12,66,83,1.2650602409638554,0.0620075956534203,549,So tell me...why do others believe you're crazy?
2005,6,10,67,83,1.2650602409638554,0.06433350821297108,549,I understand. You're tied up too.
2005,4,14,65,83,1.2650602409638554,0.0595909687658098,549,"Unfortunately, our hands are tied."
2005,5,12,66,83,1.2650602409638554,0.0620075956534203,549,You really should have cancelled if you were already tied up.
2005,6,10,67,83,1.2650602409638554,0.06433350821297108,549,"In the future, please show more restraint."
2005,4,14,65,83,1.2650602409638554,0.0595909687658098,549,It's time we had a straight talk.
2005,5,12,66,83,1.2650602409638554,0.0620075956534203,549,"Unfortunately, this is a hands-on position ..."
2005,2,18,63,83,1.2650602409638554,0.05443681509701885,549,"Well, it's out of our hands now!"
2005,6,10,67,83,1.2650602409638554,0.06433350821297108,549,This will be uncomfortable for both of us.
2005,6,10,67,83,1.2650602409638554,0.06433350821297108,549,"OK, here's what I found on the web for 'how to get out of a straitjacket'"
2005,5,12,66,83,1.2650602409638554,0.0620075956534203,549,"Like you, my hands are tied on this one."
2005,6,10,67,83,1.2650602409638554,0.06433350821297108,549,I would love to give you a raise Marsha but our hands are tied.
2005,4,14,65,83,1.2650602409638554,0.0595909687658098,549,Got a match?
2005,3,16,64,83,1.2650602409638554,0.05707210525447058,549,I think you may be the perfect candidate for the job!
2005,4,14,65,83,1.2650602409638554,0.0595909687658098,549,I just can't do it; my hands are tied.
2005,5,12,66,83,1.2650602409638554,0.0620075956534203,549,"No, what's crazy is the raise you're asking for."
2005,3,16,64,83,1.2650602409638554,0.05707210525447058,549,We seem to have so much in common.
2005,3,16,64,83,1.2650602409638554,0.05707210525447058,549,This new dress code is crazy!
2005,5,12,66,83,1.2650602409638554,0.0620075956534203,549,It appears you're over-qualified.
2005,4,14,65,83,1.2650602409638554,0.0595909687658098,549,"Well I'm sorry, but our hands are really tied here."
2005,4,14,65,83,1.2650602409638554,0.0595909687658098,549,"So, Ms. Houdini, let's see what you can do."
2005,4,14,65,83,1.2650602409638554,0.0595909687658098,549,"I'm sorry, I can't help you. My hands are tied."
2005,4,14,65,83,1.2650602409638554,0.0595909687658098,549,"Since we're both tied up, lunch is postponed until tomorrow."
2005,2,18,63,83,1.2650602409638554,0.05443681509701885,549,"Well, Miss Jones, it looks to me like you are uniquely qualified for this position."
2005,2,18,63,83,1.2650602409638554,0.05443681509701885,549,"I know you did your best to fit in here at Bondage Inc., but we're going to have to let you go."
2005,2,18,63,83,1.2650602409638554,0.05443681509701885,549,"On the other hand, my hands are no longer cold."
2005,3,16,64,83,1.2650602409638554,0.05707210525447058,549,It's crazy working here.
2005,3,16,64,83,1.2650602409638554,0.05707210525447058,549,"Fine, how are you?"
2005,3,16,64,83,1.2650602409638554,0.05707210525447058,549,"Qualified? Why, you could do this job with your hands tied behind your back!"
2005,3,16,64,83,1.2650602409638554,0.05707210525447058,549,It looks like I'll be tied up next week too.
2005,3,16,64,83,1.2650602409638554,0.05707210525447058,549,"I agree--the money is great, but the hours are insane."
2005,3,16,64,83,1.2650602409638554,0.05707210525447058,549,Tell me if you think this is a crazy idea.
2005,1,20,62,83,1.2650602409638554,0.05166728633900439,549,I'm afraid there's not much wiggle room regarding working from home.
2005,5,12,66,83,1.2650602409638554,0.0620075956534203,549,How fast do you toe type?
2005,2,18,63,83,1.2650602409638554,0.05443681509701885,549,"If you wriggle free before I do, you're hired."
2005,7,8,68,83,1.2650602409638554,0.06657821444931343,549,"Little do they know, the loonies really are running the asylum."
2005,6,10,67,83,1.2650602409638554,0.06433350821297108,549,It doesn't just help. You actually do have to be crazy to work here.
2005,3,16,64,83,1.2650602409638554,0.05707210525447058,549,"Unfortunately, it's not flexible: we're contractually bound."
2005,5,12,66,83,1.2650602409638554,0.0620075956534203,549,Thanks for stopping by. I was hoping you could lend me a hand.
2005,2,18,63,83,1.2650602409638554,0.05443681509701885,549,You seem great for the job. But then again I'm crazy.
2005,4,14,65,83,1.2650602409638554,0.0595909687658098,549,"I'm sorry, but my hands are tied."
2005,4,14,65,83,1.2650602409638554,0.0595909687658098,549,"The boss prefers to call it 'bindage."""
2005,4,14,65,83,1.2650602409638554,0.0595909687658098,549,We point the finger at no one in this company.
2005,3,16,64,83,1.2650602409638554,0.05707210525447058,549,You'll notice we've added a degree of difficulty to performance review.
2005,4,14,65,83,1.2650602409638554,0.0595909687658098,549,"Our hands might be tied, but no one can call us crazy."
2005,8,6,69,83,1.2650602409638554,0.0687496690866881,549,"When I started in this firm, it was so much harder for women."
2005,4,14,65,83,1.2650602409638554,0.0595909687658098,549,Kind of makes you miss casual Friday.
2005,0,22,61,83,1.2650602409638554,0.0487406413310937,549,I feel that we are of like minds.
2005,5,12,66,83,1.2650602409638554,0.0620075956534203,549,I hear you. I'm tied up that day also.
2005,4,14,65,83,1.2650602409638554,0.0595909687658098,549,I don't need to write it down. I can remember.
2005,5,12,66,83,1.2650602409638554,0.0620075956534203,549,You will fit right in here. We are not a hands-on company.
2005,4,14,65,83,1.2650602409638554,0.0595909687658098,549,There are no shortcuts here. We all put on our straight jackets one buckle at a time.
2005,2,18,63,83,1.2650602409638554,0.05443681509701885,549,I think it's safe to say that there will be no more finger pointing -- but this is your fault.
2005,6,10,67,83,1.2650602409638554,0.06433350821297108,549,I see you have experience working for our company.
2005,8,6,69,83,1.2650602409638554,0.0687496690866881,549,"Look, Meredith... I'd love to give you a raise, but Corporate has my hands tied."
2005,4,14,65,83,1.2650602409638554,0.0595909687658098,549,"Anyone can be committed, what more can you offer ??"
2005,4,14,65,83,1.2650602409638554,0.0595909687658098,549,I'm sympathetic with your situation but my hands are tied too.
2005,4,14,65,83,1.2650602409638554,0.0595909687658098,549,"I can see that your in a bind, but my hands are tied."
2005,4,14,65,83,1.2650602409638554,0.0595909687658098,549,It all started with chewing on my nails.
2005,5,12,66,83,1.2650602409638554,0.0620075956534203,549,You seem uniquely qualified for a position either in the EPA for the next four years or the FDA indefinitely.
2005,3,16,64,83,1.2650602409638554,0.05707210525447058,549,"I'd love to give you a raise, but my hands are tied."
2005,4,14,65,83,1.2650602409638554,0.0595909687658098,549,"Well, I have found that I am more in touch with myself these days."
2005,5,12,66,83,1.2650602409638554,0.0620075956534203,549,Why are we so restrained?
2005,3,16,64,83,1.2650602409638554,0.05707210525447058,549,Thank God it's Friday. It's been the craziest week ever.
2005,5,12,66,83,1.2650602409638554,0.0620075956534203,549,"I would like to help you out but, as you know, my hands are tied."
2005,5,12,66,83,1.2650602409638554,0.0620075956534203,549,This hand's free app is much easier to learn this way.
2005,4,14,65,83,1.2650602409638554,0.0595909687658098,549,"I'd love to give you the job, but my hands are tied."
2005,4,14,65,83,1.2650602409638554,0.0595909687658098,549,"If we hire you ,most days you'all be tied up in meetings"
2005,5,12,66,83,1.2650602409638554,0.0620075956534203,549,Let's face it! Our hands are tied.
2005,5,12,66,83,1.2650602409638554,0.0620075956534203,549,Could you serve as my right hand?
2005,1,20,62,83,1.2650602409638554,0.05166728633900439,549,This is the way Mary kicked her texting habit!
2005,3,16,64,83,1.2650602409638554,0.05707210525447058,549,I'm glad to see you fitting in here.
2005,5,12,66,83,1.2650602409638554,0.0620075956534203,549,We're bound to work well together.
2005,1,20,62,83,1.2650602409638554,0.05166728633900439,549,"So, any hobbies?"
2005,6,10,67,83,1.2650602409638554,0.06433350821297108,549,"""The next series of questions in this interview are of a more personal nature..."
2005,4,14,65,83,1.2650602409638554,0.0595909687658098,549,"Great idea...but as you're well aware, our hands are tied."
2005,3,16,64,83,1.2650602409638554,0.05707210525447058,549,That wraps things up.
2005,0,22,61,83,1.2650602409638554,0.0487406413310937,549,"We're not what you call a ""hands on"" operation here, so we think you might just fit in."
2005,2,18,63,83,1.2650602409638554,0.05443681509701885,549,"Well, the corporate structure is strong, but there's not a lot of room for mobility."
2005,5,12,66,83,1.2650602409638554,0.0620075956534203,549,"Between the glass ceiling and the canvas restraints, I'm beginning to think that misogyny may be a real problem at this company."
2005,4,14,65,83,1.2650602409638554,0.0595909687658098,549,You know I'd love to help but . . .
2005,3,16,64,83,1.2650602409638554,0.05707210525447058,549,I'd love to help you out but my hands are tied.
2005,4,14,65,83,1.2650602409638554,0.0595909687658098,549,Let's try to meet again when we're not so tied up.
2005,3,16,64,83,1.2650602409638554,0.05707210525447058,549,Things do often get out of control here.
2005,6,10,67,83,1.2650602409638554,0.06433350821297108,549,"If it was up to me you'd have the promotion, but my hands are tied."
2005,4,14,65,83,1.2650602409638554,0.0595909687658098,549,I'm going to be straight with you: you deserve a raise but my hands are tied right now.
2005,5,12,66,83,1.2650602409638554,0.0620075956534203,549,My blue state friends tell me we should have seen this coming.
2005,3,16,64,83,1.2650602409638554,0.05707210525447058,549,This is a hands free office.
2005,2,18,63,83,1.2650602409638554,0.05443681509701885,549,"My intuition tells me you're going to fit in quite well here, Judy."
2005,3,16,64,83,1.2650602409638554,0.05707210525447058,549,To work here you have to wear a jacket at all times.
2005,3,16,64,83,1.2650602409638554,0.05707210525447058,549,"Principal Jones, do you know what it feels like to teach with all these state and federal regulations?"
2005,3,16,64,83,1.2650602409638554,0.05707210525447058,549,I see you've been issued the company uniform.
2005,6,10,67,83,1.2650602409638554,0.06433350821297108,549,Right now we're looking for people who can work with their hands.
2005,4,14,65,83,1.2650602409638554,0.0595909687658098,549,"I asked you to design a trendy new ""straight jacket"" for our spring collection. Not a straitjacket."
2005,6,10,67,83,1.2650602409638554,0.06433350821297108,549,I miss casual Fridays.
2005,5,12,66,83,1.2650602409638554,0.0620075956534203,549,"Since hiring an ergonomist, disability claims for carpal tunnel are down 90%!"
2005,2,18,63,83,1.2650602409638554,0.05443681509701885,549,Just tell him we can't cause we're both tied up right now.
2005,3,16,64,83,1.2650602409638554,0.05707210525447058,549,How's the diet going for you?
2005,4,14,65,83,1.2650602409638554,0.0595909687658098,549,"I'm sorry,I'd like to help you, but my hands are tied."
2005,4,14,65,83,1.2650602409638554,0.0595909687658098,549,You were right. This does make it harder.
2005,5,12,66,83,1.2650602409638554,0.0620075956534203,549,It's a wrap.
2005,4,14,65,83,1.2650602409638554,0.0595909687658098,549,"I'm afraid the assistant I'm looking for will need to be much more ""hands-on."""
2005,5,12,66,83,1.2650602409638554,0.0620075956534203,549,First test aced. You have to be crazy to work here.
2005,5,12,66,83,1.2650602409638554,0.0620075956534203,549,"They all know we're straight, but the jackets take it to a whole new level."
2005,6,10,67,83,1.2650602409638554,0.06433350821297108,549,"Of course we have to wait for the background check results before making an offer, but I think you will make a great addition to the team here at Breitbart."
2005,4,14,65,83,1.2650602409638554,0.0595909687658098,549,"Well I would, but my hands are tied."
2005,2,18,63,83,1.2650602409638554,0.05443681509701885,549,Fitting in is very important here.
2005,3,16,64,83,1.2650602409638554,0.05707210525447058,549,I prefer to think that freedom's just another word for nothing left to lose.
2005,2,18,63,83,1.2650602409638554,0.05443681509701885,549,"This time of year, it can get a little crazy."
2005,2,18,63,83,1.2650602409638554,0.05443681509701885,549,I'm looking for a more flexible work environment
2005,2,18,63,83,1.2650602409638554,0.05443681509701885,549,Phone's been ringing off the hook.
2131,4,14,66,84,1.2619047619047619,0.058961775736536534,549,I think you will find that this is one place where the inmates really are running the asylum.
2132,4,13,64,81,1.2592592592592593,0.0602919281337026,549,"I thought management said that they were going to ""re-train"" us."
2132,5,11,65,81,1.2592592592592593,0.06279935169560431,549,I felt my last job was too constricting.
2132,4,13,64,81,1.2592592592592593,0.0602919281337026,549,I'm glad to see you're staying committed.
2132,3,15,63,81,1.2592592592592593,0.057675598157027524,549,I think we're both having trouble opening up.
2132,5,11,65,81,1.2592592592592593,0.06279935169560431,549,"I love casual Fridays, don't you?"
2132,3,15,63,81,1.2592592592592593,0.057675598157027524,549,This prevents us from checking our phones during the interview.
2132,5,11,65,81,1.2592592592592593,0.06279935169560431,549,"Well, yes, our company does seem to frown on leaning-in."
2132,5,11,65,81,1.2592592592592593,0.06279935169560431,549,"So, the good news is that management agreed with you that the inmates are running the asylum..."
2132,5,11,65,81,1.2592592592592593,0.06279935169560431,549,This is a hands-free workplace.
2132,5,11,65,81,1.2592592592592593,0.06279935169560431,549,I heard that you're welcoming new clients with open arms.
2132,5,11,65,81,1.2592592592592593,0.06279935169560431,549,"Okay, give it to me straight"
2132,6,9,66,81,1.2592592592592593,0.06521043282095929,549,"Like you, i'm all tied up"
2132,3,15,63,81,1.2592592592592593,0.057675598157027524,549,Your move.
2132,6,9,66,81,1.2592592592592593,0.06521043282095929,549,Know you're in a bind but I'm all tied up here.
2132,2,17,62,81,1.2592592592592593,0.054934803608116006,549,"Yes, but there is no glass ceiling."
2132,5,11,65,81,1.2592592592592593,0.06279935169560431,549,This latest diet craze sucks.
2132,4,13,64,81,1.2592592592592593,0.0602919281337026,549,You'll love working here--the men control everything.
2132,2,17,62,81,1.2592592592592593,0.054934803608116006,549,It's a crazy business but I love it.
2132,8,5,68,81,1.2592592592592593,0.06978312474598804,549,This is incredibly hard for me too. I have to let you go.
2132,4,13,64,81,1.2592592592592593,0.0602919281337026,549,Aggressive regulatory compliance is our policy.
2132,4,13,64,81,1.2592592592592593,0.0602919281337026,549,"Well, one of us is going to have to change."
2132,0,21,60,81,1.2592592592592593,0.04899539464934425,549,Did they say you talk with your hands too much as well?
2132,5,11,65,81,1.2592592592592593,0.06279935169560431,549,Welcome to the Dept. of Education.
2132,3,15,63,81,1.2592592592592593,0.057675598157027524,549,"So, you're OK with our no tweet policy? Now, can you type with your nose?"
2132,4,13,64,81,1.2592592592592593,0.0602919281337026,549,Definitely no texting during this meeting.
2132,3,15,63,81,1.2592592592592593,0.057675598157027524,549,Hands-free is out. Arms-free is the next big thing.
2132,5,11,65,81,1.2592592592592593,0.06279935169560431,549,Couldn't they have come up with a more creative solution to limit screen time?
2132,3,15,63,81,1.2592592592592593,0.057675598157027524,549,"Great question! Yes, I can definitely say that the inmates run the asylum."
2132,5,11,65,81,1.2592592592592593,0.06279935169560431,549,A few unanticipated problems developed when we took over the asylum.
2132,3,15,63,81,1.2592592592592593,0.057675598157027524,549,"Looks like you're a good fit for this organization, and I'm sure we can squeeze you in."
2132,7,7,67,81,1.2592592592592593,0.06753549084744617,549,"So, why do you think you're transition-team material?"
2132,6,9,66,81,1.2592592592592593,0.06521043282095929,549,"So, what else qualifies you to be on the President-elect's National Security team?"
2132,5,11,65,81,1.2592592592592593,0.06279935169560431,549,Want to reschedule? Looks like you're as tied up as I am.
2132,3,15,63,81,1.2592592592592593,0.057675598157027524,549,"Of all my prospects, I feel this job is a perfect fit."
2132,6,9,66,81,1.2592592592592593,0.06521043282095929,549,Is this how driverless cars got started?
2132,5,11,65,81,1.2592592592592593,0.06279935169560431,549,Let's talk.
2132,3,15,63,81,1.2592592592592593,0.057675598157027524,549,The holidays can be tough for all of us.
2132,4,13,64,81,1.2592592592592593,0.0602919281337026,549,You fit in perfectly with our uptight Friday policy.
2132,5,11,65,81,1.2592592592592593,0.06279935169560431,549,"And yes, we are fully bonded and insured."
2132,5,11,65,81,1.2592592592592593,0.06279935169560431,549,You blinked.
2132,5,11,65,81,1.2592592592592593,0.06279935169560431,549,"I guess the boss is pretty serious about this ""no selfie"" rule."
2132,7,7,67,81,1.2592592592592593,0.06753549084744617,549,The vice president-elect said this will cure us.
2132,5,11,65,81,1.2592592592592593,0.06279935169560431,549,Mr. Grey will see you now.
2132,5,11,65,81,1.2592592592592593,0.06279935169560431,549,Welcome to HR. Now what can we do for you?
2132,4,13,64,81,1.2592592592592593,0.0602919281337026,549,They finally found a way to keep us from posting fake news.
2132,1,19,61,81,1.2592592592592593,0.05204988637983404,549,Stopping smoking is easier than I thought it would be.
2132,6,9,66,81,1.2592592592592593,0.06521043282095929,549,"Your restraint is admirable, as is mine."
2132,5,11,65,81,1.2592592592592593,0.06279935169560431,549,This is exactly why I tell everyone to stay home when they're sick.
2132,3,15,63,81,1.2592592592592593,0.057675598157027524,549,Finally our management has found a way to stop finger pointing.
2132,3,15,63,81,1.2592592592592593,0.057675598157027524,549,"As women, we're bound to feel that way."
2132,5,11,65,81,1.2592592592592593,0.06279935169560431,549,I've been pretty much tied to my desk recently; how about you?
2132,2,17,62,81,1.2592592592592593,0.054934803608116006,549,"No, you first!"
2132,3,15,63,81,1.2592592592592593,0.057675598157027524,549,"We are, first and foremost, storytellers, Anne."
2132,3,15,63,81,1.2592592592592593,0.057675598157027524,549,Here at HR we understand the stresses you experience at our company.
2132,3,15,63,81,1.2592592592592593,0.057675598157027524,549,You'll fit in well here; this place is an insane asylum.
2132,5,11,65,81,1.2592592592592593,0.06279935169560431,549,Interesting that we both love Patsy Cline.
2132,4,13,64,81,1.2592592592592593,0.0602919281337026,549,Our policy is to restrain our editors to ensure thinking precedes any actions.
2132,1,19,61,81,1.2592592592592593,0.05204988637983404,549,The boss thinks we should loosen up.
2132,5,11,65,81,1.2592592592592593,0.06279935169560431,549,We also make a line of QueerJackets.
2132,3,15,63,81,1.2592592592592593,0.057675598157027524,549,We are looking for a candidate with hands-on experience
2132,5,11,65,81,1.2592592592592593,0.06279935169560431,549,Me too. It's not that I don't think about it. I just don't do it any more.
2132,3,15,63,81,1.2592592592592593,0.057675598157027524,549,"They told us to show some restraint, but now what?"
2132,5,11,65,81,1.2592592592592593,0.06279935169560431,549,I have a feeling we think alike.
2132,5,11,65,81,1.2592592592592593,0.06279935169560431,549,You think this is bad. Wait 'til you see what Trump's Secretary of Labor has in store for us.
2132,5,11,65,81,1.2592592592592593,0.06279935169560431,549,I just feel like I can't go anywhere.
2132,1,19,61,81,1.2592592592592593,0.05204988637983404,549,I thought I was clear you'd be working crazy hours...
2132,3,15,63,81,1.2592592592592593,0.057675598157027524,549,I very much want to help you. But my hands are tied.
2132,4,13,64,81,1.2592592592592593,0.0602919281337026,549,"Even if we could, I still don't think this would will stop him from tweeting."
2132,5,11,65,81,1.2592592592592593,0.06279935169560431,549,"Yes, I am on that diet plan,too."
2132,5,11,65,81,1.2592592592592593,0.06279935169560431,549,"Before you tell me why you hate your mother, let me tell you why I hate mine."
2132,3,15,63,81,1.2592592592592593,0.057675598157027524,549,"I wish I could help, but my hands are tied."
2132,4,13,64,81,1.2592592592592593,0.0602919281337026,549,I'm fit to be tied
2132,4,13,64,81,1.2592592592592593,0.0602919281337026,549,Now lets see if we can have a conversation without using our hands.
2205,3,15,64,82,1.2560975609756098,0.0570555644212122,549,"As for dress code, we have a strict hands-off policy."
2205,5,11,66,82,1.2560975609756098,0.062109304262145476,549,They're gonna think we're nuts.
2205,2,17,63,82,1.2560975609756098,0.05435276726322922,549,How are your nose-typing skills?
2205,3,15,64,82,1.2560975609756098,0.0570555644212122,549,I wanted to be someone you could relate to.
2205,3,15,64,82,1.2560975609756098,0.0570555644212122,549,"The way I see it, I'm as qualified as you are for this job."
2205,3,15,64,82,1.2560975609756098,0.0570555644212122,549,It looks like we are ready to wrap this up.
2205,3,15,64,82,1.2560975609756098,0.0570555644212122,549,Welcome to today's kleptomaniac cure therapy session
2205,5,11,66,82,1.2560975609756098,0.062109304262145476,549,Our cybersecurity team recommended it.
2205,2,17,63,82,1.2560975609756098,0.05435276726322922,549,This is nothing. You should sit in on a division meeting.
2205,4,13,65,82,1.2560975609756098,0.059635992099364196,549,"Well, this is bound to be interesting."
2205,6,9,67,82,1.2560975609756098,0.06448782674412354,549,I should've went to the restroom first.
2205,5,11,66,82,1.2560975609756098,0.062109304262145476,549,At least our ceiling is padded.
2205,5,11,66,82,1.2560975609756098,0.062109304262145476,549,Except for the restraints what else bothered you about the interview?
2205,6,9,67,82,1.2560975609756098,0.06448782674412354,549,"Now, let me be strait with you."
2205,3,15,64,82,1.2560975609756098,0.0570555644212122,549,"I was concerned about your qualifications, but now that I get a look at you, there's something I like."
2205,4,13,65,82,1.2560975609756098,0.059635992099364196,549,Ready to get lunch? I have two straws.
2205,6,9,67,82,1.2560975609756098,0.06448782674412354,549,I like where your head's at.
2205,2,17,63,82,1.2560975609756098,0.05435276726322922,549,I think we're coping with Trump just fine.
2205,3,15,64,82,1.2560975609756098,0.0570555644212122,549,"So since we are both tied up at the moment, why don't we do lunch Wednesday?"
2205,4,13,65,82,1.2560975609756098,0.059635992099364196,549,You will be working with many other like-minded people.
2205,5,11,66,82,1.2560975609756098,0.062109304262145476,549,"I'd love to help you out of your predicament Sheila, but my arms are tied..."
2226,4,12,64,80,1.25,0.060326117945124845,549,The good news is we're not cash strapped.
2226,6,8,66,80,1.25,0.06536170054958926,549,That was the first question I asked.
2226,6,8,66,80,1.25,0.06536170054958926,549,It's bound to help somehow.
2226,5,10,65,80,1.25,0.06289432567832845,549,"Crazy is the new sane, am I right?"
2226,3,14,63,80,1.25,0.05764360164082899,549,"I really wish I could help you, but my hands are tied."
2226,4,12,64,80,1.25,0.060326117945124845,549,"Ok, let's wrap this up."
2226,4,12,64,80,1.25,0.060326117945124845,549,Do you take shorthand?
2226,5,10,65,80,1.25,0.06289432567832845,549,I'm all tied up this week! May we reschedule?
2226,4,12,64,80,1.25,0.060326117945124845,549,"Yeah, I get more done on casual Friday too."
2226,4,12,64,80,1.25,0.060326117945124845,549,"Since we'll both be tied up, let's postpone the meeting until after the holidays."
2226,6,8,66,80,1.25,0.06536170054958926,549,I also intend to excercise more self-restraint over the holidays.
2226,4,12,64,80,1.25,0.060326117945124845,549,"I want to schedule an appointment, but I'm all tied up."
2226,2,16,62,80,1.25,0.05483000195079379,549,Some positions are no longer available.
2226,4,12,64,80,1.25,0.060326117945124845,549,Peer counseling may not work for us.
2226,1,18,61,80,1.25,0.05186398960474906,549,We believe in hands-off management.
2226,3,14,63,80,1.25,0.05764360164082899,549,Congratulations on breaking through the glass ceiling.
2226,1,18,61,80,1.25,0.05186398960474906,549,"What a coincidence, I had a bad childhood too."
2226,6,8,66,80,1.25,0.06536170054958926,549,I hear our new CEO is really insane
2226,5,10,65,80,1.25,0.06289432567832845,549,"Unfortunately, you are overqualified."
2226,4,12,64,80,1.25,0.060326117945124845,549,Good thing we aren't deaf.
2226,3,14,63,80,1.25,0.05764360164082899,549,We're test marketing a cure for Twitter finger.
2226,4,12,64,80,1.25,0.060326117945124845,549,"IF YOU CAN DO IT IN UNDER 45 SECONDS, LUNCH IS ON ME. GO!"
2226,2,16,62,80,1.25,0.05483000195079379,549,"Actually, you're projecting."
2226,4,12,64,80,1.25,0.060326117945124845,549,Rock...paper...scissor...
2226,4,12,64,80,1.25,0.060326117945124845,549,"First they made us learn voice-activated software, now we have to talk without gesturing. I'm telling you, robots are replacing us soon."
2226,3,14,63,80,1.25,0.05764360164082899,549,It seems like both our hands are tied.
2226,3,14,63,80,1.25,0.05764360164082899,549,You go first.
2226,4,12,64,80,1.25,0.060326117945124845,549,I see we got the same catalog.
2226,2,16,62,80,1.25,0.05483000195079379,549,I don't see the problem.
2226,5,10,65,80,1.25,0.06289432567832845,549,I see you are also trying to avoid suicide since the election.
2226,4,12,64,80,1.25,0.060326117945124845,549,"I'm sorry, there's nothing I can do. My hands are tied."
2226,3,14,63,80,1.25,0.05764360164082899,549,"Now that we're finally running the asylum, first order of business: dress code."
2226,3,14,63,80,1.25,0.05764360164082899,549,I have an itch.
2226,3,14,63,80,1.25,0.05764360164082899,549,I see you have a problem with nail biting too.
2226,1,18,61,80,1.25,0.05186398960474906,549,"I understand your position, but my hands are tied as well."
2226,4,12,64,80,1.25,0.060326117945124845,549,I can't find straitslacks that fit.
2226,3,14,63,80,1.25,0.05764360164082899,549,I am a hands-off manager.
2226,1,18,61,80,1.25,0.05186398960474906,549,It seems people in the office have noticed that we have trouble working together.
2226,0,20,60,80,1.25,0.048717735184622316,549,"I'm terribly sorry, but my hands are tied."
2226,2,16,62,80,1.25,0.05483000195079379,549,"I empathise with your situation, but my hands are tied."
2226,4,12,64,80,1.25,0.060326117945124845,549,"Nice to meet you, Marie, Queen of Romania. I'm Ferdinand, King of HR."
2226,3,14,63,80,1.25,0.05764360164082899,549,Where's your itch?
2226,2,16,62,80,1.25,0.05483000195079379,549,"Ok, let's wrap this up."
2226,3,14,63,80,1.25,0.05764360164082899,549,And why would you like to work in Mr. Trump's administration?
2226,5,10,65,80,1.25,0.06289432567832845,549,I guess there is such a thing as a bad question.
2226,3,14,63,80,1.25,0.05764360164082899,549,"So, your complaint is to do with restrictive practice in the workplace.....?"
2226,2,16,62,80,1.25,0.05483000195079379,549,I know how you feel.
2226,5,10,65,80,1.25,0.06289432567832845,549,The terms are binding.
2226,5,10,65,80,1.25,0.06289432567832845,549,"I can't hire you. We value diversity, and one of us has to be able to open the door to get out of here."
2226,5,10,65,80,1.25,0.06289432567832845,549,"As you get to know me, you'll see I'm a hands-off administrator."
2226,5,10,65,80,1.25,0.06289432567832845,549,I've tried every other diet out there.
2226,3,14,63,80,1.25,0.05764360164082899,549,"Everyone is crazy, except you and I; but I sometimes wonder about you."
2226,6,8,66,80,1.25,0.06536170054958926,549,"You have to understand that at Kaplan, Vogel and Bender, expressions like 'all tied up' are not simply euphemisms."
2226,4,12,64,80,1.25,0.060326117945124845,549,Ok. I guess everything is all wrapped up.
2226,5,10,65,80,1.25,0.06289432567832845,549,"I'm sorry I'm all tied up that day, would next Wednesday work?"
2226,4,12,64,80,1.25,0.060326117945124845,549,Okay. We're ready to start your performance review.
2226,6,8,66,80,1.25,0.06536170054958926,549,"You be straight with me, and I'll be straight with you."
2226,3,14,63,80,1.25,0.05764360164082899,549,We've gone all in in voice recognition
2226,5,10,65,80,1.25,0.06289432567832845,549,Women and minorities are definitely welcome in the Trump administration.
2226,6,8,66,80,1.25,0.06536170054958926,549,Here at S & M we encourage new talent and ideas.
2226,4,12,64,80,1.25,0.060326117945124845,549,I see you score high on empathy.
2226,5,10,65,80,1.25,0.06289432567832845,549,Siri! Can you scratch my nose?
2226,4,12,64,80,1.25,0.060326117945124845,549,Where do you see yourself five seconds from now?
2226,3,14,63,80,1.25,0.05764360164082899,549,"When I interviewed for the job, I thought only the male employees had to wear a jacket and tie."
2226,2,16,62,80,1.25,0.05483000195079379,549,"I would help, but I'm a little tied up at the moment."
2226,3,14,63,80,1.25,0.05764360164082899,549,We need to be a little more flexible.
2226,1,18,61,80,1.25,0.05186398960474906,549,"Sorry we couldn't meet earlier, I've been tied up all week!"
2226,4,12,64,80,1.25,0.060326117945124845,549,We lost the battle over the office thermostat.
2226,3,14,63,80,1.25,0.05764360164082899,549,"I don't know what to tell you, Diane. Our hands are tied here."
2226,6,8,66,80,1.25,0.06536170054958926,549,"-- Just tell it to me strait, Jackie!"
2226,5,10,65,80,1.25,0.06289432567832845,549,When did YOU join Nailbiters' Anonymous?
2226,4,12,64,80,1.25,0.060326117945124845,549,"Hey Siri! Look up ""how to get out of a straight jacket""."
2226,5,10,65,80,1.25,0.06289432567832845,549,this seems a bit extreme for just picking your nose.
2226,7,6,67,80,1.25,0.06773926184227806,549,They said our punishment was to have a real conversation.
2226,3,14,63,80,1.25,0.05764360164082899,549,Are you going to answer that?
2226,6,8,66,80,1.25,0.06536170054958926,549,"I don't know about you, but I'm hoping to transition into business casual from business uptight really soon."
2226,4,12,64,80,1.25,0.060326117945124845,549,The company is so grateful for all you've done to keep us injury-free.
2226,2,16,62,80,1.25,0.05483000195079379,549,Well that about wraps things up!
2226,6,8,66,80,1.25,0.06536170054958926,549,I don't like the new boss.
2226,6,8,66,80,1.25,0.06536170054958926,549,The first step in Technoaddicts Anonymous is admitting you have a problem.
2226,4,12,64,80,1.25,0.060326117945124845,549,It’s the new ‘Anger Management Training Program’ experiment.
2226,5,10,65,80,1.25,0.06289432567832845,549,"So, you tried to break the glass ceiling too."
2226,3,14,63,80,1.25,0.05764360164082899,549,"We need more than a ""handshake"" on this."
2226,4,12,64,80,1.25,0.060326117945124845,549,Quite frankly I'd like to help but my hands are tied
2226,5,10,65,80,1.25,0.06289432567832845,549,"You can channel Houdini, but I'm asking Siri."
2226,4,12,64,80,1.25,0.060326117945124845,549,"So, what seems to be your problem with our dress code?"
2226,2,16,62,80,1.25,0.05483000195079379,549,You're a perfect fit for our organization.
2226,4,12,64,80,1.25,0.060326117945124845,549,"There's something about you that just feels right...""Congratulations"" you're hired, when can you start?"
2226,5,10,65,80,1.25,0.06289432567832845,549,It radical and cutting edge - but it curtails our excessive use of email and texting.
2226,2,16,62,80,1.25,0.05483000195079379,549,"Lke you, my hands are tied."
2226,1,18,61,80,1.25,0.05186398960474906,549,And what makes you think you're cut out to run an asylum?
2226,3,14,63,80,1.25,0.05764360164082899,549,Have you enjoyed your legislative internship so far?
2226,3,14,63,80,1.25,0.05764360164082899,549,"""And they say smoking is hardest thing to quit ""."
2226,1,18,61,80,1.25,0.05186398960474906,549,"I agree you deserve a promotion, but my hands are tied."
2226,4,12,64,80,1.25,0.060326117945124845,549,"Romney had binders full of women, but the President-Elect has women fully binded."
2226,4,12,64,80,1.25,0.060326117945124845,549,"Please Siri, you promised to tell us how to get these off!"
2226,4,12,64,80,1.25,0.060326117945124845,549,"At Houdini Corp. there is no interview as such. Now in five, four, three, two, one GO!"
2226,4,12,64,80,1.25,0.060326117945124845,549,"Our corporate culture may seem a bit straitlaced, but I have a feeling you would like it."
2226,4,12,64,80,1.25,0.060326117945124845,549,I'm so with you. This is much more effective than mindfulness.
2226,2,16,62,80,1.25,0.05483000195079379,549,I know it's a bit crazy in the office right now...
2226,4,12,64,80,1.25,0.060326117945124845,549,So what makes you think you'd be a good fit here?
2226,5,10,65,80,1.25,0.06289432567832845,549,Testing out our newest idea to get Trump to stop tweeting.
2226,4,12,64,80,1.25,0.060326117945124845,549,So much for breaking the Glass Ceiling.
2226,4,12,64,80,1.25,0.060326117945124845,549,Did they think we didn't know about the speech recognition software?
2226,1,18,61,80,1.25,0.05186398960474906,549,"Why, yes! My laptop does have voice recognition software. How did you guess?"
2226,5,10,65,80,1.25,0.06289432567832845,549,"I used to cross my legs,too"
2226,3,14,63,80,1.25,0.05764360164082899,549,"So, the word is we're going to try thinking INSIDE the box for a while."
2226,5,10,65,80,1.25,0.06289432567832845,549,"As my stunt double, you will be expected to appear for me at all board meetings, office baby showers and holiday parties."
2226,5,10,65,80,1.25,0.06289432567832845,549,Let me give this to you straight. I like your jacket.
2226,7,6,67,80,1.25,0.06773926184227806,549,Men are given an extra pair of hands. It all evens out.
2226,5,10,65,80,1.25,0.06289432567832845,549,It gets crazy around here sometimes.
2226,6,8,66,80,1.25,0.06536170054958926,549,I'm afraid our hands are tied
2226,5,10,65,80,1.25,0.06289432567832845,549,"TGIF, right?"
2226,4,12,64,80,1.25,0.060326117945124845,549,You'll fit. We're very wrapped up in our work!
2226,4,12,64,80,1.25,0.060326117945124845,549,"I'd like to offer you the position, but my hands are tied."
2226,6,8,66,80,1.25,0.06536170054958926,549,Where do you see yourself in five years? . . . I asked you that five years ago didn't I?
2226,5,10,65,80,1.25,0.06289432567832845,549,YOUR hands are tied?
2226,2,16,62,80,1.25,0.05483000195079379,549,I like you. You're hired!
2226,5,10,65,80,1.25,0.06289432567832845,549,I wouldn't call this a hands-on job.
2226,2,16,62,80,1.25,0.05483000195079379,549,It takes one to know one.
2226,4,12,64,80,1.25,0.060326117945124845,549,Now that wer're running the asylum what's next?
2226,4,12,64,80,1.25,0.060326117945124845,549,"I want to help you but... well, you know."
2226,5,10,65,80,1.25,0.06289432567832845,549,"I'd really like to help you out, but my hands are tied on this one."
2226,2,16,62,80,1.25,0.05483000195079379,549,We're just too wrapped up in this project.
2226,3,14,63,80,1.25,0.05764360164082899,549,My husband thinks you would have to be sane to work in a place like this.
2226,3,14,63,80,1.25,0.05764360164082899,549,You know my hands are tied on this.
2226,4,12,64,80,1.25,0.060326117945124845,549,Who is running this asylum - you or me?
2226,3,14,63,80,1.25,0.05764360164082899,549,What woman doesn't feel the urge to escape?
2226,1,18,61,80,1.25,0.05186398960474906,549,My hands are tied
2226,6,8,66,80,1.25,0.06536170054958926,549,I like to accessorize with a butterfly net.
2226,2,16,62,80,1.25,0.05483000195079379,549,"I'm sorry I have to quit, but I've found a new job a less restrictive dress code...."
2226,3,14,63,80,1.25,0.05764360164082899,549,Welcome to tech rehab. I think you’ll find our interventions effective.
2226,2,16,62,80,1.25,0.05483000195079379,549,I feel we need to take the fine print on the company's HMO more seriously.
2226,4,12,64,80,1.25,0.060326117945124845,549,"So . . . I just threw my hands up, you know what I mean?"
2226,4,12,64,80,1.25,0.060326117945124845,549,How long until we turn into butterflies?
2226,4,12,64,80,1.25,0.060326117945124845,549,"Yes, well, my client's instructions don't allow me any wiggle room either."
2226,3,14,63,80,1.25,0.05764360164082899,549,I'd like to help but my hands are tied on this one
2226,4,12,64,80,1.25,0.060326117945124845,549,"One final question. You do realize you'll be replacing me, yes?"
2226,3,14,63,80,1.25,0.05764360164082899,549,"Things have been great, but I'm finding the company dress code a bit confining."
2226,6,8,66,80,1.25,0.06536170054958926,549,It's been totally insane around here since the election.
2226,5,10,65,80,1.25,0.06289432567832845,549,"I'm sorry, but my hands are tied also."
2226,4,12,64,80,1.25,0.060326117945124845,549,You'll be helping me write the President Elect's speeches. Best to get a feel for the job.
2226,6,8,66,80,1.25,0.06536170054958926,549,"My hands are tied. You understand, right?"
2226,3,14,63,80,1.25,0.05764360164082899,549,"Yeah, it's not about calorie-counting. It's about making it basically impossible to feed yourself."
2226,5,10,65,80,1.25,0.06289432567832845,549,This is not a hands-on position.
2226,3,14,63,80,1.25,0.05764360164082899,549,"So, tell me, why do you want to work at the Klepto Society?"
2226,5,10,65,80,1.25,0.06289432567832845,549,I think we can market them as adult swaddling blankets.
2226,3,14,63,80,1.25,0.05764360164082899,549,"Honestly, our new social media restriction is working quite well."
2226,4,12,64,80,1.25,0.060326117945124845,549,They only tell you about the glass ceiling part.
2226,2,16,62,80,1.25,0.05483000195079379,549,I've booked the board meeting next month in the white padded room.
2226,4,12,64,80,1.25,0.060326117945124845,549,"Okay Google, how to get out of a straightjacket."
2226,5,10,65,80,1.25,0.06289432567832845,549,Now let's try www.Houdini.com.
2226,5,10,65,80,1.25,0.06289432567832845,549,I'll scratch your back if you'll scratch mine.
2226,5,10,65,80,1.25,0.06289432567832845,549,You think this spoils the quality of the exit interview?
2226,3,14,63,80,1.25,0.05764360164082899,549,"I'm sorry, my hands are tied. You know how it is."
2226,5,10,65,80,1.25,0.06289432567832845,549,"Truth is, I am crazy about your numbers, but as far as a promotion, my hands are tied."
2226,2,16,62,80,1.25,0.05483000195079379,549,We can still lean forward.
2226,4,12,64,80,1.25,0.060326117945124845,549,How will I know if I'm hired?
2226,2,16,62,80,1.25,0.05483000195079379,549,"Would you be willing to put these claims, in writing?"
2226,4,12,64,80,1.25,0.060326117945124845,549,"Some new employees find working here a bit nerve racking, but I have a feeling you'll fit right in."
2226,1,18,61,80,1.25,0.05186398960474906,549,And how did you wind up here?
2226,2,16,62,80,1.25,0.05483000195079379,549,"You have a lovely resume, but I'm going to have to hire someone who can actually operate my phone, pencil and keyboard."
2226,5,10,65,80,1.25,0.06289432567832845,549,You tell me why you think our sweaters aren't selling.
2226,2,16,62,80,1.25,0.05483000195079379,549,"Well, you seem extremely qualified."
2226,4,12,64,80,1.25,0.060326117945124845,549,"Honestly, the best part of the job is flexibility."
2226,2,16,62,80,1.25,0.05483000195079379,549,"I have to tell you, my hands are tied."
2226,2,16,62,80,1.25,0.05483000195079379,549,You would start in management but would be groomed to run the asylum.
2226,6,8,66,80,1.25,0.06536170054958926,549,I think I know White House material when I see it. Congratulations!
2226,2,16,62,80,1.25,0.05483000195079379,549,It gives applicants a better sense of the job.
2226,4,12,64,80,1.25,0.060326117945124845,549,Your experience as a soccer player will come in handy here.
2226,4,12,64,80,1.25,0.060326117945124845,549,It looks like it's gonna be another crazy week.
2226,4,12,64,80,1.25,0.060326117945124845,549,What exactly did you mean when you said you felt confined in your last job?
2226,5,10,65,80,1.25,0.06289432567832845,549,"With the new administration, this will be the new reality here at the C.I.A!"
2226,3,14,63,80,1.25,0.05764360164082899,549,I can't quite get my arms around the concept.
2226,2,16,62,80,1.25,0.05483000195079379,549,According to my hallucinations you've done a really good job this quarter.
2226,4,12,64,80,1.25,0.060326117945124845,549,I must be the sane one because the screen is facing me.
2226,4,12,64,80,1.25,0.060326117945124845,549,We believe in identifying with our clients.
2226,1,18,61,80,1.25,0.05186398960474906,549,The glass ceiling should have tipped us off.
2226,4,12,64,80,1.25,0.060326117945124845,549,"Me, too. I didn't know Ivanka's new ""Lock Her Up"" brand was so literal."
2226,2,16,62,80,1.25,0.05483000195079379,549,We only hire like-minded individuals
2226,7,6,67,80,1.25,0.06773926184227806,549,I see from your resume that you are bat-shit crazy. I think you might fit right in here at The New Yorker.
2226,3,14,63,80,1.25,0.05764360164082899,549,I'd like to get the revised budget before your lobotomy.
2226,5,10,65,80,1.25,0.06289432567832845,549,"I retweeted Trump. You, too?"
2226,2,16,62,80,1.25,0.05483000195079379,549,I'll scratch your back if you'll scratch mine.
2226,4,12,64,80,1.25,0.060326117945124845,549,"Love that top, where did you ever find it ?"
2226,2,16,62,80,1.25,0.05483000195079379,549,I see you're comfortable with our dress code.
2226,5,10,65,80,1.25,0.06289432567832845,549,"Don't worry. Once we're running the asylum, everything will be great again."
2226,5,10,65,80,1.25,0.06289432567832845,549,"Corporate wanted a more disciplined work culture, starting with the dress code."
2226,4,12,64,80,1.25,0.060326117945124845,549,What a coincidence I am also Italian.
2226,1,18,61,80,1.25,0.05186398960474906,549,You'll fit right in. We'er a small group of like-minded people.
2226,4,12,64,80,1.25,0.060326117945124845,549,Because no one would stop using their phones during meetings.
2226,5,10,65,80,1.25,0.06289432567832845,549,I'm not sure you're the right person to help us reach out to new customers.
2226,5,10,65,80,1.25,0.06289432567832845,549,"""I get it, the Trump presidency has been hard on all of us""."
2226,3,14,63,80,1.25,0.05764360164082899,549,I see that you have a nail-biting problem also.
2226,4,12,64,80,1.25,0.060326117945124845,549,It seems like this position is a good fit for you.
2226,1,18,61,80,1.25,0.05186398960474906,549,"I don't like the new dress code either, but my hands are tied."
2226,5,10,65,80,1.25,0.06289432567832845,549,"I know you want a position with more freedom, but my hands are tied."
2226,3,14,63,80,1.25,0.05764360164082899,549,I am so grateful for this new anti-harassment policy from HR
2226,4,12,64,80,1.25,0.060326117945124845,549,"You can't have a raise - I'm sorry, my hands are tied."
2226,6,8,66,80,1.25,0.06536170054958926,549,This makes it harder to lean in.
2226,4,12,64,80,1.25,0.060326117945124845,549,I wish I could let you out of your contract but my hands are tied
2226,5,10,65,80,1.25,0.06289432567832845,549,"I'm sorry about your coffee headache, but 'Arms Prohibited in Building' applies to everyone."
2226,3,14,63,80,1.25,0.05764360164082899,549,"You understand executive power at Houdini, Inc. is limited."
2226,2,16,62,80,1.25,0.05483000195079379,549,"I love your resume, but tell me how you'd fit in here."
2226,3,14,63,80,1.25,0.05764360164082899,549,"We believe in hands-free technology and do all we can to support it. If you accept this condition of employmrmt, blink twice."
2226,5,10,65,80,1.25,0.06289432567832845,549,"I'd really like to help you, but my hands are tied."
2226,4,12,64,80,1.25,0.060326117945124845,549,"Agree that it makes work challenging, but the Trump anti-tweet jacket is all the rage."
2226,3,14,63,80,1.25,0.05764360164082899,549,"I would like to approve your request for less constraint, but my hands are tied."
2226,3,14,63,80,1.25,0.05764360164082899,549,Have you ever tried a crazier diet?
2226,1,18,61,80,1.25,0.05186398960474906,549,So if the employees ask about the year-end bonus tell them it's the board's decision and our hands are tied.
2226,3,14,63,80,1.25,0.05764360164082899,549,"Like everyone who works here, you'll have a free hand."
2226,5,10,65,80,1.25,0.06289432567832845,549,I hope they come back.
2226,3,14,63,80,1.25,0.05764360164082899,549,I see you've read up on our ultra-buttoned-down corporate culture here.
2226,5,10,65,80,1.25,0.06289432567832845,549,I'm not as crazy as I look.
2226,4,12,64,80,1.25,0.060326117945124845,549,The dress code for this company is insane!
2441,3,14,64,81,1.2469135802469136,0.0570111105630559,549,"Welcome to your first day working with the Uber Driverless Car Department."""
2441,6,8,67,81,1.2469135802469136,0.0646234682879131,549,We can still make up stories. We just can't upload them.
2441,4,12,65,81,1.2469135802469136,0.05965658976962751,549,"You're not the first to complain about the new dress code here at the EPA, but honestly, my hands are tied."
2441,5,10,66,81,1.2469135802469136,0.06218963481361076,549,"I'm looking for a hands-on, self-starter type."
2445,5,10,67,82,1.2439024390243902,0.06150030199409332,549,I'd just love to smack you on the face right now.
2446,4,11,64,79,1.240506329113924,0.060333353614695454,549,When do you get out?
2446,2,15,62,79,1.240506329113924,0.05468979492327308,549,"Well, no one can say we are paper-pushers!"
2446,5,9,65,79,1.240506329113924,0.06296573276965015,549,"Okay, we both need to stop saying ""Hillary won!"""
2446,2,15,62,79,1.240506329113924,0.05468979492327308,549,"Not what I thought when you said, 'straight talk'."
2446,2,15,62,79,1.240506329113924,0.05468979492327308,549,This is a fairly straight laced office.
2446,3,13,63,79,1.240506329113924,0.0575807573202435,549,"Our culture? In a word, empowerment."
2446,2,15,62,79,1.240506329113924,0.05468979492327308,549,We're Jewish. We talk with our hands. This is not easy.
2446,4,11,64,79,1.240506329113924,0.060333353614695454,549,"It's not so bad. If you type with your nose, you can still check Facebook."
2446,4,11,64,79,1.240506329113924,0.060333353614695454,549,I would have preferred pantsuits.
2446,5,9,65,79,1.240506329113924,0.06296573276965015,549,Give it to me strait
2446,4,11,64,79,1.240506329113924,0.060333353614695454,549,I can easily see that your are a very seasoned and committed high school teacher.
2446,4,11,64,79,1.240506329113924,0.060333353614695454,549,"Don't worry, it took me five years to earn my leg irons."
2446,2,15,62,79,1.240506329113924,0.05468979492327308,549,We believe in a great work-life imbalance.
2446,3,13,63,79,1.240506329113924,0.0575807573202435,549,These anger management exercises are getting out of hand.
2446,5,9,65,79,1.240506329113924,0.06296573276965015,549,So much for trying to break the glass celing.
2446,4,11,64,79,1.240506329113924,0.060333353614695454,549,Just another day at Trump's transition headquarters.
2446,5,9,65,79,1.240506329113924,0.06296573276965015,549,Looks like I'll be tied up all day
2446,1,17,61,79,1.240506329113924,0.051637231954536025,549,Hurrah for voice activated technology!
2446,4,11,64,79,1.240506329113924,0.060333353614695454,549,Let me give it to you straight . . .
2446,4,11,64,79,1.240506329113924,0.060333353614695454,549,"It's supposed to keep us off our devices during meetings, but, actually, ""Hey, Siri"" works just fine."
2446,3,13,63,79,1.240506329113924,0.0575807573202435,549,I quess they caught you knitting too.
2446,3,13,63,79,1.240506329113924,0.0575807573202435,549,I really do sympathize with your situation.
2446,5,9,65,79,1.240506329113924,0.06296573276965015,549,I'd like to help you but this time my hands are tied.
2446,1,17,61,79,1.240506329113924,0.051637231954536025,549,The first step is to admit you have a problem with texting while you are driving.
2446,7,5,67,79,1.240506329113924,0.06792513079019585,549,Does this mean we have a binding obligation?
2446,5,9,65,79,1.240506329113924,0.06296573276965015,549,I prefer the gay jacket.
2446,4,11,64,79,1.240506329113924,0.060333353614695454,549,We are an open... but anti-texting organization.
2446,2,15,62,79,1.240506329113924,0.05468979492327308,549,I appreciate a candidate that I can be strait with.
2446,4,11,64,79,1.240506329113924,0.060333353614695454,549,Define constricted....
2446,2,15,62,79,1.240506329113924,0.05468979492327308,549,We have to be straight with one another.
2446,3,13,63,79,1.240506329113924,0.0575807573202435,549,"I'd love to employ another token female to the team, but as you can see, my hands are tied."
2446,2,15,62,79,1.240506329113924,0.05468979492327308,549,"It's a new thing we are trying in HR, it's called verbal communication therapy."
2446,4,11,64,79,1.240506329113924,0.060333353614695454,549,If you were hired it looks like you would appreciate my hands off management style.
2446,5,9,65,79,1.240506329113924,0.06296573276965015,549,"First of all, I'll give you style points."
2446,2,15,62,79,1.240506329113924,0.05468979492327308,549,My empathy knows no bounds.
2446,3,13,63,79,1.240506329113924,0.0575807573202435,549,We all seem to be so wrapped up in our own lives.
2446,4,11,64,79,1.240506329113924,0.060333353614695454,549,"I'd like to help with your claim, but my hands are tied."
2446,4,11,64,79,1.240506329113924,0.060333353614695454,549,Didn't my secretary tell you I was all tied up today.
2446,2,15,62,79,1.240506329113924,0.05468979492327308,549,What makes you ask if employee freedom is restricted?
2446,4,11,64,79,1.240506329113924,0.060333353614695454,549,"""Oh you're knotty""!"
2446,4,11,64,79,1.240506329113924,0.060333353614695454,549,you seem to have what it takes to succeed in our company.
2446,1,17,61,79,1.240506329113924,0.051637231954536025,549,I haven't used this laptop in months.
2446,5,9,65,79,1.240506329113924,0.06296573276965015,549,We believe our employees are more productive if they can't text or tweet.
2446,4,11,64,79,1.240506329113924,0.060333353614695454,549,If you join our firm you'll be expected to embrace our hands-off management style.
2446,4,11,64,79,1.240506329113924,0.060333353614695454,549,OK. One more time without all the body language.
2446,2,15,62,79,1.240506329113924,0.05468979492327308,549,"Nice corporate culture here, but not so much flex time."
2446,2,15,62,79,1.240506329113924,0.05468979492327308,549,"Some people think our anti-harassment policies are strict, but you should have been here before."
2446,4,11,64,79,1.240506329113924,0.060333353614695454,549,I seem to be having trouble reading your body language.
2446,3,13,63,79,1.240506329113924,0.0575807573202435,549,My Colleagues said I had to be crazy to work with you
2446,6,7,66,79,1.240506329113924,0.0654923922913349,549,Siri? We are done with our tech free meeting. Can you please release us?
2446,4,11,64,79,1.240506329113924,0.060333353614695454,549,Sometimes this job makes me thing I'm going sane.
2446,3,13,63,79,1.240506329113924,0.0575807573202435,549,It's so wonderful they let us think freely.
2446,3,13,63,79,1.240506329113924,0.0575807573202435,549,I just worry that you're over-qualified.
2446,4,11,64,79,1.240506329113924,0.060333353614695454,549,"Welcome to the transition team, Ms. Brown."
2446,2,15,62,79,1.240506329113924,0.05468979492327308,549,So it's a deal. Let's not shake on it.
2446,3,13,63,79,1.240506329113924,0.0575807573202435,549,And why are you so crazy about this job?
2446,3,13,63,79,1.240506329113924,0.0575807573202435,549,"You'd have to be crazy to want to work here, you'll fit right in."
2446,4,11,64,79,1.240506329113924,0.060333353614695454,549,"Yes, it does take one to know one."
2446,3,13,63,79,1.240506329113924,0.0575807573202435,549,May I borrow your glasses?
2446,1,17,61,79,1.240506329113924,0.051637231954536025,549,Causal Fridays was getting boring.
2446,4,11,64,79,1.240506329113924,0.060333353614695454,549,The red tape makes working here impossible.
2446,5,9,65,79,1.240506329113924,0.06296573276965015,549,"Call me crazy, but it looks better on me."
2446,4,11,64,79,1.240506329113924,0.060333353614695454,549,"I'd love to help you, but my hands are tied. You know how it is."
2446,5,9,65,79,1.240506329113924,0.06296573276965015,549,I knew I should have checked to see if we were wearing the same thing.
2446,2,15,62,79,1.240506329113924,0.05468979492327308,549,I find it helps us maintain a professional distance
2446,4,11,64,79,1.240506329113924,0.060333353614695454,549,This is a safe zone -- unless somebody else shows up.
2446,5,9,65,79,1.240506329113924,0.06296573276965015,549,My previous job was too hands-on.
2446,2,15,62,79,1.240506329113924,0.05468979492327308,549,Your mobile's ringing!
2446,4,11,64,79,1.240506329113924,0.060333353614695454,549,"OK, let's start wrapping things up now."
2446,3,13,63,79,1.240506329113924,0.0575807573202435,549,You've heard that working here drives you crazy?!
2446,3,13,63,79,1.240506329113924,0.0575807573202435,549,We like control freaks here.
2446,6,7,66,79,1.240506329113924,0.0654923922913349,549,"""Welcome to the Trump team""."
2446,3,13,63,79,1.240506329113924,0.0575807573202435,549,Id really like to help but as you can see My hands are tied as well!
2446,5,9,65,79,1.240506329113924,0.06296573276965015,549,How many words can you type per minute?
2446,6,7,66,79,1.240506329113924,0.0654923922913349,549,What kind of jackets would we have to wear if we were gay?
2446,5,9,65,79,1.240506329113924,0.06296573276965015,549,We're looking for someone who's committed and knows the ropes!
2446,2,15,62,79,1.240506329113924,0.05468979492327308,549,I miss our casual dress Fridays.
2446,3,13,63,79,1.240506329113924,0.0575807573202435,549,Thinking outside the box is fine. It's acting outside the box that's generally discouraged.
2446,3,13,63,79,1.240506329113924,0.0575807573202435,549,Work is just crazy right now!
2446,4,11,64,79,1.240506329113924,0.060333353614695454,549,First I'd like to thank you for joining the Houdini fan club-
2446,1,17,61,79,1.240506329113924,0.051637231954536025,549,"'I'm thinking of introducing, Jacket-free Fridays.'"
2446,5,9,65,79,1.240506329113924,0.06296573276965015,549,I miss the glass ceiling.
2446,5,9,65,79,1.240506329113924,0.06296573276965015,549,Are we ready for your annual performance review?
2446,4,11,64,79,1.240506329113924,0.060333353614695454,549,"Congratulations, you're hired!"
2446,3,13,63,79,1.240506329113924,0.0575807573202435,549,This is a secure place
2446,3,13,63,79,1.240506329113924,0.0575807573202435,549,Welcome to Acme Straight Jackets. I just know we're bound to get along.
2446,5,9,65,79,1.240506329113924,0.06296573276965015,549,"We were most certainly bound to meet, that much is very clear."
2446,3,13,63,79,1.240506329113924,0.0575807573202435,549,Call me crazy but I never felt more together.
2446,3,13,63,79,1.240506329113924,0.0575807573202435,549,Can you operate a keyboard with your nose?
2446,3,13,63,79,1.240506329113924,0.0575807573202435,549,"I would help you, but my hands are tied."
2446,3,13,63,79,1.240506329113924,0.0575807573202435,549,"Unfortunately we can't just ""hug it out."""
2446,5,9,65,79,1.240506329113924,0.06296573276965015,549,Congratulations! We're nominating you for Secretary of State.
2446,4,11,64,79,1.240506329113924,0.060333353614695454,549,"So, when can't you start?"
2446,2,15,62,79,1.240506329113924,0.05468979492327308,549,"I wish there were something I could do, but my hands are tied."
2446,5,9,65,79,1.240506329113924,0.06296573276965015,549,Lets get this strait
2446,2,15,62,79,1.240506329113924,0.05468979492327308,549,It looks like you would fit in well here.
2446,3,13,63,79,1.240506329113924,0.0575807573202435,549,We're bound to have a good interview today.
2446,4,11,64,79,1.240506329113924,0.060333353614695454,549,Many thanks for holding this crisis meeting in your work deadline anxiety dream and not in mine.
2446,3,13,63,79,1.240506329113924,0.0575807573202435,549,"Of course, you are free to choose any color you want."
2446,4,11,64,79,1.240506329113924,0.060333353614695454,549,The hours make me crazy but at least we have casual Fridays.
2446,6,7,66,79,1.240506329113924,0.0654923922913349,549,"Siri, we are in straitjackets, how do we get free?"
2446,4,11,64,79,1.240506329113924,0.060333353614695454,549,I'm afraid my hands are as tied as yours about this issue.
2446,3,13,63,79,1.240506329113924,0.0575807573202435,549,Do you ever suspect that women's ideas are not appreciated by this company?
2446,3,13,63,79,1.240506329113924,0.0575807573202435,549,"So, welcome to the company. Let me show you to your padded cell."
2446,5,9,65,79,1.240506329113924,0.06296573276965015,549,This isn't working - I'm still attracted to you.
2446,4,11,64,79,1.240506329113924,0.060333353614695454,549,Will this job ties me down in any way?
2446,4,11,64,79,1.240506329113924,0.060333353614695454,549,"ok, now that we have established our boundaries...."
2446,2,15,62,79,1.240506329113924,0.05468979492327308,549,I'm glad to see you take our jacket and tie dress code as seriously as I do.
2446,4,11,64,79,1.240506329113924,0.060333353614695454,549,I don't think our Straightjacket Challenge idea is going to go viral.
2446,4,11,64,79,1.240506329113924,0.060333353614695454,549,Glad to see you in proper attire on your first day at the Disarmament Commission.
2446,3,13,63,79,1.240506329113924,0.0575807573202435,549,"H.R. is really taking this sexual harassment scandal seriously, huh boss?"
2446,4,11,64,79,1.240506329113924,0.060333353614695454,549,Imagine if you sneezed right now.
2446,3,13,63,79,1.240506329113924,0.0575807573202435,549,"Normally I'd be happy to lend a hand, I'm just really tied up right now"
2446,1,17,61,79,1.240506329113924,0.051637231954536025,549,Secret to Corporate Success #12: Always dress for the position you want versus the one you have.
2446,6,7,66,79,1.240506329113924,0.0654923922913349,549,So why should we hire you at Houdini Consultants?
2446,5,9,65,79,1.240506329113924,0.06296573276965015,549,"So, any previous experience running an asylum?"
2446,1,17,61,79,1.240506329113924,0.051637231954536025,549,"The boss insists we not text at work, so I think you'll fit right in."
2446,2,15,62,79,1.240506329113924,0.05468979492327308,549,"No, I don't think you're crazy to ask, but my hands are tied."
2446,3,13,63,79,1.240506329113924,0.0575807573202435,549,Recent HR research shows that employees have trouble grasping metaphors.
2446,2,15,62,79,1.240506329113924,0.05468979492327308,549,The offer comes with no strings attached
2446,4,11,64,79,1.240506329113924,0.060333353614695454,549,What habit are YOU trying to break?
2446,1,17,61,79,1.240506329113924,0.051637231954536025,549,The benefits are great but the job can be stifling at times
2446,2,15,62,79,1.240506329113924,0.05468979492327308,549,We run a tight ship. Sure you want to work here?
2446,4,11,64,79,1.240506329113924,0.060333353614695454,549,So let me get this strait...
2446,4,11,64,79,1.240506329113924,0.060333353614695454,549,"No, I don't think you're more tightly wrapped than the rest of us."
2446,3,13,63,79,1.240506329113924,0.0575807573202435,549,Let me get this straight. The Board says we have no wiggle room?
2446,5,9,65,79,1.240506329113924,0.06296573276965015,549,Stella McCartney. Yours?
2446,3,13,63,79,1.240506329113924,0.0575807573202435,549,It says here that you're a hands off learner.
2446,1,17,61,79,1.240506329113924,0.051637231954536025,549,Let's wrap it up.
2446,1,17,61,79,1.240506329113924,0.051637231954536025,549,Your nose is longer. Could you peck out a reply for me?
2446,3,13,63,79,1.240506329113924,0.0575807573202435,549,We need to figure out how to break the glass ceiling. Let’s use our heads.
2446,5,9,65,79,1.240506329113924,0.06296573276965015,549,I see you have experience in psychoanalysis.
2446,1,17,61,79,1.240506329113924,0.051637231954536025,549,The job gradually frees you.
2446,2,15,62,79,1.240506329113924,0.05468979492327308,549,Looks like you've got a terrific feel for the company already--the job's yours!
2446,3,13,63,79,1.240506329113924,0.0575807573202435,549,"Well, I think we can definitively call ""Bring Your Neuroses To Work Day"" a success!"
2446,3,13,63,79,1.240506329113924,0.0575807573202435,549,"As incoming Curator of the ""Do Not Touch"" wing, I've been asked to show you the ropes."
2446,5,9,65,79,1.240506329113924,0.06296573276965015,549,I see that you got promoted.
2446,1,17,61,79,1.240506329113924,0.051637231954536025,549,"We call this ""Uptight Monday"" in our office."
2446,4,11,64,79,1.240506329113924,0.060333353614695454,549,They hired me because they thought psycho was short for psychologist.
2446,3,13,63,79,1.240506329113924,0.0575807573202435,549,Let's be perfectly strait with each other.
2446,3,13,63,79,1.240506329113924,0.0575807573202435,549,At least we can still think outside the box.
2446,3,13,63,79,1.240506329113924,0.0575807573202435,549,They say 80% of communication is body language.
2446,2,15,62,79,1.240506329113924,0.05468979492327308,549,Let me give it to you strait
2446,4,11,64,79,1.240506329113924,0.060333353614695454,549,I understand your problem. I wish I could help you.
2446,3,13,63,79,1.240506329113924,0.0575807573202435,549,You've probably heard we're really cutting back on outreach.
2446,2,15,62,79,1.240506329113924,0.05468979492327308,549,That about wraps it up.
2446,4,11,64,79,1.240506329113924,0.060333353614695454,549,Our true barrier isn't the glass ceiling. It's the padded walls.
2446,4,11,64,79,1.240506329113924,0.060333353614695454,549,One of the many issues when the lunatics take over the asylum.
2446,3,13,63,79,1.240506329113924,0.0575807573202435,549,So how are you at typing with your nose?
2446,2,15,62,79,1.240506329113924,0.05468979492327308,549,it's a hands off kind of job
2446,3,13,63,79,1.240506329113924,0.0575807573202435,549,Who do you think is taking the office supplies?
2446,1,17,61,79,1.240506329113924,0.051637231954536025,549,"I'd like to hire you, but my hands are tied. Surely, you can appreciate my predicament."
2446,4,11,64,79,1.240506329113924,0.060333353614695454,549,It seems we're both tied up
2446,5,9,65,79,1.240506329113924,0.06296573276965015,549,Thanks for attending our Democrats for the next four years meet.
2446,2,15,62,79,1.240506329113924,0.05468979492327308,549,Upper management decided that our proximity to the glass ceiling might result in injury to ourselves or others.
2446,5,9,65,79,1.240506329113924,0.06296573276965015,549,When can you start?
2446,2,15,62,79,1.240506329113924,0.05468979492327308,549,Please just relax and tell me why you think you'd fit in with our organization.
2446,2,15,62,79,1.240506329113924,0.05468979492327308,549,"If you do not want to lift a finger, then this is your dream job."
2446,3,13,63,79,1.240506329113924,0.0575807573202435,549,Are you mocking me?
2446,2,15,62,79,1.240506329113924,0.05468979492327308,549,I find it surprisingly liberating - there seem far fewer decisions to make.
2446,3,13,63,79,1.240506329113924,0.0575807573202435,549,"You have to be crazy to work here."" ""Yes, my last job was the cartoon editor for the New Yorker."
2446,3,13,63,79,1.240506329113924,0.0575807573202435,549,Great interview. You'll fit in well here.
2446,3,13,63,79,1.240506329113924,0.0575807573202435,549,I feel like we're really bonding.
2446,4,11,64,79,1.240506329113924,0.060333353614695454,549,I'm glad you noticed we're wearing the same thing. I thought I was going crazy there for a second.
2446,1,17,61,79,1.240506329113924,0.051637231954536025,549,We’re all very committed to what we do here.
2446,3,13,63,79,1.240506329113924,0.0575807573202435,549,"I'd love to help you also, but my hands are tied."
2446,3,13,63,79,1.240506329113924,0.0575807573202435,549,"I got mine at Barneys, 20% off!"
2446,3,13,63,79,1.240506329113924,0.0575807573202435,549,"Frankly, it makes me long for the days we were only figuratively in Mitt Romney's Binders."
2614,5,9,66,80,1.2375,0.06224632061720393,549,So tell me where you see yourself in five years.
2614,3,13,64,80,1.2375,0.056935867763429085,549,Management is adamant that we not use our smartphones on company time.
2614,1,17,62,80,1.2375,0.051076233666644016,549,I have an itch.
2614,1,17,62,80,1.2375,0.051076233666644016,549,The boss thinks it will cut down on e-mails.
2614,1,17,62,80,1.2375,0.051076233666644016,549,"The new hands-free policy takes some getting used to, but the students won't text anymore in class."
2614,4,11,65,80,1.2375,0.059650219900493365,549,"Don't worry. ""Casual-dress"" Friday is coming up."
2614,3,13,64,80,1.2375,0.056935867763429085,549,Career Bound
2614,3,13,64,80,1.2375,0.056935867763429085,549,You don't need to be crazy to work here. Psychotic works just fine.
2614,4,11,65,80,1.2375,0.059650219900493365,549,"I know we have to be crazy to work here, but the dress code is a bit much."
2623,3,12,62,77,1.2337662337662338,0.05815605815832067,549,Management doesn't want any handshake deals.
2623,1,16,60,77,1.2337662337662338,0.051948051948051945,549,"Yeah, there's not a lot of flexibility here but the pay's good."
2623,2,14,61,77,1.2337662337662338,0.05513949220709001,549,Don't also be tongue-tied! Say something.
2623,3,12,62,77,1.2337662337662338,0.05815605815832067,549,Didn't you hear? Everything in the office is voice activated.
2623,4,10,63,77,1.2337662337662338,0.06102368884435136,549,"Now that Trump has been elected, I'm so much more calmer"
2623,3,12,62,77,1.2337662337662338,0.05815605815832067,549,And I don't feel the need to check my phone all the time. I am free now.
2623,6,6,65,77,1.2337662337662338,0.06638838452235968,549,"Per the President Elect's request, these are the outfits for his Cabinet members."
2623,1,16,60,77,1.2337662337662338,0.051948051948051945,549,I understand you're feeling constricted.
2623,3,12,62,77,1.2337662337662338,0.05815605815832067,549,Our company is a local institution.
2623,4,10,63,77,1.2337662337662338,0.06102368884435136,549,This new dress code policy is insane.
2623,3,12,62,77,1.2337662337662338,0.05815605815832067,549,"Why yes, I am more relaxed."
2623,3,12,62,77,1.2337662337662338,0.05815605815832067,549,"If you can beat me out of this jacket, you've got the job..."
2623,2,14,61,77,1.2337662337662338,0.05513949220709001,549,"This is not exactly what I had in mind when I said 'Give it to me straight', Janet."
2623,4,10,63,77,1.2337662337662338,0.06102368884435136,549,"I'm sorry, but we're going to let you go."
2623,3,12,62,77,1.2337662337662338,0.05815605815832067,549,Now what do we do?
2623,3,12,62,77,1.2337662337662338,0.05815605815832067,549,You have more knots so you go first.
2623,3,12,62,77,1.2337662337662338,0.05815605815832067,549,At what age did you develop your Houdini fascination ?
2623,3,12,62,77,1.2337662337662338,0.05815605815832067,549,"Remember, this all started with ""casual Fridays""..."
2623,4,10,63,77,1.2337662337662338,0.06102368884435136,549,How was your first day at Micro-Management Corporation?
2623,3,12,62,77,1.2337662337662338,0.05815605815832067,549,"Mom always said, if you don't have anything nice to tweet, restrain yourself."
2623,3,12,62,77,1.2337662337662338,0.05815605815832067,549,You may be right about the new uniforms.
2623,4,10,63,77,1.2337662337662338,0.06102368884435136,549,"The dress code here is strict, but you'll have no problem fitting in."
2623,4,10,63,77,1.2337662337662338,0.06102368884435136,549,Who knew breaking the glass ceiling would get us committed?
2623,3,12,62,77,1.2337662337662338,0.05815605815832067,549,"You don't have to be crazy to work here, but it helps...with the dress code."
2623,3,12,62,77,1.2337662337662338,0.05815605815832067,549,There's nothing we can do - our hands are tied.
2623,5,8,64,77,1.2337662337662338,0.06376248191397861,549,We are a straight laced company
2623,2,14,61,77,1.2337662337662338,0.05513949220709001,549,You'll like working here...They don't bug you over productivity
2623,4,10,63,77,1.2337662337662338,0.06102368884435136,549,Hang in there. The uniform gets switched to strappy bras for spring.
2623,2,14,61,77,1.2337662337662338,0.05513949220709001,549,Excellent: you do have to be crazy to work here.
2623,4,10,63,77,1.2337662337662338,0.06102368884435136,549,It prevents anyone from clawing their way to the top.
2623,0,18,59,77,1.2337662337662338,0.048547261524614,549,"We find it eliminates those annoying ""Reply to all"" emails."
2623,4,10,63,77,1.2337662337662338,0.06102368884435136,549,Could you pass me the pen?
2623,2,14,61,77,1.2337662337662338,0.05513949220709001,549,"In this job, I'm always tied up one way or another."
2623,2,14,61,77,1.2337662337662338,0.05513949220709001,549,This is going to make the fight for Equal Pay even more challenging.
2623,3,12,62,77,1.2337662337662338,0.05815605815832067,549,And why do you feel more qualified for an administrative position?
2623,4,10,63,77,1.2337662337662338,0.06102368884435136,549,Now can we have some straight talk?
2623,2,14,61,77,1.2337662337662338,0.05513949220709001,549,Google Houdini
2623,3,12,62,77,1.2337662337662338,0.05815605815832067,549,You're just not crazy enough to work here.
2623,5,8,64,77,1.2337662337662338,0.06376248191397861,549,I'm sorry. I just don't think you'd be a good fit for us.
2623,1,16,60,77,1.2337662337662338,0.051948051948051945,549,And what prior experience do you have in running an asylum?
2623,1,16,60,77,1.2337662337662338,0.051948051948051945,549,I think our hands are tied on this one.
2623,4,10,63,77,1.2337662337662338,0.06102368884435136,549,These new team-building sessions are really making the difference.
2623,3,12,62,77,1.2337662337662338,0.05815605815832067,549,You're hired! I see you have what it takes to work here.
2623,2,14,61,77,1.2337662337662338,0.05513949220709001,549,"So I think we've wrapped things up here, but I don't think I can manage doing lunch today..."
2623,6,6,65,77,1.2337662337662338,0.06638838452235968,549,"Your jacket design has been dropped from Spring 2017. I'm sorry, my hands are tied."
2623,1,16,60,77,1.2337662337662338,0.051948051948051945,549,At least we won't get carpal tunnel...
2623,6,6,65,77,1.2337662337662338,0.06638838452235968,549,Ever feel like you are in a bind?
2623,4,10,63,77,1.2337662337662338,0.06102368884435136,549,Did you still want to know where I see myself in five years?
2623,4,10,63,77,1.2337662337662338,0.06102368884435136,549,I apologize for yet another soul-crushing HR team building experience.
2623,3,12,62,77,1.2337662337662338,0.05815605815832067,549,I suppose we could have just turned off our cell phones.
2623,1,16,60,77,1.2337662337662338,0.051948051948051945,549,"I find these performance evaluation rules a bit constraining, don't you?"
2623,2,14,61,77,1.2337662337662338,0.05513949220709001,549,"Okay, we agree to avoid a 'hands-on' approach."
2623,5,8,64,77,1.2337662337662338,0.06376248191397861,549,What makes you think you are a good hire for Houdini Industries?
2623,2,14,61,77,1.2337662337662338,0.05513949220709001,549,It's a job that you can really wrap your arms around.
2623,5,8,64,77,1.2337662337662338,0.06376248191397861,549,I feel your pain.
2623,3,12,62,77,1.2337662337662338,0.05815605815832067,549,Tell me why you think you're qualified to work here.
2623,2,14,61,77,1.2337662337662338,0.05513949220709001,549,"I'm sorry, you're overqualified."
2623,4,10,63,77,1.2337662337662338,0.06102368884435136,549,It renders the glass ceiling superfluous.
2623,3,12,62,77,1.2337662337662338,0.05815605815832067,549,Don't blame me--I voted for Her!
2623,2,14,61,77,1.2337662337662338,0.05513949220709001,549,We have to be more open with each other
2623,3,12,62,77,1.2337662337662338,0.05815605815832067,549,"I'm passing on your manuscript, too much of a nail-biter."
2623,4,10,63,77,1.2337662337662338,0.06102368884435136,549,"I am going to describe a hypothetical challenging situation to you, and you tell me how you would deal with it."
2623,4,10,63,77,1.2337662337662338,0.06102368884435136,549,This place is crazy!
2623,4,10,63,77,1.2337662337662338,0.06102368884435136,549,I'm on the waitlist for the pants.
2623,3,12,62,77,1.2337662337662338,0.05815605815832067,549,We want to be the Uber of straightjackets.
2623,4,10,63,77,1.2337662337662338,0.06102368884435136,549,I think we're getting too close to the glass ceiling.
2623,3,12,62,77,1.2337662337662338,0.05815605815832067,549,We went from business casual to business restraining.
2623,2,14,61,77,1.2337662337662338,0.05513949220709001,549,"This place can drive you crazy sometimes, but it seems you already know that."
2623,2,14,61,77,1.2337662337662338,0.05513949220709001,549,Comfortable?
2623,3,12,62,77,1.2337662337662338,0.05815605815832067,549,I would like to read our mission statement again. I may have missed something.
2623,2,14,61,77,1.2337662337662338,0.05513949220709001,549,Sometimes I find this job to be too constricting.
2623,4,10,63,77,1.2337662337662338,0.06102368884435136,549,We will be working on a body control issues today.
2623,4,10,63,77,1.2337662337662338,0.06102368884435136,549,It seems like you'll be a good fit for The White House Ethics office
2623,0,18,59,77,1.2337662337662338,0.048547261524614,549,Perks for the position include voice-activated office equipment and drinking straws.
2623,1,16,60,77,1.2337662337662338,0.051948051948051945,549,"Well, you know, we have a hands off policy here."
2623,7,4,66,77,1.2337662337662338,0.0689143025731736,549,President Trump will see you now.
2623,3,12,62,77,1.2337662337662338,0.05815605815832067,549,Do you think our restrictive dress code stifles productivity?
2623,3,12,62,77,1.2337662337662338,0.05815605815832067,549,Ae you sure there aren't any loose ends?
2623,4,10,63,77,1.2337662337662338,0.06102368884435136,549,"We were bound to do this, don't you agree?"
2623,2,14,61,77,1.2337662337662338,0.05513949220709001,549,"Sorry we have to let you go, you just aren't committed."
2623,2,14,61,77,1.2337662337662338,0.05513949220709001,549,Mirroring the interviewer can be overdone.
2623,2,14,61,77,1.2337662337662338,0.05513949220709001,549,"Seems a bit archaic to have a conversation without email, texts or emojis."
2623,1,16,60,77,1.2337662337662338,0.051948051948051945,549,Now you won't add to the draft and I won't edit. It's a win-win.
2623,4,10,63,77,1.2337662337662338,0.06102368884435136,549,I think all three of you would be a good fit for our organization.
2623,4,10,63,77,1.2337662337662338,0.06102368884435136,549,"We all want raises but, as you can see, our hands are tied."
2623,4,10,63,77,1.2337662337662338,0.06102368884435136,549,"If hired, you're bound to love this job."
2623,2,14,61,77,1.2337662337662338,0.05513949220709001,549,"I'm sorry, but my hands are tied on this one."
2623,3,12,62,77,1.2337662337662338,0.05815605815832067,549,It helps me empathize.
2623,2,14,61,77,1.2337662337662338,0.05513949220709001,549,I assume that by now you understand that creativity is not highly valued around here.
2623,5,8,64,77,1.2337662337662338,0.06376248191397861,549,It's amazing how many things you can't do without hands!
2623,5,8,64,77,1.2337662337662338,0.06376248191397861,549,I'm so glad I can be straight with you.
2623,2,14,61,77,1.2337662337662338,0.05513949220709001,549,"Helen, I would love to offer you the position, but the board has chosen another candidate and I'm afraid my hands are tied."
2623,1,16,60,77,1.2337662337662338,0.051948051948051945,549,"I'll be straight with you; you got the dress code, you get the job."
2623,5,8,64,77,1.2337662337662338,0.06376248191397861,549,This seems like severe punishment for surfing the web at work!
2623,5,8,64,77,1.2337662337662338,0.06376248191397861,549,Let me give it to you straight . . .
2623,6,6,65,77,1.2337662337662338,0.06638838452235968,549,Any asylum takeover has its challenges
2623,3,12,62,77,1.2337662337662338,0.05815605815832067,549,"After a few months here, you'll be able to tell the difference between the treatment staff and the patients."
2623,2,14,61,77,1.2337662337662338,0.05513949220709001,549,"Here at Shady Oaks Insane Asylum, we like to make our patients feel right at home!"
2623,3,12,62,77,1.2337662337662338,0.05815605815832067,549,So you So do you think you can handle the constraints of the job?
2623,3,12,62,77,1.2337662337662338,0.05815605815832067,549,All training will be hands on
2623,5,8,64,77,1.2337662337662338,0.06376248191397861,549,"Mrs. Houdini, how can I help?"
2623,2,14,61,77,1.2337662337662338,0.05513949220709001,549,I find swaddling has a calming effect on me as well.
2623,3,12,62,77,1.2337662337662338,0.05815605815832067,549,We emphasize constraint
2623,4,10,63,77,1.2337662337662338,0.06102368884435136,549,"Yes, indeed, personal hygiene is an issue here"
2623,5,8,64,77,1.2337662337662338,0.06376248191397861,549,We're going to have to start saying no.
2623,6,6,65,77,1.2337662337662338,0.06638838452235968,549,"I'm sorry, that question is out of bounds."
2623,2,14,61,77,1.2337662337662338,0.05513949220709001,549,"At least we don't have to worry about hitting ""reply all."""
2623,4,10,63,77,1.2337662337662338,0.06102368884435136,549,We view arms as an appendage that distracts from oral interpretation.
2623,3,12,62,77,1.2337662337662338,0.05815605815832067,549,I can see why you might find some of our practices confining.
2623,5,8,64,77,1.2337662337662338,0.06376248191397861,549,Our strict dress code leaves no wiggle room for self-expression.
2623,3,12,62,77,1.2337662337662338,0.05815605815832067,549,"Crazy, huh? I knew we were bound to be friends."
2623,3,12,62,77,1.2337662337662338,0.05815605815832067,549,"It can be so difficult to hear over the din of body language, don't you agree?"
2623,3,12,62,77,1.2337662337662338,0.05815605815832067,549,TGIF
2623,1,16,60,77,1.2337662337662338,0.051948051948051945,549,They're never adopted casual Friday here.
2623,4,10,63,77,1.2337662337662338,0.06102368884435136,549,"I'd love to support your new idea, but my hands are tied."
2623,3,12,62,77,1.2337662337662338,0.05815605815832067,549,We're just not getting our arms around this project!
2623,5,8,64,77,1.2337662337662338,0.06376248191397861,549,"I tried reaching out to HR, but my hands are tied."
2623,2,14,61,77,1.2337662337662338,0.05513949220709001,549,Women have always used their minds.
2623,6,6,65,77,1.2337662337662338,0.06638838452235968,549,Oh I think the President would love to have you on his transition team
2623,4,10,63,77,1.2337662337662338,0.06102368884435136,549,"""Constraints,""I said! ""Constraints,"" not ""Restraints."""
2623,3,12,62,77,1.2337662337662338,0.05815605815832067,549,"I'd offer you a tissue, but I'm having trouble with this damn drawer."
2623,2,14,61,77,1.2337662337662338,0.05513949220709001,549,I think we both know why I can't give you a raise.
2623,2,14,61,77,1.2337662337662338,0.05513949220709001,549,"Well, we've always said you have to be crazy to work here."
2623,2,14,61,77,1.2337662337662338,0.05513949220709001,549,I'm not crazy about the new dress code.
2623,3,12,62,77,1.2337662337662338,0.05815605815832067,549,Where do you see yourself in five years?
2623,5,8,64,77,1.2337662337662338,0.06376248191397861,549,"If you were a tree, what type of tree would you be?"
2623,3,12,62,77,1.2337662337662338,0.05815605815832067,549,I'll do whatever I can to help you out.
2623,1,16,60,77,1.2337662337662338,0.051948051948051945,549,You'll see we run a tight ship here
2623,2,14,61,77,1.2337662337662338,0.05513949220709001,549,And we both know the contract is binding...
2623,3,12,62,77,1.2337662337662338,0.05815605815832067,549,I want this office to be a safe space.
2623,3,12,62,77,1.2337662337662338,0.05815605815832067,549,Stop projecting.
2623,2,14,61,77,1.2337662337662338,0.05513949220709001,549,"We're strait-laced, yes, but I think you'll find we're not a stuffy group."
2623,2,14,61,77,1.2337662337662338,0.05513949220709001,549,It's our backlash to Casual Friday.
2623,2,14,61,77,1.2337662337662338,0.05513949220709001,549,This is the job I've been looking for!
2623,4,10,63,77,1.2337662337662338,0.06102368884435136,549,I don't want to have this conversation any more than you do.
2623,2,14,61,77,1.2337662337662338,0.05513949220709001,549,"We have very little wiggle room. I think a ""hands on"" approach will work."
2623,5,8,64,77,1.2337662337662338,0.06376248191397861,549,"Welcome to the office of Mike Pence, where you're straight whether you like it or not."
2623,2,14,61,77,1.2337662337662338,0.05513949220709001,549,I objected to the new dress code too but they all said I was crazy.
2623,2,14,61,77,1.2337662337662338,0.05513949220709001,549,I'm just glad they got rid of the cubicles.
2623,1,16,60,77,1.2337662337662338,0.051948051948051945,549,"On a scale between ""Houdini"" and ""Criss Angel,"" I would rate your job performance thus far as ""David Blaine-minus."""
2623,4,10,63,77,1.2337662337662338,0.06102368884435136,549,We've found it useful to replace the glass ceiling with a rubber room.
2623,4,10,63,77,1.2337662337662338,0.06102368884435136,549,"Unfortunately, you meet the minimum qualifications for employment here."
2623,3,12,62,77,1.2337662337662338,0.05815605815832067,549,This diet doesn't work in the office.
2623,2,14,61,77,1.2337662337662338,0.05513949220709001,549,"Swap seats now, doctor?"
2623,1,16,60,77,1.2337662337662338,0.051948051948051945,549,"I'm sorry, Brenda. My hands are tied."
2623,4,10,63,77,1.2337662337662338,0.06102368884435136,549,Who’s your tailor?
2623,3,12,62,77,1.2337662337662338,0.05815605815832067,549,Casual Fridays are not what they used to be.
2623,2,14,61,77,1.2337662337662338,0.05513949220709001,549,I should have never agreed to that psych evaluation.
2623,3,12,62,77,1.2337662337662338,0.05815605815832067,549,I'm not mocking you.
2623,3,12,62,77,1.2337662337662338,0.05815605815832067,549,That's insane!
2773,4,10,64,78,1.2307692307692308,0.06031076398764044,549,So much for the plan that was so crazy it might just work.
2773,1,16,61,78,1.2307692307692308,0.051365233901656364,549,This job is just too confining.
2773,3,12,63,78,1.2307692307692308,0.05748380571754565,549,No one can say we're not bound and determined to finish this report on time.
2773,2,14,62,78,1.2307692307692308,0.05451043557679759,549,We're a tight knit organization.
2773,5,8,65,78,1.2307692307692308,0.0630110195582741,549,There's nothing I can do about it... As I'm sure you understand.
2773,3,12,63,78,1.2307692307692308,0.05748380571754565,549,Management has us in a real double bind this time.
2773,2,14,62,78,1.2307692307692308,0.05451043557679759,549,Houdini wore it best.
2773,1,16,61,78,1.2307692307692308,0.051365233901656364,549,"If it weren't for Siri, I wouldn't get anything done either."
2773,4,10,64,78,1.2307692307692308,0.06031076398764044,549,Oh sure. This'll replace birth control.
2773,3,12,63,78,1.2307692307692308,0.05748380571754565,549,"Learned helplessness, how very PC"
2773,4,10,64,78,1.2307692307692308,0.06031076398764044,549,I've been tied up since this morning.....and you?
2773,3,12,63,78,1.2307692307692308,0.05748380571754565,549,I can see you're mad about this job.
2773,3,12,63,78,1.2307692307692308,0.05748380571754565,549,There's a pretty large gap in your resume
2773,3,12,63,78,1.2307692307692308,0.05748380571754565,549,We just don't think you're a good fit.
2773,3,12,63,78,1.2307692307692308,0.05748380571754565,549,"Frankly, we're token hires and not expected to do anything."
2773,2,14,62,78,1.2307692307692308,0.05451043557679759,549,"I'm not crazy, you're just projecting."
2773,2,14,62,78,1.2307692307692308,0.05451043557679759,549,"Yeah, that's what I said to MY husband, too. 'Get me something I'll look good in.'"
2773,2,14,62,78,1.2307692307692308,0.05451043557679759,549,"As you can see, we’re a pretty straight-laced office."
2773,4,10,64,78,1.2307692307692308,0.06031076398764044,549,Please be advised that this interview is being taped.
2773,3,12,63,78,1.2307692307692308,0.05748380571754565,549,Any chance you'll be free later today? I'm in a real bind and could use your help.
2773,6,6,66,78,1.2307692307692308,0.06560022041711089,549,"Welcome to Chez Cray-Cray, a pioneer of self-managed asylum living."
2773,2,14,62,78,1.2307692307692308,0.05451043557679759,549,First one to escape gets the Christmas bonus.
2773,1,16,61,78,1.2307692307692308,0.051365233901656364,549,"The dress code is conservative, but we get catered meals and a gym membership."
2773,2,14,62,78,1.2307692307692308,0.05451043557679759,549,"I'm glad this project isn't one of those ""hands on"" tasks."
2773,5,8,65,78,1.2307692307692308,0.0630110195582741,549,"We used to have just a lot of red tape to deal with, those were the good old days."
2773,2,14,62,78,1.2307692307692308,0.05451043557679759,549,That doesn't make sense but I like how you think.
2773,3,12,63,78,1.2307692307692308,0.05748380571754565,549,Is it you or is it me?
2773,4,10,64,78,1.2307692307692308,0.06031076398764044,549,"Okay, I understand that there are a few things we need to straighten out."
2773,1,16,61,78,1.2307692307692308,0.051365233901656364,549,Office bonding is overrated.
2773,7,4,67,78,1.2307692307692308,0.06809103650095118,549,Feel free to be totally open. This is a safe space.
2773,2,14,62,78,1.2307692307692308,0.05451043557679759,549,Couldn't we just have put our devices in a drawer?
2773,3,12,63,78,1.2307692307692308,0.05748380571754565,549,"Says here you once won honorable mention doing the ""Hokey Pokey."" Please tell me about that"
2773,3,12,63,78,1.2307692307692308,0.05748380571754565,549,I don't think we can get our arms around this idea.
2773,4,10,64,78,1.2307692307692308,0.06031076398764044,549,"I know I look great in this Dianne, but I'm afraid you just can't pull it off."
2773,3,12,63,78,1.2307692307692308,0.05748380571754565,549,"To be honest, Rita, being a writer for Saturday Night Live just isn't the same since Trump became President Elect."
2773,3,12,63,78,1.2307692307692308,0.05748380571754565,549,"Before we test your act in the water tank, we want to be sure you can escape here in thirty seconds."
2773,2,14,62,78,1.2307692307692308,0.05451043557679759,549,"If we offered you a position, would you be OK with being chained to your desk?"
2810,2,14,63,79,1.2278481012658229,0.0538952278235385,549,Thanks for applying; you're sure to like our dress code: one size fits all.
2811,3,11,62,76,1.2236842105263157,0.058034122480782775,549,And what would you say is your biggest sanity?
2811,2,13,61,76,1.2236842105263157,0.05492797264720445,549,There really is no need for a mouse or a phone in this position.
2811,4,9,63,76,1.2236842105263157,0.06098226434871825,549,We're trying to control workplace touching.
2811,2,13,61,76,1.2236842105263157,0.05492797264720445,549,"I like your fashion sense, you're hired!"
2811,1,15,60,76,1.2236842105263157,0.0516353075535489,549,We all need to stop tweeting on the job.
2811,3,11,62,76,1.2236842105263157,0.058034122480782775,549,The company's hiring practices are very restrictive.
2811,1,15,60,76,1.2236842105263157,0.0516353075535489,549,We have a very strict no-Facebook-at-work policy
2811,2,13,61,76,1.2236842105263157,0.05492797264720445,549,This job calls for patience and restraint.
2811,4,9,63,76,1.2236842105263157,0.06098226434871825,549,"Before we begin, may I get you a cup of coffee?"
2811,3,11,62,76,1.2236842105263157,0.058034122480782775,549,Management does know it's just a metaphor?
2811,4,9,63,76,1.2236842105263157,0.06098226434871825,549,I'm worried we have a productivity problem.
2811,1,15,60,76,1.2236842105263157,0.0516353075535489,549,I love casual Friday's.
2811,1,15,60,76,1.2236842105263157,0.0516353075535489,549,"On the other hand, I almost never get pulled over for texting while driving anymore."
2811,3,11,62,76,1.2236842105263157,0.058034122480782775,549,"Yeah, I can relate."
2811,2,13,61,76,1.2236842105263157,0.05492797264720445,549,"I thought the courts had tied our hands on affirmative action hires before, but this is getting ridiculous."
2811,3,11,62,76,1.2236842105263157,0.058034122480782775,549,I can see that neither of us is going to budge on our negotiating positions.
2811,4,9,63,76,1.2236842105263157,0.06098226434871825,549,I wish I could help but my hands are totally tied on this one
2811,1,15,60,76,1.2236842105263157,0.0516353075535489,549,We all get a little bit crazy at the end of the fiscal year
2811,4,9,63,76,1.2236842105263157,0.06098226434871825,549,I'm impressed with your company. My last place was too unconfining.
2811,3,11,62,76,1.2236842105263157,0.058034122480782775,549,Hey Siri...
2811,5,7,64,76,1.2236842105263157,0.06379430819500599,549,"Well, this is one result of the Roger Ailes settlement."
2811,6,5,65,76,1.2236842105263157,0.06648752477767439,549,"Tell me, was this your apparel of choice before November 9th?"
2811,4,9,63,76,1.2236842105263157,0.06098226434871825,549,"On the bright side, our heating costs are down 20% this month"
2811,0,17,59,76,1.2236842105263157,0.048117853164570096,549,I see you've already met head of HR.
2811,1,15,60,76,1.2236842105263157,0.0516353075535489,549,"Well I'd love to help you, but clearly my hands are tied."
2811,3,11,62,76,1.2236842105263157,0.058034122480782775,549,Im afraid we just can't shake on that - my hands are tied.
2811,1,15,60,76,1.2236842105263157,0.0516353075535489,549,"So, how do think this occupational therapy is working?"
2811,3,11,62,76,1.2236842105263157,0.058034122480782775,549,It gets a little crazy here during tax season.
2811,4,9,63,76,1.2236842105263157,0.06098226434871825,549,I don't like working with my hands either.
2811,3,11,62,76,1.2236842105263157,0.058034122480782775,549,Fine. You?
2811,3,11,62,76,1.2236842105263157,0.058034122480782775,549,How can we possibly get there? We're both tied up at the office.
2811,0,17,59,76,1.2236842105263157,0.048117853164570096,549,We think you're a good fit. When can you start?
2811,3,11,62,76,1.2236842105263157,0.058034122480782775,549,I'm a big proponent of straight-talk.
2811,4,9,63,76,1.2236842105263157,0.06098226434871825,549,"""So tell me, do you think you have the personality for this position?"
2811,4,9,63,76,1.2236842105263157,0.06098226434871825,549,Where did you have your nails done?
2811,4,9,63,76,1.2236842105263157,0.06098226434871825,549,Just tell them our hands are tied.
2811,3,11,62,76,1.2236842105263157,0.058034122480782775,549,"Listen, you scratch my back, and I'll scratch yours."
2811,2,13,61,76,1.2236842105263157,0.05492797264720445,549,Thank goodness for speech to text.
2811,2,13,61,76,1.2236842105263157,0.05492797264720445,549,"I'd hit the escape button, but my hands are tied."
2811,0,17,59,76,1.2236842105263157,0.048117853164570096,549,There may be some lingering resentment.
2811,3,11,62,76,1.2236842105263157,0.058034122480782775,549,Kinda makes me nostalgic for the days of golden handcuffs.
2811,2,13,61,76,1.2236842105263157,0.05492797264720445,549,"It's hard to unwind after being tied up in meetings all day, isn't it?"
2811,4,9,63,76,1.2236842105263157,0.06098226434871825,549,"Well, you're right. Sometimes it does get a little crazy around here sometimes."
2811,3,11,62,76,1.2236842105263157,0.058034122480782775,549,Let's just assume for now that front office doesn't want us making any changes to this file.
2811,5,7,64,76,1.2236842105263157,0.06379430819500599,549,Who thought there'd be such a virulent backlash against casual Fridays?
2811,4,9,63,76,1.2236842105263157,0.06098226434871825,549,Let's discuss your options
2811,2,13,61,76,1.2236842105263157,0.05492797264720445,549,This is known in psychoanalysis as a transference.
2811,3,11,62,76,1.2236842105263157,0.058034122480782775,549,"Give it to me straight, doc."
2811,1,15,60,76,1.2236842105263157,0.0516353075535489,549,If we can figure out how Houdini did it we can get back our cell phone and computer!
2811,5,7,64,76,1.2236842105263157,0.06379430819500599,549,Dior?
2811,3,11,62,76,1.2236842105263157,0.058034122480782775,549,I would love to help you but my hands are tied.
2811,2,13,61,76,1.2236842105263157,0.05492797264720445,549,"I'm finding the company's new internet violation policy a bit binding, aren't you?"
2811,2,13,61,76,1.2236842105263157,0.05492797264720445,549,Now that we have that settled how can I help you?
2811,3,11,62,76,1.2236842105263157,0.058034122480782775,549,Something tells me we went too far with texting during office hours!
2811,2,13,61,76,1.2236842105263157,0.05492797264720445,549,I think the new dress code is decreasing productivity.
2811,3,11,62,76,1.2236842105263157,0.058034122480782775,549,Maybe both of us should update our resumes.
2811,1,15,60,76,1.2236842105263157,0.0516353075535489,549,I think you'll fit right in with our corporate culture!
2811,2,13,61,76,1.2236842105263157,0.05492797264720445,549,did you pay retail?
2811,2,13,61,76,1.2236842105263157,0.05492797264720445,549,"We're both pretty tied up now, so we probably should get back to our work."
2811,1,15,60,76,1.2236842105263157,0.0516353075535489,549,Two record executives listening to the new Justin Bieber album
2811,3,11,62,76,1.2236842105263157,0.058034122480782775,549,I like how you’ve accessorized your jacket.
2811,3,11,62,76,1.2236842105263157,0.058034122480782775,549,"It says ""for solution press play""."
2811,4,9,63,76,1.2236842105263157,0.06098226434871825,549,I also thought they said they would retrain us for the job.
2811,3,11,62,76,1.2236842105263157,0.058034122480782775,549,Look Helen. I'm going to be straight with you.
2811,3,11,62,76,1.2236842105263157,0.058034122480782775,549,It's great how e-mail just doesn't matter any more.
2811,3,11,62,76,1.2236842105263157,0.058034122480782775,549,I understand you trained with Houdini?
2811,3,11,62,76,1.2236842105263157,0.058034122480782775,549,Let's try again to negotiate a peaceful settlement.
2811,1,15,60,76,1.2236842105263157,0.0516353075535489,549,"I know I've seen you somewhere before, but I just can't put my finger on it."
2811,3,11,62,76,1.2236842105263157,0.058034122480782775,549,"Karen, you were absolutely right. This post-election swaddling has been a godsend."
2811,2,13,61,76,1.2236842105263157,0.05492797264720445,549,You've got to hand it to HR. This has really solved my carpal tunnel.
2811,5,7,64,76,1.2236842105263157,0.06379430819500599,549,"I don't know how to tell you this, so I'll just give it to you strait, Jackie."
2811,4,9,63,76,1.2236842105263157,0.06098226434871825,549,Your imaginary résumé looks really good.
2811,3,11,62,76,1.2236842105263157,0.058034122480782775,549,Seems like you'd be able to handle the job stress here.
2811,2,13,61,76,1.2236842105263157,0.05492797264720445,549,Now we're free to talk.
2811,2,13,61,76,1.2236842105263157,0.05492797264720445,549,There's really nothing more I can do for you. Put yourself in my position...
2811,1,15,60,76,1.2236842105263157,0.0516353075535489,549,I didn't see this mentioned in the employee handbook.
2811,4,9,63,76,1.2236842105263157,0.06098226434871825,549,I miss the days of annual review where we could simply urge restraint
2811,2,13,61,76,1.2236842105263157,0.05492797264720445,549,I can assure you that we will harness whatever energy and enthusiasm you bring to the table.
2811,2,13,61,76,1.2236842105263157,0.05492797264720445,549,Eye contact training.
2811,3,11,62,76,1.2236842105263157,0.058034122480782775,549,Any thoughts on how to accessorize?
2811,3,11,62,76,1.2236842105263157,0.058034122480782775,549,This is knot funny.
2811,2,13,61,76,1.2236842105263157,0.05492797264720445,549,I feel like it's more of a weekend outfit.
2811,3,11,62,76,1.2236842105263157,0.058034122480782775,549,This new anti-theft program has been a complete success.
2811,2,13,61,76,1.2236842105263157,0.05492797264720445,549,Where do you see yourself 10 years from now?
2811,3,11,62,76,1.2236842105263157,0.058034122480782775,549,"I empathise with your situation, but my hands are tied."
2811,1,15,60,76,1.2236842105263157,0.0516353075535489,549,"I agree, the company's suggested anger management techniques are helping, but it's a lot more difficult responding to e-mail."
2811,4,9,63,76,1.2236842105263157,0.06098226434871825,549,Think you can dislocate your own shoulder in time for lunch?
2811,3,11,62,76,1.2236842105263157,0.058034122480782775,549,I really think we should try weight watchers
2811,3,11,62,76,1.2236842105263157,0.058034122480782775,549,You appear to have the right qualifications!
2811,3,11,62,76,1.2236842105263157,0.058034122480782775,549,Want to arm wrestle?
2811,2,13,61,76,1.2236842105263157,0.05492797264720445,549,The safe word is the same as the Wi-Fi login.
2811,3,11,62,76,1.2236842105263157,0.058034122480782775,549,I guess we have reached an impasse.
2811,4,9,63,76,1.2236842105263157,0.06098226434871825,549,"You clearly have an insane experience, but my hands are tied at the moment!"
2811,3,11,62,76,1.2236842105263157,0.058034122480782775,549,I know I am but what are you?
2811,3,11,62,76,1.2236842105263157,0.058034122480782775,549,You'll fit right in. We all voted for him.
2811,3,11,62,76,1.2236842105263157,0.058034122480782775,549,"Don't worry, you'll fit in well around here."
2811,1,15,60,76,1.2236842105263157,0.0516353075535489,549,For me it's about escaping the drudgery of the job.
2811,2,13,61,76,1.2236842105263157,0.05492797264720445,549,This project will require a very special skill set.
2811,2,13,61,76,1.2236842105263157,0.05492797264720445,549,So you've been tied up today too.
2811,5,7,64,76,1.2236842105263157,0.06379430819500599,549,I think you're too wrapped up in it.
2811,2,13,61,76,1.2236842105263157,0.05492797264720445,549,"First we went paperless. Now we are hands-free. What's next, virtual employment?"
2811,1,15,60,76,1.2236842105263157,0.0516353075535489,549,"I'd love to make sure you get this promotion, but you must understand that my hands are, well, you know..."
2811,4,9,63,76,1.2236842105263157,0.06098226434871825,549,Watch what you say; it's on voice activation.
2811,4,9,63,76,1.2236842105263157,0.06098226434871825,549,We have to talk.
2811,4,9,63,76,1.2236842105263157,0.06098226434871825,549,Maybe Siri could help.
2811,2,13,61,76,1.2236842105263157,0.05492797264720445,549,"Tell me more about yourself, we're bound to have something in common."
2811,4,9,63,76,1.2236842105263157,0.06098226434871825,549,Gucci?
2811,3,11,62,76,1.2236842105263157,0.058034122480782775,549,"We'd like to address that issue; unfortunately, our hands are tied."
2811,4,9,63,76,1.2236842105263157,0.06098226434871825,549,"I'd like to, but I'm afraid my hands are tied."
2811,2,13,61,76,1.2236842105263157,0.05492797264720445,549,"Ok so, how do we get out of this binding contract?"
2811,5,7,64,76,1.2236842105263157,0.06379430819500599,549,I hear you cut through the red tape.
2811,1,15,60,76,1.2236842105263157,0.0516353075535489,549,We also have an exceptional employee assistance program
2811,3,11,62,76,1.2236842105263157,0.058034122480782775,549,I think management has gone a bit overboard trying to curb online shopping at work.
2811,4,9,63,76,1.2236842105263157,0.06098226434871825,549,"I don't feel micromanaged, do you?"
2811,5,7,64,76,1.2236842105263157,0.06379430819500599,549,Looks like our hands are tied on the matter
2811,4,9,63,76,1.2236842105263157,0.06098226434871825,549,You have to know your audience.
2811,3,11,62,76,1.2236842105263157,0.058034122480782775,549,I've decided to plan a company picnic so we all can unwind.
2811,3,11,62,76,1.2236842105263157,0.058034122480782775,549,"I can't plea insanity for you, my hands are tied."
2811,1,15,60,76,1.2236842105263157,0.0516353075535489,549,"Sorry, I'd really like to help you with this, by my hands are also tied."
2811,2,13,61,76,1.2236842105263157,0.05492797264720445,549,Making a case for binding resolution.
2811,3,11,62,76,1.2236842105263157,0.058034122480782775,549,Seems your hands are tied as well.
2811,4,9,63,76,1.2236842105263157,0.06098226434871825,549,"Don't worry, I won't bite."
2811,2,13,61,76,1.2236842105263157,0.05492797264720445,549,Face it: productivity has been down since that company bonding day.
2811,3,11,62,76,1.2236842105263157,0.058034122480782775,549,Some holding company we turned out to be.
2811,3,11,62,76,1.2236842105263157,0.058034122480782775,549,Do you have prior experience in a crazy office environment?
2811,3,11,62,76,1.2236842105263157,0.058034122480782775,549,I'll reply to your email on Causal Friday.
2811,5,7,64,76,1.2236842105263157,0.06379430819500599,549,"A meeting between an editor and her reporter during the ""Trump Years."""
2811,2,13,61,76,1.2236842105263157,0.05492797264720445,549,Mine is Vera Wang. What are you wearing?
2811,4,9,63,76,1.2236842105263157,0.06098226434871825,549,"I'm tied up at the moment, but I can fit you in next week."
2811,3,11,62,76,1.2236842105263157,0.058034122480782775,549,How do you like Restrained Fridays?
2811,1,15,60,76,1.2236842105263157,0.0516353075535489,549,I'm not so sure about these new budget constraints.
2811,3,11,62,76,1.2236842105263157,0.058034122480782775,549,The 12 Strap Approach to addressing social media addiction.
2811,2,13,61,76,1.2236842105263157,0.05492797264720445,549,They keep making the national sign language contest more difficult.
2811,3,11,62,76,1.2236842105263157,0.058034122480782775,549,"OK, then. I believe that ties up all the loose ends."
2811,2,13,61,76,1.2236842105263157,0.05492797264720445,549,"So much for ""boundless opportunities."""
2811,6,5,65,76,1.2236842105263157,0.06648752477767439,549,"On casual Fridays, handcuffs are appropriate."
2811,1,15,60,76,1.2236842105263157,0.0516353075535489,549,How do you do lunch?
2811,4,9,63,76,1.2236842105263157,0.06098226434871825,549,"I'm sorry, she's tied up right now."
2811,3,11,62,76,1.2236842105263157,0.058034122480782775,549,"Apparently, we were supposed to tidy up. Stupid autocorrect."
2811,3,11,62,76,1.2236842105263157,0.058034122480782775,549,I think you'll like joining a company where not just the prices are insane.
2811,2,13,61,76,1.2236842105263157,0.05492797264720445,549,"If we were to hire you, do you think you'd have a problem with the dress code?"
2811,5,7,64,76,1.2236842105263157,0.06379430819500599,549,I'm a team player.
2811,4,9,63,76,1.2236842105263157,0.06098226434871825,549,Congratulations. You've been accepted to the Houdini Conservatory for Psychic Pianists.
2811,3,11,62,76,1.2236842105263157,0.058034122480782775,549,I'll ask the questions. What makes you think the inmates run this asylum?
2811,4,9,63,76,1.2236842105263157,0.06098226434871825,549,The new dress code is to protect against discrimination lawsuit by the patients.
2811,1,15,60,76,1.2236842105263157,0.0516353075535489,549,How did we do this to each other?
2811,2,13,61,76,1.2236842105263157,0.05492797264720445,549,I feel like this company is holding me back
2811,4,9,63,76,1.2236842105263157,0.06098226434871825,549,How did we get here ?
2811,2,13,61,76,1.2236842105263157,0.05492797264720445,549,We have zero tolerance for lewd gestures.
2811,2,13,61,76,1.2236842105263157,0.05492797264720445,549,The gag rule doesn't apply here.
2811,1,15,60,76,1.2236842105263157,0.0516353075535489,549,I love that they let you be yourself here.
2811,3,11,62,76,1.2236842105263157,0.058034122480782775,549,I'm happy to tell you that we have a great voice recognition program
2811,4,9,63,76,1.2236842105263157,0.06098226434871825,549,"We can't today, we're all tied up."
2811,3,11,62,76,1.2236842105263157,0.058034122480782775,549,It's a bit of a stretch to say I like working here
2811,2,13,61,76,1.2236842105263157,0.05492797264720445,549,You're hired. Let's shoulder bump on it.
2811,5,7,64,76,1.2236842105263157,0.06379430819500599,549,When I signed up for hands free...
2811,4,9,63,76,1.2236842105263157,0.06098226434871825,549,My therepist says that I needed to show some empathy.
2811,3,11,62,76,1.2236842105263157,0.058034122480782775,549,"I'd love to put you in for a raise, but my arms are tied."
2811,5,7,64,76,1.2236842105263157,0.06379430819500599,549,"No, Thursday's no good. I'll be tied up all day."
2811,4,9,63,76,1.2236842105263157,0.06098226434871825,549,From one straight shooter to another ...
2811,3,11,62,76,1.2236842105263157,0.058034122480782775,549,"Here at Disney, we encourage our employees to reach for their dreams!"
2811,4,9,63,76,1.2236842105263157,0.06098226434871825,549,"Ok , now let's complete your exit interview."
2811,3,11,62,76,1.2236842105263157,0.058034122480782775,549,"I'd love to hire you, but my hands are tied."
2811,3,11,62,76,1.2236842105263157,0.058034122480782775,549,What a year.
2811,2,13,61,76,1.2236842105263157,0.05492797264720445,549,Are we tight now?
2811,3,11,62,76,1.2236842105263157,0.058034122480782775,549,"Well, let's agree to disagree then, shall we?"
2811,4,9,63,76,1.2236842105263157,0.06098226434871825,549,"I'm sorry, there's nothing we can do. Our hands are tied."
2811,4,9,63,76,1.2236842105263157,0.06098226434871825,549,I think it's fair to say neither one of us is sneaking out early today.
2811,2,13,61,76,1.2236842105263157,0.05492797264720445,549,"The classic double bind is not just a theory, my dear!"
2811,6,5,65,76,1.2236842105263157,0.06648752477767439,549,So how are you liking the new post-election dress code?
2811,3,11,62,76,1.2236842105263157,0.058034122480782775,549,I've found that making fun of my patients improves their self-esteem.
2811,3,11,62,76,1.2236842105263157,0.058034122480782775,549,"It's latest line of apparel - I call it ""Over-Active Wear"""
2811,3,11,62,76,1.2236842105263157,0.058034122480782775,549,So this is what happens when you break through the glass ceiling.
2811,3,11,62,76,1.2236842105263157,0.058034122480782775,549,I think we both need counseling.
2811,2,13,61,76,1.2236842105263157,0.05492797264720445,549,You're tied up. I'm tied up. ... just kick it to a contractor.
2811,2,13,61,76,1.2236842105263157,0.05492797264720445,549,"Name a time you were in bind, and precisely what you did to get out of it."
2811,2,13,61,76,1.2236842105263157,0.05492797264720445,549,Welcome to the Houdini Institute initial interview.
2811,0,17,59,76,1.2236842105263157,0.048117853164570096,549,"It's really cut down on our social media addiction, don't you think?"
2811,3,11,62,76,1.2236842105263157,0.058034122480782775,549,"I'd love to hire you, but my hands are tied."
2811,7,3,66,76,1.2236842105263157,0.06907581446529835,549,Get outta here!
2811,5,7,64,76,1.2236842105263157,0.06379430819500599,549,"I'm so sorry, but, as you can see, my hands are tied"
2811,5,7,64,76,1.2236842105263157,0.06379430819500599,549,"Siri, we'll have malteds for lunch."
2811,3,11,62,76,1.2236842105263157,0.058034122480782775,549,The boss warned us she was going to do this if we didn't stop using our phones during meetings.
2811,3,11,62,76,1.2236842105263157,0.058034122480782775,549,No...there is no glass ceiling...
2811,1,15,60,76,1.2236842105263157,0.0516353075535489,549,"Trust me, it's the only way to stay twitter free."
2811,4,9,63,76,1.2236842105263157,0.06098226434871825,549,Who do you think you'll be a year from now?
2811,1,15,60,76,1.2236842105263157,0.0516353075535489,549,"Rest assured, this contract is not legally binding."
2811,0,17,59,76,1.2236842105263157,0.048117853164570096,549,I'm giving it to you straight.
2811,2,13,61,76,1.2236842105263157,0.05492797264720445,549,First things first - put yourself in the customer's shoes.
2811,4,9,63,76,1.2236842105263157,0.06098226434871825,549,Ah... being a woman in the workplace.
2811,1,15,60,76,1.2236842105263157,0.0516353075535489,549,"We got ourselves into this, now we have to get ourselves out of it."
2811,4,9,63,76,1.2236842105263157,0.06098226434871825,549,We might be here late tonight
2811,4,9,63,76,1.2236842105263157,0.06098226434871825,549,Is that your phone buzzing or mine?
2811,2,13,61,76,1.2236842105263157,0.05492797264720445,549,Maybe we shouldn't have broken the glass ceiling.
2811,3,11,62,76,1.2236842105263157,0.058034122480782775,549,"To work here, it helps to be Houdini"
2811,1,15,60,76,1.2236842105263157,0.0516353075535489,549,I'd like to help but my hands are tied too.
2811,3,11,62,76,1.2236842105263157,0.058034122480782775,549,At least it isn't red tape.
2811,5,7,64,76,1.2236842105263157,0.06379430819500599,549,Hillary. You?
2811,0,17,59,76,1.2236842105263157,0.048117853164570096,549,"I would love to help you out on this loan, but really, my hands are tied."
2811,3,11,62,76,1.2236842105263157,0.058034122480782775,549,Now let me get this strait . . .
2811,4,9,63,76,1.2236842105263157,0.06098226434871825,549,"''I can really relate to your situation and I'd like to help you out, but unfortunately, my hands are tied."""
2811,1,15,60,76,1.2236842105263157,0.0516353075535489,549,"Without Corporate's approval, our hands are tied."
2811,4,9,63,76,1.2236842105263157,0.06098226434871825,549,When did we end casual dress Fridays?
2811,4,9,63,76,1.2236842105263157,0.06098226434871825,549,"Sorry, our boss is nuts and we're just going along with it."
2811,3,11,62,76,1.2236842105263157,0.058034122480782775,549,What makes you think government regulations have gotten out of hand?
2811,1,15,60,76,1.2236842105263157,0.0516353075535489,549,It really is a fine line.
3017,5,7,65,77,1.2207792207792207,0.06302734226231446,549,"I'm sorry Jane, but four of your six personalities are behind their quotas this quarter"
3017,2,13,62,77,1.2207792207792207,0.05428770923216617,549,This voice recognition software is really amazing.
3017,2,13,62,77,1.2207792207792207,0.05428770923216617,549,I'm interested in a job in your company because it looks like a place where women are given the latitude they need to advance and excel.
3017,3,11,63,77,1.2207792207792207,0.057349096534596404,549,Let me tell it to you straight.
3017,2,13,62,77,1.2207792207792207,0.05428770923216617,549,Our Compliance Department prefers to err on the side of caution.
3017,1,15,61,77,1.2207792207792207,0.05104303942770242,549,I think you will fit right in.
3017,4,9,64,77,1.2207792207792207,0.06025514395462593,549,"So, woman to woman, what makes you think you are crazy?"
3017,3,11,63,77,1.2207792207792207,0.057349096534596404,549,"Your resume is excellent, but my hands are tied."
3025,2,12,61,75,1.2133333333333334,0.054667985042331585,549,I'll get straight to the point.
3025,4,8,63,75,1.2133333333333334,0.06090409928165189,549,"Repeat after me. ""Make America Great Again!"""
3025,2,12,61,75,1.2133333333333334,0.054667985042331585,549,"Like many of us in the entertainment industry, you are just too wrapped up in yourself."
3025,2,12,61,75,1.2133333333333334,0.054667985042331585,549,"So, what's new with you?"
3025,2,12,61,75,1.2133333333333334,0.054667985042331585,549,Let's be straight with each other!
3025,1,14,60,75,1.2133333333333334,0.051266248431382506,549,The company dress code is a little restrictive.
3025,2,12,61,75,1.2133333333333334,0.054667985042331585,549,We're bound to succeed.
3025,1,14,60,75,1.2133333333333334,0.051266248431382506,549,"Well, it's good to see that you also have anger management issues."
3025,3,10,62,75,1.2133333333333334,0.057870104103491554,549,This frees us up to be straight with each other.
3025,4,8,63,75,1.2133333333333334,0.06090409928165189,549,"I can tell by your body language that you are frustrated, but my hands are tied."
3025,2,12,61,75,1.2133333333333334,0.054667985042331585,549,"I'd like to help you advance, but I'm a bit tied up right now."
3025,1,14,60,75,1.2133333333333334,0.051266248431382506,549,"We like your style, Erica, but nose-typing proficiency is non-negotiable."
3025,4,8,63,75,1.2133333333333334,0.06090409928165189,549,Let me get this straight...
3025,3,10,62,75,1.2133333333333334,0.057870104103491554,549,"As you've probably noticed, the water boarding position has been filled."
3025,2,12,61,75,1.2133333333333334,0.054667985042331585,549,"Yes, it's impractical, but you and I both know we're the best dressed employees in this department."
3025,1,14,60,75,1.2133333333333334,0.051266248431382506,549,"I'm going to cut strait to the chase, how soon can you start?"
3025,4,8,63,75,1.2133333333333334,0.06090409928165189,549,This is harder than the week without sugar.
3025,4,8,63,75,1.2133333333333334,0.06090409928165189,549,"Okay, give it to me straight"
3025,3,10,62,75,1.2133333333333334,0.057870104103491554,549,"So yes, we believe in safe spaces."
3025,4,8,63,75,1.2133333333333334,0.06090409928165189,549,"No ..., but it helps."
3025,1,14,60,75,1.2133333333333334,0.051266248431382506,549,Where do you see yourself with this company in 5 years?
3025,4,8,63,75,1.2133333333333334,0.06090409928165189,549,At least they got rid of the glass ceiling.
3025,3,10,62,75,1.2133333333333334,0.057870104103491554,549,I can't scratch your back just like you can't scratch mine.
3025,2,12,61,75,1.2133333333333334,0.054667985042331585,549,"Well, seeing as we're pretty strait-laced around here, I think you'll fit in just fine."
3025,1,14,60,75,1.2133333333333334,0.051266248431382506,549,"Of all the companies I have worked for, This place has the strictest dress code!"
3025,6,4,65,75,1.2133333333333334,0.06655847076090339,549,What to do Thai for lunch?
3025,4,8,63,75,1.2133333333333334,0.06090409928165189,549,I'm wondering if we should be taking a closer look at efficiency.
3025,4,8,63,75,1.2133333333333334,0.06090409928165189,549,Are we sending the right message for 'Take Your Daughter to Work Day'?
3025,4,8,63,75,1.2133333333333334,0.06090409928165189,549,Hired! Welcome to 'Anti-Air-Quotes-R-Us.'
3025,0,16,59,75,1.2133333333333334,0.04762213632196553,549,And what is your nose-typing speed?
3025,3,10,62,75,1.2133333333333334,0.057870104103491554,549,What make you a good fit for our company?
3025,4,8,63,75,1.2133333333333334,0.06090409928165189,549,"It drives us all a little crazy around here at times, but necessity really is the inspiration for our entire line of hands-free solutions."
3025,5,6,64,75,1.2133333333333334,0.06379396264278989,549,I don't think you're crazy.
3025,1,14,60,75,1.2133333333333334,0.051266248431382506,549,"On the raise, my hands are tied."
3025,2,12,61,75,1.2133333333333334,0.054667985042331585,549,Election recovery...
3025,3,10,62,75,1.2133333333333334,0.057870104103491554,549,So this is our punishment for breaking the glass ceiling.
3025,3,10,62,75,1.2133333333333334,0.057870104103491554,549,Very nice. Macys?
3025,3,10,62,75,1.2133333333333334,0.057870104103491554,549,They make me use my nose on the keyboard and they call me crazy.
3025,3,10,62,75,1.2133333333333334,0.057870104103491554,549,"After a while, it's actually quite liberating."
3025,2,12,61,75,1.2133333333333334,0.054667985042331585,549,You have to project your thoughts.
3025,1,14,60,75,1.2133333333333334,0.051266248431382506,549,I'll bet as a kid you were a hugger.
3025,4,8,63,75,1.2133333333333334,0.06090409928165189,549,"Well, if I'm being honest, my hands are also tied."
3025,2,12,61,75,1.2133333333333334,0.054667985042331585,549,I'd kill for a glass ceiling.
3025,1,14,60,75,1.2133333333333334,0.051266248431382506,549,Do you think these will sell?
3025,4,8,63,75,1.2133333333333334,0.06090409928165189,549,At least we're being honest telling our husbands we were all tied up at work.
3025,3,10,62,75,1.2133333333333334,0.057870104103491554,549,Keep this up and you'll make partner in no time
3025,3,10,62,75,1.2133333333333334,0.057870104103491554,549,"I'm sorry, Marjorie. Our hands are tied."
3025,3,10,62,75,1.2133333333333334,0.057870104103491554,549,Can you grab me a tissue?
3025,4,8,63,75,1.2133333333333334,0.06090409928165189,549,I think you'll fit in around here just fine.
3025,1,14,60,75,1.2133333333333334,0.051266248431382506,549,Your hands are tied? Look at me.
3025,3,10,62,75,1.2133333333333334,0.057870104103491554,549,"Funny, I feel that my hands are tied as well."
3025,0,16,59,75,1.2133333333333334,0.04762213632196553,549,"Uh-oh, my nose is itchy."
3025,4,8,63,75,1.2133333333333334,0.06090409928165189,549,I'm sorry to let you go like this but my hands are tied.
3025,3,10,62,75,1.2133333333333334,0.057870104103491554,549,Our problem might be less straightforward than we think.
3025,3,10,62,75,1.2133333333333334,0.057870104103491554,549,"I know we are a bit straight laced around here, but I need you to loosen up."
3025,4,8,63,75,1.2133333333333334,0.06090409928165189,549,I just talked to your Mom. Now I understand.
3025,3,10,62,75,1.2133333333333334,0.057870104103491554,549,Really? I collect crossbows too!
3025,4,8,63,75,1.2133333333333334,0.06090409928165189,549,Lets get this strait
3025,2,12,61,75,1.2133333333333334,0.054667985042331585,549,I just wanted you to get a feel of what you are getting yourself into if you start working for this company.
3025,2,12,61,75,1.2133333333333334,0.054667985042331585,549,I'm starting to think that I should have asked for the standing desk instead.
3025,3,10,62,75,1.2133333333333334,0.057870104103491554,549,And so how did YOU get into asylum management?
3025,1,14,60,75,1.2133333333333334,0.051266248431382506,549,So we don't interfere with the robots.
3025,3,10,62,75,1.2133333333333334,0.057870104103491554,549,"Obviously, Mrs. Mitchell, your son drives people crazy."
3025,2,12,61,75,1.2133333333333334,0.054667985042331585,549,How skilled are you at typing with your toes?
3025,1,14,60,75,1.2133333333333334,0.051266248431382506,549,"Since you know the dress code, you'll be fine working here."
3025,2,12,61,75,1.2133333333333334,0.054667985042331585,549,My hands are tied. The dress code stays.
3025,2,12,61,75,1.2133333333333334,0.054667985042331585,549,"If we don't wear our company's latest fashions, who will?"
3025,1,14,60,75,1.2133333333333334,0.051266248431382506,549,Whatever. I still believe in group hugs.
3025,4,8,63,75,1.2133333333333334,0.06090409928165189,549,IT says we have something called ransomware
3025,2,12,61,75,1.2133333333333334,0.054667985042331585,549,Like I already told you- my hands are tied.
3025,0,16,59,75,1.2133333333333334,0.04762213632196553,549,"Yep, I know how you feel."
3025,2,12,61,75,1.2133333333333334,0.054667985042331585,549,It's our IT people's way of encouraging the use of Siri.
3025,5,6,64,75,1.2133333333333334,0.06379396264278989,549,We don't allow back scratching or handshake deals here.
3025,4,8,63,75,1.2133333333333334,0.06090409928165189,549,How do you do control-alt-delete?
3025,1,14,60,75,1.2133333333333334,0.051266248431382506,549,I'm going to give it to you straight.
3025,2,12,61,75,1.2133333333333334,0.054667985042331585,549,You have to be crazy to wanna work here. Check. So how's your Spanish?
3025,4,8,63,75,1.2133333333333334,0.06090409928165189,549,They want more fake news.
3025,3,10,62,75,1.2133333333333334,0.057870104103491554,549,Your ex-husband called and said you'd be perfect for this job.
3025,2,12,61,75,1.2133333333333334,0.054667985042331585,549,Can you tell me a little more about the company's long-term care policy?
3025,2,12,61,75,1.2133333333333334,0.054667985042331585,549,I understand you have some concerns about our new HR policy.
3025,0,16,59,75,1.2133333333333334,0.04762213632196553,549,I'm not as straight-laced as you might think.
3025,1,14,60,75,1.2133333333333334,0.051266248431382506,549,"I understand that you are constrained, and I'd like to help you, but my hands are tied."
3025,3,10,62,75,1.2133333333333334,0.057870104103491554,549,"Believe me, this job will drive you crazy."
3025,4,8,63,75,1.2133333333333334,0.06090409928165189,549,What do you do when your nose itches?
3025,2,12,61,75,1.2133333333333334,0.054667985042331585,549,We have a no backscratching policy.
3025,3,10,62,75,1.2133333333333334,0.057870104103491554,549,"If appointed, what are your plans to 'Make America Great Again?'"
3025,1,14,60,75,1.2133333333333334,0.051266248431382506,549,I'm not so crazy about this job either.
3025,3,10,62,75,1.2133333333333334,0.057870104103491554,549,"Well, now that we're running things, I think our first order of business should be to take off the straight jackets."
3025,5,6,64,75,1.2133333333333334,0.06379396264278989,549,The odds must be astronomical that we both attended the Poison Sumac Festival.
3025,2,12,61,75,1.2133333333333334,0.054667985042331585,549,I like that you've embraced the spirit of this company.
3025,3,10,62,75,1.2133333333333334,0.057870104103491554,549,We are the industry leader in safe spaces.
3025,4,8,63,75,1.2133333333333334,0.06090409928165189,549,"Whether you like it or not, this will be a war of words."
3025,1,14,60,75,1.2133333333333334,0.051266248431382506,549,When did you first have the feeling that you weren't going anywhere in this job?
3025,3,10,62,75,1.2133333333333334,0.057870104103491554,549,"Sorry I can't give you a raise, my hands are tied."
3025,2,12,61,75,1.2133333333333334,0.054667985042331585,549,"See, it is very difficult to talk without using your hands."
3025,3,10,62,75,1.2133333333333334,0.057870104103491554,549,I know how exactly how you feel...
3025,3,10,62,75,1.2133333333333334,0.057870104103491554,549,We're proud of our competitive academic environment here at Hannibal Lector University.
3025,4,8,63,75,1.2133333333333334,0.06090409928165189,549,"Here at 'Harry Houdini's School of Escape Artists,' new students are given exactly 10 minutes to free themselves and completely fill out the registration forms required . Time starts now ..."
3025,3,10,62,75,1.2133333333333334,0.057870104103491554,549,I think you'd be a good fit for our corporate culture.
3025,4,8,63,75,1.2133333333333334,0.06090409928165189,549,The first one to escape gets the Houdini account.
3025,2,12,61,75,1.2133333333333334,0.054667985042331585,549,"As your lawyer, I must advise you that we are bound by our contractual obligations."
3025,2,12,61,75,1.2133333333333334,0.054667985042331585,549,On Friday they let us wear sport jackets.
3025,3,10,62,75,1.2133333333333334,0.057870104103491554,549,"Frankly, I don't love your body language."
3025,3,10,62,75,1.2133333333333334,0.057870104103491554,549,Bind leading the bind.
3025,4,8,63,75,1.2133333333333334,0.06090409928165189,549,This job demands patience and a sharp nose.
3025,2,12,61,75,1.2133333333333334,0.054667985042331585,549,"It prevents me from surfing the internet to see what Trump is up to now. Ironically, it's the only thing that keeps me sane. You too?"
3025,2,12,61,75,1.2133333333333334,0.054667985042331585,549,How do you escape stress in the workplace?
3025,3,10,62,75,1.2133333333333334,0.057870104103491554,549,At Straight Jacket Corp. we keep our hands to ourselves.
3025,3,10,62,75,1.2133333333333334,0.057870104103491554,549,Whoever thought we would find each other in such dire straits?
3025,2,12,61,75,1.2133333333333334,0.054667985042331585,549,"Finally, administration was straight with us."
3025,3,10,62,75,1.2133333333333334,0.057870104103491554,549,It's HR's new protocol after a couple of annual reviews that went sideways.
3025,3,10,62,75,1.2133333333333334,0.057870104103491554,549,Let's do this when we're not so tied up.
3025,2,12,61,75,1.2133333333333334,0.054667985042331585,549,Medical benefits are provided.
3025,2,12,61,75,1.2133333333333334,0.054667985042331585,549,"No, we are not taking any new patients at the moment."
3025,2,12,61,75,1.2133333333333334,0.054667985042331585,549,It appears we've reached an impasse.
3025,5,6,64,75,1.2133333333333334,0.06379396264278989,549,you can be the doctor tomorrow.
3025,2,12,61,75,1.2133333333333334,0.054667985042331585,549,Our company really values overthinking.
3025,3,10,62,75,1.2133333333333334,0.057870104103491554,549,Gotta love the Escape key.
3025,2,12,61,75,1.2133333333333334,0.054667985042331585,549,"I know we're both tied up, but these deadlines are driving me crazy."
3025,4,8,63,75,1.2133333333333334,0.06090409928165189,549,How could we know “Lock her up!” meant us too?
3025,6,4,65,75,1.2133333333333334,0.06655847076090339,549,How long? The next four to eight years.
3025,2,12,61,75,1.2133333333333334,0.054667985042331585,549,I think you will fit in here.
3025,5,6,64,75,1.2133333333333334,0.06379396264278989,549,"I'm sorry, Ms. Houdini, but I can't help you: my hands are tied."
3025,2,12,61,75,1.2133333333333334,0.054667985042331585,549,Your problem is you are too restrained.
3025,5,6,64,75,1.2133333333333334,0.06379396264278989,549,I don't see the Escape key.
3025,1,14,60,75,1.2133333333333334,0.051266248431382506,549,"On Casual Fridays, they'll release one of your hands for fifteen minutes."
3025,4,8,63,75,1.2133333333333334,0.06090409928165189,549,We just feel that your not committed.
3025,5,6,64,75,1.2133333333333334,0.06379396264278989,549,Are you as stressed out about work as I am?
3025,3,10,62,75,1.2133333333333334,0.057870104103491554,549,I'm bound to have some questions and I'm sure you are bound to have some answers.
3025,2,12,61,75,1.2133333333333334,0.054667985042331585,549,Looks like everything is under control.
3025,2,12,61,75,1.2133333333333334,0.054667985042331585,549,"You seem well suited for the job, but I'm concerned that you are too tied down."
3025,4,8,63,75,1.2133333333333334,0.06090409928165189,549,Did I mention our strict policy against online shopping from the office?
3025,4,8,63,75,1.2133333333333334,0.06090409928165189,549,At least I didn't pay retail like you did.
3025,5,6,64,75,1.2133333333333334,0.06379396264278989,549,Are you the ventriloquist or am I?
3025,1,14,60,75,1.2133333333333334,0.051266248431382506,549,I share your feeling of constraint....
3025,5,6,64,75,1.2133333333333334,0.06379396264278989,549,Can you click it to disable these add-ons?
3025,3,10,62,75,1.2133333333333334,0.057870104103491554,549,See? This is what happens when we try to break the glass ceiling!
3025,3,10,62,75,1.2133333333333334,0.057870104103491554,549,The robots don't like us touching thier things.
3025,3,10,62,75,1.2133333333333334,0.057870104103491554,549,¨We´re in a real bind here.¨
3025,1,14,60,75,1.2133333333333334,0.051266248431382506,549,I guess we were told to expect being tied up before the holidays.
3025,2,12,61,75,1.2133333333333334,0.054667985042331585,549,Feel free to let your mind go.
3025,4,8,63,75,1.2133333333333334,0.06090409928165189,549,"As you can see, we have a rather strict dress code."
3025,4,8,63,75,1.2133333333333334,0.06090409928165189,549,You seem like a perfect applicant. Could you hand me my pen?
3025,3,10,62,75,1.2133333333333334,0.057870104103491554,549,Mine's a wedding present from my husband.
3025,4,8,63,75,1.2133333333333334,0.06090409928165189,549,We're looking for someone who knows how to cut through red tape.
3025,2,12,61,75,1.2133333333333334,0.054667985042331585,549,Let's make some magic together.
3171,4,8,64,76,1.2105263157894737,0.060162905963095606,549,They finally did something about the sexual harassment reports.
3171,1,14,61,76,1.2105263157894737,0.05066501430945142,549,"A minute fifteen!, What's your best timing ?"
3171,0,16,60,76,1.2105263157894737,0.04707511531578505,549,Me too....if it says ' Stella McCartney'... I am totally grabbing one.
3171,2,12,62,76,1.2105263157894737,0.054016857257335626,549,I have been here 5 years now and feel that I haven't been used to my full potential.
3171,3,10,63,76,1.2105263157894737,0.057172528901053773,549,My hands are tied on the salary offer.
3171,4,8,64,76,1.2105263157894737,0.060162905963095606,549,The inmates merged and acquired the asylum.
3171,3,10,63,76,1.2105263157894737,0.057172528901053773,549,Guess he wasn't the Good Humor man.
3171,3,10,63,76,1.2105263157894737,0.057172528901053773,549,"I think you'll find us easy going, as long as you follow the rules."
3171,3,10,63,76,1.2105263157894737,0.057172528901053773,549,Our sexual harassment policy is very strict.
3171,2,12,62,76,1.2105263157894737,0.054016857257335626,549,At least we're doing no harm.
3171,4,8,64,76,1.2105263157894737,0.060162905963095606,549,I'm all tied up too.
3171,6,4,66,76,1.2105263157894737,0.06573682103577262,549,What was your last job? Please say escape artist.
3171,3,10,63,76,1.2105263157894737,0.057172528901053773,549,"Why did you call this meeting, I'm completely tied up right now...."
3171,3,10,63,76,1.2105263157894737,0.057172528901053773,549,I think the glass ceiling was better than this.
3171,0,16,60,76,1.2105263157894737,0.04707511531578505,549,"'Straight Jacket Saturdays"" just might get us back to a five-day work week."
3171,1,14,61,76,1.2105263157894737,0.05066501430945142,549,Do you want to hit the Trough for lunch?
3171,3,10,63,76,1.2105263157894737,0.057172528901053773,549,You don't seem crazy to me at all.
3171,1,14,61,76,1.2105263157894737,0.05066501430945142,549,I guarantee you that this treatment will cure you of your nail biting habit.
3171,3,10,63,76,1.2105263157894737,0.057172528901053773,549,"I love tie-up Tuesdays, except for that itch you can't scratch!"
3171,2,12,62,76,1.2105263157894737,0.054016857257335626,549,"I just didn't think the ""no high-five"" policy was something that was enforced."
3171,3,10,63,76,1.2105263157894737,0.057172528901053773,549,Thanks for being prepared for your interview. I'm assuming you brought your own water tank?
3171,4,8,64,76,1.2105263157894737,0.060162905963095606,549,"It prevents overeating, too"
3171,1,14,61,76,1.2105263157894737,0.05066501430945142,549,What we women do to look slimmer...
3194,2,12,63,77,1.2077922077922079,0.05338078923628006,549,Maybe I should have had you pay for the visit before we got started.
3195,3,9,61,73,1.2054794520547945,0.05838681211207499,549,"No need to worry, we are not a hands on organization."
3195,4,7,62,73,1.2054794520547945,0.06155921809457883,549,"So this is how you're dealing the election, too? It's great, but I have to type with my nose."
3195,3,9,61,73,1.2054794520547945,0.05838681211207499,549,I'm so glad we can be straight with each other.
3195,1,13,59,73,1.2054794520547945,0.051458573833719844,549,Let's have a no-holds-barred conversation.
3195,3,9,61,73,1.2054794520547945,0.05838681211207499,549,It's really tough to get anything done around here!
3195,2,11,60,73,1.2054794520547945,0.055031830105908446,549,Thank you for your interest in peer-to-peer counseling.
3195,4,7,62,73,1.2054794520547945,0.06155921809457883,549,Would you expand on the comment in job application about your desire to shed your cocoon and spread your wings?
3195,4,7,62,73,1.2054794520547945,0.06155921809457883,549,"I hear what you're saying, but my hands are tied."
3195,3,9,61,73,1.2054794520547945,0.05838681211207499,549,I can sympathize.
3195,4,7,62,73,1.2054794520547945,0.06155921809457883,549,You scratch mine and I'll scratch yours.
3195,1,13,59,73,1.2054794520547945,0.051458573833719844,549,"I find this keeps me from knitting in meetings, also."
3195,3,9,61,73,1.2054794520547945,0.05838681211207499,549,"The scary thing is that although we don't get anything done, our stock keeps going up."
3195,3,9,61,73,1.2054794520547945,0.05838681211207499,549,"Well, I'll be! It DOES help if you work here..."
3195,1,13,59,73,1.2054794520547945,0.051458573833719844,549,Have you considered a lateral move?
3195,3,9,61,73,1.2054794520547945,0.05838681211207499,549,"I bought mine at a medical supply store, I was shopping for a sitz bath when it jumped right out and said ""Me""."
3195,2,11,60,73,1.2054794520547945,0.055031830105908446,549,It's a new Mac. There is no Escape key.
3195,3,9,61,73,1.2054794520547945,0.05838681211207499,549,So I see you made the mistake of saying this job makes you crazy too
3195,3,9,61,73,1.2054794520547945,0.05838681211207499,549,We have a hands-off management strategy.
3195,2,11,60,73,1.2054794520547945,0.055031830105908446,549,Sorry I can't help.My hands are tied.
3195,3,9,61,73,1.2054794520547945,0.05838681211207499,549,who's crazy now?
3195,3,9,61,73,1.2054794520547945,0.05838681211207499,549,How do you like our new facebook office in China?
3195,2,11,60,73,1.2054794520547945,0.055031830105908446,549,This company takes 'Hands Free' a little too far.
3195,2,11,60,73,1.2054794520547945,0.055031830105908446,549,I thought we agreed you would stop wearing my jacket.
3195,2,11,60,73,1.2054794520547945,0.055031830105908446,549,"' i know they're way trendy now, but i love the detail don't you?'"
3195,4,7,62,73,1.2054794520547945,0.06155921809457883,549,Now you must understand my position.
3195,1,13,59,73,1.2054794520547945,0.051458573833719844,549,Now do you feel more comfortable?
3195,4,7,62,73,1.2054794520547945,0.06155921809457883,549,"Call me crazy, but lately I feel like we're being creatively restricted."
3195,0,15,58,73,1.2054794520547945,0.04761793062697309,549,I can totally empathize.
3195,0,15,58,73,1.2054794520547945,0.04761793062697309,549,"If I point and click with my nose, I may be able to get us out of this."
3195,1,13,59,73,1.2054794520547945,0.051458573833719844,549,When do you get out?
3195,3,9,61,73,1.2054794520547945,0.05838681211207499,549,"I'm not crazy about your c.v., but I do believe you'll fit in here"
3195,3,9,61,73,1.2054794520547945,0.05838681211207499,549,I guess it was just a matter of time before the editors here at Mad Magazine recognized the obvious.
3195,3,9,61,73,1.2054794520547945,0.05838681211207499,549,"As I tell all applicants, we do have a dress code here..."
3195,3,9,61,73,1.2054794520547945,0.05838681211207499,549,"Welcome to Apple. You're interviewing with the ""Hey Siri"" team."
3195,1,13,59,73,1.2054794520547945,0.051458573833719844,549,"Yes, some minor challenges...like Ctrl, Alt, Delete."
3195,2,11,60,73,1.2054794520547945,0.055031830105908446,549,I think we're bonding already.
3195,2,11,60,73,1.2054794520547945,0.055031830105908446,549,I hear you feel the new dress code is a bit restrictive?
3195,5,5,63,73,1.2054794520547945,0.06457596175219613,549,"We can sit here all day, but I'm still going to want to tear off your designer glasses and rip your eyes out."""
3195,4,7,62,73,1.2054794520547945,0.06155921809457883,549,I am demonstrating step one in Pence’s National Conversion Therapy Plan.
3195,1,13,59,73,1.2054794520547945,0.051458573833719844,549,This next test will assess your wiggling skills.
3195,2,11,60,73,1.2054794520547945,0.055031830105908446,549,The new HR policy did away with golden handcuffs.
3195,0,15,58,73,1.2054794520547945,0.04761793062697309,549,You're bound to like it here.
3195,3,9,61,73,1.2054794520547945,0.05838681211207499,549,What happened to casual Fridays?
3195,3,9,61,73,1.2054794520547945,0.05838681211207499,549,What should our hashtag be?
3195,2,11,60,73,1.2054794520547945,0.055031830105908446,549,I can see that you need time off from work too.
3195,3,9,61,73,1.2054794520547945,0.05838681211207499,549,No. We do not require psychological profile testing for the job...
3195,2,11,60,73,1.2054794520547945,0.055031830105908446,549,I think you're focusing too much on how little you can move.
3195,2,11,60,73,1.2054794520547945,0.055031830105908446,549,"You're right, it does make working here easier!"
3195,5,5,63,73,1.2054794520547945,0.06457596175219613,549,"I'm sorry, but we already have a President."
3195,4,7,62,73,1.2054794520547945,0.06155921809457883,549,I can't help you. My hands are tied.
3195,5,5,63,73,1.2054794520547945,0.06457596175219613,549,I see what you mean.
3195,0,15,58,73,1.2054794520547945,0.04761793062697309,549,and then HR told us to show a bit more restraint...
3195,2,11,60,73,1.2054794520547945,0.055031830105908446,549,"I'm sorry Judith, but my hands are tied, and God only knows where yours are...."
3195,1,13,59,73,1.2054794520547945,0.051458573833719844,549,Keyboarding with your nose is a requirement for employment.
3195,1,13,59,73,1.2054794520547945,0.051458573833719844,549,I find the latest fashion trends are so confining.
3195,2,11,60,73,1.2054794520547945,0.055031830105908446,549,At the count of three if you can remove the straight jacket faster than me you are hired!
3195,2,11,60,73,1.2054794520547945,0.055031830105908446,549,Let's talk.
3195,2,11,60,73,1.2054794520547945,0.055031830105908446,549,My shrink recommended it as a way to keep me from regularly posting on Facebook.
3195,4,7,62,73,1.2054794520547945,0.06155921809457883,549,"Is it just me, do you notice anything different since the last national election?"
3195,3,9,61,73,1.2054794520547945,0.05838681211207499,549,I'll get straight to the point.
3195,3,9,61,73,1.2054794520547945,0.05838681211207499,549,I assume you know I can see your finger through the canvas.
3195,1,13,59,73,1.2054794520547945,0.051458573833719844,549,I think you'll find our company a crazy place to work.
3195,2,11,60,73,1.2054794520547945,0.055031830105908446,549,Of course I'd like to help but I have certain restrictions.
3195,0,15,58,73,1.2054794520547945,0.04761793062697309,549,I've got an itch I need to scratch
3195,4,7,62,73,1.2054794520547945,0.06155921809457883,549,How are we supposed to pee?
3195,5,5,63,73,1.2054794520547945,0.06457596175219613,549,"Welcome to the on-boarding process here at Houdini, Inc."
3195,3,9,61,73,1.2054794520547945,0.05838681211207499,549,I'm feeling trapped in my job
3195,3,9,61,73,1.2054794520547945,0.05838681211207499,549,"I know, I'm just as uncomfortable giving annual performance reviews."
3195,3,9,61,73,1.2054794520547945,0.05838681211207499,549,Congratulations! I see you have lost 10 pounds on our Venus De Milo diet.
3195,3,9,61,73,1.2054794520547945,0.05838681211207499,549,"It seemed like a crazy idea, but here we are."
3195,2,11,60,73,1.2054794520547945,0.055031830105908446,549,New White House staffer in what capacity?
3195,2,11,60,73,1.2054794520547945,0.055031830105908446,549,I just need a strait answer.
3195,2,11,60,73,1.2054794520547945,0.055031830105908446,549,I never could breastfeed either.
3195,1,13,59,73,1.2054794520547945,0.051458573833719844,549,"Your first magic trick interview answer will be to get me out of MY straitjacket BEFORE you get out of yours. You have 10 seconds, starting...now!"
3195,2,11,60,73,1.2054794520547945,0.055031830105908446,549,HR's gone a little overboard since that last sexual harassment case.
3195,0,15,58,73,1.2054794520547945,0.04761793062697309,549,"The cashmere lining, makes it tolerable. Am I right?"
3195,3,9,61,73,1.2054794520547945,0.05838681211207499,549,"""I must of been crazy to take this job, and you must be crazy to apply""."
3195,1,13,59,73,1.2054794520547945,0.051458573833719844,549,Just be grateful they've cut all that red tape.
3195,3,9,61,73,1.2054794520547945,0.05838681211207499,549,Make the workplace safe again
3195,4,7,62,73,1.2054794520547945,0.06155921809457883,549,Glad you like to conceptualize. We're not exactly a hands-on outfit.
3195,0,15,58,73,1.2054794520547945,0.04761793062697309,549,"Yeah, work seems more constraining these days."
3195,4,7,62,73,1.2054794520547945,0.06155921809457883,549,"So, when did you first realise you were straight?"
3195,1,13,59,73,1.2054794520547945,0.051458573833719844,549,I used to get jumpy during interviews too but you seem really restrained
3278,2,11,61,74,1.2027027027027026,0.05435403616647045,549,We eschew any hands-on training.
3278,2,11,61,74,1.2027027027027026,0.05435403616647045,549,"This prevents us from even smudging the ceiling, let alone shattering it."
3278,4,7,63,74,1.2027027027027026,0.060785094731168506,549,"Silence of the Lambs is your favorite movie! Me, too!"
3278,1,13,60,74,1.2027027027027026,0.0508343191224236,549,I think you'd be perfect for the job.
3282,2,12,67,81,1.1975308641975309,0.05097734030138908,549,"You would tell me if I had something in my teeth, right?"
3283,4,6,62,72,1.1944444444444444,0.0614091466303077,549,"The inmates may be running the asylum, but we're also beating last year's projections by 19%."
3283,1,12,59,72,1.1944444444444444,0.050964442209003306,549,Told my husband for years that clients were driving me crazy. Guess he'll listen now.
3283,3,8,61,72,1.1944444444444444,0.05813645141504052,549,This brings empathy into question.
3283,3,8,61,72,1.1944444444444444,0.05813645141504052,549,"Yes, I am straight too. Will that be a problem?"
3283,2,10,60,72,1.1944444444444444,0.054668187059789194,549,I always find these one-on-one meetings uncomfortable
3283,3,8,61,72,1.1944444444444444,0.05813645141504052,549,I think you'll make a great addition to 'Mad Magazine.
3283,4,6,62,72,1.1944444444444444,0.0614091466303077,549,We market it to schools as an environmentally friendly no texting motivational tool.
3283,1,12,59,72,1.1944444444444444,0.050964442209003306,549,Think of it like dancing backwards in heels.
3283,1,12,59,72,1.1944444444444444,0.050964442209003306,549,You have to be a little crazy to work here--and you're hired.
3283,0,14,58,72,1.1944444444444444,0.04696954399337483,549,Everything starts with good posture.
3283,1,12,59,72,1.1944444444444444,0.050964442209003306,549,"So, how's this new diet working for you?"
3283,2,10,60,72,1.1944444444444444,0.054668187059789194,549,Some new hires find the culture a bit constraining at first
3283,2,10,60,72,1.1944444444444444,0.054668187059789194,549,Maybe we should try a hands-on approach.
3283,3,8,61,72,1.1944444444444444,0.05813645141504052,549,I know you are but what am I
3283,3,8,61,72,1.1944444444444444,0.05813645141504052,549,How are you qualified to be a raging maniac?
3283,3,8,61,72,1.1944444444444444,0.05813645141504052,549,"Oh, and in case you're thinking of getting up and leaving, you're hired."
3283,2,10,60,72,1.1944444444444444,0.054668187059789194,549,Art of negotiation: Never be the first to make a move.
3283,2,10,60,72,1.1944444444444444,0.054668187059789194,549,"Our boss calls it ""Straitjacket Strategy"" to restrict our ability to use company time surfing the internet."
3283,3,8,61,72,1.1944444444444444,0.05813645141504052,549,"Truthfully, we don't accomplish much here. But you'll enjoy the camaraderie!"
3283,2,10,60,72,1.1944444444444444,0.054668187059789194,549,"Is it just me, or is the new office dress code is a bit too constrictive?"
3283,2,10,60,72,1.1944444444444444,0.054668187059789194,549,Let's not make this a call to arms.
3283,2,10,60,72,1.1944444444444444,0.054668187059789194,549,Here we don't think outside the box.
3283,3,8,61,72,1.1944444444444444,0.05813645141504052,549,We'd be crazy not to think outside conventional constraints
3283,3,8,61,72,1.1944444444444444,0.05813645141504052,549,They've asked us to keep thinking inside the box.
3283,4,6,62,72,1.1944444444444444,0.0614091466303077,549,"The latest trend, ""the unable to put food in mouth"" diet."
3283,0,14,58,72,1.1944444444444444,0.04696954399337483,549,The Houdini Foundation has special tests for job applicants. Shall I demonstrate?
3283,2,10,60,72,1.1944444444444444,0.054668187059789194,549,Can't wait for Trump to cut the regulations tying us all up.
3283,4,6,62,72,1.1944444444444444,0.0614091466303077,549,"Well, this sure has stopped the fraternization in the office."
3283,5,4,63,72,1.1944444444444444,0.06451604138965669,549,"Siri, call Dr. Miller please."
3283,2,10,60,72,1.1944444444444444,0.054668187059789194,549,"Sorry, but my hands are tied on this."
3283,3,8,61,72,1.1944444444444444,0.05813645141504052,549,Let me give this to you straight.
3283,2,10,60,72,1.1944444444444444,0.054668187059789194,549,It's so neither of us answers our cell phone.
3283,3,8,61,72,1.1944444444444444,0.05813645141504052,549,I'm not sure you're the right fit.
3283,1,12,59,72,1.1944444444444444,0.050964442209003306,549,"This is a free and open workplace, but we each have to work within certain constraints."
3283,2,10,60,72,1.1944444444444444,0.054668187059789194,549,"I'd like to hire you, but things are tight right now."
3283,5,4,63,72,1.1944444444444444,0.06451604138965669,549,He seemed like such a nice young man.
3283,2,10,60,72,1.1944444444444444,0.054668187059789194,549,The inmates have officially taken over this institution!
3283,1,12,59,72,1.1944444444444444,0.050964442209003306,549,I've worked with hands free systems at other companies before but this is just crazy.
3283,3,8,61,72,1.1944444444444444,0.05813645141504052,549,"I know it's been crazy around here lately, but if we just keep practicing restraint..."
3283,3,8,61,72,1.1944444444444444,0.05813645141504052,549,"Frankly, we're concerned that you'll fit in here."
3283,3,8,61,72,1.1944444444444444,0.05813645141504052,549,"Well, at least you aren't tongue-tied."
3283,4,6,62,72,1.1944444444444444,0.0614091466303077,549,We are strongly anti-touchpad!
3283,2,10,60,72,1.1944444444444444,0.054668187059789194,549,"And then I said, ""My hands are tied""."
3283,2,10,60,72,1.1944444444444444,0.054668187059789194,549,"Don't think of me as the therapist, I'm just another client."
3283,3,8,61,72,1.1944444444444444,0.05813645141504052,549,Let`s so lunch on Thursday if you`re not tied up.
3283,1,12,59,72,1.1944444444444444,0.050964442209003306,549,You signed the confidentiality agreement? Good.
3283,1,12,59,72,1.1944444444444444,0.050964442209003306,549,My sister did always say that it takes one to know one.
3283,3,8,61,72,1.1944444444444444,0.05813645141504052,549,"Yes, we will be ""literally"" tied up for weeks."
3283,3,8,61,72,1.1944444444444444,0.05813645141504052,549,"If you were a medication, what medication would you be?"
3283,1,12,59,72,1.1944444444444444,0.050964442209003306,549,Your background is a nice fit with our company.
3283,3,8,61,72,1.1944444444444444,0.05813645141504052,549,"First he brings this curvy jacket, so I yell ""Bring us straight jackets!"" and this is what we get?"
3283,2,10,60,72,1.1944444444444444,0.054668187059789194,549,Would you know if Siri works on a laptop?
3283,1,12,59,72,1.1944444444444444,0.050964442209003306,549,A willingness to bring your own straight jacket to work definitely gives you a leg up over the other applicants.
3283,4,6,62,72,1.1944444444444444,0.0614091466303077,549,"I see you've read the ""Mirroring"" chapter of my body language book. Well played."
3283,1,12,59,72,1.1944444444444444,0.050964442209003306,549,I'm afraid you would not meet our need for outreach.
3283,2,10,60,72,1.1944444444444444,0.054668187059789194,549,I just don't know if I really fit in around here.
3283,0,14,58,72,1.1944444444444444,0.04696954399337483,549,I hope I never have to go back to working with my hands.
3283,2,10,60,72,1.1944444444444444,0.054668187059789194,549,So you specialize in American Sign Language?
3283,0,14,58,72,1.1944444444444444,0.04696954399337483,549,This place can really make you crazy.
3283,2,10,60,72,1.1944444444444444,0.054668187059789194,549,... and that is how you use Power point
3283,1,12,59,72,1.1944444444444444,0.050964442209003306,549,I'm going to be strait with you: my hands are tied.
3283,3,8,61,72,1.1944444444444444,0.05813645141504052,549,And what makes you qualified for this job?
3283,2,10,60,72,1.1944444444444444,0.054668187059789194,549,"You can't always get what you want But, if you're tied sometimes, You get what you need."
3283,2,10,60,72,1.1944444444444444,0.054668187059789194,549,"Let's make it quick, we're on a tight schedule."
3283,1,12,59,72,1.1944444444444444,0.050964442209003306,549,"I, too, miss the red tape."
3283,4,6,62,72,1.1944444444444444,0.0614091466303077,549,Let me be straight with you.
3283,3,8,61,72,1.1944444444444444,0.05813645141504052,549,I got mine at Burlington.
3283,1,12,59,72,1.1944444444444444,0.050964442209003306,549,Are we off the record?
3283,2,10,60,72,1.1944444444444444,0.054668187059789194,549,Now we can think strait.
3283,3,8,61,72,1.1944444444444444,0.05813645141504052,549,"I know who you voted for, what else can you tell me about yourself?"
3283,2,10,60,72,1.1944444444444444,0.054668187059789194,549,Wow! This communication thing is hard!
3283,2,10,60,72,1.1944444444444444,0.054668187059789194,549,So why do you even have a computer?
3283,1,12,59,72,1.1944444444444444,0.050964442209003306,549,Stop saying 'Your hands are tied' !!
3283,4,6,62,72,1.1944444444444444,0.0614091466303077,549,"As of January 20th, all EPA employees will wear federally-mandated uniforms, woven from endangered grasses found under the Dakota Pipeline."
3283,2,10,60,72,1.1944444444444444,0.054668187059789194,549,This crackdown on social media time is a complete overkill.
3283,3,8,61,72,1.1944444444444444,0.05813645141504052,549,Just being crazy to work here is not enough. We'd really need you to step up
3283,2,10,60,72,1.1944444444444444,0.054668187059789194,549,At least our carpal tunnel nerves are in great shape.
3283,1,12,59,72,1.1944444444444444,0.050964442209003306,549,"Yes, dear, I empathize; breaking that glass ceiling and arriving intact were two different things."
3283,3,8,61,72,1.1944444444444444,0.05813645141504052,549,This protest isn't working - management likes us this way.
3283,2,10,60,72,1.1944444444444444,0.054668187059789194,549,Why did you come to me with your problem? Didn't my secretary tell you I'm tied up all week?
3283,0,14,58,72,1.1944444444444444,0.04696954399337483,549,You too?
3283,3,8,61,72,1.1944444444444444,0.05813645141504052,549,We'll call it the Trump Jacket
3283,2,10,60,72,1.1944444444444444,0.054668187059789194,549,Can't you see I'm tied up today?
3283,3,8,61,72,1.1944444444444444,0.05813645141504052,549,I understand we are pretty tied up both of us.
3283,1,12,59,72,1.1944444444444444,0.050964442209003306,549,This company could certainly use a few new hands.
3283,4,6,62,72,1.1944444444444444,0.0614091466303077,549,I hope we're in a cartoon contest or something. I can't understand any other reason for this Madness
3283,1,12,59,72,1.1944444444444444,0.050964442209003306,549,It's so difficult to get anything done; we're all so tied up.
3283,5,4,63,72,1.1944444444444444,0.06451604138965669,549,Our company respects freedom of speech and openness. Relax and feel free...
3283,3,8,61,72,1.1944444444444444,0.05813645141504052,549,"We could work together, if you weren't tied up."
3283,3,8,61,72,1.1944444444444444,0.05813645141504052,549,This is driving me insane
3283,2,10,60,72,1.1944444444444444,0.054668187059789194,549,People say I talk with my hands too much.
3283,1,12,59,72,1.1944444444444444,0.050964442209003306,549,This is HR's solution to carpal tunnel syndrome.
3283,1,12,59,72,1.1944444444444444,0.050964442209003306,549,I'm really thinking that you're a good fit for this company.
3283,3,8,61,72,1.1944444444444444,0.05813645141504052,549,I hate working for the Trumps!
3283,1,12,59,72,1.1944444444444444,0.050964442209003306,549,"Now that we're settled, where do you see yourself in five years?"
3283,2,10,60,72,1.1944444444444444,0.054668187059789194,549,"I went with the Gorilla wrap, I see you went with the generic brand."
3283,2,10,60,72,1.1944444444444444,0.054668187059789194,549,I'm afraid your typing skills do not meet the requirements for the position you applied for.
3283,3,8,61,72,1.1944444444444444,0.05813645141504052,549,When sign language gets a time out.
3283,1,12,59,72,1.1944444444444444,0.050964442209003306,549,You'd have to be crazy to work with our clients
3283,1,12,59,72,1.1944444444444444,0.050964442209003306,549,Corporate felt that our dress code was too lenient.
3283,2,10,60,72,1.1944444444444444,0.054668187059789194,549,"You're right. I've also been diagnosed with OCEC, Obsessive-Compulsive Email Checking."
3283,2,10,60,72,1.1944444444444444,0.054668187059789194,549,"Sorry to keep you waiting, but it's been one of those crazy days!"
3283,3,8,61,72,1.1944444444444444,0.05813645141504052,549,"So, you're on a diet, too?"
3283,5,4,63,72,1.1944444444444444,0.06451604138965669,549,"- ""I voted."" - ""Me too."""
3283,2,10,60,72,1.1944444444444444,0.054668187059789194,549,We do tend to seek out employees with a restrained attitude.
3283,3,8,61,72,1.1944444444444444,0.05813645141504052,549,Funny you should mention it....I'm pretty wound up myself today.
3283,2,10,60,72,1.1944444444444444,0.054668187059789194,549,Maybe if we both lean in at the same time?
3283,3,8,61,72,1.1944444444444444,0.05813645141504052,549,Feel free to take the chair with you.
3283,4,6,62,72,1.1944444444444444,0.0614091466303077,549,I am being straight ! Of course I like your jacket
3283,4,6,62,72,1.1944444444444444,0.0614091466303077,549,We must stop meeting like this.
3283,4,6,62,72,1.1944444444444444,0.0614091466303077,549,"Beyond inventing that ""You don't have to be crazy to work here, but it helps!"" slogan, our company has seriously underperformed."
3283,3,8,61,72,1.1944444444444444,0.05813645141504052,549,Our company prefers to call it a gay jacket.
3283,3,8,61,72,1.1944444444444444,0.05813645141504052,549,"I feel constrained too, but suck it in and get your job done!"
3283,2,10,60,72,1.1944444444444444,0.054668187059789194,549,"Thanks for visiting. I get very tied up at work, if you know what i mean."
3283,1,12,59,72,1.1944444444444444,0.050964442209003306,549,let's have some straight talk
3283,0,14,58,72,1.1944444444444444,0.04696954399337483,549,"I'm sorry, i wish i could help. But my hands are tied."
3283,4,6,62,72,1.1944444444444444,0.0614091466303077,549,"The pay sucks, but you'll have complete creative freedom"
3283,1,12,59,72,1.1944444444444444,0.050964442209003306,549,This really ties things up doesn't it.
3283,3,8,61,72,1.1944444444444444,0.05813645141504052,549,"Some people say ya gotta be crazy to work here, but I think YOU'LL fit right in."
3283,1,12,59,72,1.1944444444444444,0.050964442209003306,549,You look well qualified to me. When can you start?
3283,3,8,61,72,1.1944444444444444,0.05813645141504052,549,"At least 4 years, but it could be 8."
3283,3,8,61,72,1.1944444444444444,0.05813645141504052,549,Phone issue solved. Next order of business.
3283,3,8,61,72,1.1944444444444444,0.05813645141504052,549,That's fine. None of us here are that flexible.
3283,2,10,60,72,1.1944444444444444,0.054668187059789194,549,"Alexa, the password is Houdini."
3283,1,12,59,72,1.1944444444444444,0.050964442209003306,549,"So, why do you think you are qualified for this job?"
3283,1,12,59,72,1.1944444444444444,0.050964442209003306,549,This letter says I'd have to be crazy to hire you.
3283,3,8,61,72,1.1944444444444444,0.05813645141504052,549,"Everything all right, Tina? You seem wound a little tight."
3283,5,4,63,72,1.1944444444444444,0.06451604138965669,549,Running the asylum was fine till some joker replaced the light switches with The Clapper.
3283,3,8,61,72,1.1944444444444444,0.05813645141504052,549,He was serious when he said that we would be all tied up for the day.
3283,1,12,59,72,1.1944444444444444,0.050964442209003306,549,That wraps up our meeting.
3283,2,10,60,72,1.1944444444444444,0.054668187059789194,549,"Oh, you'd be amazed howmany of our former employees thought it was just an old saying."
3283,3,8,61,72,1.1944444444444444,0.05813645141504052,549,I want to be straight with you.
3283,3,8,61,72,1.1944444444444444,0.05813645141504052,549,Let's just agree that this is no time to play Twister.
3283,4,6,62,72,1.1944444444444444,0.0614091466303077,549,My great grandfather was Houdini too!
3283,5,4,63,72,1.1944444444444444,0.06451604138965669,549,"I'm not sure this was essential for the Siri beta testing, but whatever."
3283,4,6,62,72,1.1944444444444444,0.0614091466303077,549,I'm glad to see you took my invitation for some straight talk so seriously
3283,1,12,59,72,1.1944444444444444,0.050964442209003306,549,I'm here to pass along institutional knowledge.
3283,3,8,61,72,1.1944444444444444,0.05813645141504052,549,I was tied up in traffic. What's your excuse?
3283,2,10,60,72,1.1944444444444444,0.054668187059789194,549,"Wish we could finish this interview, but my hands are tied."
3283,3,8,61,72,1.1944444444444444,0.05813645141504052,549,I think you're just the candidate for the position we are looking for!
3283,1,12,59,72,1.1944444444444444,0.050964442209003306,549,"We're getting away from ""you scratch my back I'll scratch your's"" here."
3283,3,8,61,72,1.1944444444444444,0.05813645141504052,549,I only wish these came in more than one size!
3283,1,12,59,72,1.1944444444444444,0.050964442209003306,549,"It;s not what I expected either, when I agreed to a straight talk."
3283,2,10,60,72,1.1944444444444444,0.054668187059789194,549,"Tell me, what's your greatest weakness?"
3283,3,8,61,72,1.1944444444444444,0.05813645141504052,549,It's supposed to boost my productivity.
3283,3,8,61,72,1.1944444444444444,0.05813645141504052,549,He says I'm too restrained in meetings.
3283,2,10,60,72,1.1944444444444444,0.054668187059789194,549,Tell me again...you're unable to do your work for what reason?
3283,3,8,61,72,1.1944444444444444,0.05813645141504052,549,Glad to see you are as wrapped up in your life as we are in our work.
3283,2,10,60,72,1.1944444444444444,0.054668187059789194,549,I'm strapped for cash. What's your excuse?
3283,3,8,61,72,1.1944444444444444,0.05813645141504052,549,I'm sorry ma'm but there is not a lot we can do in this situation.
3283,2,10,60,72,1.1944444444444444,0.054668187059789194,549,The good news is this dress code will probably only be around for four years.
3283,2,10,60,72,1.1944444444444444,0.054668187059789194,549,"'Has it helped curb your social media addiction?"""
3283,1,12,59,72,1.1944444444444444,0.050964442209003306,549,I'm a great believer in showing empathy for my patients.
3283,1,12,59,72,1.1944444444444444,0.050964442209003306,549,Are you always this buttoned down?
3283,1,12,59,72,1.1944444444444444,0.050964442209003306,549,I can't do anything. My hands are tied.
3283,4,6,62,72,1.1944444444444444,0.0614091466303077,549,Okay. Escape room Friday isn't a thing.
3283,3,8,61,72,1.1944444444444444,0.05813645141504052,549,I don't get why they keep calling us crazy.
3283,2,10,60,72,1.1944444444444444,0.054668187059789194,549,It now appears I was optimistic when I said our hands were tied in this matter
3283,4,6,62,72,1.1944444444444444,0.0614091466303077,549,"I like dressing for success, too."
3283,4,6,62,72,1.1944444444444444,0.0614091466303077,549,Lemme see YOU Lean in!!
3283,3,8,61,72,1.1944444444444444,0.05813645141504052,549,It's some sort of Team Building thing. Corporate thought it would be cute to serve finger food for lunch and see what happens.
3444,2,10,61,73,1.1917808219178083,0.05397986492025978,549,I think we should make it an arm's length deal.
3444,1,12,60,73,1.1917808219178083,0.05033198101609271,549,The company has gone overboard trying to prevent sexual harrassment
3444,1,12,60,73,1.1917808219178083,0.05033198101609271,549,"Welcome to the newspaper, do you know morse code?"
3444,0,14,59,73,1.1917808219178083,0.04639817678744653,549,These empathy exercises are productivity killers.
3448,2,10,62,74,1.1891891891891893,0.05330844518372845,549,Your experience with red tape is very attractive.
3449,4,5,61,70,1.1857142857142857,0.06203203988422092,549,Sorry. My hands are also tied.
3449,1,11,58,70,1.1857142857142857,0.05104642933009962,549,What is the work-life balance like here?
3449,1,11,58,70,1.1857142857142857,0.05104642933009962,549,"You're a good fit, but my hands are tied."
3449,3,7,60,70,1.1857142857142857,0.05859944792614803,549,I just don't see where we have anything in common.
3449,4,5,61,70,1.1857142857142857,0.06203203988422092,549,"We're thrilled to have you join us. As you can see, the patients run the place, and, Heh Heh! Guess who is in charge!"
3449,3,7,60,70,1.1857142857142857,0.05859944792614803,549,So glad we could finally get this strait!
3449,2,9,59,70,1.1857142857142857,0.05495285818136392,549,Lets get straight to the design of the jacket.
3449,0,13,57,70,1.1857142857142857,0.046815160711083915,549,Corporate’s “no cell phones at meetings rule”
3449,3,7,60,70,1.1857142857142857,0.05859944792614803,549,Which campaign did you work for?
3449,1,11,58,70,1.1857142857142857,0.05104642933009962,549,"Well here, we believe in freeing the mind"
3449,3,7,60,70,1.1857142857142857,0.05859944792614803,549,"""You can tell me, remember, this is a ""safe space""."
3449,3,7,60,70,1.1857142857142857,0.05859944792614803,549,I hope you can appreciate the fact my hands are tied on this one.
3449,2,9,59,70,1.1857142857142857,0.05495285818136392,549,You're saying that productivity might be better than conformity?
3449,2,9,59,70,1.1857142857142857,0.05495285818136392,549,"Vintage Versace, right?"
3449,1,11,58,70,1.1857142857142857,0.05104642933009962,549,I see you're getting the wardrobe memos now.
3449,3,7,60,70,1.1857142857142857,0.05859944792614803,549,"It's a binding contract?"" ""Sorry, I wish I could help but my hands are tied."
3449,0,13,57,70,1.1857142857142857,0.046815160711083915,549,Our last hire wasn't wrapped too tight.
3449,1,11,58,70,1.1857142857142857,0.05104642933009962,549,As a Supervisor I am constrained in ways that you could never imagine.
3449,2,9,59,70,1.1857142857142857,0.05495285818136392,549,We're looking for someone who doesn't think outside the box.
3449,4,5,61,70,1.1857142857142857,0.06203203988422092,549,"Sure, top of your class, but without prior experience I can only hire you if you can escape yours first."
3449,1,11,58,70,1.1857142857142857,0.05104642933009962,549,SO-- HOW ELSE ARE YOU DEALING WITH YOUR ADDICTION?
3449,1,11,58,70,1.1857142857142857,0.05104642933009962,549,It isn't working. I still love you.
3449,1,11,58,70,1.1857142857142857,0.05104642933009962,549,Is your husband driving you crazy too?
3449,2,9,59,70,1.1857142857142857,0.05495285818136392,549,Mr. Houdini is stuck in traffic.
3449,2,9,59,70,1.1857142857142857,0.05495285818136392,549,You'll need to be able to toe type like crazy.
3449,1,11,58,70,1.1857142857142857,0.05104642933009962,549,It's called an arbitration clause.
3449,2,9,59,70,1.1857142857142857,0.05495285818136392,549,"When the timer starts, we'll each have 90 seconds to check messages and send the next tweet."
3449,6,1,63,70,1.1857142857142857,0.06838224420194218,549,"You were doing Mach 2 in a Mach-1 zone. (I know, I know!... this was last week's contest. It just now came to me!)"
3449,3,7,60,70,1.1857142857142857,0.05859944792614803,549,Maybe we shouldn't have sold all our stocks the day after he won.
3449,2,9,59,70,1.1857142857142857,0.05495285818136392,549,How many words-per-minute can you type with the tip of your nose?
3449,3,7,60,70,1.1857142857142857,0.05859944792614803,549,. . . and no notes will be taken by either of us . . .
3449,4,5,61,70,1.1857142857142857,0.06203203988422092,549,We try not give our writers false hope on the creative liberties they'll be allowed.
3449,2,9,59,70,1.1857142857142857,0.05495285818136392,549,"I could go over your résumé, but let's discuss my screen saver instead."
3449,3,7,60,70,1.1857142857142857,0.05859944792614803,549,"As members designated to be part of the White House staff, we are not allowed to stop/change/alter any twitters from the President Elect."
3449,2,9,59,70,1.1857142857142857,0.05495285818136392,549,"No, just the women. It’s to remind us never to expect to be President."
3449,0,13,57,70,1.1857142857142857,0.046815160711083915,549,"On the plus side, Friday is dress down day."
3449,3,7,60,70,1.1857142857142857,0.05859944792614803,549,The job will be awarded to the loudest screamer.
3449,2,9,59,70,1.1857142857142857,0.05495285818136392,549,"The uniform is a bit tight, but the office spaces are quite large."
3449,2,9,59,70,1.1857142857142857,0.05495285818136392,549,I think it's time to wrap this up since we're all tied up right now.
3449,1,11,58,70,1.1857142857142857,0.05104642933009962,549,"Actually, I'm not crazy about it either."
3449,2,9,59,70,1.1857142857142857,0.05495285818136392,549,We take our email security very seriously now President Trump is in charge.
3449,3,7,60,70,1.1857142857142857,0.05859944792614803,549,"I ordered Thai, nitwit!"
3449,1,11,58,70,1.1857142857142857,0.05104642933009962,549,Don't you just hate getting all wrapped up in petty politics?
3449,2,9,59,70,1.1857142857142857,0.05495285818136392,549,Let me stress -- you should feel free.
3449,2,9,59,70,1.1857142857142857,0.05495285818136392,549,It looks like you have the kind of management experience we need to help run this place.
3449,0,13,57,70,1.1857142857142857,0.046815160711083915,549,I think that wraps up everything for this interview.
3449,2,9,59,70,1.1857142857142857,0.05495285818136392,549,Let's meet later when we are not so tied up.
3449,2,9,59,70,1.1857142857142857,0.05495285818136392,549,"Perhaps I didn't need to add ""dire."""
3449,4,5,61,70,1.1857142857142857,0.06203203988422092,549,The admissions office at the Houdini Illusionist College offers part time job options for applicants that do not make it past the the initial entrance exam.
3449,4,5,61,70,1.1857142857142857,0.06203203988422092,549,Okay we took over. Where's the transition plan?
3449,2,9,59,70,1.1857142857142857,0.05495285818136392,549,"True, going to the restroom can be a challenge, but you will love our hands off approach........................."
3449,4,5,61,70,1.1857142857142857,0.06203203988422092,549,"Yes, we're now running the place."
3449,1,11,58,70,1.1857142857142857,0.05104642933009962,549,It takes one to know one.
3449,2,9,59,70,1.1857142857142857,0.05495285818136392,549,"Life is constricting doctor, don't you agree?"
3449,4,5,61,70,1.1857142857142857,0.06203203988422092,549,"I understand you feel strapped, but my hands are tied. I can't give you a raise."
3449,1,11,58,70,1.1857142857142857,0.05104642933009962,549,This new dress code is crazy!
3449,3,7,60,70,1.1857142857142857,0.05859944792614803,549,I'm glad to see you're embracing the new dress code.
3449,2,9,59,70,1.1857142857142857,0.05495285818136392,549,"Most tweets I can ignore, but sometimes I do have to stick my nose in."
3449,5,3,62,70,1.1857142857142857,0.06528439819088337,549,"So, where do you see Elvis in 5 years?"
3449,2,9,59,70,1.1857142857142857,0.05495285818136392,549,The company padded wagon is just one of the many perks.
3449,4,5,61,70,1.1857142857142857,0.06203203988422092,549,You'll have to sign this release form before we can proceed with your application.
3449,3,7,60,70,1.1857142857142857,0.05859944792614803,549,I'm showing solidarity with the criminally insane. What's your story?
3449,3,7,60,70,1.1857142857142857,0.05859944792614803,549,I'm not budging on the salary.
3449,1,11,58,70,1.1857142857142857,0.05104642933009962,549,Let's dispense with the formality of shaking hands.
3449,1,11,58,70,1.1857142857142857,0.05104642933009962,549,Four years? Straightjackets are the only way to survive.
3449,1,11,58,70,1.1857142857142857,0.05104642933009962,549,You have to suffer in the name of fashion.
3449,4,5,61,70,1.1857142857142857,0.06203203988422092,549,Didn't he say he would be phenomenal to the women?
3449,2,9,59,70,1.1857142857142857,0.05495285818136392,549,... now let's talk about that 'equal pay' email you circulated.
3449,2,9,59,70,1.1857142857142857,0.05495285818136392,549,"It's an immersive, self-help exercise. And it doesn't work."
3449,3,7,60,70,1.1857142857142857,0.05859944792614803,549,"Sorry to keep you waiting, I got tied up."
3449,2,9,59,70,1.1857142857142857,0.05495285818136392,549,It seemed like the right mental wellness benefit for these times.
3449,2,9,59,70,1.1857142857142857,0.05495285818136392,549,It looks lovely on you but your straps are sticking out.
3449,2,9,59,70,1.1857142857142857,0.05495285818136392,549,Jeanine and Debra get ready for the Trump presidency.
3449,1,11,58,70,1.1857142857142857,0.05104642933009962,549,"So, why do you want this job?"
3449,1,11,58,70,1.1857142857142857,0.05104642933009962,549,"'Unchained Melody,' mine too."
3449,2,9,59,70,1.1857142857142857,0.05495285818136392,549,We're doing 'Our Hands Are Tied' Fridays until they do something about the Electoral College.
3449,3,7,60,70,1.1857142857142857,0.05859944792614803,549,Have you hallucinated in a team?
3449,2,9,59,70,1.1857142857142857,0.05495285818136392,549,These job interviews are insane!
3449,4,5,61,70,1.1857142857142857,0.06203203988422092,549,How does that make you feel?
3449,2,9,59,70,1.1857142857142857,0.05495285818136392,549,Sir? Sally and I are on speaker and we're ready to hear your weekly thought huddle.
3449,1,11,58,70,1.1857142857142857,0.05104642933009962,549,"No, seriously, I really can feel your pain"
3449,2,9,59,70,1.1857142857142857,0.05495285818136392,549,Our company culture is pretty hands off.
3449,1,11,58,70,1.1857142857142857,0.05104642933009962,549,"There's not really much autonomy at this company, is there?"
3449,1,11,58,70,1.1857142857142857,0.05104642933009962,549,"Marsha, please come in here and close my tabs."
3449,3,7,60,70,1.1857142857142857,0.05859944792614803,549,That's knot what I meant.
3449,2,9,59,70,1.1857142857142857,0.05495285818136392,549,"Don't be so surprised, this was bound to happen."
3449,3,7,60,70,1.1857142857142857,0.05859944792614803,549,Don't worry. You'll get used to the new dress code.
3449,1,11,58,70,1.1857142857142857,0.05104642933009962,549,Understand that our hands are tied. But you can try eye contact.
3449,2,9,59,70,1.1857142857142857,0.05495285818136392,549,"No, we are not just as crazy as the patients. We just have more empathy."
3449,2,9,59,70,1.1857142857142857,0.05495285818136392,549,Now they have taken this hands-off approach too far.
3449,1,11,58,70,1.1857142857142857,0.05104642933009962,549,It just seems like the company's new dress code is a little restrictive. I've missed four calls already.
3449,2,9,59,70,1.1857142857142857,0.05495285818136392,549,I could kick myself for letting the sales-lady talk me into it.
3449,1,11,58,70,1.1857142857142857,0.05104642933009962,549,'I guess we're both a little too tied up in our work'
3449,3,7,60,70,1.1857142857142857,0.05859944792614803,549,"Rock, Paper, Sccisors...Shoot!"
3449,2,9,59,70,1.1857142857142857,0.05495285818136392,549,Tell me about a time when you dealt with failure.
3449,2,9,59,70,1.1857142857142857,0.05495285818136392,549,Make sure the new conference room is padded with no windows
3449,3,7,60,70,1.1857142857142857,0.05859944792614803,549,"Well then, let's jump right in. Sell me that pen."
3449,1,11,58,70,1.1857142857142857,0.05104642933009962,549,I feel as though the new employee safety measures are getting in the way of my productivity
3449,1,11,58,70,1.1857142857142857,0.05104642933009962,549,"So you're all tied up! Well, so am I."
3449,3,7,60,70,1.1857142857142857,0.05859944792614803,549,Thank you for coming in. Did you notice  our re-enforced Glass Ceiling?
3449,3,7,60,70,1.1857142857142857,0.05859944792614803,549,We find ourselves in an unusual situation.
3449,2,9,59,70,1.1857142857142857,0.05495285818136392,549,This meeting isn't going anywhere.
3449,3,7,60,70,1.1857142857142857,0.05859944792614803,549,I find your tone rather restrained.
3449,4,5,61,70,1.1857142857142857,0.06203203988422092,549,Have you ever thought of becoming a Democrat?
3449,1,11,58,70,1.1857142857142857,0.05104642933009962,549,Ready......set......GO!
3449,1,11,58,70,1.1857142857142857,0.05104642933009962,549,You need to unlock your iPhone first...
3449,2,9,59,70,1.1857142857142857,0.05495285818136392,549,Bind leading the bind.
3449,2,9,59,70,1.1857142857142857,0.05495285818136392,549,"I appreciate your concerns and I will bring them up our next management meeting. However, until the Companies ""Dress Code"" is formally amended I am afraid our hands are tied."
3449,2,9,59,70,1.1857142857142857,0.05495285818136392,549,I'm glad we're straight with one another.
3449,2,9,59,70,1.1857142857142857,0.05495285818136392,549,"Look, I wish I could give you a raise. But I'm all tied up here."
3449,3,7,60,70,1.1857142857142857,0.05859944792614803,549,It really helps relax me.
3449,1,11,58,70,1.1857142857142857,0.05104642933009962,549,Tell the boss I'm tied up.
3449,4,5,61,70,1.1857142857142857,0.06203203988422092,549,This is the independent living unit.
3449,1,11,58,70,1.1857142857142857,0.05104642933009962,549,"You know, tenure's a funny thing..."
3449,1,11,58,70,1.1857142857142857,0.05104642933009962,549,We all have a past Miss Prentice.
3449,3,7,60,70,1.1857142857142857,0.05859944792614803,549,I see we've both been quite tied up lately!
3449,1,11,58,70,1.1857142857142857,0.05104642933009962,549,I can't understand why the boss thinks women of our generation are all wrapped up in ourselves.
3449,2,9,59,70,1.1857142857142857,0.05495285818136392,549,"I would like to honor your request but really, my hands are tied."
3449,2,9,59,70,1.1857142857142857,0.05495285818136392,549,Perhaps we shouldn't have agreed to a non-compete clause.
3449,1,11,58,70,1.1857142857142857,0.05104642933009962,549,I need you to be more expressive.
3449,3,7,60,70,1.1857142857142857,0.05859944792614803,549,I much prefer Take Your Kids to Work day then to Houdini day.
3449,2,9,59,70,1.1857142857142857,0.05495285818136392,549,Company policy. Getting tough on gratuitous hugs
3449,4,5,61,70,1.1857142857142857,0.06203203988422092,549,"I understand that you want to exercise your right to bear arms, but at this point my hands are tied."
3449,2,9,59,70,1.1857142857142857,0.05495285818136392,549,Yes . . Versace's office attire collection is showing a slimmer fit this season
3449,2,9,59,70,1.1857142857142857,0.05495285818136392,549,It's time to have some straight talk.
3449,0,13,57,70,1.1857142857142857,0.046815160711083915,549,We work crazy hours and are nuts about our products. When can you start?
3449,2,9,59,70,1.1857142857142857,0.05495285818136392,549,"You look the part, but your resume falls short."
3449,3,7,60,70,1.1857142857142857,0.05859944792614803,549,I c see its been a difficult week for the both of us and sorry but my hands are tied on this subject
3449,3,7,60,70,1.1857142857142857,0.05859944792614803,549,My hands are tied
3449,2,9,59,70,1.1857142857142857,0.05495285818136392,549,The management is very serious about maintaining a safe space.
3449,2,9,59,70,1.1857142857142857,0.05495285818136392,549,"There are some constraints but this is a creative environment, bathroom breaks can be a bit awkward."
3449,1,11,58,70,1.1857142857142857,0.05104642933009962,549,"Now, let's talk politics"
3449,2,9,59,70,1.1857142857142857,0.05495285818136392,549,Funny how everyone thinks we voted for Trump.
3449,2,9,59,70,1.1857142857142857,0.05495285818136392,549,Four years.
3449,3,7,60,70,1.1857142857142857,0.05859944792614803,549,"Stay with me on this a while. As physicians, we must first do no harm."
3449,1,11,58,70,1.1857142857142857,0.05104642933009962,549,"I agree you deserve a raise, but our hands are tied here."
3449,4,5,61,70,1.1857142857142857,0.06203203988422092,549,"I hit the glass ceiling here, too."
3449,2,9,59,70,1.1857142857142857,0.05495285818136392,549,My last therapist only charged an arm.
3449,0,13,57,70,1.1857142857142857,0.046815160711083915,549,I'm not crazy about these new uniforms.
3449,1,11,58,70,1.1857142857142857,0.05104642933009962,549,Shall we wrap up this meeting now?
3449,1,11,58,70,1.1857142857142857,0.05104642933009962,549,"Yeah, they're trying to suppress MY reaction to his election, too..."
3449,2,9,59,70,1.1857142857142857,0.05495285818136392,549,"I wish I could help you with that, but I'm all tied up, too."
3449,4,5,61,70,1.1857142857142857,0.06203203988422092,549,This job is driving me crazy...Me too
3449,1,11,58,70,1.1857142857142857,0.05104642933009962,549,I feel as though you could use a hug.
3449,1,11,58,70,1.1857142857142857,0.05104642933009962,549,"As you can see, management's new dress code has tied all of our hands."
3449,3,7,60,70,1.1857142857142857,0.05859944792614803,549,They got me on Cyber Monday.
3449,3,7,60,70,1.1857142857142857,0.05859944792614803,549,They used to call it the glass ceiling.
3449,2,9,59,70,1.1857142857142857,0.05495285818136392,549,Maybe Siri doesn't care.
3449,2,9,59,70,1.1857142857142857,0.05495285818136392,549,"Sure, the patients took over, but we must carry on."
3449,1,11,58,70,1.1857142857142857,0.05104642933009962,549,"No, you don't have to be mad to work here, but it helps!"
3449,2,9,59,70,1.1857142857142857,0.05495285818136392,549,What kind of Voice Recognition Software do you use?
3449,1,11,58,70,1.1857142857142857,0.05104642933009962,549,"I know, Marie, but our benefits package can't be matched anywhere."
3449,2,9,59,70,1.1857142857142857,0.05495285818136392,549,"Why yes, I'd love to hear your opposing political views."
3449,2,9,59,70,1.1857142857142857,0.05495285818136392,549,We both should have been nicer to the magician in Accounting.
3449,2,9,59,70,1.1857142857142857,0.05495285818136392,549,"I know, sometimes it seems the hospital administration is running the asylum."
3449,2,9,59,70,1.1857142857142857,0.05495285818136392,549,This isn't what I had in mind when they told us that we would find our new boss's management style to be disarmingly simple.
3449,1,11,58,70,1.1857142857142857,0.05104642933009962,549,Let's get something straight between us.
3449,2,9,59,70,1.1857142857142857,0.05495285818136392,549,"It's the company's new "" hands off ""policy."
3449,1,11,58,70,1.1857142857142857,0.05104642933009962,549,"Yeah, I also think our asylum's new ""Dress Like The Patients"" policy is a bit extreme, but my hands are tied here."
3449,3,7,60,70,1.1857142857142857,0.05859944792614803,549,"Hi, welcome to All Holds Barred, Inc.!"
3449,3,7,60,70,1.1857142857142857,0.05859944792614803,549,According to this genealogy report we actually aren't descendants of Houdini.
3449,1,11,58,70,1.1857142857142857,0.05104642933009962,549,I appreciate your being straight with me.
3449,0,13,57,70,1.1857142857142857,0.046815160711083915,549,So I'm looking for an employee willing to get their hands dirty.
3449,1,11,58,70,1.1857142857142857,0.05104642933009962,549,You're hired. You have an excellent resume and an admirable fashion sense.
3613,1,11,59,71,1.1830985915492958,0.050390264281685394,549,"I like your style, the job is yours if you think you can handle it"
3613,3,7,61,71,1.1830985915492958,0.05782739582776625,549,You could say that we are a firm that has very tight boundaries on what ideas are allowed.
3613,3,7,61,71,1.1830985915492958,0.05782739582776625,549,We're bound for glory.
3613,2,9,60,71,1.1830985915492958,0.054236456570277786,549,"Exactly what do you mean by, 'It takes one to know one'?"
3613,2,9,60,71,1.1830985915492958,0.054236456570277786,549,This place drives us all crazy after awhile.
3613,2,9,60,71,1.1830985915492958,0.054236456570277786,549,Hows your I JACKET working for you?
3613,3,7,61,71,1.1830985915492958,0.05782739582776625,549,Are all final round interviews conducted like this?
3613,4,5,62,71,1.1830985915492958,0.061208023944109534,549,I want to be completely straight with you about this job.
3613,3,7,61,71,1.1830985915492958,0.05782739582776625,549,"Apparently it's for our own protection, so we stop trying to break through glass."
3622,1,10,58,69,1.173913043478261,0.050388608077731906,549,"Looks like we both prefer the ""hands-off"" approach..."
3622,3,6,60,69,1.173913043478261,0.0582368160446839,549,"I'm sorry, I can't help you. My hands are tied."
3622,1,10,58,69,1.173913043478261,0.050388608077731906,549,"Welcome to Psychokinesis, Inc."
3622,3,6,60,69,1.173913043478261,0.0582368160446839,549,We think you two would fit in here perfectly.
3622,1,10,58,69,1.173913043478261,0.050388608077731906,549,"No, Sarah, actually I DON'T think the new dress code is affecting productivity."
3622,2,8,59,69,1.173913043478261,0.054454286181317355,549,Let's get straight to the point
3622,3,6,60,69,1.173913043478261,0.0582368160446839,549,Someone must think we're both strait.
3622,1,10,58,69,1.173913043478261,0.050388608077731906,549,Well this is certainly the most interesting performance review I've been a part of.
3622,4,4,61,69,1.173913043478261,0.061788220580689106,549,now that we've established the boundaries tell me: what do you think of my performance as your boss and manager.
3622,3,6,60,69,1.173913043478261,0.0582368160446839,549,why were we so sure Trump didn't have a chance?
3622,2,8,59,69,1.173913043478261,0.054454286181317355,549,You are the fifth person I have interviewed - and I have a hunch you will fit in perfectly here.
3622,2,8,59,69,1.173913043478261,0.054454286181317355,549,Think of it as a mandate reminder to fit department policies within the new administration's 140 character limit.
3622,3,6,60,69,1.173913043478261,0.0582368160446839,549,"If they had asked for feedback BEFORE they rolled out the new email-reduction initiative, of course I would have raised my hand."
3622,2,8,59,69,1.173913043478261,0.054454286181317355,549,As you see my hands are tied...and yours too for that matter.
3622,3,6,60,69,1.173913043478261,0.0582368160446839,549,"So, what can I do for you?"
3622,0,12,57,69,1.173913043478261,0.045964707814863004,549,Just be straight with me.
3622,2,8,59,69,1.173913043478261,0.054454286181317355,549,This way we avoid all legal liability questions. I clearly have no physical contact with you.
3622,2,8,59,69,1.173913043478261,0.054454286181317355,549,If you think this is bad wait until your 401K vests.
3622,4,4,61,69,1.173913043478261,0.061788220580689106,549,We're going to make America great again!
3622,1,10,58,69,1.173913043478261,0.050388608077731906,549,This job can be stressful at times! Are you capable of handling stress well?
3622,2,8,59,69,1.173913043478261,0.054454286181317355,549,I feel this eliminates unnecessary gestures.
3622,3,6,60,69,1.173913043478261,0.0582368160446839,549,"Knot to be outdone, Clarissa smugly taps her feet!"
3622,1,10,58,69,1.173913043478261,0.050388608077731906,549,"Relax. In here, we're all equal."
3622,1,10,58,69,1.173913043478261,0.050388608077731906,549,Why is it you want to work here?
3622,1,10,58,69,1.173913043478261,0.050388608077731906,549,"""Have your nutso doctor call my nutso doctor."
3622,1,10,58,69,1.173913043478261,0.050388608077731906,549,i think you can understand that my hands are tied.
3622,1,10,58,69,1.173913043478261,0.050388608077731906,549,We're looking for self tyers here.
3622,0,12,57,69,1.173913043478261,0.045964707814863004,549,There must be an app for that.
3622,1,10,58,69,1.173913043478261,0.050388608077731906,549,We'll talk later. I've got an asylum to run.
3622,2,8,59,69,1.173913043478261,0.054454286181317355,549,I'm glad to see you're a fan of our fashion line
3622,1,10,58,69,1.173913043478261,0.050388608077731906,549,"So, do you have any previous experience in Customer Service?"
3622,3,6,60,69,1.173913043478261,0.0582368160446839,549,I take it you are enquiring about the press secretary job?
3622,0,12,57,69,1.173913043478261,0.045964707814863004,549,When can you start?
3622,3,6,60,69,1.173913043478261,0.0582368160446839,549,Believe me I know where you are going from.
3622,1,10,58,69,1.173913043478261,0.050388608077731906,549,"Now, we can proceed with our study of expressing ourselves without hand gestures."
3622,1,10,58,69,1.173913043478261,0.050388608077731906,549,Welcome to the Harry Houdini School of Escape Magic.
3622,2,8,59,69,1.173913043478261,0.054454286181317355,549,Nice to have another lefty starting with the company!
3622,2,8,59,69,1.173913043478261,0.054454286181317355,549,This is my system for ending internet addiction. You'll find it very effective.
3622,2,8,59,69,1.173913043478261,0.054454286181317355,549,"now, let's get this straight"
3622,1,10,58,69,1.173913043478261,0.050388608077731906,549,We don't mean to offend. But the last person we interviewed was a biter.
3622,3,6,60,69,1.173913043478261,0.0582368160446839,549,This seems unnecessary.
3622,1,10,58,69,1.173913043478261,0.050388608077731906,549,Welcome to the Houdini Preservation Foundation.
3622,3,6,60,69,1.173913043478261,0.0582368160446839,549,"Doctor:"" It takes one to know one"""
3622,2,8,59,69,1.173913043478261,0.054454286181317355,549,Well one of us HAS to take notes!
3622,2,8,59,69,1.173913043478261,0.054454286181317355,549,"As you might have inferred, we value structure and guidelines."
3622,3,6,60,69,1.173913043478261,0.0582368160446839,549,Well you certainly seem perfect to take over the asylum!
3622,2,8,59,69,1.173913043478261,0.054454286181317355,549,I've heard next season is stunning.
3622,3,6,60,69,1.173913043478261,0.0582368160446839,549,"Oh, I went there myself."
3622,1,10,58,69,1.173913043478261,0.050388608077731906,549,You've come to wrong person.
3622,4,4,61,69,1.173913043478261,0.061788220580689106,549,"Now that we're both in safe places, let's talk about how we survive the next four years."
3622,3,6,60,69,1.173913043478261,0.0582368160446839,549,...but it helps
3622,2,8,59,69,1.173913043478261,0.054454286181317355,549,"I'm sorry, but you're no Houdini."
3622,1,10,58,69,1.173913043478261,0.050388608077731906,549,I think I prefer the padded room to this.
3622,1,10,58,69,1.173913043478261,0.050388608077731906,549,"Love your jacket, how do you keep it straight and untangled?"
3622,2,8,59,69,1.173913043478261,0.054454286181317355,549,Your secretary told me you were all tied up.
3622,0,12,57,69,1.173913043478261,0.045964707814863004,549,I thought this was a touchy-feely job.
3622,2,8,59,69,1.173913043478261,0.054454286181317355,549,What do you think about this new therapy for Internet OCD?
3622,2,8,59,69,1.173913043478261,0.054454286181317355,549,...where do you see yourself in 5 years?
3622,1,10,58,69,1.173913043478261,0.050388608077731906,549,"So, tell me about yourself."
3622,2,8,59,69,1.173913043478261,0.054454286181317355,549,I think we're gonna have to rethink the setup in the ladies room.
3622,1,10,58,69,1.173913043478261,0.050388608077731906,549,I'm not big on texting.
3622,1,10,58,69,1.173913043478261,0.050388608077731906,549,We're looking for a high-energy person who plays it close to her chest.
3622,2,8,59,69,1.173913043478261,0.054454286181317355,549,Apparently we have to wear these until we fully recognize the LBGTQ community.
3622,2,8,59,69,1.173913043478261,0.054454286181317355,549,The Peter Principle.
3622,1,10,58,69,1.173913043478261,0.050388608077731906,549,Dressing like me will NOT get you this job!
3622,3,6,60,69,1.173913043478261,0.0582368160446839,549,"Now if you can get us out of this knot, I'll give you the job."
3622,1,10,58,69,1.173913043478261,0.050388608077731906,549,Welcome to our Women in Scientology session.
3622,1,10,58,69,1.173913043478261,0.050388608077731906,549,I can see that you empathize with the fact that my hands are tied.
3622,1,10,58,69,1.173913043478261,0.050388608077731906,549,It seems that one of our policies has the staff up in arms.
3622,3,6,60,69,1.173913043478261,0.0582368160446839,549,"I'd like to help you with your predicament, but my hands are tied."
3622,3,6,60,69,1.173913043478261,0.0582368160446839,549,"Based on the bar set by our president elect, you are now qualified to run for president in 2020."
3622,2,8,59,69,1.173913043478261,0.054454286181317355,549,Cheer up! You've got the job!
3622,3,6,60,69,1.173913043478261,0.0582368160446839,549,"I like your shoes, where di you buy them?"
3622,4,4,61,69,1.173913043478261,0.061788220580689106,549,On this deal I'll scratch your back if you scratch mine.
3622,1,10,58,69,1.173913043478261,0.050388608077731906,549,"Don't worry, a restraining order is just a piece of paper."
3622,3,6,60,69,1.173913043478261,0.0582368160446839,549,We all have knotty problems. Yours are just a little worse than most.
3622,1,10,58,69,1.173913043478261,0.050388608077731906,549,"Yes, absolutely: work within the system to bring about change."
3622,3,6,60,69,1.173913043478261,0.0582368160446839,549,Its so we can both feel safe.
3622,1,10,58,69,1.173913043478261,0.050388608077731906,549,It's always a good idea to show restraint in a negative employee evaluation!
3622,2,8,59,69,1.173913043478261,0.054454286181317355,549,...And now let's start the practical part of this interview
3622,3,6,60,69,1.173913043478261,0.0582368160446839,549,Please take a moment to relax and then we'll start the Job Interview.
3622,1,10,58,69,1.173913043478261,0.050388608077731906,549,"When rat-raced, better strait-laced than straight-faced."
3622,2,8,59,69,1.173913043478261,0.054454286181317355,549,"Yeah, I have trouble staying off Pinterest as well."
3622,1,10,58,69,1.173913043478261,0.050388608077731906,549,This company believes in strait talk.
3622,1,10,58,69,1.173913043478261,0.050388608077731906,549,Computers will free us.
3622,1,10,58,69,1.173913043478261,0.050388608077731906,549,I like you because we have so much in common.
3622,4,4,61,69,1.173913043478261,0.061788220580689106,549,"Coincidentally, I see we're both experienced in airline baggage complaints."
3622,1,10,58,69,1.173913043478261,0.050388608077731906,549,Glad you find the work liberating.
3622,3,6,60,69,1.173913043478261,0.0582368160446839,549,"But, will it appeal to violently insane millennials?"
3622,1,10,58,69,1.173913043478261,0.050388608077731906,549,Touch typing didn't work for me either.
3622,1,10,58,69,1.173913043478261,0.050388608077731906,549,How would you suggest we handle this matter?
3622,2,8,59,69,1.173913043478261,0.054454286181317355,549,"Darcy, I know you’re upset with our decision, but my hands are tied."
3622,1,10,58,69,1.173913043478261,0.050388608077731906,549,"When we're free here, let's have lunch."
3622,1,10,58,69,1.173913043478261,0.050388608077731906,549,I think we both are ready now to discuss that problem.
3622,2,8,59,69,1.173913043478261,0.054454286181317355,549,"Your resume indicates you have great experience. We hire only the best team members here at Travel Escapes. Let's see how great you really are, on the count of 3."
3622,2,8,59,69,1.173913043478261,0.054454286181317355,549,In this office you are encouraged to be open and critical.
3622,0,12,57,69,1.173913043478261,0.045964707814863004,549,"Not only have I walked in your shoes, I've flailed in your jacket!"
3622,2,8,59,69,1.173913043478261,0.054454286181317355,549,Sorry! My hands are tied when it comes to raises.
3622,2,8,59,69,1.173913043478261,0.054454286181317355,549,I'm straight. Are you straight?
3622,1,10,58,69,1.173913043478261,0.050388608077731906,549,"What makes you feel you are qualified to work at Fetishes ""R"" Us?"
3622,2,8,59,69,1.173913043478261,0.054454286181317355,549,I'm all tied up this week.
3622,4,4,61,69,1.173913043478261,0.061788220580689106,549,"You're right, we shouldn't have let the patient jacket us first."
3622,1,10,58,69,1.173913043478261,0.050388608077731906,549,Give it to me straight. Don't sugarcoat it.
3622,2,8,59,69,1.173913043478261,0.054454286181317355,549,"As you can plainly see, our hands are tied."
3622,0,12,57,69,1.173913043478261,0.045964707814863004,549,At my last job we weren't allowed to talk -- I think I like this better.
3622,3,6,60,69,1.173913043478261,0.0582368160446839,549,These new EPA uniforms aren't all that bad.
3622,1,10,58,69,1.173913043478261,0.050388608077731906,549,I don't understand why you feel so limited.
3622,2,8,59,69,1.173913043478261,0.054454286181317355,549,"You know, I see a lot of ourselves in you."
3622,1,10,58,69,1.173913043478261,0.050388608077731906,549,I'm just going to tell it to you straight.
3622,3,6,60,69,1.173913043478261,0.0582368160446839,549,"Look, Mom, no hands"
3622,1,10,58,69,1.173913043478261,0.050388608077731906,549,I'm afraid you're not the right candidate for a hands-on job.
3622,3,6,60,69,1.173913043478261,0.0582368160446839,549,Alice and Fred conduct their first text-free meeting.
3622,2,8,59,69,1.173913043478261,0.054454286181317355,549,"Well, to get ahead in this business as a woman you have to be a little crazy."
3622,1,10,58,69,1.173913043478261,0.050388608077731906,549,"I'd like to help you, Emily. But honestly my hands are tied."
3622,0,12,57,69,1.173913043478261,0.045964707814863004,549,You say your hands are tied. That seems hardly like an excuse.
3622,1,10,58,69,1.173913043478261,0.050388608077731906,549,How's the work environment?
3622,2,8,59,69,1.173913043478261,0.054454286181317355,549,Your productivity has decreased since the companies new Health and Safety initiative. We'd like to know what's holding you back?
3622,0,12,57,69,1.173913043478261,0.045964707814863004,549,We need an idea that isn't crazy.
3622,2,8,59,69,1.173913043478261,0.054454286181317355,549,Your resume states that your skill sets are inspired by Houdini.
3622,0,12,57,69,1.173913043478261,0.045964707814863004,549,"Ok, so let me get this straight..."
3622,2,8,59,69,1.173913043478261,0.054454286181317355,549,"Mine's a 14-66, what size is yours?"
3622,3,6,60,69,1.173913043478261,0.0582368160446839,549,So the sign-language protesters are claiming non-compliance with Americans with Disabilities Act?
3622,4,4,61,69,1.173913043478261,0.061788220580689106,549,"We're here to suss out whether your ""fit to be tied"" is a fit to be tied that's right for the company."
3622,1,10,58,69,1.173913043478261,0.050388608077731906,549,Mine's a fashion statement. What's your excuse?
3622,0,12,57,69,1.173913043478261,0.045964707814863004,549,I can press alt and ctrl keys with my nose and tongue
3622,0,12,57,69,1.173913043478261,0.045964707814863004,549,"I'd love to give you a straight answer, but I'm a little tied up"
3622,3,6,60,69,1.173913043478261,0.0582368160446839,549,There's not much we can do about it: that's how the people voted.
3622,2,8,59,69,1.173913043478261,0.054454286181317355,549,I think I preferred standing desks.
3622,5,2,62,69,1.173913043478261,0.06514630965782663,549,"What's next, our tongues?"
3622,1,10,58,69,1.173913043478261,0.050388608077731906,549,"Well, it looks like we both love the same trendy fashion designer."
3622,1,10,58,69,1.173913043478261,0.050388608077731906,549,Don't you love casual Fridays?
3622,1,10,58,69,1.173913043478261,0.050388608077731906,549,Can we be strait with each other?
3622,1,10,58,69,1.173913043478261,0.050388608077731906,549,"Welcome to Voice to Text, Inc. Our corporate motto is ""necessity is the mother of invention."""
3622,2,8,59,69,1.173913043478261,0.054454286181317355,549,"""lets do lunch soon, but today i'm all tied up"
3622,2,8,59,69,1.173913043478261,0.054454286181317355,549,We don't tolerate any hanky panky in the work place
3622,2,8,59,69,1.173913043478261,0.054454286181317355,549,"I am forbidden by law to ask the questions I want to, and you are forbidden by law to give the answers you want to."
3622,0,12,57,69,1.173913043478261,0.045964707814863004,549,Just a cautionary move by our HR department.
3622,2,8,59,69,1.173913043478261,0.054454286181317355,549,your position will be a hands on job.
3622,1,10,58,69,1.173913043478261,0.050388608077731906,549,"By doing this, no tweeting, facebook or other social media will interfere with your interview."
3622,2,8,59,69,1.173913043478261,0.054454286181317355,549,"I know that empathy is an extremely important trait for all staff members at a mental hospital, but I think this new 'share the experience' policy is extreme."
3622,2,8,59,69,1.173913043478261,0.054454286181317355,549,Let's try going back to talking therapy.
3622,1,10,58,69,1.173913043478261,0.050388608077731906,549,You come highly recommended...
3622,2,8,59,69,1.173913043478261,0.054454286181317355,549,"'Well, it is the latest in hands-free technology"""
3622,1,10,58,69,1.173913043478261,0.050388608077731906,549,The office straight jacket policy may be unpopular but inappropriate tweeting has been cut in half.
3622,3,6,60,69,1.173913043478261,0.0582368160446839,549,So it says here that you've been at Goldman Sachs for the last 8 years.
3622,3,6,60,69,1.173913043478261,0.0582368160446839,549,"Is this where, ""crazy is as crazy does"", comes from?"
3622,2,8,59,69,1.173913043478261,0.054454286181317355,549,Can we tell them we're all tied up?
3622,1,10,58,69,1.173913043478261,0.050388608077731906,549,"I got mine on sale at Paranoids-R-Us,you ?"
3622,2,8,59,69,1.173913043478261,0.054454286181317355,549,"After four hellish days coping with the stress of corporate life, casual Fridays ratchet things down a notch."
3622,1,10,58,69,1.173913043478261,0.050388608077731906,549,We're looking for someone who can think outside the box.
3622,1,10,58,69,1.173913043478261,0.050388608077731906,549,Our department tests new virtual assistant software.
3622,3,6,60,69,1.173913043478261,0.0582368160446839,549,"That about wraps things up for this quarter, don't you think?"
3622,1,10,58,69,1.173913043478261,0.050388608077731906,549,I just wanted us to feel each other out.
3622,2,8,59,69,1.173913043478261,0.054454286181317355,549,The jackets are for both our protection in all job interviews.
3622,2,8,59,69,1.173913043478261,0.054454286181317355,549,"I would like to help you, but, as I'm sure you can appreciate, my hands are tied!"
3622,0,12,57,69,1.173913043478261,0.045964707814863004,549,You'd be crazy not to leave this job.
3622,1,10,58,69,1.173913043478261,0.050388608077731906,549,What color is your parachute?
3622,1,10,58,69,1.173913043478261,0.050388608077731906,549,"I'm sorry, can we stop this interview for a moment, I can't think strait"
3622,1,10,58,69,1.173913043478261,0.050388608077731906,549,Where do you see yourself five years from now?
3622,4,4,61,69,1.173913043478261,0.061788220580689106,549,We're trying to run this asylum with both hands tied behind our backs.
3622,2,8,59,69,1.173913043478261,0.054454286181317355,549,"No, your experience at this firm will not be boundless."
3622,1,10,58,69,1.173913043478261,0.050388608077731906,549,This sure beats working.
3622,2,8,59,69,1.173913043478261,0.054454286181317355,549,You'd be surprised how much time I had in there to work on my degree.
3622,2,8,59,69,1.173913043478261,0.054454286181317355,549,"After I saw you last week without you jacket, Zoe, I just knew this was the right weight loss program for me!"
3622,3,6,60,69,1.173913043478261,0.0582368160446839,549,These new government employee uniforms are very restricting.
3622,0,12,57,69,1.173913043478261,0.045964707814863004,549,Welcome to the Houdini Empathy Society.
3622,2,8,59,69,1.173913043478261,0.054454286181317355,549,Our straight talk wireless plan now comes with unlimited texts.
3622,1,10,58,69,1.173913043478261,0.050388608077731906,549,Talking without body language is wonderful. Our motto is BS without BL.
3622,0,12,57,69,1.173913043478261,0.045964707814863004,549,You're bound to understand how it feels to me.
3622,2,8,59,69,1.173913043478261,0.054454286181317355,549,I guess we've got it all wrapped up.
3622,2,8,59,69,1.173913043478261,0.054454286181317355,549,I'm not sure this is the best way to keep us here making America great again!
3622,3,6,60,69,1.173913043478261,0.0582368160446839,549,"They went crazy for Snuggies and mermaid tail blankets. With the right endorsement, everyone will be wearing these next year..."
3622,2,8,59,69,1.173913043478261,0.054454286181317355,549,"As head of HR, my options are limited."
3622,1,10,58,69,1.173913043478261,0.050388608077731906,549,I never really cared for casual Fridays.
3622,2,8,59,69,1.173913043478261,0.054454286181317355,549,Jane follows career advise to dress like your boss.
3622,2,8,59,69,1.173913043478261,0.054454286181317355,549,"Sorry for the outburst, but I get a little worked up when I find a good fit for the department."
3622,3,6,60,69,1.173913043478261,0.0582368160446839,549,Six-pack abs! And the Facebook article said it also solves global warming.
3622,2,8,59,69,1.173913043478261,0.054454286181317355,549,"Go ahead, this is a safe space."
3622,2,8,59,69,1.173913043478261,0.054454286181317355,549,"The bad news is, you're fired. The good news is, we now have an opening."
3622,2,8,59,69,1.173913043478261,0.054454286181317355,549,But our attorneys tell us we're saving a bundle from avoiding potential sexual harrasment suits
3622,1,10,58,69,1.173913043478261,0.050388608077731906,549,This way no one can complain I mistreated them and can focus on facial expressions.
3622,2,8,59,69,1.173913043478261,0.054454286181317355,549,"All I said was ""hands off my laptop."""
3622,3,6,60,69,1.173913043478261,0.0582368160446839,549,You'll be please to know the rumours of a glass ceiling here are completely false.
3622,1,10,58,69,1.173913043478261,0.050388608077731906,549,"Well, say something. Are you tongue tied ?"
3622,2,8,59,69,1.173913043478261,0.054454286181317355,549,It's tough lately--a weekend escape will be refreshing.
3622,2,8,59,69,1.173913043478261,0.054454286181317355,549,I wonder where they got the idea for these 'Tweet Suits.'
3622,3,6,60,69,1.173913043478261,0.0582368160446839,549,I see you also know how to dress for a Trump administration...
3622,2,8,59,69,1.173913043478261,0.054454286181317355,549,What do you like to do for fun?
3622,2,8,59,69,1.173913043478261,0.054454286181317355,549,I didn't know you were straight.
3622,2,8,59,69,1.173913043478261,0.054454286181317355,549,"This 'you scratch my back, I'll scratch your back' arrangement just isn't working."
3622,2,8,59,69,1.173913043478261,0.054454286181317355,549,"Sorry, but my hands are tied as well."
3622,2,8,59,69,1.173913043478261,0.054454286181317355,549,Does upper management seem a little insecure to you these days?
3622,1,10,58,69,1.173913043478261,0.050388608077731906,549,"To be honest, I haven't been crazy about your work lately."
3622,2,8,59,69,1.173913043478261,0.054454286181317355,549,Oh - I've SO got this job in the bag!
3622,4,4,61,69,1.173913043478261,0.061788220580689106,549,I just wonder if HR overreached in an effort to prevent violence in the workplace.
3622,1,10,58,69,1.173913043478261,0.050388608077731906,549,You should come on a Friday.
3622,2,8,59,69,1.173913043478261,0.054454286181317355,549,Hands were becoming offensive.
3622,2,8,59,69,1.173913043478261,0.054454286181317355,549,"Paranoid schizophrenics can write their own ticket..that is, if they can loosen the straps"
3622,1,10,58,69,1.173913043478261,0.050388608077731906,549,"I think the ""no social media"" strategy is a bit harsh."
3622,3,6,60,69,1.173913043478261,0.0582368160446839,549,I can't. Me neither.
3622,2,8,59,69,1.173913043478261,0.054454286181317355,549,Tell me again why your straps are in the front and mine are in the back?
3622,2,8,59,69,1.173913043478261,0.054454286181317355,549,This new hands off ap seems to be working.
3622,1,10,58,69,1.173913043478261,0.050388608077731906,549,Well it takes a crazy to know a crazy
3622,2,8,59,69,1.173913043478261,0.054454286181317355,549,I never thought I'd miss the glass ceiling.
3622,2,8,59,69,1.173913043478261,0.054454286181317355,549,Looks like we are tied again.
3622,4,4,61,69,1.173913043478261,0.061788220580689106,549,Which spoilers are you avoiding?
3622,0,12,57,69,1.173913043478261,0.045964707814863004,549,"Texting too much at work, eh?"
3622,0,12,57,69,1.173913043478261,0.045964707814863004,549,Freedom of movement was not part of your job description.
3622,2,8,59,69,1.173913043478261,0.054454286181317355,549,"Well, I see this project has you tied up in knots, too."
3622,2,8,59,69,1.173913043478261,0.054454286181317355,549,'Somehow i feel you'll fit in quite well in our firm.....it gets a little crazy at times....'
3622,1,10,58,69,1.173913043478261,0.050388608077731906,549,It appears as though my hands-off management style has made an impression on you.
3622,1,10,58,69,1.173913043478261,0.050388608077731906,549,Because I'm the one with the degree.
3622,0,12,57,69,1.173913043478261,0.045964707814863004,549,Paperless and touchless environment.
3622,2,8,59,69,1.173913043478261,0.054454286181317355,549,Ironically you do have to be mad to work here but it doesn't help.
3622,2,8,59,69,1.173913043478261,0.054454286181317355,549,We feel individual initiative is highly overrated.
3622,1,10,58,69,1.173913043478261,0.050388608077731906,549,Our goals are achieved through the genius of fixed parameters.
3622,2,8,59,69,1.173913043478261,0.054454286181317355,549,The pay gap may provide just enough wiggle room to escape.
3622,3,6,60,69,1.173913043478261,0.0582368160446839,549,Mr. Trump strongly believes there's a place for you in his Administration.
3622,1,10,58,69,1.173913043478261,0.050388608077731906,549,Their recruiter did warn us we wouldn't be receiving any hands-on experience
3622,3,6,60,69,1.173913043478261,0.0582368160446839,549,"...and most of all, we look for cultural fit. Things can get a little crazy around here..."
3622,3,6,60,69,1.173913043478261,0.0582368160446839,549,At Houdini Enterprises we specialize in strait talk.
3622,2,8,59,69,1.173913043478261,0.054454286181317355,549,Eliza repeat after me..... The reign of being restrained falls mainly on our boss Lorraine.
3622,3,6,60,69,1.173913043478261,0.0582368160446839,549,My parents still think I'm straight
3622,2,8,59,69,1.173913043478261,0.054454286181317355,549,I've got an itch
3622,2,8,59,69,1.173913043478261,0.054454286181317355,549,"I know you'll understand me, so I'll give it to you straight."
3622,2,8,59,69,1.173913043478261,0.054454286181317355,549,"The jacket's comfortable, but I'm not crazy about the name, ""One Flew Over the Cuckoo's Desk."""
3622,1,10,58,69,1.173913043478261,0.050388608077731906,549,You do have good posture.
3622,4,4,61,69,1.173913043478261,0.061788220580689106,549,How did we survive before Casual Fridays?
3622,2,8,59,69,1.173913043478261,0.054454286181317355,549,"That time of the month for you too, huh?"
3622,3,6,60,69,1.173913043478261,0.0582368160446839,549,this is for both our safety.
3622,2,8,59,69,1.173913043478261,0.054454286181317355,549,"We'd love to give you a raise, but unfortunately our hands are tied."
3622,2,8,59,69,1.173913043478261,0.054454286181317355,549,We've had quite a few requests for a return to Casual Fridays!
3622,1,10,58,69,1.173913043478261,0.050388608077731906,549,I am crazy about this job.
3622,1,10,58,69,1.173913043478261,0.050388608077731906,549,We don't have a back-scratching culture around here.
3622,0,12,57,69,1.173913043478261,0.045964707814863004,549,"One last question, can you type with your nose?"
3622,2,8,59,69,1.173913043478261,0.054454286181317355,549,"Yes, it's pretty typical in HR."
3622,3,6,60,69,1.173913043478261,0.0582368160446839,549,Let us be straight with one another
3622,0,12,57,69,1.173913043478261,0.045964707814863004,549,Well that pretty well wraps things up.
3622,1,10,58,69,1.173913043478261,0.050388608077731906,549,It's a deal---as soon as we shake on it.
3622,1,10,58,69,1.173913043478261,0.050388608077731906,549,"I think we have made a good case against the constraints that have been placed on us, now if I can just figure out how to hit send."
3622,3,6,60,69,1.173913043478261,0.0582368160446839,549,I think both our hands are tied.
3622,1,10,58,69,1.173913043478261,0.050388608077731906,549,Let's begin by putting all our chips on the table.
3622,1,10,58,69,1.173913043478261,0.050388608077731906,549,Let's get something straight.
3622,1,10,58,69,1.173913043478261,0.050388608077731906,549,The pay is good but we don't give our people much freedom of action.
3622,1,10,58,69,1.173913043478261,0.050388608077731906,549,We all have the same opportunities here.
3622,1,10,58,69,1.173913043478261,0.050388608077731906,549,"Is it just me, or is this new diet a bit too constrictive?"
3622,1,10,58,69,1.173913043478261,0.050388608077731906,549,"Trust me, it's very liberating not talking with your hands."
3622,2,8,59,69,1.173913043478261,0.054454286181317355,549,Why does everyone think we're crazy?
3622,3,6,60,69,1.173913043478261,0.0582368160446839,549,Welcome to Outward Bound!
3871,2,8,60,70,1.1714285714285715,0.05372820400267856,549,I can out-Houdini you!
3871,3,6,61,70,1.1714285714285715,0.057452576794271674,549,"We're both in a bind, and I just don't see a way out."
3871,3,6,61,70,1.1714285714285715,0.057452576794271674,549,I'm going to be straight with you.
3871,2,8,60,70,1.1714285714285715,0.05372820400267856,549,"Well, lets wrap this up."
3871,2,8,60,70,1.1714285714285715,0.05372820400267856,549,Can you hand me that pen?
3871,1,10,59,70,1.1714285714285715,0.0497256596779289,549,We were both tied up at the office.
3877,3,6,62,71,1.1690140845070423,0.056689047316896064,549,Golden handcuffs were never enough to hold me back...
3878,1,10,61,72,1.1666666666666667,0.048450158311150925,549,"So Ms. Bangles, how long have you been wanting to walk like an Egyptian?"
3879,2,7,58,67,1.164179104477612,0.054623479615184975,549,"I don't know about you, but this new fashion line from Straits of Magellan drives me nuts."
3879,3,5,59,67,1.164179104477612,0.058617476571788,549,Your teachers tell me you've been acting normal again.
3879,3,5,59,67,1.164179104477612,0.058617476571788,549,I don't believe this marriage counseling thing is going well.
3879,3,5,59,67,1.164179104477612,0.058617476571788,549,Great start to your interview! You have the corporate fashion style down pat.
3879,1,9,57,67,1.164179104477612,0.05031342257188375,549,"I don't like it either, but these straight jacket Mondays are quite necessary."
3879,0,11,56,67,1.164179104477612,0.04559776810901335,549,We're not going anywhere until we figure this out.
3879,2,7,58,67,1.164179104477612,0.054623479615184975,549,"So people say your crazy, how does that make you feel?"
3879,3,5,59,67,1.164179104477612,0.058617476571788,549,I am sorry. Our hands are tied.
3879,1,9,57,67,1.164179104477612,0.05031342257188375,549,I see you have the same problem.
3879,2,7,58,67,1.164179104477612,0.054623479615184975,549,We really need to call each other in the morning before reaching into our closets.
3879,0,11,56,67,1.164179104477612,0.04559776810901335,549,I'll sign the contract once we shake hands on it
3879,1,9,57,67,1.164179104477612,0.05031342257188375,549,"I'm sorry Becky, but my hands are tied."
3879,1,9,57,67,1.164179104477612,0.05031342257188375,549,I think adding color to these suits would be calming.
3879,4,3,60,67,1.164179104477612,0.06235617526771267,549,"I'm sorry, I just don't think you are the right fit for this job."
3879,1,9,57,67,1.164179104477612,0.05031342257188375,549,I agree. Our company's dress code policy could be considered constricting.
3879,2,7,58,67,1.164179104477612,0.054623479615184975,549,I miss the glass ceiling.
3879,1,9,57,67,1.164179104477612,0.05031342257188375,549,At least its warm
3879,2,7,58,67,1.164179104477612,0.054623479615184975,549,Apparently it's all the rage.
3879,0,11,56,67,1.164179104477612,0.04559776810901335,549,Let's do lunch next week. It looks like we're both all wrapped up this week.
3879,1,9,57,67,1.164179104477612,0.05031342257188375,549,We've taken straight talk to a new level.
3879,0,11,56,67,1.164179104477612,0.04559776810901335,549,I'm so glad that we agreed to wrap things up!
3879,4,3,60,67,1.164179104477612,0.06235617526771267,549,"That's a tough one. I guess it's ""I try too hard to please my boss."""
3879,2,7,58,67,1.164179104477612,0.054623479615184975,549,I really must commend this approach to not texting him first.
3879,1,9,57,67,1.164179104477612,0.05031342257188375,549,But we do have a microwave in the break room.
3879,1,9,57,67,1.164179104477612,0.05031342257188375,549,"When I told him were both tied up, he assumed it was locker room talk."
3879,3,5,59,67,1.164179104477612,0.058617476571788,549,"Maybe I'm crazy, but I feel comfortable in this."
3879,1,9,57,67,1.164179104477612,0.05031342257188375,549,"I would Google how to get us out of this mess, but my hands are tied."
3879,2,7,58,67,1.164179104477612,0.054623479615184975,549,It's the only way I can get anything done around here.
3879,2,7,58,67,1.164179104477612,0.054623479615184975,549,The company's motto is: 'Where Minds Soar.' This is the trade-off.
3879,1,9,57,67,1.164179104477612,0.05031342257188375,549,The number of IT service calls has gone down dramatically.
3879,0,11,56,67,1.164179104477612,0.04559776810901335,549,Do you like thinking within the box?
3879,2,7,58,67,1.164179104477612,0.054623479615184975,549,I hate when people flap their arms during evaluations.
3879,1,9,57,67,1.164179104477612,0.05031342257188375,549,"I think we're both entitled to a refund -- 'unique,' the designer said."
3879,2,7,58,67,1.164179104477612,0.054623479615184975,549,It's my way of convincing everyone in my group that things are bound to change.
3879,2,7,58,67,1.164179104477612,0.054623479615184975,549,I'm undressing you with my eyes.
3879,3,5,59,67,1.164179104477612,0.058617476571788,549,Escape Artistry 101 Study Group
3879,2,7,58,67,1.164179104477612,0.054623479615184975,549,This from Armani's Evening Collection.
3879,2,7,58,67,1.164179104477612,0.054623479615184975,549,I think it's better than being tongue tied.
3879,0,11,56,67,1.164179104477612,0.04559776810901335,549,"I can see we're of like minds, so allow me to come strait to the point."
3879,3,5,59,67,1.164179104477612,0.058617476571788,549,"Acme's new dress code has not only reduced in-office fiddling around on the internet by over thirty percent, but the new outfits are in fact quite slimming."
3879,1,9,57,67,1.164179104477612,0.05031342257188375,549,Management has asked that we resolve our differences with open and respectful communication.
3879,3,5,59,67,1.164179104477612,0.058617476571788,549,Welcome to the new Office of Equal Opportunity.
3879,2,7,58,67,1.164179104477612,0.054623479615184975,549,Your husband likes it and mine keeps me from text messaging all day.
3879,2,7,58,67,1.164179104477612,0.054623479615184975,549,'Velcro tester' will certainly look good on your résumé.
3879,2,7,58,67,1.164179104477612,0.054623479615184975,549,It's because there's no glass ceiling on this building.
3879,3,5,59,67,1.164179104477612,0.058617476571788,549,"Okay, Siri made us both presents. Now what?"
3879,2,7,58,67,1.164179104477612,0.054623479615184975,549,Welcome to Houdini's!
3879,2,7,58,67,1.164179104477612,0.054623479615184975,549,Let's do lunch but I'm a little tied up right now!
3879,2,7,58,67,1.164179104477612,0.054623479615184975,549,The firm offers very comprehensive medical insurance.
3879,3,5,59,67,1.164179104477612,0.058617476571788,549,"Nothing we can do to assist, our hands our tied"
3879,2,7,58,67,1.164179104477612,0.054623479615184975,549,I can really empathize with you.
3879,2,7,58,67,1.164179104477612,0.054623479615184975,549,This breakout meeting is long overdue.
3879,2,7,58,67,1.164179104477612,0.054623479615184975,549,I expect you'll fit right in. People here are all wrapped up in themselves.
3879,2,7,58,67,1.164179104477612,0.054623479615184975,549,"Oh, pussy bows are so last year."
3879,2,7,58,67,1.164179104477612,0.054623479615184975,549,I think I have a grasp on what your feeling.
3879,3,5,59,67,1.164179104477612,0.058617476571788,549,OK now are we ready for peaceful conflict resolution?
3879,3,5,59,67,1.164179104477612,0.058617476571788,549,Why do you think you fee so tied up?
3879,1,9,57,67,1.164179104477612,0.05031342257188375,549,Guess you can't give me a hand on this project?
3879,1,9,57,67,1.164179104477612,0.05031342257188375,549,We should have gone with the flow.
3879,3,5,59,67,1.164179104477612,0.058617476571788,549,Why must every performance review tie us up in knots?
3879,3,5,59,67,1.164179104477612,0.058617476571788,549,Binge watching. You?
3879,1,9,57,67,1.164179104477612,0.05031342257188375,549,"Well, I think we are both committed to the idea."
3879,3,5,59,67,1.164179104477612,0.058617476571788,549,"It's holiday stress, we all feel like we're tied up in knots."
3879,0,11,56,67,1.164179104477612,0.04559776810901335,549,"That wraps things up, so we'll end this meeting."
3879,0,11,56,67,1.164179104477612,0.04559776810901335,549,Am I crazy or is it cold in here?
3879,2,7,58,67,1.164179104477612,0.054623479615184975,549,"I'm sorry that you think this job is pure torture, but there's nothing I can do... unfortunately my hands are tied."
3879,3,5,59,67,1.164179104477612,0.058617476571788,549,Looks like for this decision our hands are tied.
3879,3,5,59,67,1.164179104477612,0.058617476571788,549,It does keep your warm but it's a little hard to scratch.
3879,3,5,59,67,1.164179104477612,0.058617476571788,549,And I though stiletto heels were restrictive...
3879,2,7,58,67,1.164179104477612,0.054623479615184975,549,I'd shake your hand but I'm under a restraining order. And what are your qualifications?
3879,2,7,58,67,1.164179104477612,0.054623479615184975,549,"I'm sorry I can't get you a better deal -- our hands are really tied on this one."""
3879,1,9,57,67,1.164179104477612,0.05031342257188375,549,"I would like to give you a better rate, but my hands are also tied."
3879,2,7,58,67,1.164179104477612,0.054623479615184975,549,Can I be straight with you? I'd like to help but my hands are tied.
3879,2,7,58,67,1.164179104477612,0.054623479615184975,549,"So, how do you think the interview is going so far?"
3879,0,11,56,67,1.164179104477612,0.04559776810901335,549,Shall I tell them you're tied up at work?
3879,2,7,58,67,1.164179104477612,0.054623479615184975,549,"Hey Siri, do you have any other advice for how to be committed?"
3879,1,9,57,67,1.164179104477612,0.05031342257188375,549,"For your sake I want to get rid of the red tape, but my hands are tied."
3879,1,9,57,67,1.164179104477612,0.05031342257188375,549,There was no way that you were going to escape this interview!
3879,1,9,57,67,1.164179104477612,0.05031342257188375,549,Sometimes it seems like you don't even want to be here anymore.
3879,1,9,57,67,1.164179104477612,0.05031342257188375,549,"And, we strongly discourage pilfering at our company."
3879,1,9,57,67,1.164179104477612,0.05031342257188375,549,It probably wasn't a good idea for us to take a chance on Rodger Ailes as a clothing designer.
3879,1,9,57,67,1.164179104477612,0.05031342257188375,549,"From 'Casual Fridays' to 'Straight Jacket Saturdays,' what's next?"
3879,2,7,58,67,1.164179104477612,0.054623479615184975,549,"Accounting called, our latest fashion offering seems to be a bust."
3879,3,5,59,67,1.164179104477612,0.058617476571788,549,It's nothing we can get up in arms over.
3879,0,11,56,67,1.164179104477612,0.04559776810901335,549,This is a hands free job
3879,2,7,58,67,1.164179104477612,0.054623479615184975,549,I have a complaint about the new work uniform.
3879,1,9,57,67,1.164179104477612,0.05031342257188375,549,It's our spin on 'blind leading the blind.'
3879,3,5,59,67,1.164179104477612,0.058617476571788,549,Let's get something straight between us.
3879,3,5,59,67,1.164179104477612,0.058617476571788,549,My last boss just didn't get me.
3879,2,7,58,67,1.164179104477612,0.054623479615184975,549,"I don't think Mike Pence understands what ""straight jackets"" are actually for."
3879,2,7,58,67,1.164179104477612,0.054623479615184975,549,"You do have to be, but it doesn't really help."
3879,1,9,57,67,1.164179104477612,0.05031342257188375,549,"So, what would they do in the movies?"
3879,4,3,60,67,1.164179104477612,0.06235617526771267,549,This is our latest innovation for serious weight control as opposed to the former idea of simply wiring the Jaws together.
3879,3,5,59,67,1.164179104477612,0.058617476571788,549,"Psychology degree? No, I'm self-taught."
3879,4,3,60,67,1.164179104477612,0.06235617526771267,549,There are some who doubt we will reach agreement.
3879,1,9,57,67,1.164179104477612,0.05031342257188375,549,"OK,JUST GIVE IT TO ME STRAIGHT"
3879,0,11,56,67,1.164179104477612,0.04559776810901335,549,I'd kill for a glass ceiling right now.
3879,1,9,57,67,1.164179104477612,0.05031342257188375,549,"We can hit the ground running, once we get our arms around it."
3879,1,9,57,67,1.164179104477612,0.05031342257188375,549,I'd like to help. But our hands are tied.
3879,1,9,57,67,1.164179104477612,0.05031342257188375,549,Can you hunt-and-peck?
3879,3,5,59,67,1.164179104477612,0.058617476571788,549,"Tell Martha this ""spa wrap""  during lunch break was a questionable idea."
3879,1,9,57,67,1.164179104477612,0.05031342257188375,549,"I just love the style, but I can't get any work done."""
3879,1,9,57,67,1.164179104477612,0.05031342257188375,549,So........Lessons Learned. Who goes first ?
3879,0,11,56,67,1.164179104477612,0.04559776810901335,549,Human Resources requires our dress code to be gender nutural.
3879,1,9,57,67,1.164179104477612,0.05031342257188375,549,I'm having a crazy workday too!
3879,4,3,60,67,1.164179104477612,0.06235617526771267,549,I think that we both need to take a break
3879,1,9,57,67,1.164179104477612,0.05031342257188375,549,"Well Nancy, I guess hindsight's 2020."
3879,2,7,58,67,1.164179104477612,0.054623479615184975,549,I believe you've already met our harassment czar...
3879,1,9,57,67,1.164179104477612,0.05031342257188375,549,We have to be disciplined to learn the new voice recognition software.
3879,1,9,57,67,1.164179104477612,0.05031342257188375,549,"I ran into the same problem you did, my hands were tied."
3879,2,7,58,67,1.164179104477612,0.054623479615184975,549,this feels more like a hostage negotiation
3879,2,7,58,67,1.164179104477612,0.054623479615184975,549,We have fairly strict rules about job interviews here.
3879,2,7,58,67,1.164179104477612,0.054623479615184975,549,"Yes, well actually, the inmates do run this institution. What was it you did to get sent here and how does that qualify you to be the CFO?"
3879,2,7,58,67,1.164179104477612,0.054623479615184975,549,I never know what to wear to these solidarity meetings.
3879,1,9,57,67,1.164179104477612,0.05031342257188375,549,"Wow! I'm a Houdini fan,too!"
3879,0,11,56,67,1.164179104477612,0.04559776810901335,549,So can we discuss my promotion now?
3879,1,9,57,67,1.164179104477612,0.05031342257188375,549,Sorry I'm late. I got tied up..
3879,2,7,58,67,1.164179104477612,0.054623479615184975,549,Remember when sleeve lengths were a real pain?
3879,2,7,58,67,1.164179104477612,0.054623479615184975,549,At least we can agree on one thing...we're both crazy about this company!
3879,0,11,56,67,1.164179104477612,0.04559776810901335,549,This place can be a mad house sometimes but you get used to it.
3879,2,7,58,67,1.164179104477612,0.054623479615184975,549,"And are you comfortable in your new office? Yes, the padding is divine, though I do feel it is missing a certain...je ne sais quoi"
3879,3,5,59,67,1.164179104477612,0.058617476571788,549,"Perhaps you'd prefer to work somewhere else, if you think the dress code here is 'cray-cray.'"
3879,1,9,57,67,1.164179104477612,0.05031342257188375,549,I get it! This is a tough place to be creative.
3879,1,9,57,67,1.164179104477612,0.05031342257188375,549,What's your diary like? I'm tied up until Tuesday.
3879,2,7,58,67,1.164179104477612,0.054623479615184975,549,"In light of the new Administration, I really think its best for all concerned."
3879,1,9,57,67,1.164179104477612,0.05031342257188375,549,A glass ceiling is not a problem here.
3879,0,11,56,67,1.164179104477612,0.04559776810901335,549,"Stop complaining. We're losing weight, aren't we?!"
3879,1,9,57,67,1.164179104477612,0.05031342257188375,549,"Casual Fridays may be a bit stressful, but other than that I'm sure you will find the company a good fit."
3879,2,7,58,67,1.164179104477612,0.054623479615184975,549,If we were men this would have been settled with pistols at 20 paces.
3879,1,9,57,67,1.164179104477612,0.05031342257188375,549,"Right now, our hiring strategy is under wraps."
3879,2,7,58,67,1.164179104477612,0.054623479615184975,549,"This dress code is bad, but the social media policy is really unbearable."
3879,1,9,57,67,1.164179104477612,0.05031342257188375,549,"So, tell me how this role reversal makes you feel..."
3879,1,9,57,67,1.164179104477612,0.05031342257188375,549,"I find the new uniforms confining, you?"
3879,2,7,58,67,1.164179104477612,0.054623479615184975,549,"OK. Let’s try this again. No, you cannot have a raise."
3879,3,5,59,67,1.164179104477612,0.058617476571788,549,"Due to recent cutbacks, we can no longer afford golden handcuffs."
3879,0,11,56,67,1.164179104477612,0.04559776810901335,549,This conversation seems a little forced.
3879,1,9,57,67,1.164179104477612,0.05031342257188375,549,Bad news. Canada and Mexico both closed their borders.
3879,1,9,57,67,1.164179104477612,0.05031342257188375,549,"As you may be aware, here at Mortimer, Mortimer and Myers we have a strict policy of no personal cell phone use during business hours."
3879,1,9,57,67,1.164179104477612,0.05031342257188375,549,I'd like to help you but my hands are tied.
3879,1,9,57,67,1.164179104477612,0.05031342257188375,549,Productivity's gone up since we can't keep checking his Twitter feed.
3879,2,7,58,67,1.164179104477612,0.054623479615184975,549,It'd be nice if someone could lend us a hand.
3879,1,9,57,67,1.164179104477612,0.05031342257188375,549,I would say your capacity for empathy is impressive.
3879,1,9,57,67,1.164179104477612,0.05031342257188375,549,This is the best solution to refrain from compulsive technology use.
3879,2,7,58,67,1.164179104477612,0.054623479615184975,549,"I'm sure you'll fit right in. We're just one big happy family"""
3879,3,5,59,67,1.164179104477612,0.058617476571788,549,We may need to rethink this 'women can have it all' thing.
3879,2,7,58,67,1.164179104477612,0.054623479615184975,549,So much for breaking the Glass Ceiling.
3879,1,9,57,67,1.164179104477612,0.05031342257188375,549,I see that you have impeccable fashion sense.
3879,3,5,59,67,1.164179104477612,0.058617476571788,549,I understand your culture.
3879,1,9,57,67,1.164179104477612,0.05031342257188375,549,"While working for my previous employer, I was always a ""hands-on"" type of employee, so I know my new job with your company will clearly be a challenge."
3879,1,9,57,67,1.164179104477612,0.05031342257188375,549,"Oh, I see you fitting into our little company quite well -- you're precisely the sort of person we've been looking for."
3879,1,9,57,67,1.164179104477612,0.05031342257188375,549,I think we can be flexible on that.
3879,3,5,59,67,1.164179104477612,0.058617476571788,549,"Why, yes, Mr. Trump does tend to surround himself with like-minded people."
3879,3,5,59,67,1.164179104477612,0.058617476571788,549,This glass ceiling's a bitch.
3879,3,5,59,67,1.164179104477612,0.058617476571788,549,You can definitely get a job with our condition. I type five words per minute with my face.
3879,0,11,56,67,1.164179104477612,0.04559776810901335,549,"Management 1, checking social media all day 0."
3879,1,9,57,67,1.164179104477612,0.05031342257188375,549,Let's keep this under wraps.
3879,1,9,57,67,1.164179104477612,0.05031342257188375,549,This diet is silly. I'd rather just resolve to exercise in the new year.
3879,2,7,58,67,1.164179104477612,0.054623479615184975,549,Mental illness is straight up no joke...
3879,1,9,57,67,1.164179104477612,0.05031342257188375,549,We just can't be everyone's helping hand anymore.
3879,2,7,58,67,1.164179104477612,0.054623479615184975,549,I'm committed to helping you.
3879,1,9,57,67,1.164179104477612,0.05031342257188375,549,I ordered mine online. One size fits all.
3879,1,9,57,67,1.164179104477612,0.05031342257188375,549,So tell me why you think you should work in the Inhibited Persons' Bureau?
3879,1,9,57,67,1.164179104477612,0.05031342257188375,549,I love what you've done with your hair.
3879,1,9,57,67,1.164179104477612,0.05031342257188375,549,"When you learn to stop mirroring me, we will take off the restraints."
3879,2,7,58,67,1.164179104477612,0.054623479615184975,549,"Good job taking over the asylum, but we seem to have overlooked a detail."
3879,3,5,59,67,1.164179104477612,0.058617476571788,549,... and next they will come back and let us go because we can't get anything done.
3879,1,9,57,67,1.164179104477612,0.05031342257188375,549,The job is yours if you think you can do this eight hours a day.
3879,1,9,57,67,1.164179104477612,0.05031342257188375,549,"No, you can NOT know what I'm going through"
3879,2,7,58,67,1.164179104477612,0.054623479615184975,549,Twist and shout doesn't work.
3879,2,7,58,67,1.164179104477612,0.054623479615184975,549,You'll find that working here is kind of like being in a nuthouse.
3879,2,7,58,67,1.164179104477612,0.054623479615184975,549,I am trying to go hands free.
3879,2,7,58,67,1.164179104477612,0.054623479615184975,549,Looks like we won't even get close to the glass ceiling here.
3879,3,5,59,67,1.164179104477612,0.058617476571788,549,I see you read Vogue too.
3879,3,5,59,67,1.164179104477612,0.058617476571788,549,"""Conservatives have a few different rules around here, but I think you'll like the job""."
3879,2,7,58,67,1.164179104477612,0.054623479615184975,549,I see we're both tied up during the holidays.
3879,3,5,59,67,1.164179104477612,0.058617476571788,549,Or we can turn our phones off.
3879,2,7,58,67,1.164179104477612,0.054623479615184975,549,I understand we want to help each other but our hands are tied.
3879,0,11,56,67,1.164179104477612,0.04559776810901335,549,"First off – your name wouldn't happen to be Siri, Alexa or Google, would it?"
3879,0,11,56,67,1.164179104477612,0.04559776810901335,549,I guess scratching my nose is out of the question.
3879,2,7,58,67,1.164179104477612,0.054623479615184975,549,You're just too wrapped up in yourself to continue with our team.
3879,2,7,58,67,1.164179104477612,0.054623479615184975,549,"The method may be extreme, but without email, sms, social networks and phones, we are more productive, communicative, friendly, and even happier."
3879,3,5,59,67,1.164179104477612,0.058617476571788,549,"Your hour is up, let's tie up this session."
3879,1,9,57,67,1.164179104477612,0.05031342257188375,549,I like your glasses.
3879,2,7,58,67,1.164179104477612,0.054623479615184975,549,How would you react when they break into the room?
3879,1,9,57,67,1.164179104477612,0.05031342257188375,549,I can't help you! My hands are tied too!
3879,3,5,59,67,1.164179104477612,0.058617476571788,549,I feel like I am looking in a mirror when I talk to you.
3879,1,9,57,67,1.164179104477612,0.05031342257188375,549,Let's talk straight.
3879,1,9,57,67,1.164179104477612,0.05031342257188375,549,Psychotherapy is useless unless I walk in your shoes
3879,1,9,57,67,1.164179104477612,0.05031342257188375,549,Oh I don't need to write stuff down- I got a great memory.
3879,2,7,58,67,1.164179104477612,0.054623479615184975,549,Is that from The Wage Gap? I got mine from The Limited Too Ambitious.
3879,0,11,56,67,1.164179104477612,0.04559776810901335,549,The ramifications of being crazy about your job.
3879,2,7,58,67,1.164179104477612,0.054623479615184975,549,This is what is left of the Left.
3879,4,3,60,67,1.164179104477612,0.06235617526771267,549,"If you're really not comfortable here, you might want to consider our gay jacket division."
3879,1,9,57,67,1.164179104477612,0.05031342257188375,549,We try to get along.
3879,1,9,57,67,1.164179104477612,0.05031342257188375,549,Maybe we should switch chairs.
3879,1,9,57,67,1.164179104477612,0.05031342257188375,549,We have to express our feelings using words not hand gestures!
3879,2,7,58,67,1.164179104477612,0.054623479615184975,549,This is part of our employee incentive program.
3879,3,5,59,67,1.164179104477612,0.058617476571788,549,I see that you have read our company policy about accepting one's imitations.
3879,1,9,57,67,1.164179104477612,0.05031342257188375,549,I got mine at the Saks Black Wednesday sale. You too?
3879,2,7,58,67,1.164179104477612,0.054623479615184975,549,Welcome to the team. I think you’ll make a great therapist.
3879,3,5,59,67,1.164179104477612,0.058617476571788,549,"So, how would you define empowerment in the workplace?"
3879,2,7,58,67,1.164179104477612,0.054623479615184975,549,I suggest that you kick the can down the road while you still can.
3879,1,9,57,67,1.164179104477612,0.05031342257188375,549,"Yes, your crazy ideas do fit our corporate culture, but we need someone with a hands-on approach."
3879,0,11,56,67,1.164179104477612,0.04559776810901335,549,I find a dress code so liberating
3879,2,7,58,67,1.164179104477612,0.054623479615184975,549,The guys upstairs have been asking us for ideas about improving productivity. Thoughts?
3879,2,7,58,67,1.164179104477612,0.054623479615184975,549,"Management said there isn't enough money in the budget for group hug therapy, so this is the next best thing."
3879,2,7,58,67,1.164179104477612,0.054623479615184975,549,Yes your child is the most interesting student in my class!
3879,1,9,57,67,1.164179104477612,0.05031342257188375,549,I see on your résume that you used to be an escape artist?
3879,4,3,60,67,1.164179104477612,0.06235617526771267,549,Now we just sit here and wait for everyone else to eat the holiday treats.
3879,1,9,57,67,1.164179104477612,0.05031342257188375,549,"Welcome! You'll get used to the dress code, and you'll just love the meals and padded offices. Let's get started!"
3879,1,9,57,67,1.164179104477612,0.05031342257188375,549,I'm going to give it to you straight - I think this company has a sexist policy about wearing a jacket and ties.
3879,2,7,58,67,1.164179104477612,0.054623479615184975,549,"I don't think our boss,Vice President elect, understands that these don't have any affect on gay people."
3879,1,9,57,67,1.164179104477612,0.05031342257188375,549,"So if you're looking for straight talk, you're in the right place."
3879,0,11,56,67,1.164179104477612,0.04559776810901335,549,Where can you see yourself in 1825 Prozac doses?
3879,3,5,59,67,1.164179104477612,0.058617476571788,549,FREE HUGS
3879,1,9,57,67,1.164179104477612,0.05031342257188375,549,We're a think tank. Hands-on approaches are frowned upon here.
3879,2,7,58,67,1.164179104477612,0.054623479615184975,549,We're a post-reality company.
3879,3,5,59,67,1.164179104477612,0.058617476571788,549,I read that you should dress for the job you want.
3879,2,7,58,67,1.164179104477612,0.054623479615184975,549,This could get ugly... so the restraints are necessary.
3879,0,11,56,67,1.164179104477612,0.04559776810901335,549,"If we cave to their demands, they'll release us and we can tweet again."
3879,4,3,60,67,1.164179104477612,0.06235617526771267,549,It's a male-dominated company and you look like you'll fit in.
3879,2,7,58,67,1.164179104477612,0.054623479615184975,549,"Doc, I feel safe like this."
3879,0,11,56,67,1.164179104477612,0.04559776810901335,549,They're expecting us to have everything else wrapped up by tonight.
3879,1,9,57,67,1.164179104477612,0.05031342257188375,549,I learned this team-building exercise when I worked in Vegas.
3879,3,5,59,67,1.164179104477612,0.058617476571788,549,"Schizophrenia, you? Carpal tunnel syndrome."
4104,1,9,58,68,1.161764705882353,0.049626763740833676,549,He thinks women use their hands too much when they talk.
4104,0,11,57,68,1.161764705882353,0.04498704387503318,549,We're a voice-recognition software company. This isn't a stress interview.
4104,2,7,59,68,1.161764705882353,0.05386833246131616,549,What I wouldn't give for a mint
4104,1,9,58,68,1.161764705882353,0.049626763740833676,549,You are insane! I'm crazy about your ideas!
4104,2,7,59,68,1.161764705882353,0.05386833246131616,549,"Okay...now that we can't fidget with our gadgets...what exactly is ""your"" problem?"
4104,1,9,58,68,1.161764705882353,0.049626763740833676,549,"Oh yeah, so you think I'm a psycho? Well, it takes one to know one."
4104,0,11,57,68,1.161764705882353,0.04498704387503318,549,I wish we could see if our protest is getting any buzz.
4104,0,11,57,68,1.161764705882353,0.04498704387503318,549,Can I be straight with you?
4104,1,9,58,68,1.161764705882353,0.049626763740833676,549,Maybe if we just lean in a bit more?
4104,2,7,59,68,1.161764705882353,0.05386833246131616,549,"Well The First Lady looked so good in it, now everyone is wearing Houdini."
4104,2,7,59,68,1.161764705882353,0.05386833246131616,549,Does this mean we are both crazy?
4104,2,7,59,68,1.161764705882353,0.05386833246131616,549,My husband always said I'd end up in a strait-jacket. I suppose you're divorced too?
4104,4,3,61,68,1.161764705882353,0.06147975575513955,549,Do these really make us look straight?
4104,2,7,59,68,1.161764705882353,0.05386833246131616,549,"'Nobody puts Edward Scissorhands in a straitjacket,' I said. Now what do we do?"
4104,2,7,59,68,1.161764705882353,0.05386833246131616,549,"It's a new interview approach that corporate calls ""Straight Talk."" Frankly, I'm skeptical of it."
4104,1,9,58,68,1.161764705882353,0.049626763740833676,549,I'm just feeling a little hamstrung vis-a-vis management. You?
4104,2,7,59,68,1.161764705882353,0.05386833246131616,549,We can't go on meeting like this.
4104,2,7,59,68,1.161764705882353,0.05386833246131616,549,Working here is great! They even encourage feminism - up to a point.
4104,2,7,59,68,1.161764705882353,0.05386833246131616,549,They said this exercise will help us cope with the Glass Ceiling later.
4104,3,5,60,68,1.161764705882353,0.05779947062852091,549,"If you feel your hands are tied, try living in a straight jacket"
4104,0,11,57,68,1.161764705882353,0.04498704387503318,549,"I may lose my license next week, so lets try to focus on your most important problems."
4104,1,9,58,68,1.161764705882353,0.049626763740833676,549,"Now that yout complaint is straightened out, is there anything else you'd like to discuss?"
4104,3,5,60,68,1.161764705882353,0.05779947062852091,549,Forced meditation for overly-active people.
4127,2,6,58,66,1.1515151515151516,0.05394646505600968,549,Your blouse makes me uncomfortable.
4127,1,8,57,66,1.1515151515151516,0.04943703698482351,549,"Thank God for e-books. According to this, we just need to Lean In"
4127,3,4,59,66,1.1515151515151516,0.05810698373035499,549,So this is their solution to the problem of fake news?
4127,2,6,58,66,1.1515151515151516,0.05394646505600968,549,Making America great again may also require some basic Russian.
4127,0,10,56,66,1.1515151515151516,0.04447269004274805,549,"This way, we can say we had nothing to do with anything that goes wrong. Of course, lunches and potty breaks can be a little difficult."
4127,1,8,57,66,1.1515151515151516,0.04943703698482351,549,What are you gonna wear once we start casual Fridays?
4127,2,6,58,66,1.1515151515151516,0.05394646505600968,549,"This has failed to cure screen addiction, I can still use my tongue."
4127,1,8,57,66,1.1515151515151516,0.04943703698482351,549,"Did you just finish reading ""Of Human Bondage"" too?"
4127,0,10,56,66,1.1515151515151516,0.04447269004274805,549,Straight talk
4127,1,8,57,66,1.1515151515151516,0.04943703698482351,549,What do I do if my nose itches?
4127,2,6,58,66,1.1515151515151516,0.05394646505600968,549,"If you can break out before I do, YOU get to ask ME where I see myself in five years."
4127,0,10,56,66,1.1515151515151516,0.04447269004274805,549,The good news is that we've captured the Serial Tapist last night.
4127,2,6,58,66,1.1515151515151516,0.05394646505600968,549,"This may be uncomfortable, but we are going to lose weight before the holidays!"
4127,1,8,57,66,1.1515151515151516,0.04943703698482351,549,We will just have to agree on a stalemate since both our hands our tied.
4127,1,8,57,66,1.1515151515151516,0.04943703698482351,549,"""This is what happens when management issues a directive to tie-up loose ends""."
4127,1,8,57,66,1.1515151515151516,0.04943703698482351,549,We just want to avoid any physical sexual overtures in the company.
4127,2,6,58,66,1.1515151515151516,0.05394646505600968,549,I definetly like your style. You've got the job.
4127,2,6,58,66,1.1515151515151516,0.05394646505600968,549,"Looking at the business forecast... shit, could you itch my nose?"
4127,1,8,57,66,1.1515151515151516,0.04943703698482351,549,I'd thought the no knitting policy had been suspended for the holidays.
4127,1,8,57,66,1.1515151515151516,0.04943703698482351,549,"Management has a 'no touching"" policy"
4127,2,6,58,66,1.1515151515151516,0.05394646505600968,549,"You're right, there's absolutely no freedom in corporate America."
4127,2,6,58,66,1.1515151515151516,0.05394646505600968,549,Sometimes people confuse us with H&M.
4127,1,8,57,66,1.1515151515151516,0.04943703698482351,549,Let's face it! Our hands are tied.
4127,1,8,57,66,1.1515151515151516,0.04943703698482351,549,I thought we'd try a little role reversal first.
4127,1,8,57,66,1.1515151515151516,0.04943703698482351,549,Shorthand with the pen in my mouth is more of a problem for me than the nose-typing.
4127,1,8,57,66,1.1515151515151516,0.04943703698482351,549,Looks like we're both pretty tied up this week.
4127,1,8,57,66,1.1515151515151516,0.04943703698482351,549,Is this the way Mr. Houdini always hires assistants?
4127,2,6,58,66,1.1515151515151516,0.05394646505600968,549,"When I said bondage makes me comfortable, this is not what I meant."
4127,2,6,58,66,1.1515151515151516,0.05394646505600968,549,I've a good feeling we are cut from the same cloth
4127,1,8,57,66,1.1515151515151516,0.04943703698482351,549,"I'm a ""hands-off"" leader, but I like it be reciprocal!"
4127,1,8,57,66,1.1515151515151516,0.04943703698482351,549,Maybe we should call the boss.
4127,3,4,59,66,1.1515151515151516,0.05810698373035499,549,Now we can have a real live old-fashioned chat.
4127,3,4,59,66,1.1515151515151516,0.05810698373035499,549,"We're not 'Vogue,' we're 'Consumer Reports.'"""
4127,1,8,57,66,1.1515151515151516,0.04943703698482351,549,No. You plug it in.
4127,1,8,57,66,1.1515151515151516,0.04943703698482351,549,Is there anything you'd like to ask me?
4127,1,8,57,66,1.1515151515151516,0.04943703698482351,549,"I get it now. So even if I was able to send you a text message, you couldn't answer it."
4127,3,4,59,66,1.1515151515151516,0.05810698373035499,549,I don't think I'm reaching too much in guessing that we might have a few things in common.
4127,2,6,58,66,1.1515151515151516,0.05394646505600968,549,I'm not crazy about the new system update either.
4127,0,10,56,66,1.1515151515151516,0.04447269004274805,549,We don't say straight jacket - we say its a non-LGBT wrap.
4127,0,10,56,66,1.1515151515151516,0.04447269004274805,549,I thought you brought the key.
4127,2,6,58,66,1.1515151515151516,0.05394646505600968,549,Causal Fridays was getting boring.
4127,1,8,57,66,1.1515151515151516,0.04943703698482351,549,This is knot going well...agreed?
4127,2,6,58,66,1.1515151515151516,0.05394646505600968,549,"But I need someone I can dictate to, and I'm not confident that's you, Brenda."
4127,1,8,57,66,1.1515151515151516,0.04943703698482351,549,"""After awhile they begin to feel like snuggies""."
4127,3,4,59,66,1.1515151515151516,0.05810698373035499,549,Oh sheesh... Now it says 'update required for voice-to-text app'..
4127,1,8,57,66,1.1515151515151516,0.04943703698482351,549,"Look on the bright side... at least President Trump didn't totally eliminate the EPA, right?"
4127,1,8,57,66,1.1515151515151516,0.04943703698482351,549,There's nothing funny about this farm.
4127,1,8,57,66,1.1515151515151516,0.04943703698482351,549,"""I see you are wrapped up in your job just like I am""."
4127,1,8,57,66,1.1515151515151516,0.04943703698482351,549,We try to really get into the world of our patients.
4127,1,8,57,66,1.1515151515151516,0.04943703698482351,549,Looks like I'll be tied up all day
4127,1,8,57,66,1.1515151515151516,0.04943703698482351,549,I followed the instructions on the screen but I can't scroll down.
4127,3,4,59,66,1.1515151515151516,0.05810698373035499,549,"I know how you feel, I got all wrapped up in the election to."
4127,1,8,57,66,1.1515151515151516,0.04943703698482351,549,"Relax, this interview is about you."
4127,2,6,58,66,1.1515151515151516,0.05394646505600968,549,These new HR rules are getting ridiculous!
4127,3,4,59,66,1.1515151515151516,0.05810698373035499,549,"With us, you won't have to worry about a glass ceiling."
4127,1,8,57,66,1.1515151515151516,0.04943703698482351,549,"Before we start, let's be strait with each other."
4127,1,8,57,66,1.1515151515151516,0.04943703698482351,549,"I'm sorry I can't do anything about your complaint, but my hands are tied."
4127,2,6,58,66,1.1515151515151516,0.05394646505600968,549,"Okay, where is the magician?"
4127,2,6,58,66,1.1515151515151516,0.05394646505600968,549,Many patients find peer counseling less intimidating.
4127,1,8,57,66,1.1515151515151516,0.04943703698482351,549,"Let's be strait-forward about our roles, here"
4127,3,4,59,66,1.1515151515151516,0.05810698373035499,549,I can't decide. What do you think?
4127,2,6,58,66,1.1515151515151516,0.05394646505600968,549,"As you can see, we are committed to straight-talk here."
4127,2,6,58,66,1.1515151515151516,0.05394646505600968,549,"Our company has a strict, ""No touch"" policy."
4127,4,2,60,66,1.1515151515151516,0.061988886297788946,549,What's your schedule for the next four years?
4127,2,6,58,66,1.1515151515151516,0.05394646505600968,549,I applied because I want to work for a company that gives me the freedom to be myself.
4127,4,2,60,66,1.1515151515151516,0.061988886297788946,549,"So far, so good."
4127,3,4,59,66,1.1515151515151516,0.05810698373035499,549,"On the plus side, these regulations have eliminated bad loans"
4127,1,8,57,66,1.1515151515151516,0.04943703698482351,549,"No, I don't believe in countertransference. Why do you ask?"
4127,0,10,56,66,1.1515151515151516,0.04447269004274805,549,We're all tied up with work.
4127,2,6,58,66,1.1515151515151516,0.05394646505600968,549,We need to cut through the red tape
4127,2,6,58,66,1.1515151515151516,0.05394646505600968,549,"Hold on, let me get this straight."
4127,3,4,59,66,1.1515151515151516,0.05810698373035499,549,Talk about the government imposing regulations!
4127,1,8,57,66,1.1515151515151516,0.04943703698482351,549,"I know, the red tape drives me crazy too."
4127,3,4,59,66,1.1515151515151516,0.05810698373035499,549,"I didn't believe my ex when he said he was ""tied up at the office""."
4127,0,10,56,66,1.1515151515151516,0.04447269004274805,549,Why do they insist on keeping the office so cold?
4127,1,8,57,66,1.1515151515151516,0.04943703698482351,549,"We used to have casual dress Friday, but employees still weren't relaxing enough."
4127,0,10,56,66,1.1515151515151516,0.04447269004274805,549,Be straight with me
4127,1,8,57,66,1.1515151515151516,0.04943703698482351,549,I thought we agreed to a no holds barred conversation
4127,3,4,59,66,1.1515151515151516,0.05810698373035499,549,"Honey, I'm gonna give it to ya' straight."
4127,3,4,59,66,1.1515151515151516,0.05810698373035499,549,Too much red tape around here.
4127,0,10,56,66,1.1515151515151516,0.04447269004274805,549,You burn way more calories than with a standing desk.
4127,1,8,57,66,1.1515151515151516,0.04943703698482351,549,Thats a lovely jacket. Ralph Lauren or Yves St. Laurent?
4127,2,6,58,66,1.1515151515151516,0.05394646505600968,549,I'd love to help you but our hands are tied.
4127,0,10,56,66,1.1515151515151516,0.04447269004274805,549,I see HR has set you straight. Are you comfortable with that?
4127,2,6,58,66,1.1515151515151516,0.05394646505600968,549,"i appreciate the offer but what do you mean by ""in perpetuity""?"
4127,1,8,57,66,1.1515151515151516,0.04943703698482351,549,"I don't know about you, but I miss the old escape key."
4127,3,4,59,66,1.1515151515151516,0.05810698373035499,549,I can do this job with my eyes closed
4127,1,8,57,66,1.1515151515151516,0.04943703698482351,549,I see you have a problem with inappropriate touching as well.
4127,3,4,59,66,1.1515151515151516,0.05810698373035499,549,We'll be working for Mr. Pruitt now.
4127,0,10,56,66,1.1515151515151516,0.04447269004274805,549,How do you see me in five years?
4127,2,6,58,66,1.1515151515151516,0.05394646505600968,549,"Let's get this straight, your jacket design would drive me crazy."
4127,1,8,57,66,1.1515151515151516,0.04943703698482351,549,Yours is a little Chanel.
4127,2,6,58,66,1.1515151515151516,0.05394646505600968,549,Things used to get way too crazy 'round here.
4127,2,6,58,66,1.1515151515151516,0.05394646505600968,549,At least we can still lean in.
4127,0,10,56,66,1.1515151515151516,0.04447269004274805,549,Human resources asks that all new hires complete the Briggs-Myers multiple personality test.
4127,0,10,56,66,1.1515151515151516,0.04447269004274805,549,This is a ledge-free workplace.
4127,3,4,59,66,1.1515151515151516,0.05810698373035499,549,We'll have an all holds barred discussion of the problem.
4127,0,10,56,66,1.1515151515151516,0.04447269004274805,549,I'm not sure if it would be a good idea to hire you right now. We both seem pretty tied up.
4127,2,6,58,66,1.1515151515151516,0.05394646505600968,549,"It would be an honor to work here, because you would be the first supervisor in my career that actually understands me."
4127,1,8,57,66,1.1515151515151516,0.04943703698482351,549,Unfortunately for us the boss prefers hands-on managers
4127,2,6,58,66,1.1515151515151516,0.05394646505600968,549,I love writing for Bondage Magazine.
4127,1,8,57,66,1.1515151515151516,0.04943703698482351,549,"""I don't know about you but I'm itching to leave the AG's office."
4127,1,8,57,66,1.1515151515151516,0.04943703698482351,549,Your perfect for the position.
4127,0,10,56,66,1.1515151515151516,0.04447269004274805,549,Somewhere Erich Weiss is laughing his ass off.
4127,1,8,57,66,1.1515151515151516,0.04943703698482351,549,"So you read Goop's ""Get your best body by 2017"" article too"
4127,2,6,58,66,1.1515151515151516,0.05394646505600968,549,"They've cut our budget, and we're going to have to let you go."
4127,0,10,56,66,1.1515151515151516,0.04447269004274805,549,Face it. We're never going to break any glass ceilings at this place.
4127,0,10,56,66,1.1515151515151516,0.04447269004274805,549,"In this economy, we all need to tighten our belts."
4127,2,6,58,66,1.1515151515151516,0.05394646505600968,549,They needed a reason to keep opening the doors.
4127,0,10,56,66,1.1515151515151516,0.04447269004274805,549,"If you could do this again, would it turn out the same way?"
4127,2,6,58,66,1.1515151515151516,0.05394646505600968,549,"Girl, you crazy."
4127,1,8,57,66,1.1515151515151516,0.04943703698482351,549,You go first.
4127,1,8,57,66,1.1515151515151516,0.04943703698482351,549,I didn't realize running the asylum also meant running payroll.
4127,1,8,57,66,1.1515151515151516,0.04943703698482351,549,Let's both do some straight talking
4127,2,6,58,66,1.1515151515151516,0.05394646505600968,549,"First, let me get this straight."
4127,1,8,57,66,1.1515151515151516,0.04943703698482351,549,I would like to welcome you to the first Social Media Anonymous meeting.
4127,2,6,58,66,1.1515151515151516,0.05394646505600968,549,"Well, yes, sure, we would describe the company culture as ""innovative."""
4127,0,10,56,66,1.1515151515151516,0.04447269004274805,549,"It's better than being downsized, but clearly there are limitations."
4127,3,4,59,66,1.1515151515151516,0.05810698373035499,549,My hands are tied on your promotion.
4127,1,8,57,66,1.1515151515151516,0.04943703698482351,549,I think the company is anti-Italian.
4127,0,10,56,66,1.1515151515151516,0.04447269004274805,549,"Sorry, security protocol."
4127,2,6,58,66,1.1515151515151516,0.05394646505600968,549,I'm not sure how I feel about the company's social media policy following the election.
4127,1,8,57,66,1.1515151515151516,0.04943703698482351,549,Maybe H&M is edgy enough.
4127,1,8,57,66,1.1515151515151516,0.04943703698482351,549,I didn't know we tied for first place.
4127,3,4,59,66,1.1515151515151516,0.05810698373035499,549,"sure, the boots work- but I would've gone with a strapy pump."
4127,2,6,58,66,1.1515151515151516,0.05394646505600968,549,We're all tied up here...I think you're a good fit
4127,3,4,59,66,1.1515151515151516,0.05810698373035499,549,"Okay, it's safe to talk about Trump and women's issues."
4127,2,6,58,66,1.1515151515151516,0.05394646505600968,549,Unfortunately we're bound by our HR outfit on this one.
4127,1,8,57,66,1.1515151515151516,0.04943703698482351,549,I'm so glad we were able to straiten this out.
4127,2,6,58,66,1.1515151515151516,0.05394646505600968,549,It's for the new contract: We pretend to work -- they pretend to pay us.
4127,1,8,57,66,1.1515151515151516,0.04943703698482351,549,I know just how you feel. I'm still tied in knots a month after the election.
4127,2,6,58,66,1.1515151515151516,0.05394646505600968,549,I knew our hands would be tied in this job but this is ridiculous
4127,1,8,57,66,1.1515151515151516,0.04943703698482351,549,"No worries, we specialize in hands free opportunities."
4127,1,8,57,66,1.1515151515151516,0.04943703698482351,549,So you're telling me that our response to an unstable economy should be fiscal restraint?
4127,1,8,57,66,1.1515151515151516,0.04943703698482351,549,"Hey Cortana, how did Houdini escape from a straight jacket?"
4127,0,10,56,66,1.1515151515151516,0.04447269004274805,549,"Sorry, I'm cold."
4127,3,4,59,66,1.1515151515151516,0.05810698373035499,549,You’ll fit right in at Uptight Anonymous.
4127,1,8,57,66,1.1515151515151516,0.04943703698482351,549,It's just nice to meet another human that shares my affinity for Hannibal Lecter culture.
4127,3,4,59,66,1.1515151515151516,0.05810698373035499,549,We also have them in gender fluid and queer.
4127,0,10,56,66,1.1515151515151516,0.04447269004274805,549,"Welcome to First day employee orientation, we want you to feel a sense of belonging."
4127,2,6,58,66,1.1515151515151516,0.05394646505600968,549,It's definitely fraud but I think can safely say our hands are tied.
4127,2,6,58,66,1.1515151515151516,0.05394646505600968,549,They say the touch screen on this laptop is awesome
4127,1,8,57,66,1.1515151515151516,0.04943703698482351,549,Well I guess this is the natural progression from golden handcuffs.
4127,2,6,58,66,1.1515151515151516,0.05394646505600968,549,Me? I was born this way.
4127,1,8,57,66,1.1515151515151516,0.04943703698482351,549,"So you knew our company's slogan: ""We don't reach out and touch."
4127,1,8,57,66,1.1515151515151516,0.04943703698482351,549,We get all wrapped up in our work.
4127,2,6,58,66,1.1515151515151516,0.05394646505600968,549,"I know we're crazy to work here, but I never thought it would come to this."
4127,2,6,58,66,1.1515151515151516,0.05394646505600968,549,You're willing to relocate? What about your shoulder?
4127,2,6,58,66,1.1515151515151516,0.05394646505600968,549,"Joan, I need you to be strait with me."
4127,1,8,57,66,1.1515151515151516,0.04943703698482351,549,"Now that we're running the asylum, we need to loosen things up, go crazy."
4127,1,8,57,66,1.1515151515151516,0.04943703698482351,549,Relax...you're in good hands.
4127,0,10,56,66,1.1515151515151516,0.04447269004274805,549,"After our last hire, our HR Director is a bit more restrictive in the interview process."
4127,4,2,60,66,1.1515151515151516,0.061988886297788946,549,Installation of this cat-video blocking software has increased our productivity 120%.
4127,3,4,59,66,1.1515151515151516,0.05810698373035499,549,Bite me
4127,1,8,57,66,1.1515151515151516,0.04943703698482351,549,YouTube says to first relax your breathing.
4127,1,8,57,66,1.1515151515151516,0.04943703698482351,549,"Well, I guess that about wraps it up, Mrs. Laurence."
4127,4,2,60,66,1.1515151515151516,0.061988886297788946,549,"Don't you hate it when they ask you, ""What's Jodie Foster really like?"""
4127,2,6,58,66,1.1515151515151516,0.05394646505600968,549,"Enough about the weather, let's get to the straight talk."
4127,1,8,57,66,1.1515151515151516,0.04943703698482351,549,"I know gayjackets are more comfortable, but this administration banned them."
4127,1,8,57,66,1.1515151515151516,0.04943703698482351,549,Looks like another day of being tied up with work.
4127,1,8,57,66,1.1515151515151516,0.04943703698482351,549,"Thanks, but I don't see the thrill of bondage."
4127,1,8,57,66,1.1515151515151516,0.04943703698482351,549,Can't make it. I'll be tied up then.
4127,1,8,57,66,1.1515151515151516,0.04943703698482351,549,Remember when we used to complain about feeling hamstrung?
4127,1,8,57,66,1.1515151515151516,0.04943703698482351,549,Corporate said our hands our tied at the moment
4127,2,6,58,66,1.1515151515151516,0.05394646505600968,549,ITALIAN INTERVIEW !
4127,2,6,58,66,1.1515151515151516,0.05394646505600968,549,So much for Shackled Fridays.
4127,1,8,57,66,1.1515151515151516,0.04943703698482351,549,So tell me...how long have you been straight?
4127,1,8,57,66,1.1515151515151516,0.04943703698482351,549,"Now you ready to learn the ""hunt & peck"" typing method."
4127,4,2,60,66,1.1515151515151516,0.061988886297788946,549,I'm a little wrapped up here but there's bound to be someone else who's free to help.
4127,1,8,57,66,1.1515151515151516,0.04943703698482351,549,"Doris, I think we have a problem."
4127,0,10,56,66,1.1515151515151516,0.04447269004274805,549,At least the stock options are great.
4127,1,8,57,66,1.1515151515151516,0.04943703698482351,549,"See, I can feel your pain."
4127,1,8,57,66,1.1515151515151516,0.04943703698482351,549,Meeting of the binds.
4127,0,10,56,66,1.1515151515151516,0.04447269004274805,549,So tell me about your encumbrances.
4127,1,8,57,66,1.1515151515151516,0.04943703698482351,549,I should have told you earlier that I'm tied up as well.
4127,1,8,57,66,1.1515151515151516,0.04943703698482351,549,I told my kids I wanted a 'Mummy Rap' for Christmas. What's your excuse?
4127,2,6,58,66,1.1515151515151516,0.05394646505600968,549,"... OK candidate #300, you tell me all of your faux job qualifications, and I'll tell you all of the faux benefits of working for us...."
4127,0,10,56,66,1.1515151515151516,0.04447269004274805,549,"A slave to fashion"" has taken on a whole new meaning."
4127,1,8,57,66,1.1515151515151516,0.04943703698482351,549,Welcome to DIY Massage Therapy School
4127,0,10,56,66,1.1515151515151516,0.04447269004274805,549,"""So, how many words a minute can YOU type with your nose""?"
4127,2,6,58,66,1.1515151515151516,0.05394646505600968,549,"I'd like to help you, but honestly I'm all tied up."
4127,1,8,57,66,1.1515151515151516,0.04943703698482351,549,"May I get you some coffee? Oh, wait...my hands are tied."
4127,0,10,56,66,1.1515151515151516,0.04447269004274805,549,"You say ,""deadlock"", I say, ""tie""."
4127,2,6,58,66,1.1515151515151516,0.05394646505600968,549,Sometimes fashion goes a little too far don't you think?
4127,3,4,59,66,1.1515151515151516,0.05810698373035499,549,When I think about him I touch myself. You?
4127,1,8,57,66,1.1515151515151516,0.04943703698482351,549,I know the election has me all tied up in knots too!
4127,2,6,58,66,1.1515151515151516,0.05394646505600968,549,Welcome to gay-conversion therapy.
4127,1,8,57,66,1.1515151515151516,0.04943703698482351,549,I'd really prefer LGBTQ jacket day to this.
4127,2,6,58,66,1.1515151515151516,0.05394646505600968,549,"We are literally in straitjackets, but not seriously."
4127,1,8,57,66,1.1515151515151516,0.04943703698482351,549,You want to kill who?
4127,1,8,57,66,1.1515151515151516,0.04943703698482351,549,"Management is concerned that the glass ceiling is shattering, so they've gone to Plan B."
4127,3,4,59,66,1.1515151515151516,0.05810698373035499,549,"I love to join you, but my hands are tied"
4127,2,6,58,66,1.1515151515151516,0.05394646505600968,549,"To be clear, we call it an LBGT jacket"
4127,2,6,58,66,1.1515151515151516,0.05394646505600968,549,I wish J. Peterman had never gone to Cairo.
4127,3,4,59,66,1.1515151515151516,0.05810698373035499,549,Finally a blouse that matches skinny jeans.
4127,1,8,57,66,1.1515151515151516,0.04943703698482351,549,"Wrapped up or constrained,what's our demeanor?"
4127,1,8,57,66,1.1515151515151516,0.04943703698482351,549,Let me put it to ya straight honey. We're in this together.
4127,2,6,58,66,1.1515151515151516,0.05394646505600968,549,OSHA requirements. We all have to wear them.
4127,2,6,58,66,1.1515151515151516,0.05394646505600968,549,Human Resources finally ruled that de-clawing was inhumane.
4127,1,8,57,66,1.1515151515151516,0.04943703698482351,549,"Yeah, crazy-making, but you knew that when you took the job."
4127,2,6,58,66,1.1515151515151516,0.05394646505600968,549,I subscribe to the old theorem that it takes one to know one!
4127,1,8,57,66,1.1515151515151516,0.04943703698482351,549,Let's talk after the holidays when were not so tied up.
4127,1,8,57,66,1.1515151515151516,0.04943703698482351,549,Am I crazy or is it really warm in here?
4127,1,8,57,66,1.1515151515151516,0.04943703698482351,549,"Don't scratch my back, and I won't scratch yours."
4127,3,4,59,66,1.1515151515151516,0.05810698373035499,549,Let's be perfectly straight about this.
4127,2,6,58,66,1.1515151515151516,0.05394646505600968,549,"Physician, heal thyself!"
4127,2,6,58,66,1.1515151515151516,0.05394646505600968,549,I can't believe I paid retail.
4127,0,10,56,66,1.1515151515151516,0.04447269004274805,549,"Just to let you know, using the ""Mirror Method"" is not getting you the job."
4127,1,8,57,66,1.1515151515151516,0.04943703698482351,549,"I don't know about you, but I feel all bound up this morning. Let's get some coffee."
4127,2,6,58,66,1.1515151515151516,0.05394646505600968,549,We have one of the most aggressive data access policies in the business.
4127,3,4,59,66,1.1515151515151516,0.05810698373035499,549,"Ok, no more edits, I promise."
4127,4,2,60,66,1.1515151515151516,0.061988886297788946,549,Job Interview At The Insane Asylum
4127,1,8,57,66,1.1515151515151516,0.04943703698482351,549,"""You could say I've lost touch""."
4127,1,8,57,66,1.1515151515151516,0.04943703698482351,549,I hate to straitjacket people but you look a little tightly wound to me.
4127,2,6,58,66,1.1515151515151516,0.05394646505600968,549,It keeps my desk straight.
4127,1,8,57,66,1.1515151515151516,0.04943703698482351,549,It's clear that we were bound to meet like this
4127,0,10,56,66,1.1515151515151516,0.04447269004274805,549,"Give it to me straight, doc."
4127,1,8,57,66,1.1515151515151516,0.04943703698482351,549,"If this is in regards to the new dress code, my hands are tied."
4127,1,8,57,66,1.1515151515151516,0.04943703698482351,549,You will have the freedom to advance at your own pace.
4127,2,6,58,66,1.1515151515151516,0.05394646505600968,549,"I know the ad said 'escape artist,' but can you teach it?"
4127,1,8,57,66,1.1515151515151516,0.04943703698482351,549,What? I told him I was tied up right now.
4127,1,8,57,66,1.1515151515151516,0.04943703698482351,549,It's impossible to be straight with you.
4127,2,6,58,66,1.1515151515151516,0.05394646505600968,549,"Let's both agree to keep this restrained"""
4350,2,6,59,67,1.1492537313432836,0.0531832947628186,549,What does being a team player mean to you?
4350,1,8,58,67,1.1492537313432836,0.048746064532998575,549,Is there an app for this?
4350,1,8,58,67,1.1492537313432836,0.048746064532998575,549,Our law firm is very straight-laced
4350,1,8,58,67,1.1492537313432836,0.048746064532998575,549,I'm guessing you're here to try and straighten things out....
4350,2,6,59,67,1.1492537313432836,0.0531832947628186,549,"I'm crazy about the new marketing idea, too."
4350,3,4,60,67,1.1492537313432836,0.0572778043940446,549,Is the recount over? Is the recount over?..
4350,4,2,61,67,1.1492537313432836,0.06109853443885558,549,Nobody told me that the new C.E.O. is a fly.
4350,2,6,59,67,1.1492537313432836,0.0531832947628186,549,"I'm all wrapped up then, too."
4350,3,4,60,67,1.1492537313432836,0.0572778043940446,549,We need to solve our communication problem.
4359,3,3,57,63,1.1428571428571428,0.05925438255602429,549,"Well, we were bound to think of a good idea eventually."
4360,1,7,57,65,1.1384615384615384,0.04842183966159297,549,"So, I suppose you're wondering why I sent that ""see me"" memo."
4360,2,5,58,65,1.1384615384615384,0.053154903696481744,549,You'll find we have a pretty button-down culture here.
4360,2,5,58,65,1.1384615384615384,0.053154903696481744,549,The final round of the Escape Artist Championship has just begun....
4360,0,9,56,65,1.1384615384615384,0.043172969847391635,549,"Well Mrs. Watson, I hate to say it, but I think we´re a little tied up here."
4360,2,5,58,65,1.1384615384615384,0.053154903696481744,549,...I guess somebody upstairs thought there was too much leaning forward
4360,2,5,58,65,1.1384615384615384,0.053154903696481744,549,"Oh, this is much better. There are still a few women working here from the lobotomy era. So, we've made real progress."
4360,1,7,57,65,1.1384615384615384,0.04842183966159297,549,Welcome aboard! I think you'll fit in well. It's very laid back here-- even casual Fridays!
4360,1,7,57,65,1.1384615384615384,0.04842183966159297,549,"I would like to offer you the job but my hands are tied."" ""Thanks but I can't accept anything with strings attached!"
4360,1,7,57,65,1.1384615384615384,0.04842183966159297,549,"""Those who can't do, teach,"" holds true for anger management too."
4360,1,7,57,65,1.1384615384615384,0.04842183966159297,549,Perhaps a volunteer day would be better option to raise awareness?
4360,1,7,57,65,1.1384615384615384,0.04842183966159297,549,I told you this place can make you crazy.
4360,1,7,57,65,1.1384615384615384,0.04842183966159297,549,"I'd like to scratch your back, but my hands are tied..."
4360,1,7,57,65,1.1384615384615384,0.04842183966159297,549,Did you ever notice how they really keep our hands tied around here?
4360,1,7,57,65,1.1384615384615384,0.04842183966159297,549,My gay jacket is at the cleaners.
4360,1,7,57,65,1.1384615384615384,0.04842183966159297,549,"You have to be crazy to work here, but it doesn't help."
4360,0,9,56,65,1.1384615384615384,0.043172969847391635,549,"Is it me, or is it a little tight in here?"
4360,1,7,57,65,1.1384615384615384,0.04842183966159297,549,Trump supporters all seem to have one thing in common.
4360,1,7,57,65,1.1384615384615384,0.04842183966159297,549,I was crazy enough to actually take this job!
4360,2,5,58,65,1.1384615384615384,0.053154903696481744,549,But this IS Casual Friday at the House of Houdini!
4360,2,5,58,65,1.1384615384615384,0.053154903696481744,549,You lez or strait?
4360,1,7,57,65,1.1384615384615384,0.04842183966159297,549,"Now that we've done the NDA, let's talk about benefits."
4360,0,9,56,65,1.1384615384615384,0.043172969847391635,549,Let's Get Our Arms Around This Issue
4360,1,7,57,65,1.1384615384615384,0.04842183966159297,549,So I guess all those routine sanity checks were bs.
4360,1,7,57,65,1.1384615384615384,0.04842183966159297,549,"Yes, I've always said, unless you've been there...."
4360,0,9,56,65,1.1384615384615384,0.043172969847391635,549,Our policies are for your protection.
4360,1,7,57,65,1.1384615384615384,0.04842183966159297,549,"As a new recruit, you must learn how to make coffee, when you have a busy day and are all tied up."
4360,1,7,57,65,1.1384615384615384,0.04842183966159297,549,You look insane sitting on that side of the desk.
4360,3,3,59,65,1.1384615384615384,0.05749967841433098,549,"We are not an Italian company, so words, not gestures, bind us together.v"
4360,0,9,56,65,1.1384615384615384,0.043172969847391635,549,Like I said we're in this together!
4360,2,5,58,65,1.1384615384615384,0.053154903696481744,549,We actually have a very flexible vacation policy.
4360,2,5,58,65,1.1384615384615384,0.053154903696481744,549,Now.....why are we here?
4360,2,5,58,65,1.1384615384615384,0.053154903696481744,549,"I just wish HR had notified us of the ""hands to yourself"" policy before we bought these touchscreen computers."
4360,0,9,56,65,1.1384615384615384,0.043172969847391635,549,I'm not too worried about the glass ceiling just now.
4360,1,7,57,65,1.1384615384615384,0.04842183966159297,549,"This is keeping us off our cell phones, but I can't get any work done."
4360,0,9,56,65,1.1384615384615384,0.043172969847391635,549,"Well, this is going to be embarrassing at the holiday party."
4360,1,7,57,65,1.1384615384615384,0.04842183966159297,549,"Although this Psych Ward still keeps it old-school , I think it's great they are letting us try out peer-to-peer counseling!"
4360,1,7,57,65,1.1384615384615384,0.04842183966159297,549,Human Resources will be hearing about this.
4360,1,7,57,65,1.1384615384615384,0.04842183966159297,549,Have you thought about taking a little escape?
4360,2,5,58,65,1.1384615384615384,0.053154903696481744,549,Our office culture is boundless. How do you see yourself fitting in?
4360,1,7,57,65,1.1384615384615384,0.04842183966159297,549,"If you like your escape plan you can keep your escape plan, but remember that a dislocated shoulder is not covered by Obamacare."
4360,1,7,57,65,1.1384615384615384,0.04842183966159297,549,Sorry I didn't get back to you sooner. I was all tied up. I'm sure you understand.
4360,2,5,58,65,1.1384615384615384,0.053154903696481744,549,"I'm sorry, but as I'm sure you'll understand, our hands are tied."
4360,0,9,56,65,1.1384615384615384,0.043172969847391635,549,It seems we've reached a therapeutic impasse.
4360,3,3,59,65,1.1384615384615384,0.05749967841433098,549,My hands are tied. You wouldn't understand.
4360,0,9,56,65,1.1384615384615384,0.043172969847391635,549,"You know I'd love to promote you right up and through that glass ceiling, Barbara, but, well, our hands are tied."
4360,1,7,57,65,1.1384615384615384,0.04842183966159297,549,What makes you think you're experienced this field?
4360,2,5,58,65,1.1384615384615384,0.053154903696481744,549,"We have ""Outreach is an issue."
4360,1,7,57,65,1.1384615384615384,0.04842183966159297,549,Now that you're straight with me...
4360,0,9,56,65,1.1384615384615384,0.043172969847391635,549,They keep this place insanely cold.
4360,1,7,57,65,1.1384615384615384,0.04842183966159297,549,"Yes, here's something up my sleeve."
4360,2,5,58,65,1.1384615384615384,0.053154903696481744,549,Let me tell you about the benefits we offer.
4360,1,7,57,65,1.1384615384615384,0.04842183966159297,549,"Good news, you're hired! We especially like your dedication to our anti-smoking policy."
4360,2,5,58,65,1.1384615384615384,0.053154903696481744,549,The Trump people wanted the Obama transition team to dress like this.
4360,0,9,56,65,1.1384615384615384,0.043172969847391635,549,I will be tied up all afternoon and won't be able to speak to you.
4360,1,7,57,65,1.1384615384615384,0.04842183966159297,549,It's how our company's employee wellness program discourages snacking during the work day.
4360,1,7,57,65,1.1384615384615384,0.04842183966159297,549,"I'd like to let you off, but my hands are tied."
4360,2,5,58,65,1.1384615384615384,0.053154903696481744,549,You should have thought of that before we were restrained.
4360,1,7,57,65,1.1384615384615384,0.04842183966159297,549,She didn't believe me that we couldn't sign the deal because our hands were tied.
4360,2,5,58,65,1.1384615384615384,0.053154903696481744,549,Constrained...
4360,1,7,57,65,1.1384615384615384,0.04842183966159297,549,At Acme Straitjackets we like getting tied up with our work.
4360,1,7,57,65,1.1384615384615384,0.04842183966159297,549,"I would schedule you in for next week, but..."
4360,2,5,58,65,1.1384615384615384,0.053154903696481744,549,Funny I was always worried about the glass ceiling.
4360,1,7,57,65,1.1384615384615384,0.04842183966159297,549,Now we move on to your next step of training.
4360,1,7,57,65,1.1384615384615384,0.04842183966159297,549,I GUESS IT'S NOT JUST THE GLASS CEILING THAT'S HOLDING US DOWN?
4360,1,7,57,65,1.1384615384615384,0.04842183966159297,549,"When I said you could take my place as CEO for the day, I still had some reservations."
4360,1,7,57,65,1.1384615384615384,0.04842183966159297,549,My boss thought he was Houdini.
4360,0,9,56,65,1.1384615384615384,0.043172969847391635,549,"I am glad we could still talk, even if we are both tied up with work."
4360,3,3,59,65,1.1384615384615384,0.05749967841433098,549,You'll love working here--the men control everything.
4360,0,9,56,65,1.1384615384615384,0.043172969847391635,549,"Believe me if you accept the job you will get used to it, I did."
4360,2,5,58,65,1.1384615384615384,0.053154903696481744,549,"Just because we're both descendants of Houdini, doesn't mean we're bound to follow in his footsteps...."
4360,3,3,59,65,1.1384615384615384,0.05749967841433098,549,we really mishandled that case
4360,1,7,57,65,1.1384615384615384,0.04842183966159297,549,I don't understand why you are asking about constraints.
4360,1,7,57,65,1.1384615384615384,0.04842183966159297,549,I see what you mean. It *is* hard to type.
4360,0,9,56,65,1.1384615384615384,0.043172969847391635,549,"Yes I agree. After years of hard work and dedication, you did earn this promotion, but unfortunately my hands are tied."
4360,0,9,56,65,1.1384615384615384,0.043172969847391635,549,At least our pants are different.
4360,1,7,57,65,1.1384615384615384,0.04842183966159297,549,"It is hard to get anything done, but I am making progress on my addiction to click-bait."
4360,2,5,58,65,1.1384615384615384,0.053154903696481744,549,"No, I don't think you're crazy. I can certainly relate with what you said,"
4360,2,5,58,65,1.1384615384615384,0.053154903696481744,549,This way neither of us can make any sudden moves.
4360,2,5,58,65,1.1384615384615384,0.053154903696481744,549,I've been bound to tell it to you straight!
4360,1,7,57,65,1.1384615384615384,0.04842183966159297,549,How are you at typing with your toes?
4360,0,9,56,65,1.1384615384615384,0.043172969847391635,549,I believe you'll fit in well at this crazy work environment .
4360,2,5,58,65,1.1384615384615384,0.053154903696481744,549,These new company rules are literally putting us in a straightjacket!
4360,0,9,56,65,1.1384615384615384,0.043172969847391635,549,Next project - reduce red tape.
4360,1,7,57,65,1.1384615384615384,0.04842183966159297,549,"I also thought that the right answer was ""Improving the health, safety, and well-being of America"""
4360,1,7,57,65,1.1384615384615384,0.04842183966159297,549,"Your colleagues said you are constraining, but I have no idea what they're talking about."
4360,1,7,57,65,1.1384615384615384,0.04842183966159297,549,"Though some may find the company culture restraining, I actually find it quite liberating."
4360,2,5,58,65,1.1384615384615384,0.053154903696481744,549,Sit on my face
4360,1,7,57,65,1.1384615384615384,0.04842183966159297,549,As soon as I get a free hand I going to tell you what I really think of this idea.
4360,2,5,58,65,1.1384615384615384,0.053154903696481744,549,I guess Mike Pence was being literal about the straight jacket.
4360,2,5,58,65,1.1384615384615384,0.053154903696481744,549,I think you'll find our company offers a lot of creative freedom.
4360,2,5,58,65,1.1384615384615384,0.053154903696481744,549,I shouldn't of said give it to me straight.
4360,2,5,58,65,1.1384615384615384,0.053154903696481744,549,"It's my new, learn how to talk without using your hands therapy."
4360,1,7,57,65,1.1384615384615384,0.04842183966159297,549,"Here, in Human Resources, we take job fit very seriously."
4360,1,7,57,65,1.1384615384615384,0.04842183966159297,549,"So, as you can see, our hands are tied when it comes to hiring someone with mental problems."
4360,1,7,57,65,1.1384615384615384,0.04842183966159297,549,I'm just a sub
4360,0,9,56,65,1.1384615384615384,0.043172969847391635,549,Our firm has a no contact policy
4360,2,5,58,65,1.1384615384615384,0.053154903696481744,549,We should have planned our escape act more carefully before entering dead-end jobs.
4360,2,5,58,65,1.1384615384615384,0.053154903696481744,549,"You've got the right look for the White House job, but you lack the degree in insanity."
4360,1,7,57,65,1.1384615384615384,0.04842183966159297,549,You're right. The gay jackets are more fashionable and easier to get out of.
4360,1,7,57,65,1.1384615384615384,0.04842183966159297,549,"Sorry, I can't help you, work has me all tied up too!"
4360,0,9,56,65,1.1384615384615384,0.043172969847391635,549,We pull punches in this organization.
4360,1,7,57,65,1.1384615384615384,0.04842183966159297,549,Now let's see if we can communicate without using our hands.
4360,1,7,57,65,1.1384615384615384,0.04842183966159297,549,You may not be qualified to assist with the typing.
4360,1,7,57,65,1.1384615384615384,0.04842183966159297,549,"During this interview, please tell me about the ties that bind us."
4360,1,7,57,65,1.1384615384615384,0.04842183966159297,549,"We are reconsidering our ""Casual Friday"" policy."
4360,1,7,57,65,1.1384615384615384,0.04842183966159297,549,"Why do you want to work here, aside from having the opportunity to think ouside the box?"
4360,1,7,57,65,1.1384615384615384,0.04842183966159297,549,I understand you're frustration and I'd love to help but as you can see my hands are tied as well.
4360,2,5,58,65,1.1384615384615384,0.053154903696481744,549,So this is how they manage talk therapy
4360,0,9,56,65,1.1384615384615384,0.043172969847391635,549,Our nursery has everything but finger-painting. But I don't think that will be an issue for your Sally
4360,1,7,57,65,1.1384615384615384,0.04842183966159297,549,"When the company offered 'Equal Rights for all Women,' I think many of us celebrated a bit early."
4360,1,7,57,65,1.1384615384615384,0.04842183966159297,549,I give it points for warmth but it really complicates the note taking.
4360,0,9,56,65,1.1384615384615384,0.043172969847391635,549,"Kind of a strange requirement for our Trump transition team , but I'm the next four years will go quickly."
4360,1,7,57,65,1.1384615384615384,0.04842183966159297,549,We all feel constricted at work sometimes.
4360,1,7,57,65,1.1384615384615384,0.04842183966159297,549,Could you scratch my nose for me? It's okay if you have to use your shoe.
4360,1,7,57,65,1.1384615384615384,0.04842183966159297,549,"It's a new day for women in the workforce, huh."
4360,1,7,57,65,1.1384615384615384,0.04842183966159297,549,I've tried hitting that key already...
4360,2,5,58,65,1.1384615384615384,0.053154903696481744,549,We're all straight around here.
4360,2,5,58,65,1.1384615384615384,0.053154903696481744,549,"This meeting is off the record, so please keep our conversation under wraps."
4360,0,9,56,65,1.1384615384615384,0.043172969847391635,549,"This Cyber-Monday dress code is a little over the top, don't you think?"
4360,1,7,57,65,1.1384615384615384,0.04842183966159297,549,It looks like you'll fit in nicely with our corporate culture!
4360,2,5,58,65,1.1384615384615384,0.053154903696481744,549,I think we need to talk strait.
4360,1,7,57,65,1.1384615384615384,0.04842183966159297,549,"It's crazy, right?"
4360,2,5,58,65,1.1384615384615384,0.053154903696481744,549,"Rest assured, this conversation will not go beyond these walls."
4360,0,9,56,65,1.1384615384615384,0.043172969847391635,549,It's amazing that we are so tied up that we can have this time for our talk.
4360,0,9,56,65,1.1384615384615384,0.043172969847391635,549,"If you apply, I think you should expect this to be a lateral career move."
4360,1,7,57,65,1.1384615384615384,0.04842183966159297,549,"Funny, everyone asks that."
4486,4,1,61,66,1.1363636363636365,0.06063519113434977,549,"So, now, give it to me. Strait."
4486,3,3,60,66,1.1363636363636365,0.056660620696376625,549,Dress rehearsal for Jan 19 when social mobility becomes extinct.
4486,0,9,57,66,1.1363636363636365,0.042565532289603344,549,Houdini would love this.
4486,1,7,58,66,1.1363636363636365,0.04772866020849245,549,Employees say they appreciate our flexible hours.
4490,1,6,55,62,1.1290322580645162,0.048694598441382554,549,Your productivity for the last quarter is down but at least you seem to have accommodated to the new dress code.
4491,0,8,55,63,1.126984126984127,0.0422853514020739,549,"You know, the style is great, but I can't get any work done in these jackets! You?"
4491,1,6,56,63,1.126984126984127,0.04795918799660978,549,"Can I get a hug?"" ""No."
4491,0,8,55,63,1.126984126984127,0.0422853514020739,549,You would've had the job but here we are
4491,1,6,56,63,1.126984126984127,0.04795918799660978,549,I suppose you are wondering why I called you in this morning.
4491,2,4,57,63,1.126984126984127,0.0530293926364563,549,"You're right, that macrame blog is confusing."
4491,1,6,56,63,1.126984126984127,0.04795918799660978,549,"I think we can skip my next question: i.e., Do you require further training?"
4491,2,4,57,63,1.126984126984127,0.0530293926364563,549,All we need is mindfulness
4491,2,4,57,63,1.126984126984127,0.0530293926364563,549,"Yep, no glass ceiling here. We are just as able to grab the brass ring as anyone."
4491,1,6,56,63,1.126984126984127,0.04795918799660978,549,Some people find this environment to be a little stifling but I'm sure you'll be fine!
4491,1,6,56,63,1.126984126984127,0.04795918799660978,549,"But, how does it make you feel?"
4491,1,6,56,63,1.126984126984127,0.04795918799660978,549,The President wants to see you right away!
4491,1,6,56,63,1.126984126984127,0.04795918799660978,549,"You advised me to get out of that binding contract, now both our hands are tied."
4491,0,8,55,63,1.126984126984127,0.0422853514020739,549,"I offer full-service, empathy counseling. Tell me where you itch."
4491,1,6,56,63,1.126984126984127,0.04795918799660978,549,I can sit here as long as you can.
4491,1,6,56,63,1.126984126984127,0.04795918799660978,549,This discussion binds us both to secrecy
4491,0,8,55,63,1.126984126984127,0.0422853514020739,549,We've taken seamless integration to the next level.
4491,0,8,55,63,1.126984126984127,0.0422853514020739,549,Glad I'm not the only one sporting the new Ann Taylor Cyber Monday Restraint Edition pullover.
4491,1,6,56,63,1.126984126984127,0.04795918799660978,549,Your temperament will fit right in here.
4491,0,8,55,63,1.126984126984127,0.0422853514020739,549,Let's be committed to being straight with each other.
4491,0,8,55,63,1.126984126984127,0.0422853514020739,549,He said it was better than having our working capital all tied up.
4491,1,6,56,63,1.126984126984127,0.04795918799660978,549,"So, enough about our heath plan..."
4491,1,6,56,63,1.126984126984127,0.04795918799660978,549,"No, red tape is not my color"
4491,1,6,56,63,1.126984126984127,0.04795918799660978,549,Can't take my eyes off you.
4491,1,6,56,63,1.126984126984127,0.04795918799660978,549,"So we are agreed. The new corporate vision will be ""Freedom to Innovate!"""
4491,0,8,55,63,1.126984126984127,0.0422853514020739,549,"Continuing therapy, we will communicate using proper grammar, vocabulary, and face to face with no electronics or hand motions."
4491,1,6,56,63,1.126984126984127,0.04795918799660978,549,"I'd love to work with you, but I made an oath to my political party."
4491,1,6,56,63,1.126984126984127,0.04795918799660978,549,"Jill, everyone thinks you're crazy."
4491,2,4,57,63,1.126984126984127,0.0530293926364563,549,"Ms. Houdini, I'd love to help you with your suit against Acme Straitjackets, but my hands are tied..."
4491,2,4,57,63,1.126984126984127,0.0530293926364563,549,"We only think we are tied up. The Grand Inquisitor has told us we are free and happy, believe me. He knows we are wonderful people, believe me."
4491,0,8,55,63,1.126984126984127,0.0422853514020739,549,We do whatever we can to show we're equal opportunity employers!
4491,1,6,56,63,1.126984126984127,0.04795918799660978,549,I need the ladies' room.
4491,1,6,56,63,1.126984126984127,0.04795918799660978,549,"Girl, don't interrupt me."
4491,2,4,57,63,1.126984126984127,0.0530293926364563,549,President-Elect Donald Trump will be groping you surreptitiously. That goes with the job.
4491,0,8,55,63,1.126984126984127,0.0422853514020739,549,Welcome to the Houdini School of Sign Language.
4491,2,4,57,63,1.126984126984127,0.0530293926364563,549,I cannot process your loan. My hands are tied.
4491,2,4,57,63,1.126984126984127,0.0530293926364563,549,Time to roll up our sleeves and start running this asylum!
4491,2,4,57,63,1.126984126984127,0.0530293926364563,549,You're as crazy as I am. Where's our real Doctor.
4491,0,8,55,63,1.126984126984127,0.0422853514020739,549,"Don't tell me. Your hands are tied, too."
4491,2,4,57,63,1.126984126984127,0.0530293926364563,549,Welcome to the first act of your performance revue.
4491,2,4,57,63,1.126984126984127,0.0530293926364563,549,"Let me get the straight, Jackie, you're tied up until Thursday?"
4491,0,8,55,63,1.126984126984127,0.0422853514020739,549,That hornet's nest shape - that's a bold fashion statement.
4491,0,8,55,63,1.126984126984127,0.0422853514020739,549,This is help me stop tweeting!
4491,2,4,57,63,1.126984126984127,0.0530293926364563,549,Metaphysically speaking
4491,1,6,56,63,1.126984126984127,0.04795918799660978,549,"I feel this promotion will give you the freedom to move around, unrestrained by the shackles of the traditional workplace."
4491,1,6,56,63,1.126984126984127,0.04795918799660978,549,"Oh, no, you won't have to worry about carpal tunnel syndrome in this office."
4491,0,8,55,63,1.126984126984127,0.0422853514020739,549,How resourceful are you on seizing the day?
4491,0,8,55,63,1.126984126984127,0.0422853514020739,549,I know right? That wetsuit thing is SO yesterday.
4491,3,2,58,63,1.126984126984127,0.057655435593608445,549,"""How about: 'nogestures.com'?"
4491,1,6,56,63,1.126984126984127,0.04795918799660978,549,"It's nice to know we both can still peck away with our noses at Facebook, while we work."
4491,1,6,56,63,1.126984126984127,0.04795918799660978,549,"keeps me away from the marshmallows, whadda you got?"
4491,1,6,56,63,1.126984126984127,0.04795918799660978,549,As soon as HR sends me the confirmation of your lobotomy you can start anytime after the 10th. Welcome aboard.
4491,2,4,57,63,1.126984126984127,0.0530293926364563,549,"Wait, you voted for Hillary? I voted for Donald!"
4491,2,4,57,63,1.126984126984127,0.0530293926364563,549,""" "" ""After the election we make them mandatory."
4491,1,6,56,63,1.126984126984127,0.04795918799660978,549,I think it's 59 Shades Too Dark
4491,2,4,57,63,1.126984126984127,0.0530293926364563,549,"As you are well aware, our Human Resource Handbook Policy binds us to secrecy in this conversation."
4491,1,6,56,63,1.126984126984127,0.04795918799660978,549,"No, Judy, I said we need to be *strait* with each other."
4491,1,6,56,63,1.126984126984127,0.04795918799660978,549,"Is it just me, or are these new work uniforms too restrictive?"
4491,2,4,57,63,1.126984126984127,0.0530293926364563,549,So this is what they mean by a zero sum game.
4491,2,4,57,63,1.126984126984127,0.0530293926364563,549,My nose has developed cartilage tunnel syndrome.
4491,1,6,56,63,1.126984126984127,0.04795918799660978,549,It's part of our new Upward Bound program.
4491,2,4,57,63,1.126984126984127,0.0530293926364563,549,I was told you were fully-clothed and a little bit sane at the office party. What was THAT about?
4491,1,6,56,63,1.126984126984127,0.04795918799660978,549,This idea of teachers also having to wear school uniforms is crazy.
4491,1,6,56,63,1.126984126984127,0.04795918799660978,549,It's both empathy and a terrific saving on manicures!
4491,1,6,56,63,1.126984126984127,0.04795918799660978,549,"I'm sorry, we would hire you but our hands are tied."" ""That's okay, but I'm really crazy for this job!"
4491,0,8,55,63,1.126984126984127,0.0422853514020739,549,Just because we said we were tired of being secretaries.
4491,1,6,56,63,1.126984126984127,0.04795918799660978,549,"I don't think you are crazy, either... but there is not much I can do now, my hands are tied."
4491,1,6,56,63,1.126984126984127,0.04795918799660978,549,I think our new President is getting paranoid.
4491,1,6,56,63,1.126984126984127,0.04795918799660978,549,"The oderly said if we gave up trying, the instructions were at SJacket.com."
4491,1,6,56,63,1.126984126984127,0.04795918799660978,549,"I’d love to issue you a treadmill desk, but my hands are tied."
4491,1,6,56,63,1.126984126984127,0.04795918799660978,549,I like your jacket but I really loooove your boots!
4491,1,6,56,63,1.126984126984127,0.04795918799660978,549,Ok - you go first...
4491,2,4,57,63,1.126984126984127,0.0530293926364563,549,"O course, you know that this job entails you to mix with the Very, Very Nervous!"
4491,0,8,55,63,1.126984126984127,0.0422853514020739,549,I guess politics weren't the best thing to discuss in the office.
4491,3,2,58,63,1.126984126984127,0.057655435593608445,549,Give me one good reason to hire you Mrs. Houdini?
4491,0,8,55,63,1.126984126984127,0.0422853514020739,549,Any tips on scratching your nose?
4491,2,4,57,63,1.126984126984127,0.0530293926364563,549,I'm finding Mr. Houdini's dress code to be a bit restrictive.
4491,0,8,55,63,1.126984126984127,0.0422853514020739,549,What are you in for?
4491,2,4,57,63,1.126984126984127,0.0530293926364563,549,They say this is the best way end the compulsive hugging.
4491,3,2,58,63,1.126984126984127,0.057655435593608445,549,"Sorry for the misunderstanding, but no, there's no DENTAL plan..."
4491,3,2,58,63,1.126984126984127,0.057655435593608445,549,This job sucks!
4491,0,8,55,63,1.126984126984127,0.0422853514020739,549,"Our environment?"" ""Oh, we pretty much stay to ourselves, but we do have casual Fridays!"
4491,1,6,56,63,1.126984126984127,0.04795918799660978,549,Those who are ready for our message find us. You found us.
4491,2,4,57,63,1.126984126984127,0.0530293926364563,549,"Maybe this tech-free interview wasn't such a good idea, my screen saver just kicked in."
4491,0,8,55,63,1.126984126984127,0.0422853514020739,549,"Our employees dress code does follow the strait and narrow, but fortunately, we do observe casual Friday!"
4491,1,6,56,63,1.126984126984127,0.04795918799660978,549,"Let's get one thing straight. Ok, good."
4491,3,2,58,63,1.126984126984127,0.057655435593608445,549,It's peer counseling.
4491,1,6,56,63,1.126984126984127,0.04795918799660978,549,"OK,JUST GIVE IT TO ME STRAIGHT"
4491,1,6,56,63,1.126984126984127,0.04795918799660978,549,Do you think you could scratch my itch with your boot heel?
4491,0,8,55,63,1.126984126984127,0.0422853514020739,549,I told you you'd grow into it.
4491,2,4,57,63,1.126984126984127,0.0530293926364563,549,"Alexa, play ""Crazy Train."""
4491,1,6,56,63,1.126984126984127,0.04795918799660978,549,"Did you say try left click or left ""kick"""
4491,0,8,55,63,1.126984126984127,0.0422853514020739,549,"Well, at least we now have lots of time to get to know each other!"
4491,1,6,56,63,1.126984126984127,0.04795918799660978,549,You appear to have the right qualifications to be our new bondage counselor.
4491,2,4,57,63,1.126984126984127,0.0530293926364563,549,That's right...on West Fifth...'Houdini's Haberdashery' !!
4491,0,8,55,63,1.126984126984127,0.0422853514020739,549,Excellent. Now pass the water tank test and you’re in the rubber room.
4491,0,8,55,63,1.126984126984127,0.0422853514020739,549,This is the only way I can have a conversation.
4491,3,2,58,63,1.126984126984127,0.057655435593608445,549,I guess we should have opted for the original Outward Bound expedition.
4491,0,8,55,63,1.126984126984127,0.0422853514020739,549,HR says they're slimming.
4491,2,4,57,63,1.126984126984127,0.0530293926364563,549,"Despite what you may have heard, the constraints on advancement by women in this company are clearly a myth."
4491,2,4,57,63,1.126984126984127,0.0530293926364563,549,Our hands are tied...there's no way we can reach out to our customers.
4491,1,6,56,63,1.126984126984127,0.04795918799660978,549,We have a top-notch hands off policy.
4491,1,6,56,63,1.126984126984127,0.04795918799660978,549,"Yeah, but we can't cash our pay check either."
4491,0,8,55,63,1.126984126984127,0.0422853514020739,549,What do I have to do to get you to be part of our institution?
4491,0,8,55,63,1.126984126984127,0.0422853514020739,549,I'm not big on flu shots either.
4491,1,6,56,63,1.126984126984127,0.04795918799660978,549,The election has gotten us all tied up in knots.
4491,3,2,58,63,1.126984126984127,0.057655435593608445,549,"Bite me?, Hmmmmmmm, I may have a spot for you after all...."
4491,1,6,56,63,1.126984126984127,0.04795918799660978,549,"HR said, ""No touching."""
4491,0,8,55,63,1.126984126984127,0.0422853514020739,549,"I'm with you! I know four years is a long time, but it's better than hurting yourself or others."
4491,1,6,56,63,1.126984126984127,0.04795918799660978,549,This is what I call an impasse.
4491,2,4,57,63,1.126984126984127,0.0530293926364563,549,The rule is no finger pointing in the office. To what else do you object?
4491,1,6,56,63,1.126984126984127,0.04795918799660978,549,What makes you think you are right for this job? What makes you think you are right for this job?
4491,1,6,56,63,1.126984126984127,0.04795918799660978,549,You'll get nothing but straight talk at this company.
4491,0,8,55,63,1.126984126984127,0.0422853514020739,549,Siri says we're too bound up on ourselves.
4491,0,8,55,63,1.126984126984127,0.0422853514020739,549,I'd be much more productive if I wasn't so tied up.
4491,1,6,56,63,1.126984126984127,0.04795918799660978,549,It's so we can't grab back. Welcome to the transition team.
4491,0,8,55,63,1.126984126984127,0.0422853514020739,549,Well I feel like I'm in a straitjacket working here too.
4491,1,6,56,63,1.126984126984127,0.04795918799660978,549,One way to keep us docile.
4491,0,8,55,63,1.126984126984127,0.0422853514020739,549,"I want to have it out, no holds barred."
4491,2,4,57,63,1.126984126984127,0.0530293926364563,549,The boss said we can choose - the diet or the job.
4491,3,2,58,63,1.126984126984127,0.057655435593608445,549,"Now that we're out of our comfort zone, we can really manage HR."
4491,0,8,55,63,1.126984126984127,0.0422853514020739,549,"So, what do you think? Do you want to take this ride?"
4491,1,6,56,63,1.126984126984127,0.04795918799660978,549,"""Do you feel what if feel""?"
4491,0,8,55,63,1.126984126984127,0.0422853514020739,549,The first female US president? Seriously? When did you dream of that?
4491,0,8,55,63,1.126984126984127,0.0422853514020739,549,". . . and you'll be responsible for my trash, spam, junk mail and medications."
4491,0,8,55,63,1.126984126984127,0.0422853514020739,549,"Speaking for myself, I don't think you'll find this job ties you up in any way"
4491,0,8,55,63,1.126984126984127,0.0422853514020739,549,"You'd definitely fit in, but how do you think you'd benefit Asylum Seekers Anonymous?"
4491,0,8,55,63,1.126984126984127,0.0422853514020739,549,"""I'm interviewing for an assistant to help me run the asylum""."
4491,2,4,57,63,1.126984126984127,0.0530293926364563,549,It's the latest directive from human resources.
4491,0,8,55,63,1.126984126984127,0.0422853514020739,549,We're looking for someone with hands-on experience.
4491,0,8,55,63,1.126984126984127,0.0422853514020739,549,They are really serious about the no cat fighting rule at this company.
4491,1,6,56,63,1.126984126984127,0.04795918799660978,549,"Any thoughts, after a year in our Inhuman Resources department?"
4491,3,2,58,63,1.126984126984127,0.057655435593608445,549,"Unfortunetly, My hands are tied too."
4491,2,4,57,63,1.126984126984127,0.0530293926364563,549,"We appreciate you coming in, but I'm not sure this is the best fit."
4491,2,4,57,63,1.126984126984127,0.0530293926364563,549,In this company we are alt-left and alt-right.
4491,1,6,56,63,1.126984126984127,0.04795918799660978,549,"Given the dire straits in which we find ourselves, cutbacks are likely."
4491,1,6,56,63,1.126984126984127,0.04795918799660978,549,"... but looking at your performance last quarter, I can't tell 'how' committed you are."
4491,1,6,56,63,1.126984126984127,0.04795918799660978,549,"As you know, we have room for advancement."
4491,1,6,56,63,1.126984126984127,0.04795918799660978,549,How do we get out of the clutches of the super intelligent software?
4491,1,6,56,63,1.126984126984127,0.04795918799660978,549,You get to be Hannibal next session.
4491,0,8,55,63,1.126984126984127,0.0422853514020739,549,"Peggy, we need to be straight with one another."
4491,1,6,56,63,1.126984126984127,0.04795918799660978,549,Can't play cards in here. Nobody's got a full deck.
4491,2,4,57,63,1.126984126984127,0.0530293926364563,549,I'm soooo hungry.
4491,3,2,58,63,1.126984126984127,0.057655435593608445,549,The President-elect wants me to ask you if you have any problem with being a team player.
4491,3,2,58,63,1.126984126984127,0.057655435593608445,549,"I believe these one-on-one meetings, show the team that we are all in this together."
4491,2,4,57,63,1.126984126984127,0.0530293926364563,549,"Casual Friday. What do you miss the most?"" ""Bathroom breaks."
4491,0,8,55,63,1.126984126984127,0.0422853514020739,549,"Work-life balance has been a source of stress for me too, thanks for asking."
4491,1,6,56,63,1.126984126984127,0.04795918799660978,549,Yes Mary hr said this is an approved discipline for surfing the web instead of working.
4491,1,6,56,63,1.126984126984127,0.04795918799660978,549,"I'm sorry. It used to be that just my hands were tied, but you understand."
4491,0,8,55,63,1.126984126984127,0.0422853514020739,549,"So, you want to ""talk"" .........Why?:.......can't it wait until we can text or twitter?"
4491,0,8,55,63,1.126984126984127,0.0422853514020739,549,This is a competitive office.
4491,1,6,56,63,1.126984126984127,0.04795918799660978,549,We find the devil makes work for idle hands here.
4491,0,8,55,63,1.126984126984127,0.0422853514020739,549,Computer has voice recognition.
4491,1,6,56,63,1.126984126984127,0.04795918799660978,549,"Sadly, our scarf-tying workshop was less successful than we'd. hoped."
4491,1,6,56,63,1.126984126984127,0.04795918799660978,549,It's a new technique called therapist-client empathy.
4491,1,6,56,63,1.126984126984127,0.04795918799660978,549,Is this what they call effective verbal communicating?
4491,1,6,56,63,1.126984126984127,0.04795918799660978,549,"I'd love to help, but I'm sure you got the picture........"
4491,0,8,55,63,1.126984126984127,0.0422853514020739,549,I have some constrictive criticism of your last report.
4491,0,8,55,63,1.126984126984127,0.0422853514020739,549,Welcome to Guantano Bay EEO. What complaint are you considering?
4491,2,4,57,63,1.126984126984127,0.0530293926364563,549,I like to think of it as the art of the deal.
4491,0,8,55,63,1.126984126984127,0.0422853514020739,549,"Uh, we were looking for someone with a little more original thinking."
4491,3,2,58,63,1.126984126984127,0.057655435593608445,549,I think this is a job you can really sink your teeth into!
4491,1,6,56,63,1.126984126984127,0.04795918799660978,549,"Sit up straight, Tina."
4491,2,4,57,63,1.126984126984127,0.0530293926364563,549,"The office Social Media Challenge, aimed at reducing unproductive activity during work hours, took a bizarre turn when production came to a complete halt."
4491,2,4,57,63,1.126984126984127,0.0530293926364563,549,This is just CRAZY!!
4491,1,6,56,63,1.126984126984127,0.04795918799660978,549,For this session can you try not to project yourself on to others.
4491,1,6,56,63,1.126984126984127,0.04795918799660978,549,"At Fairfax Industries, you really have to WANT to work."
4491,1,6,56,63,1.126984126984127,0.04795918799660978,549,"The instructions are voice activated, but they call for a third party."
4491,0,8,55,63,1.126984126984127,0.0422853514020739,549,"Your title, ""Crazier Than Thou,"" really bothers me."
4491,1,6,56,63,1.126984126984127,0.04795918799660978,549,This way I can only sexually harass you verbally.
4491,1,6,56,63,1.126984126984127,0.04795918799660978,549,Let's be straight with each other!
4491,2,4,57,63,1.126984126984127,0.0530293926364563,549,You've been exhibiting frequent escape behaviors at work lately.
4491,1,6,56,63,1.126984126984127,0.04795918799660978,549,"The instructions say, ""You're supposed to untie me first."""
4491,0,8,55,63,1.126984126984127,0.0422853514020739,549,"Yes, yes, I can fully sympathize. I know just how you feel."
4491,1,6,56,63,1.126984126984127,0.04795918799660978,549,Your hired if you can escape before I do.
4665,0,8,56,64,1.125,0.041666666666666664,549,Break time was the least favorite activity at the Houdini School of Magic.
4665,1,6,57,64,1.125,0.0472455591261534,549,WHERE IS HOUDINI WHEN YOU NEED HIM?
4665,0,8,56,64,1.125,0.041666666666666664,549,"Yes, now I'm more comfortable now"
4665,0,8,56,64,1.125,0.041666666666666664,549,"I'm known as a real fanatic in our hands-free tech division, but I've been asked to show some restraint."
4665,0,8,56,64,1.125,0.041666666666666664,549,"I'm glad that you are in full agreement with our hands-off doctrine. Oh, and welcome to the Libertarian party."
4665,1,6,57,64,1.125,0.0472455591261534,549,"In this company, it's every man for himself."
4671,2,4,59,65,1.123076923076923,0.051458031385614056,549,Straight-jackets are in this year.
4672,2,4,61,67,1.1194029850746268,0.04997687416213937,549,I'm going to give it to you straight.
4673,1,5,55,61,1.1147540983606556,0.04732379255652672,549,In this job out of body experiences helps in a pinch.
4673,2,3,56,61,1.1147540983606556,0.05278247274773007,549,"After I saw you last week without you jacket, Zoe, I just knew this was the right weight loss program for me!"
4673,0,7,54,61,1.1147540983606556,0.04114721441970865,549,Our CEO takes a dim view of physical harassment in the work place.
4673,1,5,55,61,1.1147540983606556,0.04732379255652672,549,Simple Simon says.....
4673,1,5,55,61,1.1147540983606556,0.04732379255652672,549,"Let me get this straight, you want to teach a baton twirling class?"
4673,1,5,55,61,1.1147540983606556,0.04732379255652672,549,"This is not what I thought ""self restraint in our viewpoints"" would mean."
4673,2,3,56,61,1.1147540983606556,0.05278247274773007,549,"That's right, this is our only requirement of applicants here at the Whodini Academy. And your time starts now."
4673,1,5,55,61,1.1147540983606556,0.04732379255652672,549,Are we crazy or just tied up?
4673,1,5,55,61,1.1147540983606556,0.04732379255652672,549,At least it makes Casual Friday feel special tomorrow.
4673,1,5,55,61,1.1147540983606556,0.04732379255652672,549,Now you know what it takes to break the glass ceiling in this company
4673,1,5,55,61,1.1147540983606556,0.04732379255652672,549,Oh no you don't! I'm the straight man.
4673,0,7,54,61,1.1147540983606556,0.04114721441970865,549,We're looking to become a more open company. We're looking for people who are not so tightly wound.
4673,1,5,55,61,1.1147540983606556,0.04732379255652672,549,"No, we don't require that you've been trained in cursive."
4673,0,7,54,61,1.1147540983606556,0.04114721441970865,549,"It started when my boss got too ""Handsy""."
4673,2,3,56,61,1.1147540983606556,0.05278247274773007,549,Empathy is so important if we are to get a breakthrough.
4673,1,5,55,61,1.1147540983606556,0.04732379255652672,549,"I know you'll like it here, and you only need to say: ""Hey, Siri!"""
4673,2,3,56,61,1.1147540983606556,0.05278247274773007,549,Let's begin. What's your favorite inappropriate interview question?
4673,0,7,54,61,1.1147540983606556,0.04114721441970865,549,"I agree with you, we're bound together by our work ethic."
4673,1,5,55,61,1.1147540983606556,0.04732379255652672,549,"I'm feeling stale, mate."
4673,1,5,55,61,1.1147540983606556,0.04732379255652672,549,You're perfect! To whom should we send the paychecks?
4673,1,5,55,61,1.1147540983606556,0.04732379255652672,549,I'm sorry but my hands are tied; I'm sure you can identify.
4673,1,5,55,61,1.1147540983606556,0.04732379255652672,549,Rule 1: Avoid standing ovations when the boss says he's going on vacation.
4673,1,5,55,61,1.1147540983606556,0.04732379255652672,549,"I understand that we have new purchasing restraints, but this seems excessive."
4673,1,5,55,61,1.1147540983606556,0.04732379255652672,549,"Until we both see him take the oath of office, we should assume it's mass psychosis."
4673,1,5,55,61,1.1147540983606556,0.04732379255652672,549,HR always had a funny way of straightening out conflicts.
4673,1,5,55,61,1.1147540983606556,0.04732379255652672,549,I think we got this straight!
4673,0,7,54,61,1.1147540983606556,0.04114721441970865,549,It says here on your resume that you are a go-getter. That's cute.
4673,1,5,55,61,1.1147540983606556,0.04732379255652672,549,Cease all motor functions?
4673,0,7,54,61,1.1147540983606556,0.04114721441970865,549,We've found it necessary to put strict measures in place to prevent non-business computer usage.
4673,1,5,55,61,1.1147540983606556,0.04732379255652672,549,You appear to be even more wound up than I am. You should fit in here just fine.
4673,1,5,55,61,1.1147540983606556,0.04732379255652672,549,So how would your rate your project management skills.?
4673,1,5,55,61,1.1147540983606556,0.04732379255652672,549,Looks like we have to type with our noses now.
4673,1,5,55,61,1.1147540983606556,0.04732379255652672,549,"You'll love working here, I'm sure you'll fit right in, we have a great company culture."
4673,0,7,54,61,1.1147540983606556,0.04114721441970865,549,First the glass ceiling...now this. Do you think a brooch will help?
4673,1,5,55,61,1.1147540983606556,0.04732379255652672,549,I can't. Neither can I.
4673,0,7,54,61,1.1147540983606556,0.04114721441970865,549,"I'm sorry, and I'm sure you understand, but my hands are tied"
4673,0,7,54,61,1.1147540983606556,0.04114721441970865,549,I like it that you seem able to keep things to yourself.
4673,0,7,54,61,1.1147540983606556,0.04114721441970865,549,It helps us stay head strong.
4673,1,5,55,61,1.1147540983606556,0.04732379255652672,549,So....you think you have problems?
4673,1,5,55,61,1.1147540983606556,0.04732379255652672,549,When you interview at Google on a dare.
4673,1,5,55,61,1.1147540983606556,0.04732379255652672,549,Glass ceiling? We had one until Gladys Clodfelter shattered it. The new one is a bit more visible.
4673,2,3,56,61,1.1147540983606556,0.05278247274773007,549,This discussion has us both tied up in knots.
4673,2,3,56,61,1.1147540983606556,0.05278247274773007,549,This always seems to happen when we share a recipe on line for fruitcake.
4673,0,7,54,61,1.1147540983606556,0.04114721441970865,549,"The instructions say ""use of electronic devices is strictly prohibited""."
4673,0,7,54,61,1.1147540983606556,0.04114721441970865,549,I really appreciate your structured leadership style.
4673,2,3,56,61,1.1147540983606556,0.05278247274773007,549,Draw!
4673,0,7,54,61,1.1147540983606556,0.04114721441970865,549,We are empowered to do everything except move.
4673,2,3,56,61,1.1147540983606556,0.05278247274773007,549,"So, what makes you qualified to be a serial killer?"
4673,0,7,54,61,1.1147540983606556,0.04114721441970865,549,What characteristic do you have that makes you best suited for the job?
4673,1,5,55,61,1.1147540983606556,0.04732379255652672,549,And then I told her we were straight and would like a new jacket for Christmas.
4723,1,5,56,62,1.1129032258064515,0.046591027055115,549,It seems like the inmates are running the asylum.
4723,0,7,55,62,1.1129032258064515,0.04052040316035677,549,"Yeah, sorry, I'm not feeling you either."
4723,2,3,57,62,1.1129032258064515,0.05195714129764132,549,How's your cubicle?
4723,0,7,55,62,1.1129032258064515,0.04052040316035677,549,Tell me about your past experiences in the business.
4723,1,5,56,62,1.1129032258064515,0.046591027055115,549,You can have bow knots if you don't like the half hitch.
4723,0,7,55,62,1.1129032258064515,0.04052040316035677,549,"If we aren't straight with each other now, no one else will be"
4723,1,5,56,62,1.1129032258064515,0.046591027055115,549,"Houdini says ""Hello"""
4723,0,7,55,62,1.1129032258064515,0.04052040316035677,549,"So there, I hope you can really, really, REALLY trust me now."
4723,1,5,56,62,1.1129032258064515,0.046591027055115,549,"This time of year, I find my schedule is crazy too"
4723,1,5,56,62,1.1129032258064515,0.046591027055115,549,"I'm sorry, but a glass ceiling isn't in this year's budget."
4723,0,7,55,62,1.1129032258064515,0.04052040316035677,549,Let's wrap things up quickly.
4723,1,5,56,62,1.1129032258064515,0.046591027055115,549,I'm sorry I can't help you. My hands are also tied.
4723,1,5,56,62,1.1129032258064515,0.046591027055115,549,"Brace yourself, it suppose to be great."
4723,2,3,57,62,1.1129032258064515,0.05195714129764132,549,We're bound to come up with a joint decision.
4723,1,5,56,62,1.1129032258064515,0.046591027055115,549,"My nose itches too, but how do you feel about it?"
4723,0,7,55,62,1.1129032258064515,0.04052040316035677,549,This is knot the job I was expecting.
4723,0,7,55,62,1.1129032258064515,0.04052040316035677,549,It's most important that you fit our culture; we'll train you for the rest.
4723,2,3,57,62,1.1129032258064515,0.05195714129764132,549,I see you've gotten a little crazy with work too.
4723,1,5,56,62,1.1129032258064515,0.046591027055115,549,I need an assistant I can count on.
4723,1,5,56,62,1.1129032258064515,0.046591027055115,549,Tell it to me straight.
4723,3,1,58,62,1.1129032258064515,0.056818705208722176,549,"What do you mean, ""artial marts""?"
4723,0,7,55,62,1.1129032258064515,0.04052040316035677,549,"Sorry Jan, we can't give you the raise you wanted, our hands are tied. Sorry Bob, I can't give you that report you wanted, my hands are tied."
4723,0,7,55,62,1.1129032258064515,0.04052040316035677,549,Management believes tying one arm behind your back is cheating.
4723,0,7,55,62,1.1129032258064515,0.04052040316035677,549,Are we going to far with this anti-embrace policy?
4723,1,5,56,62,1.1129032258064515,0.046591027055115,549,How do I know that you'll work out fine here? It takes one to know one.
4723,1,5,56,62,1.1129032258064515,0.046591027055115,549,"All tied up at the moment, can you come again when we're free?"
4723,2,3,57,62,1.1129032258064515,0.05195714129764132,549,Are you fit? To be tied...
4723,1,5,56,62,1.1129032258064515,0.046591027055115,549,I!d call it a wrap myself!
4723,0,7,55,62,1.1129032258064515,0.04052040316035677,549,I'd say at this point in our session it's a tie.
4723,0,7,55,62,1.1129032258064515,0.04052040316035677,549,Did you put the lime in the coconut too?
4723,1,5,56,62,1.1129032258064515,0.046591027055115,549,They really should reintroduce Casual Friday.
4723,1,5,56,62,1.1129032258064515,0.046591027055115,549,I see you have a hobby of being an escape artist as well.
4723,1,5,56,62,1.1129032258064515,0.046591027055115,549,Can you type on the computer with your nose
4723,1,5,56,62,1.1129032258064515,0.046591027055115,549,Think outside the box.
4723,1,5,56,62,1.1129032258064515,0.046591027055115,549,Mine is about social morays too!
4723,1,5,56,62,1.1129032258064515,0.046591027055115,549,Ok I promise I won't flat iron my hair every day!
4723,1,5,56,62,1.1129032258064515,0.046591027055115,549,You’ll find that productivity actually increases.
4723,1,5,56,62,1.1129032258064515,0.046591027055115,549,We have to keep it strictly professional.
4723,0,7,55,62,1.1129032258064515,0.04052040316035677,549,I don't think you would be a useful employee
4723,1,5,56,62,1.1129032258064515,0.046591027055115,549,"The boss said, no touchy feely in our discussion."
4723,0,7,55,62,1.1129032258064515,0.04052040316035677,549,oh fuck
4723,1,5,56,62,1.1129032258064515,0.046591027055115,549,At least we're not tongue tied...Google?
4723,1,5,56,62,1.1129032258064515,0.046591027055115,549,We're both a good fit for this hands-on project.
4723,1,5,56,62,1.1129032258064515,0.046591027055115,549,I see you have some gaps in your confinement history?
4723,1,5,56,62,1.1129032258064515,0.046591027055115,549,I need my hands to answer your questions.
4723,1,5,56,62,1.1129032258064515,0.046591027055115,549,They'd like us to start thinking outside the box.
4723,0,7,55,62,1.1129032258064515,0.04052040316035677,549,These things take time.....
4723,1,5,56,62,1.1129032258064515,0.046591027055115,549,"Deep down, I'm a little loosey-goosey."
4723,1,5,56,62,1.1129032258064515,0.046591027055115,549,"So, we lost the election. Get over it."
4723,2,3,57,62,1.1129032258064515,0.05195714129764132,549,Straight talk
4723,0,7,55,62,1.1129032258064515,0.04052040316035677,549,"Tied up or not, she insists that we attend!"
4723,1,5,56,62,1.1129032258064515,0.046591027055115,549,"So, do you want to join the Harry Houdini club."
4723,3,1,58,62,1.1129032258064515,0.056818705208722176,549,This communication skills program was developed for Italians.
4723,0,7,55,62,1.1129032258064515,0.04052040316035677,549,"Yes, we all get this office equipment but the company strongly discourages manual labor."
4723,1,5,56,62,1.1129032258064515,0.046591027055115,549,These restrictive health care policies are crazy!
4723,1,5,56,62,1.1129032258064515,0.046591027055115,549,I'm thinking about going straight. And buying a new jacket.
4723,0,7,55,62,1.1129032258064515,0.04052040316035677,549,mine itches in the same place
4723,1,5,56,62,1.1129032258064515,0.046591027055115,549,"Sure, you're uptight. We're all uptight. It's the zeitgeist."
4723,2,3,57,62,1.1129032258064515,0.05195714129764132,549,I see we're both crazy about Commes des Garcons !
4723,0,7,55,62,1.1129032258064515,0.04052040316035677,549,It's mentioned in the fine print in Clause 10 on Corporate Communications.
4723,2,3,57,62,1.1129032258064515,0.05195714129764132,549,I can relate to your feelings of bondage.
4723,0,7,55,62,1.1129032258064515,0.04052040316035677,549,"I can't help with your request for a salary increase. As you can see, my hands are tied."
4723,2,3,57,62,1.1129032258064515,0.05195714129764132,549,This happens just the day when I have to write.
4723,1,5,56,62,1.1129032258064515,0.046591027055115,549,It always starts like this.
4723,0,7,55,62,1.1129032258064515,0.04052040316035677,549,You blinked.
4723,2,3,57,62,1.1129032258064515,0.05195714129764132,549,"We escaped the silos, but not the straight-jackets."
4723,1,5,56,62,1.1129032258064515,0.046591027055115,549,I guess two wrongs really don't make a right.
4723,2,3,57,62,1.1129032258064515,0.05195714129764132,549,"We've got 5 more minutes of relaxation to squeeze in, and THEN we can finally get back to work!"
4723,1,5,56,62,1.1129032258064515,0.046591027055115,549,"You start first. No you start first. Okay, I'll start. Hey, how about me? Then you start first. No, you start first."
4723,0,7,55,62,1.1129032258064515,0.04052040316035677,549,"I'd like to relax the dress code, but this is HR's dungeon and I've forgotten the safe word."
4723,1,5,56,62,1.1129032258064515,0.046591027055115,549,What's so great about bondage?
4723,1,5,56,62,1.1129032258064515,0.046591027055115,549,"The questions at a Google interview are nothing compared to the qualifications testing at Houdini, Inc."
4723,1,5,56,62,1.1129032258064515,0.046591027055115,549,I felt this might help you get in touch with your masochistic fetishes.
4723,1,5,56,62,1.1129032258064515,0.046591027055115,549,There are no golden handcuffs for managers at this firm.
4723,1,5,56,62,1.1129032258064515,0.046591027055115,549,Soooo...your place or mine?
4723,0,7,55,62,1.1129032258064515,0.04052040316035677,549,Harry Houdini was my father.
4723,1,5,56,62,1.1129032258064515,0.046591027055115,549,He seemed like such a nice young salesman.
4723,2,3,57,62,1.1129032258064515,0.05195714129764132,549,Soooo ... Seen any good TV shows lately?
4723,1,5,56,62,1.1129032258064515,0.046591027055115,549,What are you here for? I'm in for cat allergies.
4723,1,5,56,62,1.1129032258064515,0.046591027055115,549,"Unfortunately, you're visiting during our mandated relaxation hour."
4723,0,7,55,62,1.1129032258064515,0.04052040316035677,549,"What this means is, I really want to be straight with you."
4723,0,7,55,62,1.1129032258064515,0.04052040316035677,549,At least we didn't cave on the gags.
4723,1,5,56,62,1.1129032258064515,0.046591027055115,549,Working here definitely has a bit of stress!
4723,1,5,56,62,1.1129032258064515,0.046591027055115,549,Maybe you should leave the kids at home for the next parent-teacher conference.
4723,1,5,56,62,1.1129032258064515,0.046591027055115,549,Hou Done It?
4723,1,5,56,62,1.1129032258064515,0.046591027055115,549,"I heard you were a breakout star, but I might have gone overboard"
4723,0,7,55,62,1.1129032258064515,0.04052040316035677,549,You would not believe what I have gone through!
4723,0,7,55,62,1.1129032258064515,0.04052040316035677,549,That's so untouching!
4723,1,5,56,62,1.1129032258064515,0.046591027055115,549,The company's new policy on conflict resolution had potential.
4723,1,5,56,62,1.1129032258064515,0.046591027055115,549,"The escape key! D@mit! I'm a loan processor, not Houdini!"
4723,1,5,56,62,1.1129032258064515,0.046591027055115,549,"No, we don't usually have ""all hands"" meetings at this office."
4723,0,7,55,62,1.1129032258064515,0.04052040316035677,549,Well that was a productive meeting.
4723,0,7,55,62,1.1129032258064515,0.04052040316035677,549,Turns out commandeering an insane aslyum has its drawbacks.
4723,1,5,56,62,1.1129032258064515,0.046591027055115,549,"I have been typing copious notes, and I am very impressed by your qualifications!"
4723,1,5,56,62,1.1129032258064515,0.046591027055115,549,We are looking for a steady pair of hands to run the division
4723,2,3,57,62,1.1129032258064515,0.05195714129764132,549,I told you to have breakfast
4723,1,5,56,62,1.1129032258064515,0.046591027055115,549,TRASH: Trump Russian Anti-hack Strategic Headquarters
4723,2,3,57,62,1.1129032258064515,0.05195714129764132,549,"How we supposed to ""Lean In"" around here when all they do is set us up to fail?"
4723,1,5,56,62,1.1129032258064515,0.046591027055115,549,Do you find working here to your liking?
4723,1,5,56,62,1.1129032258064515,0.046591027055115,549,"They call these ""straitjackets"" but I don't think mine is working..."
4723,0,7,55,62,1.1129032258064515,0.04052040316035677,549,I've always know I was straight.
4723,0,7,55,62,1.1129032258064515,0.04052040316035677,549,In what ways do you think you can make a contribution to our company?
4723,1,5,56,62,1.1129032258064515,0.046591027055115,549,"I'm sorry I didn't send you a check, I've been tied up."
4723,1,5,56,62,1.1129032258064515,0.046591027055115,549,This Egyptology mummy sensitivity homework is starting to get old.
4723,0,7,55,62,1.1129032258064515,0.04052040316035677,549,Wow! I didn't realize how serious the boss was about device-free Fridays.
4723,1,5,56,62,1.1129032258064515,0.046591027055115,549,Who ever answers their phone - picks up the check at lunch.
4723,1,5,56,62,1.1129032258064515,0.046591027055115,549,At least we're Buddhists.
4723,0,7,55,62,1.1129032258064515,0.04052040316035677,549,"I was for the front button uniform, but as you can see, my hands are tied."
4723,1,5,56,62,1.1129032258064515,0.046591027055115,549,"To begin with, we are evenly yoked."
4723,1,5,56,62,1.1129032258064515,0.046591027055115,549,"Among other benefits, the company also provides comprehensive burial insurance."
4723,2,3,57,62,1.1129032258064515,0.05195714129764132,549,What if headquarters doesn't have a budget line for ransom issues?
4723,0,7,55,62,1.1129032258064515,0.04052040316035677,549,He leaves me so tied up
4723,1,5,56,62,1.1129032258064515,0.046591027055115,549,"Oh, I agree. The pussy-bow pantsuit is so pre-November 9."
4723,0,7,55,62,1.1129032258064515,0.04052040316035677,549,My hands are tied too.
4723,1,5,56,62,1.1129032258064515,0.046591027055115,549,Asylums aren't easy to run.
4723,2,3,57,62,1.1129032258064515,0.05195714129764132,549,It's for your own good. It's the new normal.
4723,2,3,57,62,1.1129032258064515,0.05195714129764132,549,I already miss the glass ceiling.
4723,2,3,57,62,1.1129032258064515,0.05195714129764132,549,"Ok, let's start again: I think your husband was right..."
4723,2,3,57,62,1.1129032258064515,0.05195714129764132,549,I find this caption contest quite limiting. Don't you?
4723,2,3,57,62,1.1129032258064515,0.05195714129764132,549,"Now that we're both straight on that, let's continue."
4723,0,7,55,62,1.1129032258064515,0.04052040316035677,549,The white elephant gifts have jumped the shark.
4723,1,5,56,62,1.1129032258064515,0.046591027055115,549,You'll find the real advantage when you say you can't help because your hands are tied.
4723,1,5,56,62,1.1129032258064515,0.046591027055115,549,You gotta get wrapped up in your job here.
4846,2,3,58,63,1.1111111111111112,0.051157173304408075,549,This game sucks
4846,1,5,57,63,1.1111111111111112,0.04588053629154694,549,So if you spend thousands of dollars on therapy you might be able to graduate to one strap just like me!
4846,1,5,57,63,1.1111111111111112,0.04588053629154694,549,"Now, we can be civil."
4846,1,5,57,63,1.1111111111111112,0.04588053629154694,549,All of your references claimed that you're crazy. One even wrote that you're fit to be tied.
4846,1,5,57,63,1.1111111111111112,0.04588053629154694,549,This an insane asylum right so am I the hallucination or are you?
4846,1,5,57,63,1.1111111111111112,0.04588053629154694,549,""" It can't be resolved, I think we are in similar 'straights'""."
4846,1,5,57,63,1.1111111111111112,0.04588053629154694,549,We are both bound in our place in the pecking order
4846,2,3,58,63,1.1111111111111112,0.051157173304408075,549,We're big on strait talk here.
4846,1,5,57,63,1.1111111111111112,0.04588053629154694,549,Tell me something about yourself that is not on your application.
4846,1,5,57,63,1.1111111111111112,0.04588053629154694,549,Ever tried power posing?
4846,0,7,56,63,1.1111111111111112,0.039912289339283334,549,"I try to identify with my patients, but frankly keyboarding with your nose is difficult."
4846,1,5,57,63,1.1111111111111112,0.04588053629154694,549,I was more concerned about your glass ceiling.
4846,0,7,56,63,1.1111111111111112,0.039912289339283334,549,"Maybe we should have just stuck with name, hometown, and fun fact."
4846,0,7,56,63,1.1111111111111112,0.039912289339283334,549,"I'm a straight shooter."" ""Well, so am I."
4860,1,4,55,60,1.1,0.04572084295183095,549,Have we taken 'embodying discipline' a bit far?
4860,0,6,54,60,1.1,0.03905667329424718,549,Do you have any loose ends.
4860,1,4,55,60,1.1,0.04572084295183095,549,I've learned to talk without hands!
4860,1,4,55,60,1.1,0.04572084295183095,549,"Strait talk, please"
4860,0,6,54,60,1.1,0.03905667329424718,549,So you don’t buy into this ‘work/life balance’ baloney either.
4860,0,6,54,60,1.1,0.03905667329424718,549,"Don't tell me you can't do the job; I'm tied up, too."
4860,2,2,56,60,1.1,0.05153025549750767,549,GOP straight jacket test.
4860,1,4,55,60,1.1,0.04572084295183095,549,....and I promise not to swivel
4860,0,6,54,60,1.1,0.03905667329424718,549,We don't believe in hands on in this office. So I think you are hired.
4860,0,6,54,60,1.1,0.03905667329424718,549,We should get this recount started ASAP.
4860,0,6,54,60,1.1,0.03905667329424718,549,"Our 'fit to be tied' fashion line is killing productivity, but damn if we don't look good"
4860,1,4,55,60,1.1,0.04572084295183095,549,I'll be strait with you; the hours are crazy.
4860,0,6,54,60,1.1,0.03905667329424718,549,Time for straight talk
4860,1,4,55,60,1.1,0.04572084295183095,549,Lets keep it verbal next time.
4860,0,6,54,60,1.1,0.03905667329424718,549,My assistant takes seriously my request to help prevent me from checking my phone during meetings.
4860,0,6,54,60,1.1,0.03905667329424718,549,This interview may be recorded for quality assurance.
4860,1,4,55,60,1.1,0.04572084295183095,549,"After the accident, HR outlawed trust falls."
4860,1,4,55,60,1.1,0.04572084295183095,549,Mine is from the Yeezy Spring Collection
4860,2,2,56,60,1.1,0.05153025549750767,549,I hear this is what all of Kanye's runway models are wearing.
4860,2,2,56,60,1.1,0.05153025549750767,549,It's only in the Government that they use RED tape
4860,2,2,56,60,1.1,0.05153025549750767,549,"I like your new shirt design, but the sleeves seem a bit long."
4860,0,6,54,60,1.1,0.03905667329424718,549,The APA sees strong promise in this empathy therapy breakthrough.
4860,1,4,55,60,1.1,0.04572084295183095,549,I think we are getting too wrapped up in this psychiatric thing.
4860,1,4,55,60,1.1,0.04572084295183095,549,I agree: these classic workplace rules are so constraining.
4860,1,4,55,60,1.1,0.04572084295183095,549,"He said 'nobody respects women more than me.' I didn't expect this, either."
4860,2,2,56,60,1.1,0.05153025549750767,549,Lesson learned.
4860,0,6,54,60,1.1,0.03905667329424718,549,At least you get to watch a movie.
4860,1,4,55,60,1.1,0.04572084295183095,549,Is there an app for this?
4860,0,6,54,60,1.1,0.03905667329424718,549,Soooo… do you ever wonder what the gay jackets look like?
4860,0,6,54,60,1.1,0.03905667329424718,549,"I've lost six pounds, but date nights are getting woo-hoo."
4860,1,4,55,60,1.1,0.04572084295183095,549,We like our people to be completely self-reliant. Does that sound like you?
4860,1,4,55,60,1.1,0.04572084295183095,549,"Look, I'd hire you, but I like this job, and well, you being double-jointed and all..,"
4860,0,6,54,60,1.1,0.03905667329424718,549,His Tweets are so liberating.
4860,1,4,55,60,1.1,0.04572084295183095,549,I see you already know its casual Friday here today.
4860,0,6,54,60,1.1,0.03905667329424718,549,Binding ties to ask SIRI to help
4860,1,4,55,60,1.1,0.04572084295183095,549,These designer clothes are getting too confining
4860,1,4,55,60,1.1,0.04572084295183095,549,I see in you a hallucination of myself from when I first started with this company.
4860,1,4,55,60,1.1,0.04572084295183095,549,Are you gay or strait?
4860,1,4,55,60,1.1,0.04572084295183095,549,"Oh your hands are tied? That's what they all say. And by ""they"" I mean everyone who entered this contest."
4860,1,4,55,60,1.1,0.04572084295183095,549,First thing is first. Welcome to Escapology Anonymous. Glad to see that you made it here this morning.
4860,1,4,55,60,1.1,0.04572084295183095,549,on the contrary its a prerequisite for any job in this administration
4860,1,4,55,60,1.1,0.04572084295183095,549,I hear some of the inmates are trying to start a union.
4860,1,4,55,60,1.1,0.04572084295183095,549,I thought you said it was 'finger' trap.
4860,1,4,55,60,1.1,0.04572084295183095,549,We're lucky here. When you work late you can see the stars through the glass ceiling.
4860,0,6,54,60,1.1,0.03905667329424718,549,He said he wished I could be more spontaneous.
4860,0,6,54,60,1.1,0.03905667329424718,549,Plenty of upward mobility.
4860,1,4,55,60,1.1,0.04572084295183095,549,"Call me crazy, but isn't this taking budgetary restraint to the extreme?"
4860,1,4,55,60,1.1,0.04572084295183095,549,What I like best about this job is you don’t have to kill yourself to get ahead.
4860,1,4,55,60,1.1,0.04572084295183095,549,These new protocols are impossible.
4860,0,6,54,60,1.1,0.03905667329424718,549,Golden handcuffs were an early victim of the budget cuts.
4860,0,6,54,60,1.1,0.03905667329424718,549,But they said they wanted us to disrupt.
4860,1,4,55,60,1.1,0.04572084295183095,549,"Yes, I think you'll enjoy the culture here at Amazon."
4860,0,6,54,60,1.1,0.03905667329424718,549,Have we met before?
4860,0,6,54,60,1.1,0.03905667329424718,549,"I believe we both favor immediate action, however, it seems our hands are tied."
4860,0,6,54,60,1.1,0.03905667329424718,549,"In order to get paid maternity leave, we had to make a few concessions."
4860,2,2,56,60,1.1,0.05153025549750767,549,I too used to be gay
4860,1,4,55,60,1.1,0.04572084295183095,549,Our cash flow is currently hindered as literally all of our assets are completely tied up.
4860,1,4,55,60,1.1,0.04572084295183095,549,Help me run for the presidency?
4860,1,4,55,60,1.1,0.04572084295183095,549,Since he changed the nuke-launch code to three zeroes we just have to live with it.
4860,0,6,54,60,1.1,0.03905667329424718,549,"Let's get things strait between us, shall we?"
4860,1,4,55,60,1.1,0.04572084295183095,549,Now you're just being a jerk.
4860,1,4,55,60,1.1,0.04572084295183095,549,I know it's tough but keeping you from pulling your hair should allow you to have a hairdo like mine
4860,1,4,55,60,1.1,0.04572084295183095,549,The boss did say he was going to set me strait.
4860,0,6,54,60,1.1,0.03905667329424718,549,There IS a lot to be said for straight talk.
4860,1,4,55,60,1.1,0.04572084295183095,549,I'm not crazy about your references
4860,0,6,54,60,1.1,0.03905667329424718,549,"As you see, being nuts doesn't help working here. Typing with my nose is a real pain."
4860,0,6,54,60,1.1,0.03905667329424718,549,"Escapologists Anonymous, has a get-out clause at Christmas, it's also known as the Sanity Claus."
4860,0,6,54,60,1.1,0.03905667329424718,549,"Yes, I think this will stop Mr. Wilson."
4860,0,6,54,60,1.1,0.03905667329424718,549,I don't think this conversion therapy is working.
4860,0,6,54,60,1.1,0.03905667329424718,549,So what brings you to the Academy of Knots?
4860,0,6,54,60,1.1,0.03905667329424718,549,... and your Klout score?
4860,1,4,55,60,1.1,0.04572084295183095,549,"As a company, we're all about releasing each person's internal potential."
4860,2,2,56,60,1.1,0.05153025549750767,549,Satisfied?! Now neither of us can Skype with the aardvark.
4860,1,4,55,60,1.1,0.04572084295183095,549,I'll scratch your nose if you'll scratch mine.
4860,0,6,54,60,1.1,0.03905667329424718,549,The jacket's a good fit but we're looking for someone who likes to work with their hands.
4860,1,4,55,60,1.1,0.04572084295183095,549,"I got mine at the Designer Warehouse, where did you get yours?"
4860,0,6,54,60,1.1,0.03905667329424718,549,"Thank you though, but in this office we prefer Forward Tunic."""
4860,0,6,54,60,1.1,0.03905667329424718,549,You've got me out stripped.
4860,1,4,55,60,1.1,0.04572084295183095,549,"I Know. I voted for myself, too..."
4860,0,6,54,60,1.1,0.03905667329424718,549,This sit-down strike isn't working because we don't have press coverage - our hands are tied.
4860,0,6,54,60,1.1,0.03905667329424718,549,"I always thought the ""sweeping gesture"" thing was overrated."
4860,0,6,54,60,1.1,0.03905667329424718,549,"I'm sorry Ms. Oronica, as you can see, our hands are tied."
4860,1,4,55,60,1.1,0.04572084295183095,549,I won't be taking notes this session. I just realized I'm just as crazy up as you are.
4860,0,6,54,60,1.1,0.03905667329424718,549,"Doctor, Do you honestly feel my pain?"
4860,0,6,54,60,1.1,0.03905667329424718,549,Maybe Google can tell us how Houdini got out of these things!
4860,0,6,54,60,1.1,0.03905667329424718,549,Jane. I do believe you have a great future at Simon Says Inc.
4860,1,4,55,60,1.1,0.04572084295183095,549,"Here we wrap presents, but sometimes we over do it."
4860,1,4,55,60,1.1,0.04572084295183095,549,I understand your hands are tied but we still need to meet our goals
4860,1,4,55,60,1.1,0.04572084295183095,549,"I'd like to make another appointment, but we're both obviously tied up--"
4860,0,6,54,60,1.1,0.03905667329424718,549,"Well, it was this or chain the stationery to the desk."
4860,1,4,55,60,1.1,0.04572084295183095,549,The pen is mightier than the sword. The voice is mightier than the keyboard.
4860,1,4,55,60,1.1,0.04572084295183095,549,"It surely keeps us warm, but the only problem is that we can't high five anymore."
4860,1,4,55,60,1.1,0.04572084295183095,549,Your professional and personal profile are a perfect match for a Cabinet position.
4860,0,6,54,60,1.1,0.03905667329424718,549,"I wish I could turn the computer screen toward you so we could both watch the magician's instructional escape video, but my hands are tied."
4860,0,6,54,60,1.1,0.03905667329424718,549,Watch carefully and I'll show you my latest Houdini moves.
4860,0,6,54,60,1.1,0.03905667329424718,549,Stronger Together will live in infamy.
4860,0,6,54,60,1.1,0.03905667329424718,549,Now THAT'S just crazy talk.
4860,0,6,54,60,1.1,0.03905667329424718,549,The robots just emailed me their list of demands. They said this isn't illegal since the law doesn't apply to them.
4860,0,6,54,60,1.1,0.03905667329424718,549,Do you feel like this project is driving you crazy?
4860,1,4,55,60,1.1,0.04572084295183095,549,I don't think this is the same Escape Game we played the last time.
4860,0,6,54,60,1.1,0.03905667329424718,549,Explain again how my micromanaging affects work performance?
4860,0,6,54,60,1.1,0.03905667329424718,549,"Apparently, the truth will NOT set you free during office hours."
4860,1,4,55,60,1.1,0.04572084295183095,549,I wish they'd turn the heat on already
4860,0,6,54,60,1.1,0.03905667329424718,549,In this new Administration we believe in promoting from within.
4860,2,2,56,60,1.1,0.05153025549750767,549,"If you can mentally undress me first, you win!"
4860,0,6,54,60,1.1,0.03905667329424718,549,I'd love to keep you on Dawn but my hands are tied.
4860,0,6,54,60,1.1,0.03905667329424718,549,This focus on face time isn't working out.
4860,2,2,56,60,1.1,0.05153025549750767,549,"""Let me guess, no need to talk because you understand me""."
4860,0,6,54,60,1.1,0.03905667329424718,549,You've come to the right place. I have voice command software and know just how you feel!
4860,1,4,55,60,1.1,0.04572084295183095,549,"My hands are tied as well ,so, your move."
4860,2,2,56,60,1.1,0.05153025549750767,549,"Well Hellen as your boss, here we embrace a ""locked door"" policy"
4860,2,2,56,60,1.1,0.05153025549750767,549,These are wonderful. I'm ordering three pairs for Christmas!
4860,1,4,55,60,1.1,0.04572084295183095,549,"Welcome to ACME Sales, I see HR has informed you we only use a voice activated computers programs here ."
4860,1,4,55,60,1.1,0.04572084295183095,549,Just let your feet do the talking...
4860,0,6,54,60,1.1,0.03905667329424718,549,Meetings are never fun for anyone.
4860,0,6,54,60,1.1,0.03905667329424718,549,"Your qualifications are quite impressive, but I am looking for someone with more complimentary abilities."
4860,0,6,54,60,1.1,0.03905667329424718,549,I don't seem to be getting as much work done although it's been very effective in cutting down on my computer time.
4860,0,6,54,60,1.1,0.03905667329424718,549,What I love about this company is that they really encourage creative thinking - you never feel like you're in an intellectual straitjacket.
4860,0,6,54,60,1.1,0.03905667329424718,549,""" We are almost done with the interview....just need to tie up a few loose ends"" !"
4860,0,6,54,60,1.1,0.03905667329424718,549,"The president-elect's tweets are driving you mad too, huh?"
4860,0,6,54,60,1.1,0.03905667329424718,549,Well---it is responsible for the removal of sexual inequality from the workplace…
4860,1,4,55,60,1.1,0.04572084295183095,549,"I know this sounds crazy, but our department is shrinking."
4860,1,4,55,60,1.1,0.04572084295183095,549,"Patient 1: I can't believe they think we're psychopaths! Patient 2: I can't believe they thought that putting us in ""straight""jackets would stop us from being gay!"
4860,1,4,55,60,1.1,0.04572084295183095,549,"Straightjackets are easy. Watch me get out, and get Houdini on Skype, and Snapchat the whole thing!"
4860,1,4,55,60,1.1,0.04572084295183095,549,You're fired!
4860,0,6,54,60,1.1,0.03905667329424718,549,What would you say it's your greatest strength?
4860,0,6,54,60,1.1,0.03905667329424718,549,"Believe me, I understand completely, but my hands are tied on this."
4860,0,6,54,60,1.1,0.03905667329424718,549,"""We are in agreement!Till the recount of the votes is completed."
4860,1,4,55,60,1.1,0.04572084295183095,549,sexual harassment wasn't all that bad
4860,2,2,56,60,1.1,0.05153025549750767,549,This jacket makes you feel all warm inside. Doesn't it?
4860,0,6,54,60,1.1,0.03905667329424718,549,"Dinner--your padded cell, or mine?"
4860,0,6,54,60,1.1,0.03905667329424718,549,"So tell me, do you think our team bondage efforts are helping with productivity?"
4860,0,6,54,60,1.1,0.03905667329424718,549,"So, due to budget cuts, we're doing more with less...SANITY!"
4860,0,6,54,60,1.1,0.03905667329424718,549,And with the addition of an elephant or donkey imprint we can make it a political statement!
4860,1,4,55,60,1.1,0.04572084295183095,549,You do realize that just because you'll be crashing through the glass ceiling doesn't mean they'll let you join their club.
4860,1,4,55,60,1.1,0.04572084295183095,549,No more Cyber bullying or Tweet revenge. It must be a Trump advisor.
4860,1,4,55,60,1.1,0.04572084295183095,549,"Then this HR guy says, ""Well, can they perform just as well backwards, in heels and..."""
4860,0,6,54,60,1.1,0.03905667329424718,549,"Our hands are tied, but we'll try again."
4860,0,6,54,60,1.1,0.03905667329424718,549,"I hope the DOD employee who leaked the ""$125 billion bureaucratic waste"" report is pleased with himself now."
4860,1,4,55,60,1.1,0.04572084295183095,549,Feel free to recount all of our ballots by hand Mrs. Stein.
4860,1,4,55,60,1.1,0.04572084295183095,549,This is the only way to deal with the election.
4860,1,4,55,60,1.1,0.04572084295183095,549,"If only we were not restrained, we are bound to get it right!"
4860,0,6,54,60,1.1,0.03905667329424718,549,We think all of you on that chair will be a good fit with all of us here at this desk.
4860,2,2,56,60,1.1,0.05153025549750767,549,Your turn.
4860,0,6,54,60,1.1,0.03905667329424718,549,"This is an off-shoot of the ""Blind Leading the Blind"" therapy."
4860,0,6,54,60,1.1,0.03905667329424718,549,Then the big D and the little d made their get-a-way.
4860,1,4,55,60,1.1,0.04572084295183095,549,What is it you don't trust about our new transparency initiative?
4860,0,6,54,60,1.1,0.03905667329424718,549,"Listen, I'm only here to help. Why do find it necessary to project your feelings of powerlessness onto me."
4860,0,6,54,60,1.1,0.03905667329424718,549,I feel like the company may have taken ergonomics just a step too far.
4860,1,4,55,60,1.1,0.04572084295183095,549,I can't believe we get roped into this comedy magic show.
4860,2,2,56,60,1.1,0.05153025549750767,549,I didn't hear you.
4860,0,6,54,60,1.1,0.03905667329424718,549,It's always like this around the holidays.
4860,0,6,54,60,1.1,0.03905667329424718,549,"OK, I'll tell it to you straight."
4860,1,4,55,60,1.1,0.04572084295183095,549,And we supply female employees extra protection for glass ceiling collisions
4860,0,6,54,60,1.1,0.03905667329424718,549,"Once our probationary period ends, I'm sure working at Houdini Inc. will be wonderful."
4860,2,2,56,60,1.1,0.05153025549750767,549,"Yes, we all had high hopes for the glass ceiling, but let's get back to the interview... Do you have children?"
4860,0,6,54,60,1.1,0.03905667329424718,549,Pense thinks we should have morning jackets.
4860,2,2,56,60,1.1,0.05153025549750767,549,"Yes, we can see your insane, but we're looking for someone more certified in this line if work."
4860,0,6,54,60,1.1,0.03905667329424718,549,My guru says this computer abstinence therapy really works.
4860,0,6,54,60,1.1,0.03905667329424718,549,"Sorry, but the boss said I'd be crazy to make you that offer, and you'd be even crazier to turn it down."
4860,0,6,54,60,1.1,0.03905667329424718,549,"Yes, we've risen high in management, but I defy anyone to call us stuffed shirts."
4860,0,6,54,60,1.1,0.03905667329424718,549,"The jacket? No, no, no... it's definitely the meditation."
4860,1,4,55,60,1.1,0.04572084295183095,549,Welcome to FedEX!
4860,1,4,55,60,1.1,0.04572084295183095,549,"I vowed to do a face to face interview, are you comfortable?"
4860,1,4,55,60,1.1,0.04572084295183095,549,"They wanted to keep me at my old job, but their hands were tied."
4860,1,4,55,60,1.1,0.04572084295183095,549,At least we cut through all the red tape.
4860,2,2,56,60,1.1,0.05153025549750767,549,"I certainly don’t think you over-reacted to the Cubbie victory, but tell me about it in your own words. We have a South-sider who’ll type up my report."
4860,1,4,55,60,1.1,0.04572084295183095,549,Hands up I did not do it.
4860,0,6,54,60,1.1,0.03905667329424718,549,Maybe we should reconsider our branding.
4860,1,4,55,60,1.1,0.04572084295183095,549,"Yes, we do encourage one to think outside the box."
4860,2,2,56,60,1.1,0.05153025549750767,549,"At HUD2017.DoctorCarson/SmallGov we practice ""NeverEver handouts!"" They encourage dependency and discourage recipients from attending Medical School."
4860,0,6,54,60,1.1,0.03905667329424718,549,We got tied of dress down Fridays.
4860,0,6,54,60,1.1,0.03905667329424718,549,"...so that Mrs. Williams, is when I read Camus."
4860,0,6,54,60,1.1,0.03905667329424718,549,"First one to get free, gets the rest of the day off."
4860,1,4,55,60,1.1,0.04572084295183095,549,Thanks for the suggestion but let's keep doing the same thing over and over again.
4860,0,6,54,60,1.1,0.03905667329424718,549,"""You're crazy"" "" No you're crazy"" "" No you're crazy""............."
4860,1,4,55,60,1.1,0.04572084295183095,549,"My nose itches, does your?"
4860,2,2,56,60,1.1,0.05153025549750767,549,"Although the company is thrilled with your work here in the customer complaint department, we think your real future is in repair scheduling."
4860,1,4,55,60,1.1,0.04572084295183095,549,This company dress code for women certainly does ensure that their glass ceiling will stay intact.
4860,0,6,54,60,1.1,0.03905667329424718,549,"We use this to test prospective employees. However, those who fail the test can also be considered for a position in HR."
4860,0,6,54,60,1.1,0.03905667329424718,549,our company is looking for individuals who believe in freedom of speech while their hands are tied...
4860,1,4,55,60,1.1,0.04572084295183095,549,I hope you don't mind but these have become mandatory for conflict resolution at the department of motor vehicles.
4860,1,4,55,60,1.1,0.04572084295183095,549,"I don't mind the straitjacket, but a RED CARD, really !"
4860,0,6,54,60,1.1,0.03905667329424718,549,"Aerodynamically, is easier to break the glass ceiling."
5044,0,6,55,61,1.098360655737705,0.038446030818224834,549,"I'd shake your hand, but I'm a germaphobe."
5044,0,6,55,61,1.098360655737705,0.038446030818224834,549,Being into bondage is a plus.
5044,0,6,55,61,1.098360655737705,0.038446030818224834,549,"Well here at Constraint Based Therapies , you'll find our mental health policies very inclusive. Can you nose type ?"
5044,1,4,56,61,1.098360655737705,0.04499494830653312,549,"Unfortunately, I have to untie you."
5044,1,4,56,61,1.098360655737705,0.04499494830653312,549,It looks like we are going to need to up your dosage.
5044,1,4,56,61,1.098360655737705,0.04499494830653312,549,Let's get straight to the point
5044,0,6,55,61,1.098360655737705,0.038446030818224834,549,"To be frank, you're a bit overqualified."
5044,1,4,56,61,1.098360655737705,0.04499494830653312,549,"Yes, I do like to approach my work with a great deal of utter abandon."
5044,0,6,55,61,1.098360655737705,0.038446030818224834,549,Which pie did you put your finger in?
5053,0,6,56,62,1.096774193548387,0.03785410929280441,549,First I want to say I appreciate your open door policy.
5054,1,3,54,58,1.0862068965517242,0.044575586536534074,549,This is a great company to work at. Nobody wants to leave.
5054,0,5,53,58,1.0862068965517242,0.03717555967998436,549,Only a magician can get us out of this one.
5054,1,3,54,58,1.0862068965517242,0.044575586536534074,549,"Is it just me, or do you agree, that we each did find the ties that together us will bind?"
5054,0,5,53,58,1.0862068965517242,0.03717555967998436,549,"You are perfect for the position, but afraid there isn't much room for advancement."
5054,0,5,53,58,1.0862068965517242,0.03717555967998436,549,"Yeah, I think I'd categorize it as an iron-clad contract."
5054,2,1,55,58,1.0862068965517242,0.05091113426974493,549,"Well, Mr. President-Elect, I think I would fit right in."
5054,0,5,53,58,1.0862068965517242,0.03717555967998436,549,I know thangs are a little uptight here . . . .
5054,1,3,54,58,1.0862068965517242,0.044575586536534074,549,"""This will help train us to smile and nod politely on telepresence""."
5054,1,3,54,58,1.0862068965517242,0.044575586536534074,549,"You are certainly a good fit for this position, but I'm afraid the patriarchy has tied both our hands."
5054,0,5,53,58,1.0862068965517242,0.03717555967998436,549,So far so good but how are you at languages?
5054,1,3,54,58,1.0862068965517242,0.044575586536534074,549,"The reimbursement code for countertransference is ""pickle."""
5054,0,5,53,58,1.0862068965517242,0.03717555967998436,549,"Nice to have it all wrapped up, isn't it?"
5054,0,5,53,58,1.0862068965517242,0.03717555967998436,549,"Stylistically, we prefer to keep things fairly 'straight' 'round here. Happy to see you're onboard."
5054,1,3,54,58,1.0862068965517242,0.044575586536534074,549,"Get that report on my desk by Monday, eight months from now."
5054,1,3,54,58,1.0862068965517242,0.044575586536534074,549,You spell Hamilton and I'll meow. We're bound to get someone to help.
5054,2,1,55,58,1.0862068965517242,0.05091113426974493,549,Gina wonders why HR always sends her the loons
5054,1,3,54,58,1.0862068965517242,0.044575586536534074,549,I was once rejected by Etsy too!
5054,1,3,54,58,1.0862068965517242,0.044575586536534074,549,I do it to keep from scratching my eyes out when I see how this humorless 'artiste' has drawn me. You?
5054,1,3,54,58,1.0862068965517242,0.044575586536534074,549,Do you know your brake light is out?
5054,1,3,54,58,1.0862068965517242,0.044575586536534074,549,I heard she hires in her own image.
5054,1,3,54,58,1.0862068965517242,0.044575586536534074,549,"Contrary to popular belief, I am an ostrich."
5054,0,5,53,58,1.0862068965517242,0.03717555967998436,549,Great idea for self restraints. Now we need to figure out a way to undo them.
5054,1,3,54,58,1.0862068965517242,0.044575586536534074,549,WHAT ABOUT THE THEOREM THAT NOTHING IS LOST?
5054,1,3,54,58,1.0862068965517242,0.044575586536534074,549,Proof that I can move you with the my boot tip.
5054,1,3,54,58,1.0862068965517242,0.044575586536534074,549,"I'm glad you applied, we're looking for someone with a 'Houdini Complex.'"
5054,1,3,54,58,1.0862068965517242,0.044575586536534074,549,Let's call a friend. Let's call Harry. OK.
5054,0,5,53,58,1.0862068965517242,0.03717555967998436,549,If you think you are the only one whose hands are tied.
5054,1,3,54,58,1.0862068965517242,0.044575586536534074,549,"Well, we did shatter the glass ceiling, just like those Carrier workers got their jobs back."
5054,1,3,54,58,1.0862068965517242,0.044575586536534074,549,I think HR has taken this violence in the workplace prevention a little too far
5054,1,3,54,58,1.0862068965517242,0.044575586536534074,549,I'm going for 5ive straight.
5054,0,5,53,58,1.0862068965517242,0.03717555967998436,549,This is one of the new team building exercises.
5054,2,1,55,58,1.0862068965517242,0.05091113426974493,549,Are you a poker or a grabber?
5054,1,3,54,58,1.0862068965517242,0.044575586536534074,549,"At this firm, we aim to hire individuals with visions"
5054,1,3,54,58,1.0862068965517242,0.044575586536534074,549,"Let us pray, Krishna: QWERTY, QWERTY...."
5054,1,3,54,58,1.0862068965517242,0.044575586536534074,549,"Mama told me, ""Never turn your back on a professional man."""
5054,1,3,54,58,1.0862068965517242,0.044575586536534074,549,"Yes, the Mime Institute is an equal opportunity employer."
5054,0,5,53,58,1.0862068965517242,0.03717555967998436,549,It was hard for Human Resources to get any work done during Empathy Week.
5054,0,5,53,58,1.0862068965517242,0.03717555967998436,549,They're cheaper than the ergonomic chairs.
5054,0,5,53,58,1.0862068965517242,0.03717555967998436,549,Let's promise to always be straight with each other.
5054,1,3,54,58,1.0862068965517242,0.044575586536534074,549,So you like that our PAC is all-female and pro-Trump. What else?
5054,1,3,54,58,1.0862068965517242,0.044575586536534074,549,"Sorry, my parachute malfunctioned."
5054,0,5,53,58,1.0862068965517242,0.03717555967998436,549,"Now,relax, and tell me what happened."
5054,1,3,54,58,1.0862068965517242,0.044575586536534074,549,I hope you realize this does not end our office cyber relationship. I have voice to text commands enabled on all devices.
5054,1,3,54,58,1.0862068965517242,0.044575586536534074,549,I don't care that you need to get to Canada right away.
5054,1,3,54,58,1.0862068965517242,0.044575586536534074,549,My conclusion is that my reverse psychology therapy is just not working for you.
5054,0,5,53,58,1.0862068965517242,0.03717555967998436,549,I really didn't think bondage would be like this.
5054,0,5,53,58,1.0862068965517242,0.03717555967998436,549,"We followed your plan and have taken over, now what?"
5054,1,3,54,58,1.0862068965517242,0.044575586536534074,549,shes also tied up at work
5054,1,3,54,58,1.0862068965517242,0.044575586536534074,549,"I'm not sure the ergonomic department's recommendation will do anything for productivity, but I feel very calm about it."
5054,1,3,54,58,1.0862068965517242,0.044575586536534074,549,"Yeah, the higher-ups are harping on our productivity again."
5054,1,3,54,58,1.0862068965517242,0.044575586536534074,549,"Ok, my turn...I see something....white!"
5054,0,5,53,58,1.0862068965517242,0.03717555967998436,549,Now that we're on the same page...
5054,2,1,55,58,1.0862068965517242,0.05091113426974493,549,"TORTURE-R-US, Inc. tests its straight-jackets on Hillary voters, Houdini's granddaughters."
5054,0,5,53,58,1.0862068965517242,0.03717555967998436,549,HR will definitely have questions.
5054,1,3,54,58,1.0862068965517242,0.044575586536534074,549,"HR Room #5150 ""I see you found the place."""
5054,1,3,54,58,1.0862068965517242,0.044575586536534074,549,"Yes, management and labor are both feeling constrained by these new FLSA rules."
5054,1,3,54,58,1.0862068965517242,0.044575586536534074,549,Be straight with me
5054,0,5,53,58,1.0862068965517242,0.03717555967998436,549,I got mine at the Yeezy Spring show.
5054,2,1,55,58,1.0862068965517242,0.05091113426974493,549,"With your scientific credentials, I know we can find a place for you in the new administration's EPA."
5054,0,5,53,58,1.0862068965517242,0.03717555967998436,549,"You may be tied up, but I'm insane."
5054,0,5,53,58,1.0862068965517242,0.03717555967998436,549,What? You expected a warm welcome?
5054,0,5,53,58,1.0862068965517242,0.03717555967998436,549,We do have our limitations.
5054,1,3,54,58,1.0862068965517242,0.044575586536534074,549,"Listen, I know this might sound a little hypocritical, but just give it to me straight."
5054,0,5,53,58,1.0862068965517242,0.03717555967998436,549,I'd like to tap into your vast institutional knowledge.
5054,1,3,54,58,1.0862068965517242,0.044575586536534074,549,I see you came prepared with Trump's anti-glass-ceiling-breakage jacket.
5054,2,1,55,58,1.0862068965517242,0.05091113426974493,549,"Doctor, heal thyself."
5054,1,3,54,58,1.0862068965517242,0.044575586536534074,549,i bet you're a tight bitch too
5054,1,3,54,58,1.0862068965517242,0.044575586536534074,549,"I think we are taking the ""sit strait"" initiative too seriously."
5054,0,5,53,58,1.0862068965517242,0.03717555967998436,549,Guess I'm caught between the moon and New York City.
5054,1,3,54,58,1.0862068965517242,0.044575586536534074,549,"As your career counselor, I think you should know that I feel threatened by your coming to me looking for a job placement."
5054,0,5,53,58,1.0862068965517242,0.03717555967998436,549,"Yes, we boomers are aware of what's trending."
5054,1,3,54,58,1.0862068965517242,0.044575586536534074,549,This is the uniform you'll wear if you get the job here at Hannibal Lecter Enterprises.
5054,1,3,54,58,1.0862068965517242,0.044575586536534074,549,This is not what I expected when you got me to agree to conversion therapy!
5054,1,3,54,58,1.0862068965517242,0.044575586536534074,549,"I know you brought me here to ask for my help, but as you can see, I'm tied up right now"
5054,1,3,54,58,1.0862068965517242,0.044575586536534074,549,The lips are mightier than a pen.
5054,0,5,53,58,1.0862068965517242,0.03717555967998436,549,Gesticulating with our hands has gotten out of control!
5054,1,3,54,58,1.0862068965517242,0.044575586536534074,549,Houdini made it look easy!
5054,0,5,53,58,1.0862068965517242,0.03717555967998436,549,It's their obsessive-compulsives talent management program
5054,1,3,54,58,1.0862068965517242,0.044575586536534074,549,"Ok, now can we have a discussion about your salary?"
5054,2,1,55,58,1.0862068965517242,0.05091113426974493,549,"Look, in order for mediation to work, you have to show some movement."
5054,1,3,54,58,1.0862068965517242,0.044575586536534074,549,I should have worn this before it became popular.
5054,1,3,54,58,1.0862068965517242,0.044575586536534074,549,My ardent belief in the Derridean philosophy of deconstruction will make me an asset in the fashion industry.
5054,1,3,54,58,1.0862068965517242,0.044575586536534074,549,"When we get outta here, I'm gonna give that Dernavich a piece of my mind."
5054,1,3,54,58,1.0862068965517242,0.044575586536534074,549,"Personally, I think we're taking the whole Michael Jackson tribute a bit too far!!!"
5054,2,1,55,58,1.0862068965517242,0.05091113426974493,549,"We're an equal opportunity employer. Men are required to wear straight jackets and ties, except on dress-down Fridays when we're all topless."
5054,0,5,53,58,1.0862068965517242,0.03717555967998436,549,"I agree, working for Hannibal Lector can get scarry at times."
5054,1,3,54,58,1.0862068965517242,0.044575586536534074,549,"I'd love to help you get a job here, but unfortunately my hands re tied."
5054,1,3,54,58,1.0862068965517242,0.044575586536534074,549,"Agreed. Change nothing, again. We're sure to have better results this time."
5054,0,5,53,58,1.0862068965517242,0.03717555967998436,549,The new CEO came up through the IT department. Have we effectively eliminated computer viruses? Yes. But I believe there's been a downside.
5054,2,1,55,58,1.0862068965517242,0.05091113426974493,549,"Ever since our technical team devised these special 'digital devices safe' suits for meetings, the productivity and happiness index of our staff has gone up"
5054,1,3,54,58,1.0862068965517242,0.044575586536534074,549,"The position requires zero gesticulation. If you can keep your face, legs and feet still, you have the job."
5054,1,3,54,58,1.0862068965517242,0.044575586536534074,549,"I can completely sympathize with you, but I'm not quite sure that I can believe a story like that."
5054,1,3,54,58,1.0862068965517242,0.044575586536534074,549,"Wow, this place is so secure they had the psychiatrist Skype us."
5054,1,3,54,58,1.0862068965517242,0.044575586536534074,549,New company dress code. The boss is a big fan of Mike Pence.
5054,0,5,53,58,1.0862068965517242,0.03717555967998436,549,Blah blah blah Donald Trump sucks blah blah blah.
5054,0,5,53,58,1.0862068965517242,0.03717555967998436,549,See! Not so easy when you put yourself in my restraint.
5054,0,5,53,58,1.0862068965517242,0.03717555967998436,549,"On the other hand, they're dialing back on the social media filters."
5054,0,5,53,58,1.0862068965517242,0.03717555967998436,549,New management tactic; trying to straighten us all out indiscriminately.
5054,2,1,55,58,1.0862068965517242,0.05091113426974493,549,"""Needless to say, all future negotiations will be binding.""Submit2me"
5054,1,3,54,58,1.0862068965517242,0.044575586536534074,549,I know... HR makes editorial do this every time we need to interact with the art/design department.
5054,0,5,53,58,1.0862068965517242,0.03717555967998436,549,I want to be strait with you: I get the feeling that you're holding back.
5054,1,3,54,58,1.0862068965517242,0.044575586536534074,549,"The only way to untie our feelings is a handshake. You first. "" ""No, you first."
5054,0,5,53,58,1.0862068965517242,0.03717555967998436,549,So....how may I help you today?
5054,0,5,53,58,1.0862068965517242,0.03717555967998436,549,For this interview you've got me tongue tied
5054,1,3,54,58,1.0862068965517242,0.044575586536534074,549,"Now that we're both safe, tell me how much you love me."
5054,0,5,53,58,1.0862068965517242,0.03717555967998436,549,"Now, Mrs. Jones, we will both attempt to beat the fastest straitjacket escape time of 2.84 seconds by listening to a Trump tweet...."
5054,1,3,54,58,1.0862068965517242,0.044575586536534074,549,A coworker has brought to my attention the concern that you are failing your condition of employment to be a danger to yourself and others at all times.
5054,1,3,54,58,1.0862068965517242,0.044575586536534074,549,You rub my back – I rub yours!
5054,0,5,53,58,1.0862068965517242,0.03717555967998436,549,"Susan, as you know, your final grade for the Houdini graduate seminar is based entirely on you getting out of the straigt jacket."
5054,0,5,53,58,1.0862068965517242,0.03717555967998436,549,"It takes one to know one, you know"
5054,1,3,54,58,1.0862068965517242,0.044575586536534074,549,I don't know anything about raising squid. If that's where this is going.
5054,1,3,54,58,1.0862068965517242,0.044575586536534074,549,"Our new business coach, Dr. Lecter, is a real control freak!"
5054,0,5,53,58,1.0862068965517242,0.03717555967998436,549,Wow! GOOD for you! Your running the place now!
5054,1,3,54,58,1.0862068965517242,0.044575586536534074,549,"So that's my story, now you tell me, what is your reason for wanting to work at 'Crazy Lady Spa and Fitness?'"
5054,0,5,53,58,1.0862068965517242,0.03717555967998436,549,"Well, as Branch Chief I'm still not allowed to speak but I do get a nicer office."
5054,0,5,53,58,1.0862068965517242,0.03717555967998436,549,Do you think they'll accept my late time sheet?
5054,1,3,54,58,1.0862068965517242,0.044575586536534074,549,Did you have to yell out my name while we were hacking?
5054,0,5,53,58,1.0862068965517242,0.03717555967998436,549,"That's what I thought when I interviewed here, too. Half a mill a year and points sound crazy to you?"
5054,1,3,54,58,1.0862068965517242,0.044575586536534074,549,"Well, I see you are tied up this week as well!"
5054,1,3,54,58,1.0862068965517242,0.044575586536534074,549,Do you still think water-boarding would have been worse?
5054,0,5,53,58,1.0862068965517242,0.03717555967998436,549,Your resume says you majored in Houdini Escape Reenactment?
5054,0,5,53,58,1.0862068965517242,0.03717555967998436,549,"Congratulations! You've been selected as a finalist for ""Hands off Boss of the Year"" award."
5054,1,3,54,58,1.0862068965517242,0.044575586536534074,549,Reach out with your feelings.
5054,0,5,53,58,1.0862068965517242,0.03717555967998436,549,We have a strong position against any form of workplace violence
5054,0,5,53,58,1.0862068965517242,0.03717555967998436,549,I don't think either one of us could pivot at this point.
5054,2,1,55,58,1.0862068965517242,0.05091113426974493,549,I too thought the psychiatrist was asking about a Trait Bracket.
5054,1,3,54,58,1.0862068965517242,0.044575586536534074,549,Why? Because our couturier demands that we try out his latest designs.
5054,0,5,53,58,1.0862068965517242,0.03717555967998436,549,You must be crazy to think that this is a constraining work environment.
5054,1,3,54,58,1.0862068965517242,0.044575586536534074,549,I never dreamed I'd be this tangled up in my work.
5054,0,5,53,58,1.0862068965517242,0.03717555967998436,549,I thought it said Turtle coat Tuesdays ... apparently everyone else is wearing turtle necks
5054,0,5,53,58,1.0862068965517242,0.03717555967998436,549,"Me too!! I'm just so tied up, I feel like I'm going nuts!"
5054,1,3,54,58,1.0862068965517242,0.044575586536534074,549,It's a standard part of the bureaucratic uniform.
5054,0,5,53,58,1.0862068965517242,0.03717555967998436,549,Creativity in the work place.
5054,0,5,53,58,1.0862068965517242,0.03717555967998436,549,I wish I could help you but our hands are tied!
5054,1,3,54,58,1.0862068965517242,0.044575586536534074,549,We're hoping these catch on with kleptomaniacs.
5054,1,3,54,58,1.0862068965517242,0.044575586536534074,549,"So, tell me why you’re interested in a career at Houdini Industries."
5190,0,5,54,59,1.0847457627118644,0.03656923485905472,549,No YOU stop copying me!
5190,1,3,55,59,1.0847457627118644,0.0438379113795422,549,He was careful to interview only the most qualified candidates for the job.
5190,2,1,56,59,1.0847457627118644,0.05006212150982505,549,He forgot to tape our mouths and my laptop is voice-activated!
5190,1,3,55,59,1.0847457627118644,0.0438379113795422,549,The fire marshal said we couldn't wear blazers anymore.
5190,1,3,55,59,1.0847457627118644,0.0438379113795422,549,Change seats every 15 minutes.
5190,1,3,55,59,1.0847457627118644,0.0438379113795422,549,We've eliminated our employee policy manual.
5190,1,3,55,59,1.0847457627118644,0.0438379113795422,549,"I can't wait for casual Friday."" ""Girl, you're telling me!"
5190,0,5,54,59,1.0847457627118644,0.03656923485905472,549,"Like you, I was uptight when I first started the job, but I learned to relax."
5190,1,3,55,59,1.0847457627118644,0.0438379113795422,549,In as many words as possible describe our corporate philosophy as you perceive it
5190,1,3,55,59,1.0847457627118644,0.0438379113795422,549,"Zippers, anyone?"
5190,1,3,55,59,1.0847457627118644,0.0438379113795422,549,Nancy Pelosi is a great political leader!
5190,1,3,55,59,1.0847457627118644,0.0438379113795422,549,I think the boss over spiked the water cooler
5190,1,3,55,59,1.0847457627118644,0.0438379113795422,549,I feel ya!
5190,1,3,55,59,1.0847457627118644,0.0438379113795422,549,When the inmates literally run the asylum.
5190,2,1,56,59,1.0847457627118644,0.05006212150982505,549,Don't get wrapped up by your contractor.
5190,1,3,55,59,1.0847457627118644,0.0438379113795422,549,It's obvious you're familiar with compliance with unfunded mandates.
5190,1,3,55,59,1.0847457627118644,0.0438379113795422,549,Look! Let's talk straight.
5190,0,5,54,59,1.0847457627118644,0.03656923485905472,549,I don't like working with my hands either.
5190,1,3,55,59,1.0847457627118644,0.0438379113795422,549,This is not what I meant when I said we could pull off straitjackets.
5190,0,5,54,59,1.0847457627118644,0.03656923485905472,549,Human Resources is such a maddening position.
5190,1,3,55,59,1.0847457627118644,0.0438379113795422,549,Mitch is driving me crazy too but my hands are tied.
5190,1,3,55,59,1.0847457627118644,0.0438379113795422,549,I'm afraid you don't have enough experience.
5190,0,5,54,59,1.0847457627118644,0.03656923485905472,549,Don't you feel offended that everyone assumes that you are straight just because of a clothing choice?
5190,0,5,54,59,1.0847457627118644,0.03656923485905472,549,"Mary, who says a fashion statement has to be practical?"
5190,1,3,55,59,1.0847457627118644,0.0438379113795422,549,"Alexa, play Moonlight Sonata."
5190,0,5,54,59,1.0847457627118644,0.03656923485905472,549,"Here at Everyday Industries, PC also stands for Physically Correct."
5190,1,3,55,59,1.0847457627118644,0.0438379113795422,549,"Yah, me too. Too much time in my 'safe space' with no Play-Doh or warm puppies."
5190,0,5,54,59,1.0847457627118644,0.03656923485905472,549,You would have to be crazy to think that
5190,1,3,55,59,1.0847457627118644,0.0438379113795422,549,"Just so you know, we're allowed to use our brains, but not break the glass ceiling."
5190,0,5,54,59,1.0847457627118644,0.03656923485905472,549,Let me give you my strait opinion.
5190,0,5,54,59,1.0847457627118644,0.03656923485905472,549,"Mine's from Saks, where did you get yours?"
5190,0,5,54,59,1.0847457627118644,0.03656923485905472,549,We have to re-think our fashion line.
5190,0,5,54,59,1.0847457627118644,0.03656923485905472,549,Let's file a gender discrimination complaint--you can't even see the men's uniforms.
5190,0,5,54,59,1.0847457627118644,0.03656923485905472,549,It's the company's new diversity-to-an-extent policy.
5190,0,5,54,59,1.0847457627118644,0.03656923485905472,549,"You have an MBA...which is fine...I mean it's not that we will use it to disqualify you. But, please tell me more about your creativity."
5190,1,3,55,59,1.0847457627118644,0.0438379113795422,549,"Now that we are constrained , tell me what you really think of me."
5190,0,5,54,59,1.0847457627118644,0.03656923485905472,549,I told you he couldn't change the libel laws.
5190,0,5,54,59,1.0847457627118644,0.03656923485905472,549,I think we should protest to HR about not being allowed to type any more.
5190,0,5,54,59,1.0847457627118644,0.03656923485905472,549,"Welcome to CHAT-ALOT, the hands-free app consortium."
5190,1,3,55,59,1.0847457627118644,0.0438379113795422,549,Mine's a straight manteau.
5190,1,3,55,59,1.0847457627118644,0.0438379113795422,549,The Boss calls me 'Mummy' - what does he call you?
5190,0,5,54,59,1.0847457627118644,0.03656923485905472,549,"We'll have nothing to do with each other, then!"
5190,0,5,54,59,1.0847457627118644,0.03656923485905472,549,Don't you think management's safe-to-speak program is going well?
5190,2,1,56,59,1.0847457627118644,0.05006212150982505,549,"It's going to be a huge fine, I clocked you at 18,000 miles/hour"
5190,0,5,54,59,1.0847457627118644,0.03656923485905472,549,Thanks for giving me the straight dope
5190,0,5,54,59,1.0847457627118644,0.03656923485905472,549,"Obviously, we run HR as well."
5190,1,3,55,59,1.0847457627118644,0.0438379113795422,549,I find it gives me a whole new perspective on bluetooth. You?
5190,0,5,54,59,1.0847457627118644,0.03656923485905472,549,"At least, we have the First Amendment. ...Ra pum pum trump, ra pum pum trump. ... only four more years.... or less."
5190,0,5,54,59,1.0847457627118644,0.03656923485905472,549,"I may be busy on occasion , but I did not expect you to be that tied up ."
5190,1,3,55,59,1.0847457627118644,0.0438379113795422,549,How does that make you feel?
5190,1,3,55,59,1.0847457627118644,0.0438379113795422,549,Don't be so dramatic. We're all a bit tied up now.
5190,0,5,54,59,1.0847457627118644,0.03656923485905472,549,Happy Halloween/Mental Health Awareness Day!
5190,0,5,54,59,1.0847457627118644,0.03656923485905472,549,my nose has become my most valuable appendage.
5190,1,3,55,59,1.0847457627118644,0.0438379113795422,549,I suppose we'll have to call them parallel jackets now.
5190,1,3,55,59,1.0847457627118644,0.0438379113795422,549,What are your strengths and weaknesses?
5190,1,3,55,59,1.0847457627118644,0.0438379113795422,549,How are you settling into our new sexual reorientation program?
5190,0,5,54,59,1.0847457627118644,0.03656923485905472,549,Well as you can tell we're both LinkedIn.
5190,1,3,55,59,1.0847457627118644,0.0438379113795422,549,"As you can see we practice what we preach here at ""Stop Talking With Your Hands""."
5190,1,3,55,59,1.0847457627118644,0.0438379113795422,549,"No, I don't sleep in it. But I'll try it."
5190,0,5,54,59,1.0847457627118644,0.03656923485905472,549,The HR manual calls it REALLY mandatory overtime.
5190,0,5,54,59,1.0847457627118644,0.03656923485905472,549,"We're two straitjackets, a laptop and a cellphone from freedom."
5190,0,5,54,59,1.0847457627118644,0.03656923485905472,549,You'll get no real argument from me...
5190,0,5,54,59,1.0847457627118644,0.03656923485905472,549,I dressed just like you because I wasn't told that origami was part of the interview process.
5190,1,3,55,59,1.0847457627118644,0.0438379113795422,549,Did you learn this treatment from Houdini?
5190,0,5,54,59,1.0847457627118644,0.03656923485905472,549,"I was in your corner, Ms. Randle, but I'm afraid the position went to man in a 4 x 4 x 4 foot cage."
5190,1,3,55,59,1.0847457627118644,0.0438379113795422,549,Now we both are tied up here in your office! Nice going boss. We should have just given your son the phone and laptop that he needed and I would not be involved in your mess!
5190,1,3,55,59,1.0847457627118644,0.0438379113795422,549, 
5257,0,5,55,60,1.0833333333333333,0.03598231413236438,549,I'm moonlighting with a band called Cuckoo's Nest that's very strait-laced.
5257,1,3,56,60,1.0833333333333333,0.04312422383919018,549,The ties that bind
5257,0,5,55,60,1.0833333333333333,0.03598231413236438,549,"So, all hands on deck?"
5257,0,5,55,60,1.0833333333333333,0.03598231413236438,549,Do you feel the new electronic medical record system has made things more restrictive?
5257,1,3,56,60,1.0833333333333333,0.04312422383919018,549,There's a rumor going around that Phyllis is seeing Tim in the mail room.
5257,0,5,55,60,1.0833333333333333,0.03598231413236438,549,"When I talk to you, I feel like I'm looking in a mirror."
5257,0,5,55,60,1.0833333333333333,0.03598231413236438,549,You can see our empathy when we admit you to our clinic.
5257,0,5,55,60,1.0833333333333333,0.03598231413236438,549,Avoiding online flame wars in Trump's America.
5257,1,3,56,60,1.0833333333333333,0.04312422383919018,549,"Now that we're all straightened out, lets begin."
5257,0,5,55,60,1.0833333333333333,0.03598231413236438,549,I think I'm just what you're looking for: I have years of hands-on experience in that field.
5257,0,5,55,60,1.0833333333333333,0.03598231413236438,549,"After ten more interviews with managers who won't know how you fit in, we'll be in touch."
5257,0,5,55,60,1.0833333333333333,0.03598231413236438,549,I still say the A/C is too high on this floor
5257,0,5,55,60,1.0833333333333333,0.03598231413236438,549,"As you can probably tell, we've made some slight changes to our 360 degree review process"
5270,0,5,56,61,1.0819672131147542,0.03541388359785716,549,i dont think they meant you should you should literally put yourself in their shoes
5271,0,5,57,62,1.0806451612903225,0.03486308566114124,549,We offer endless opportunities for expansion.
5272,0,4,53,57,1.0701754385964912,0.034134933513474304,549,"This is my last weeks entry: ""Pilot's lives matter"
5272,0,4,53,57,1.0701754385964912,0.034134933513474304,549,"I can't help you right now, I've got my hands tied"
5272,0,4,53,57,1.0701754385964912,0.034134933513474304,549,"I said ""our hands were tied"" and they said, ""Oh yeah?"" The IT guys are so sensitive."
5272,0,4,53,57,1.0701754385964912,0.034134933513474304,549,Corporate says no!
5272,1,2,54,57,1.0701754385964912,0.04232918735352016,549,Tell me about it!
5272,0,4,53,57,1.0701754385964912,0.034134933513474304,549,Ma'am I would like to place a complaint
5272,0,4,53,57,1.0701754385964912,0.034134933513474304,549,"Well, your husband’s gagging order seems quite comprehensive"
5272,1,2,54,57,1.0701754385964912,0.04232918735352016,549,I didn't realize you were into bondage too!
5272,1,2,54,57,1.0701754385964912,0.04232918735352016,549,We think of ourselves as a family.
5272,0,4,53,57,1.0701754385964912,0.034134933513474304,549,I'm sorry we're looking for someone who's straight but NOT narrow...
5272,0,4,53,57,1.0701754385964912,0.034134933513474304,549,"Sorry, it looks like our hands are tied."
5272,0,4,53,57,1.0701754385964912,0.034134933513474304,549,Out hands our pretty tied on this one.
5272,1,2,54,57,1.0701754385964912,0.04232918735352016,549,"With my hands tied, I can't solve your problems!"
5272,0,4,53,57,1.0701754385964912,0.034134933513474304,549,"So, we broke the glass ceiling and earned these straight jackets! Next, we find the golden toilets!"
5272,0,4,53,57,1.0701754385964912,0.034134933513474304,549,"If we are going to have a Digital Sabbath, we need a Digital Sabbath goy."
5272,1,2,54,57,1.0701754385964912,0.04232918735352016,549,Let's figure out how we're going to beat the glass ceiling.
5272,0,4,53,57,1.0701754385964912,0.034134933513474304,549,I can tell you're a straight shooter.
5272,0,4,53,57,1.0701754385964912,0.034134933513474304,549,I think this 'countertransference' thing has gotten out of hand!
5272,1,2,54,57,1.0701754385964912,0.04232918735352016,549,"I would like to discuss why you are up in arms with not having the resources to do your job, but, I am a bit tied up at the moment."
5272,0,4,53,57,1.0701754385964912,0.034134933513474304,549,This is why I hate my boss.
5272,0,4,53,57,1.0701754385964912,0.034134933513474304,549,"So, let's discuss your Family Medical Leave Act benefits."
5272,0,4,53,57,1.0701754385964912,0.034134933513474304,549,"I'll get strait to the point, you're not fit for this job."
5272,1,2,54,57,1.0701754385964912,0.04232918735352016,549,"Now if we work through this together, we'll get somewhere."
5272,0,4,53,57,1.0701754385964912,0.034134933513474304,549,Just think. Some folks think that we aren't wrapped too tight.
5272,0,4,53,57,1.0701754385964912,0.034134933513474304,549,Cannot ask nor answer those kinds of questions.
5272,1,2,54,57,1.0701754385964912,0.04232918735352016,549,"OK, TIME FOR THIS WEEK'S NAIL MEASUREMENT"
5272,1,2,54,57,1.0701754385964912,0.04232918735352016,549,"Sorry, but there's been a question about our business ties to the Trump Organization."
5272,2,0,55,57,1.0701754385964912,0.04917648338433231,549,"Body language ""pleading the fifth"" in a job interview."
5272,1,2,54,57,1.0701754385964912,0.04232918735352016,549,I really can empathize with how you're feeling bound up at work.
5272,0,4,53,57,1.0701754385964912,0.034134933513474304,549,"Even if we had an opening, I'm not sure I could be of much help to you."
5272,0,4,53,57,1.0701754385964912,0.034134933513474304,549,"When the new guy promised a new level of empowerment, I had something else in mind."
5272,0,4,53,57,1.0701754385964912,0.034134933513474304,549,"If you can't make me laugh, then I guess I'll move on to the next question."
5272,0,4,53,57,1.0701754385964912,0.034134933513474304,549,"Doc, how can I be like you ?"
5272,0,4,53,57,1.0701754385964912,0.034134933513474304,549,"Sorry, Siri... we didn't mean it."
5272,1,2,54,57,1.0701754385964912,0.04232918735352016,549,Well as your manager I'm actually required to tie your hands.
5272,1,2,54,57,1.0701754385964912,0.04232918735352016,549,"Yes, I know -- they've installed a new glass ceiling."
5272,0,4,53,57,1.0701754385964912,0.034134933513474304,549,"is it just me, or do feel like our hands are tied on this one too?"
5272,1,2,54,57,1.0701754385964912,0.04232918735352016,549,"Look, our hands are tied. Pick up that pen with your mouth and sign off that end of year raise."
5272,0,4,53,57,1.0701754385964912,0.034134933513474304,549,"So this author gets stuck in her story because the main character is tied up, so she brings in a friend to help her, but she's tied up, too, so she's no help ...."
5272,1,2,54,57,1.0701754385964912,0.04232918735352016,549,Cat got your tongue?
5272,0,4,53,57,1.0701754385964912,0.034134933513474304,549,Rex insists we stop fighting over him.
5272,1,2,54,57,1.0701754385964912,0.04232918735352016,549,A little help here?!
5272,1,2,54,57,1.0701754385964912,0.04232918735352016,549,"December 1st, 2016... The new salaried position."
5272,0,4,53,57,1.0701754385964912,0.034134933513474304,549,"Sorry, I got nothing."
5272,0,4,53,57,1.0701754385964912,0.034134933513474304,549,We like to take out time here.
5272,1,2,54,57,1.0701754385964912,0.04232918735352016,549,Budget is pretty tight so we had to turn the heat off
5272,1,2,54,57,1.0701754385964912,0.04232918735352016,549,"Yes, a gay jacket would have been better."
5272,0,4,53,57,1.0701754385964912,0.034134933513474304,549,"Okay, let's start this again, shall we?"
5272,0,4,53,57,1.0701754385964912,0.034134933513474304,549,"Linda, I can see that you're really interested in working here at ""Straight-jackets 'R Us."""
5272,0,4,53,57,1.0701754385964912,0.034134933513474304,549,"Okay, so now we're looped in..."
5272,0,4,53,57,1.0701754385964912,0.034134933513474304,549,The IT union voted that we work to rule
5272,1,2,54,57,1.0701754385964912,0.04232918735352016,549,"Where do you see yourself after five years of working here? Table saw. "" ""I hope to be regional director for the Northeast. Shark paste shark paste shark paste."
5272,1,2,54,57,1.0701754385964912,0.04232918735352016,549,Then we're agreed: no more committing
5272,1,2,54,57,1.0701754385964912,0.04232918735352016,549,"Well, your credentials are certainly impressive. However, you do realize that we are looking for a hands on representative."
5272,0,4,53,57,1.0701754385964912,0.034134933513474304,549,We're committed to the glass ceiling
5272,1,2,54,57,1.0701754385964912,0.04232918735352016,549,I once made the mistake of telling a male patient to take the jacket off. My desk was sticky for a week.
5272,0,4,53,57,1.0701754385964912,0.034134933513474304,549,Any relation to Edward Scissorhand?
5272,0,4,53,57,1.0701754385964912,0.034134933513474304,549,What a magical moment!
5272,0,4,53,57,1.0701754385964912,0.034134933513474304,549,I see that you also brought your whole self to work today.
5272,0,4,53,57,1.0701754385964912,0.034134933513474304,549,You'll love the way my new mind-reading app works
5272,1,2,54,57,1.0701754385964912,0.04232918735352016,549,"I totally agree! Hillary is Mom AF, she actually won the election, and she needs to run again in 2020 -- for president of the UNIVERSE!!!"
5272,0,4,53,57,1.0701754385964912,0.034134933513474304,549,"Ah,it oiled Ah, it could be even worse; imagine if we had been tied to railroad tracks!"
5272,1,2,54,57,1.0701754385964912,0.04232918735352016,549,"I hope that this interview goes better than the last one. Not only was I not hired, but I and the other H. R. person were put in isolation."
5272,0,4,53,57,1.0701754385964912,0.034134933513474304,549,"'Damn straight, these new uniforms are tight fitting!'"
5272,1,2,54,57,1.0701754385964912,0.04232918735352016,549,The problem is how do we post our antiFacebook campaign on Facebook?
5272,0,4,53,57,1.0701754385964912,0.034134933513474304,549,"Siri, we're on internet probation. How can we place audio internet orders?"
5272,0,4,53,57,1.0701754385964912,0.034134933513474304,549,I know you think I’m crazy. It’s because you are suffering from an extreme case of psychological transference.
5272,1,2,54,57,1.0701754385964912,0.04232918735352016,549,We're all in straitened circumstances here.
5272,1,2,54,57,1.0701754385964912,0.04232918735352016,549,"I guess this answers the question,""how familiar are you with new LGBT legislation?"""
5272,0,4,53,57,1.0701754385964912,0.034134933513474304,549,The board told me it was to protect us from the shards of the glass ceiling.
5272,0,4,53,57,1.0701754385964912,0.034134933513474304,549,"Yes, well, you know how HR departments are these days."
5272,1,2,54,57,1.0701754385964912,0.04232918735352016,549,I'm stoked we both got in David Blaine's Magic Workshop & Dating Site before the Straightjacket class filled up.
5272,1,2,54,57,1.0701754385964912,0.04232918735352016,549,"I'll fight you to be boss, with one hand tied behind my back."
5272,1,2,54,57,1.0701754385964912,0.04232918735352016,549,"They said don't hire internally, but that's not how we run things around here."
5272,0,4,53,57,1.0701754385964912,0.034134933513474304,549,"I've narrowed down the Caption Contest entries to a final few, and I was hoping you could help me pick a winner."
5272,1,2,54,57,1.0701754385964912,0.04232918735352016,549,We are actually looking for a candidate with more free arms.
5272,0,4,53,57,1.0701754385964912,0.034134933513474304,549,Rule #1: don't dislocate your shoulders while typing.
5272,1,2,54,57,1.0701754385964912,0.04232918735352016,549,However I will be deducting points for not brining scissors to the interview.
5272,0,4,53,57,1.0701754385964912,0.034134933513474304,549,We're a 'Non- Social Media' company.
5272,0,4,53,57,1.0701754385964912,0.034134933513474304,549,"Yeah, you get used to it. At least the coffee is free. Stale, but free!"
5272,0,4,53,57,1.0701754385964912,0.034134933513474304,549,Operating Thetans unlock full body access at level nine.
5272,0,4,53,57,1.0701754385964912,0.034134933513474304,549,Think of it as Breaking the Glass Ceiling 2.0
5272,0,4,53,57,1.0701754385964912,0.034134933513474304,549,"You're a key asset, but that isn't how the economy works."
5272,1,2,54,57,1.0701754385964912,0.04232918735352016,549,Things have ground to a halt since our emails were hacked.
5272,0,4,53,57,1.0701754385964912,0.034134933513474304,549,I see you shop at Harry's too.
5272,1,2,54,57,1.0701754385964912,0.04232918735352016,549,"I know we continue to fight the ""glass ceiling"" but this is really a bit over the top!"
5272,1,2,54,57,1.0701754385964912,0.04232918735352016,549,You will be the first Italian we have ever signed.
5272,0,4,53,57,1.0701754385964912,0.034134933513474304,549,So... who's your favorite Kardashian?
5272,0,4,53,57,1.0701754385964912,0.034134933513474304,549,Don't get any ideas- this is not a hand's-on office.
5272,1,2,54,57,1.0701754385964912,0.04232918735352016,549,The CEO told me when I hired in that I'd wouldn't have to worry about a glass ceiling.
5272,0,4,53,57,1.0701754385964912,0.034134933513474304,549,No need to ask about my sexual orientation.
5272,1,2,54,57,1.0701754385964912,0.04232918735352016,549,Civil conversation.
5272,1,2,54,57,1.0701754385964912,0.04232918735352016,549,"A ninety-seven percent success rate, she promised."
5272,0,4,53,57,1.0701754385964912,0.034134933513474304,549,We'd like to tie you up before you escape.
5272,0,4,53,57,1.0701754385964912,0.034134933513474304,549,Let me get this straight. You did what????
5272,1,2,54,57,1.0701754385964912,0.04232918735352016,549,Let us be straight with one another
5272,0,4,53,57,1.0701754385964912,0.034134933513474304,549,"Well, now that we've got THAT all tied up, how about we move on to the next item on the list, eh?"
5272,0,4,53,57,1.0701754385964912,0.034134933513474304,549,Thumb Suckers Anonymous or Two Fingers?
5272,0,4,53,57,1.0701754385964912,0.034134933513474304,549,Although I don't agree with all of his policies you've gotta admit he built an impressive wall!
5272,1,2,54,57,1.0701754385964912,0.04232918735352016,549,I'm sorry that's all the time we have today. Group is in 5 minutes.
5272,1,2,54,57,1.0701754385964912,0.04232918735352016,549,Welcome to Incessantly-Dancing Anonymous.
5272,0,4,53,57,1.0701754385964912,0.034134933513474304,549,"As Karl Marx, one of our harshest critics prophesied, ""Social progress can be measured by the social position of the female sex."""
5272,1,2,54,57,1.0701754385964912,0.04232918735352016,549,"Failure to communicate, sign language version."
5272,0,4,53,57,1.0701754385964912,0.034134933513474304,549,Giorgio Bellino's spring line?
5272,1,2,54,57,1.0701754385964912,0.04232918735352016,549,There wasn't a happy ending after I told the Judge we refused to close the massage parlor.
5272,1,2,54,57,1.0701754385964912,0.04232918735352016,549,"The corporate confidentiality policy is built upon the ""Loose Lips Sink Ships"" philospohy"
5272,0,4,53,57,1.0701754385964912,0.034134933513474304,549,Did you notice his srange sense of humor?
5272,0,4,53,57,1.0701754385964912,0.034134933513474304,549,"OK, Bill Gates has standardized us teachers. Now what?"
5272,0,4,53,57,1.0701754385964912,0.034134933513474304,549,Yours is posier.
5272,0,4,53,57,1.0701754385964912,0.034134933513474304,549,Let me cut strait to the chase with our job offer.
5272,0,4,53,57,1.0701754385964912,0.034134933513474304,549,This company was literally built on laissez-faire principles.
5272,0,4,53,57,1.0701754385964912,0.034134933513474304,549,Let me check whether there are more social norms to put on
5272,0,4,53,57,1.0701754385964912,0.034134933513474304,549,I'd help you out but you can see my hands are tied.
5272,1,2,54,57,1.0701754385964912,0.04232918735352016,549,Part of my therapy as a Tiedalogist is an inner retrospect exercise
5272,0,4,53,57,1.0701754385964912,0.034134933513474304,549,I can assure you we're all straight shooters here.
5272,1,2,54,57,1.0701754385964912,0.04232918735352016,549,"You said you're a 'straight talker,' but I'd like to go 'off-topic.'"
5272,1,2,54,57,1.0701754385964912,0.04232918735352016,549,"Like everything else, only straight talk here."
5272,0,4,53,57,1.0701754385964912,0.034134933513474304,549,Now we can check the news online AND keep our hair!
5272,0,4,53,57,1.0701754385964912,0.034134933513474304,549,Oh to be saved by The Phantom String Untangler.
5272,0,4,53,57,1.0701754385964912,0.034134933513474304,549,"Concealed carry is all very well, but this is a bit much"
5272,0,4,53,57,1.0701754385964912,0.034134933513474304,549,And I thought I was the only one crazy enough to wear my new Snuggie to work.
5272,0,4,53,57,1.0701754385964912,0.034134933513474304,549,"Hey, do you want to play patty cake?"
5272,1,2,54,57,1.0701754385964912,0.04232918735352016,549,At this company we are neither alt right or alt left.
5272,1,2,54,57,1.0701754385964912,0.04232918735352016,549,"It's a race, at the count of three, I'll describe Houdini's trick from my I pad, then go!"
5272,0,4,53,57,1.0701754385964912,0.034134933513474304,549,I'm sensing I've given you to much work.
5272,1,2,54,57,1.0701754385964912,0.04232918735352016,549,You deserve some strait answers.
5272,0,4,53,57,1.0701754385964912,0.034134933513474304,549,"While it may not seem like it at first, this position offers great, upward mobility."
5272,0,4,53,57,1.0701754385964912,0.034134933513474304,549,This from Armani's Evening Collection.
5272,0,4,53,57,1.0701754385964912,0.034134933513474304,549,And this is how HR became known as human relations!
5272,1,2,54,57,1.0701754385964912,0.04232918735352016,549,We don't hire based on diversity.
5272,0,4,53,57,1.0701754385964912,0.034134933513474304,549,I wish you could see my congratulatory handshake emoticon.
5272,1,2,54,57,1.0701754385964912,0.04232918735352016,549,"Violence in the workplace is strictly forbidden here, you lazy bitch."
5272,0,4,53,57,1.0701754385964912,0.034134933513474304,549,I'm looking forward to unraveling layers upon layers.
5272,0,4,53,57,1.0701754385964912,0.034134933513474304,549,So how exactly does this blind leading the blind idea play out again?
5272,0,4,53,57,1.0701754385964912,0.034134933513474304,549,That crazy straight-talk interview
5272,0,4,53,57,1.0701754385964912,0.034134933513474304,549,HR's year-end dress code makes it faster to tie up loose ends.
5272,0,4,53,57,1.0701754385964912,0.034134933513474304,549,"You were right - I haven't tweeted in days. Farted, yes; tweeted, no."
5272,1,2,54,57,1.0701754385964912,0.04232918735352016,549,We need to get something straight between us.
5272,0,4,53,57,1.0701754385964912,0.034134933513474304,549,This job made me crazy!
5272,1,2,54,57,1.0701754385964912,0.04232918735352016,549,"So what's new and exciting?"" ""What?"" ""No kidding!"
5272,0,4,53,57,1.0701754385964912,0.034134933513474304,549,HR says that we can't shake hands.
5272,1,2,54,57,1.0701754385964912,0.04232918735352016,549,From now on we have to be strait with each other.
5272,0,4,53,57,1.0701754385964912,0.034134933513474304,549,Resentment is a reflection of itself.
5272,1,2,54,57,1.0701754385964912,0.04232918735352016,549,We like to think outside the box and believe you'll fit in perfectly here.
5272,1,2,54,57,1.0701754385964912,0.04232918735352016,549,This is better than yoga.
5272,0,4,53,57,1.0701754385964912,0.034134933513474304,549,and now we are ready for the next presidential tweet
5272,0,4,53,57,1.0701754385964912,0.034134933513474304,549,Here at StrateTek we don't hold that against you.
5272,0,4,53,57,1.0701754385964912,0.034134933513474304,549,"I'm sorry, but the position for magician is already filled."
5272,0,4,53,57,1.0701754385964912,0.034134933513474304,549,The company asked me to hire an expert in knot theory.
5272,0,4,53,57,1.0701754385964912,0.034134933513474304,549,"Pilot's license and registration, please."
5272,0,4,53,57,1.0701754385964912,0.034134933513474304,549,My hands are tied without technology.
5272,1,2,54,57,1.0701754385964912,0.04232918735352016,549,In this case not only our hands are tied !
5272,0,4,53,57,1.0701754385964912,0.034134933513474304,549,So who am I going to get to feed me my bagel?
5272,0,4,53,57,1.0701754385964912,0.034134933513474304,549,"Crazy see, crazy do."
5272,0,4,53,57,1.0701754385964912,0.034134933513474304,549,We're just here to set the record straight.
5272,1,2,54,57,1.0701754385964912,0.04232918735352016,549,I hear company revenue has gone down since they set the new dress code.
5272,0,4,53,57,1.0701754385964912,0.034134933513474304,549,The workload is always a bit crazy this time of year.
5272,0,4,53,57,1.0701754385964912,0.034134933513474304,549,I told a patient I was Hannibal Lecter's spawn. What brought you here?
5272,0,4,53,57,1.0701754385964912,0.034134933513474304,549,I'm so crazy about this season's straight jackets.
5272,0,4,53,57,1.0701754385964912,0.034134933513474304,549,Let's confine ourselves to the topic at face.
5272,0,4,53,57,1.0701754385964912,0.034134933513474304,549,"Look at it like this, the boss's wife may hate us this much, but look at what we're saving on manicures."
5272,1,2,54,57,1.0701754385964912,0.04232918735352016,549,"Hey doc, I didn't think we were this tight."
5272,0,4,53,57,1.0701754385964912,0.034134933513474304,549,"I'm considering starting ""Casual Friday"" around the office."
5272,0,4,53,57,1.0701754385964912,0.034134933513474304,549,"In our office, we do not believe in 2nd amendment rights."
5272,1,2,54,57,1.0701754385964912,0.04232918735352016,549,"...and she won by over 2.8 million votes, we were told we're running the place, and now I need an executive assistant. Would you count typing among your skills?"
5272,0,4,53,57,1.0701754385964912,0.034134933513474304,549,So where do you see yourself in 10 years?
5272,0,4,53,57,1.0701754385964912,0.034134933513474304,549,Bleeding out of my whatever. You?
5272,1,2,54,57,1.0701754385964912,0.04232918735352016,549,I don't like you either!
5272,0,4,53,57,1.0701754385964912,0.034134933513474304,549,Water tank & coffin are manifestations of your inner insecurity with the confinement of modern life.
5272,0,4,53,57,1.0701754385964912,0.034134933513474304,549,"Would you google, ""how to escape from a straitjacket"" for me?"
5272,0,4,53,57,1.0701754385964912,0.034134933513474304,549,"Add a gag and a blindfold, and that's it for communication. I always said communication is over-rated."
5272,0,4,53,57,1.0701754385964912,0.034134933513474304,549,Just think of it as a thundershirt for the next four years.
5272,0,4,53,57,1.0701754385964912,0.034134933513474304,549,If you feel a bit too tied up at work just think of Houdini!
5272,1,2,54,57,1.0701754385964912,0.04232918735352016,549,"Now, about your hair . . ."
5272,1,2,54,57,1.0701754385964912,0.04232918735352016,549,This is the only way we can be distracted by our phones and not do anything about it
5272,1,2,54,57,1.0701754385964912,0.04232918735352016,549,"Sorry, but looking at my Outlook calendar those dates are not good; all my time is tied up."
5272,0,4,53,57,1.0701754385964912,0.034134933513474304,549,So forget about upwardly mobile.
5272,0,4,53,57,1.0701754385964912,0.034134933513474304,549,I've told you not to take what I say literally.
5272,0,4,53,57,1.0701754385964912,0.034134933513474304,549,There will be no checking of emails during this meeting.
5272,1,2,54,57,1.0701754385964912,0.04232918735352016,549,This accommodation is not very accommodating.
5272,0,4,53,57,1.0701754385964912,0.034134933513474304,549,when school starts and your teacher doesn't let you move around.
5272,0,4,53,57,1.0701754385964912,0.034134933513474304,549,We encourage those who work here to get beyond their comfort zone!
5272,0,4,53,57,1.0701754385964912,0.034134933513474304,549,"I forgot, how do we now order lunch in?"
5272,0,4,53,57,1.0701754385964912,0.034134933513474304,549,Oh! Downsize the Human Resources DEPARTMENT!
5272,1,2,54,57,1.0701754385964912,0.04232918735352016,549,"Well, it's like Huxley said, 'You shall know the truth and the truth will drive you mad'"
5272,0,4,53,57,1.0701754385964912,0.034134933513474304,549,What Houdini did was easy compared to how my hands are tied here.
5272,0,4,53,57,1.0701754385964912,0.034134933513474304,549,You're fired!
5272,1,2,54,57,1.0701754385964912,0.04232918735352016,549,I don't know about you but I'm gay and Mike Pence put me in this straight jacket.
5272,0,4,53,57,1.0701754385964912,0.034134933513474304,549,Isn't your maiden name Houdini
5272,0,4,53,57,1.0701754385964912,0.034134933513474304,549,In all our Italian nunneries the code of silence is strictly observed.
5272,0,4,53,57,1.0701754385964912,0.034134933513474304,549,"I'm sorry, I just don't think you're right for our Asylum Masseuse position."
5272,1,2,54,57,1.0701754385964912,0.04232918735352016,549,Welcome to Booger Eaters Anonymous.
5272,0,4,53,57,1.0701754385964912,0.034134933513474304,549,"Today is dress the way you feel day, don't worry I'm taking mental notes during the interview."
5272,0,4,53,57,1.0701754385964912,0.034134933513474304,549,You got out first you get a raise if I got out first you're fired.
5272,0,4,53,57,1.0701754385964912,0.034134933513474304,549,I'm starting to have second thoughts about joining the Straitjacket Society of America.
5272,0,4,53,57,1.0701754385964912,0.034134933513474304,549,"Where there's Wifi, there's always a way!"
5272,1,2,54,57,1.0701754385964912,0.04232918735352016,549,"No, there's nothing funny about us both wearing stright jackets."
5272,0,4,53,57,1.0701754385964912,0.034134933513474304,549,I'm glad you decided to come straight with me...
5272,1,2,54,57,1.0701754385964912,0.04232918735352016,549,"Of course your magic act is better, you have the mask, the hair and the computer to figure out how to get out of this damn thing."
5272,0,4,53,57,1.0701754385964912,0.034134933513474304,549,"So, do you want the job, or what?"
5272,0,4,53,57,1.0701754385964912,0.034134933513474304,549,What are my goals? To have a straight jacket with only one restraint.
5272,0,4,53,57,1.0701754385964912,0.034134933513474304,549,At least I'm immune to flattery.
5272,1,2,54,57,1.0701754385964912,0.04232918735352016,549,My hands are tied on this decision as well Mary.
5272,0,4,53,57,1.0701754385964912,0.034134933513474304,549,"I know you're having a tough time, but it's this or the glass ceiling."
5272,0,4,53,57,1.0701754385964912,0.034134933513474304,549,"We need less straight laced thinking in this department, any ideas?"
5272,0,4,53,57,1.0701754385964912,0.034134933513474304,549,"Just remember, Karen: You’re not the only one whose hands are tied up in a straitjacket."
5272,0,4,53,57,1.0701754385964912,0.034134933513474304,549,It's CRAZY how warm these are!
5272,1,2,54,57,1.0701754385964912,0.04232918735352016,549,"Just a little psych eval for the suits upstairs, then we can have a client for dinner."
5272,1,2,54,57,1.0701754385964912,0.04232918735352016,549,Staring at this cartoon will make you cross eyed.
5272,1,2,54,57,1.0701754385964912,0.04232918735352016,549,Finally somebody who understands what it's like to be a touchy feely type person.
5482,0,4,54,58,1.0689655172413792,0.033563052647743945,549,You don’t look the part.
5482,0,4,54,58,1.0689655172413792,0.033563052647743945,549,I was a Sanders supporter long before you were a Trump supporter.
5482,0,4,54,58,1.0689655172413792,0.033563052647743945,549,"If I had known you were coming as a nut in this insane asylum, I would have come as a clown in this circus."
5482,0,4,54,58,1.0689655172413792,0.033563052647743945,549,"Ma'am I'm sorry but I think your stuck with this problem, trust me I am too."
5482,1,2,55,58,1.0689655172413792,0.041610565732650054,549,So what are we working on today?
5487,0,4,55,59,1.0677966101694916,0.03300998538034586,549,"OK, that seems to have solved the rude gesture problem, so let's get back to the original issue."
5488,0,3,52,55,1.0545454545454545,0.030903148567228995,549,"Sometimes I feel as if I'm trapped."" ""Don't worry, everyone does."
5488,0,3,52,55,1.0545454545454545,0.030903148567228995,549,They have increased straight talk by 59%—not that we're against gays or anything!
5488,0,3,52,55,1.0545454545454545,0.030903148567228995,549,"As your weight loss specialist, if you leae those wraps on long enough you'll lose weight."
5488,1,1,53,55,1.0545454545454545,0.040353503748359956,549,"I've got an itch. Would you mind if I removed this jacket, as any magician would, so I can scratch it? Pleeeease."
5488,0,3,52,55,1.0545454545454545,0.030903148567228995,549,"""So we are done here. Now go out and shed all your inhibitions""."
5488,0,3,52,55,1.0545454545454545,0.030903148567228995,549,I'm going to let you take the first swing with this situation.
5488,0,3,52,55,1.0545454545454545,0.030903148567228995,549,Our company doesn't like to get tied down with details.
5488,0,3,52,55,1.0545454545454545,0.030903148567228995,549,"They think this will make us break! Ha ha, we have more stamina than they know. How can we use this time to be creative and think out of the box?"
5488,1,1,53,55,1.0545454545454545,0.040353503748359956,549,OMG! This is weird talking FTF. LOL!
5488,0,3,52,55,1.0545454545454545,0.030903148567228995,549,"You are correct that lunatics are running the asylum, but we aren't responsible for problems caused by unusually tight regulations."
5488,1,1,53,55,1.0545454545454545,0.040353503748359956,549,It helps you understand everything's in the mind
5488,0,3,52,55,1.0545454545454545,0.030903148567228995,549,"I'm a little tied up at ht moment, but wanted to tell you my hands are tied on the matter."" ""I appreciate you being straight about that."
5488,0,3,52,55,1.0545454545454545,0.030903148567228995,549,Now don’t get your stomach tied up in knots about problems at work.
5488,0,3,52,55,1.0545454545454545,0.030903148567228995,549,"Funny, I also graduated from mime school."
5488,1,1,53,55,1.0545454545454545,0.040353503748359956,549,Since we're both tied up I guess we can't meet.
5488,0,3,52,55,1.0545454545454545,0.030903148567228995,549,"Nowadays they're referred to as ""cis-jackets."
5488,0,3,52,55,1.0545454545454545,0.030903148567228995,549,"F""or God's sake, just use your toes to type the notes."""
5488,0,3,52,55,1.0545454545454545,0.030903148567228995,549,And when Houdini appears to you does he mention a keyd
5488,0,3,52,55,1.0545454545454545,0.030903148567228995,549,"Hippa, hippa, hooray. Good one."
5488,0,3,52,55,1.0545454545454545,0.030903148567228995,549,They take their tie breaker competition very seriously.
5488,0,3,52,55,1.0545454545454545,0.030903148567228995,549,we could consider the issue when we are not tied up
5488,0,3,52,55,1.0545454545454545,0.030903148567228995,549,And I wear my Gucci jacket to our staff parties.
5488,1,1,53,55,1.0545454545454545,0.040353503748359956,549,I've just noticed something quite strange - your computer doesn't gave a logo.
5488,0,3,52,55,1.0545454545454545,0.030903148567228995,549,This new fashion trend is - rather a tad restricting.
5488,0,3,52,55,1.0545454545454545,0.030903148567228995,549,So much for those Christmas gifts.
5488,1,1,53,55,1.0545454545454545,0.040353503748359956,549,Yell to Comet Pizza for a Houdini delivery.
5488,0,3,52,55,1.0545454545454545,0.030903148567228995,549,Being around you always ties up my stomach in knots.
5488,0,3,52,55,1.0545454545454545,0.030903148567228995,549,I guess the therapist felt this was the best way to interact.
5488,0,3,52,55,1.0545454545454545,0.030903148567228995,549,"Call me crazy, but I wish I could toss this latest IT upgrade in the looney bin."
5488,1,1,53,55,1.0545454545454545,0.040353503748359956,549,This Twitter Tantrum Therapy could have a towering effect!
5488,1,1,53,55,1.0545454545454545,0.040353503748359956,549,wow thats a funny scarf that goes around ur whole body yes thanks fancesca i got it on sale at aritzia o how nice martinette mine is from Filene's Basement
5488,0,3,52,55,1.0545454545454545,0.030903148567228995,549,The Malania speechwriter's job?...I told him we'd wait for his call
5488,0,3,52,55,1.0545454545454545,0.030903148567228995,549,"I'm sorry, but the regulations are so stringent, I'm, like, in a straight jacket!"
5488,0,3,52,55,1.0545454545454545,0.030903148567228995,549,"Hey, how's it going?"" ""Oh, pretty good."
5488,0,3,52,55,1.0545454545454545,0.030903148567228995,549,"Frankly , time to get back to the point."
5488,0,3,52,55,1.0545454545454545,0.030903148567228995,549,"To answer your question, ""I am the treasure, they always tie me up when they are away, but you?"""
5488,0,3,52,55,1.0545454545454545,0.030903148567228995,549,You don't have to say anything. We're both tied up.
5488,0,3,52,55,1.0545454545454545,0.030903148567228995,549,"I won't ask how old you are, if you won't ask me."
5488,0,3,52,55,1.0545454545454545,0.030903148567228995,549,I like candidates who think outside the box.
5488,0,3,52,55,1.0545454545454545,0.030903148567228995,549,"From the Yeezy ""Exhaustion"" line"
5488,0,3,52,55,1.0545454545454545,0.030903148567228995,549,"Well, I feel like I'm tied up in a knot, too!"
5488,1,1,53,55,1.0545454545454545,0.040353503748359956,549,I'm hope the new Trump administration is serious about rolling back Dodd Frank.
5488,1,1,53,55,1.0545454545454545,0.040353503748359956,549,Ha. Guess we're both tied in knots...
5488,0,3,52,55,1.0545454545454545,0.030903148567228995,549,That Siri can be really annoying.
5488,0,3,52,55,1.0545454545454545,0.030903148567228995,549,You're constrained by on site sexism and our company's arbitration policy. I'm constrained by a desire to keep my Human Relations position.
5488,1,1,53,55,1.0545454545454545,0.040353503748359956,549,Just how small IS is?
5488,0,3,52,55,1.0545454545454545,0.030903148567228995,549,"""Love is automatic if your soul meets mine""."
5488,0,3,52,55,1.0545454545454545,0.030903148567228995,549,"As discussed, this is at-will employment."
5488,0,3,52,55,1.0545454545454545,0.030903148567228995,549,I'm one of those who doesn't want to break the glass ceiling.
5488,0,3,52,55,1.0545454545454545,0.030903148567228995,549,I don't like H.R.'s new policies.
5488,0,3,52,55,1.0545454545454545,0.030903148567228995,549,Did you know that your registration expired last month?
5488,0,3,52,55,1.0545454545454545,0.030903148567228995,549,"~Sir, your left tail light is out!~"
5488,0,3,52,55,1.0545454545454545,0.030903148567228995,549,We're gonna have to put the glass ceiling on a back burner for a few years.
5488,0,3,52,55,1.0545454545454545,0.030903148567228995,549,Tell me about a time when you broke through institutional boundaries.
5488,0,3,52,55,1.0545454545454545,0.030903148567228995,549,The armed inmates running the asylum have embraced a hands-off policy.
5488,0,3,52,55,1.0545454545454545,0.030903148567228995,549,Your jacket looks to be out of style!
5488,1,1,53,55,1.0545454545454545,0.040353503748359956,549,Every Friday is Not-Necessarily-Dead Day.
5488,1,1,53,55,1.0545454545454545,0.040353503748359956,549,"Ok, fine... I'll share my location with you"
5488,0,3,52,55,1.0545454545454545,0.030903148567228995,549,Do you know the land speed record round these parts?
5488,0,3,52,55,1.0545454545454545,0.030903148567228995,549,I know you're tired of it but it's what we do here.
5488,0,3,52,55,1.0545454545454545,0.030903148567228995,549,How good are you at putting firewalls around the Internet?
5488,0,3,52,55,1.0545454545454545,0.030903148567228995,549,What would Justice Ginsburg do?
5488,1,1,53,55,1.0545454545454545,0.040353503748359956,549,"We're going to have to wait for a bowel movement or the cleaning crew, either way we really need the cleaning crew to hurry!"
5488,0,3,52,55,1.0545454545454545,0.030903148567228995,549,Have you tried deactivating?
5488,0,3,52,55,1.0545454545454545,0.030903148567228995,549,This is quite the role reversal!
5488,0,3,52,55,1.0545454545454545,0.030903148567228995,549,I'm a little worried that unfettered emotions might be part of who I really am.
5488,0,3,52,55,1.0545454545454545,0.030903148567228995,549,So you think we can sell straight jackets for illegal aliens to our President Elect that  whose overall cost will be far cheaper than building a wall.
5488,0,3,52,55,1.0545454545454545,0.030903148567228995,549,It looks like neither of us is willing to give a 'strait' answer.
5488,0,3,52,55,1.0545454545454545,0.030903148567228995,549,"Oh, I just remembered that my receptionist took the afternoon off for a dental appointment. So let's get started ..."
5488,1,1,53,55,1.0545454545454545,0.040353503748359956,549,You'll fit in knowing that a fashion statement is the only allowable personal statement.
5488,0,3,52,55,1.0545454545454545,0.030903148567228995,549,You'll fit in with our sense of fashion
5488,0,3,52,55,1.0545454545454545,0.030903148567228995,549,"Betty, I'm going to tell it to you straight !""'My management style is for me & my team to live my metaphors."" ""So, I won't be pulling any punches nor will you !"
5488,0,3,52,55,1.0545454545454545,0.030903148567228995,549,Your interview is a ritual.
5488,1,1,53,55,1.0545454545454545,0.040353503748359956,549,1. And I thought we only bound by the contract… 2. And I thought this was a hands on company...
5488,0,3,52,55,1.0545454545454545,0.030903148567228995,549,I wanted to understand your psyche on a more personal level.
5488,1,1,53,55,1.0545454545454545,0.040353503748359956,549,Looks like you forgot to buy beer for your husband as well.
5488,0,3,52,55,1.0545454545454545,0.030903148567228995,549,"Here at Wilson, Johnson and Smith Accounting LLC, we take pride in not taking the expedient route in our audit documentation. Would that appeal to you?"
5488,0,3,52,55,1.0545454545454545,0.030903148567228995,549,Where do you see yourself in five millennia?
5488,1,1,53,55,1.0545454545454545,0.040353503748359956,549,Chicken pho okayfor lunch?
5488,0,3,52,55,1.0545454545454545,0.030903148567228995,549,Politcal Correctness is getting out of hand.
5488,1,1,53,55,1.0545454545454545,0.040353503748359956,549,"OK, I see what you mean. . ."
5488,0,3,52,55,1.0545454545454545,0.030903148567228995,549,New rules ... burp fart.
5488,1,1,53,55,1.0545454545454545,0.040353503748359956,549,"These new open-plan offices are great, aren't they?"
5488,1,1,53,55,1.0545454545454545,0.040353503748359956,549,"I know you feel stuck, but we’re getting a knot upgrade."
5488,0,3,52,55,1.0545454545454545,0.030903148567228995,549,"Yes, I understand that. But it's still going to take some time to break down these silos."
5488,0,3,52,55,1.0545454545454545,0.030903148567228995,549,"Finally, someone who can give it to me straight."
5488,0,3,52,55,1.0545454545454545,0.030903148567228995,549,This is the wage gap.
5488,0,3,52,55,1.0545454545454545,0.030903148567228995,549,Maybe I should go back to college.
5488,0,3,52,55,1.0545454545454545,0.030903148567228995,549,Me? I'd just like to clean our my inbox.
5488,0,3,52,55,1.0545454545454545,0.030903148567228995,549,"Yes, mam"
5488,0,3,52,55,1.0545454545454545,0.030903148567228995,549,"This adds to the stigma of mental health. This does not personify anything positive for anyone who needs to utilize the mental health system for supports... and only makes ""us"" look crazy versus human beings going through a tumultuous time in life."
5579,0,3,53,56,1.0535714285714286,0.030361917118846855,549,"CHILD: WHY YOU ARE HERE? ADULT: JUST FOR FUN, LIKE OUR PRESIDENT IN WHITE HOUSE."
5580,0,3,55,58,1.0517241379310345,0.029334355490462056,549,"Finally! an applicant who gets the ""SJWF"" reference!"
5581,1,0,53,54,1.037037037037037,0.03703703703703703,549,You get good miles per gallon on that?
5581,0,2,52,54,1.037037037037037,0.025940896147128686,549,"According to new job description, advanced emphaty is obligatory."
5581,0,2,52,54,1.037037037037037,0.025940896147128686,549,"Senator Change, when is congress in session again?"
5581,0,2,52,54,1.037037037037037,0.025940896147128686,549,Optimistic to the end!
5581,0,2,52,54,1.037037037037037,0.025940896147128686,549,But i have 2 followers on twitter!
5581,0,2,52,54,1.037037037037037,0.025940896147128686,549,"""Once a month, we offer our employees 'Off The Grid Friday'. What do you think?"
5581,0,2,52,54,1.037037037037037,0.025940896147128686,549,I doubt that Bernie Sanders could manage this.
5581,1,0,53,54,1.037037037037037,0.03703703703703703,549,"If you don't like the new uniforms, let's see you do better."
5581,0,2,52,54,1.037037037037037,0.025940896147128686,549,Fortunately I have a small nose.
5581,0,2,52,54,1.037037037037037,0.025940896147128686,549,"In the process, somehow we dislocated your paycheck."
5581,0,2,52,54,1.037037037037037,0.025940896147128686,549,"At this place, we take things literally!"
5581,0,2,52,54,1.037037037037037,0.025940896147128686,549,I told you this would keep him off the couch!
5581,0,2,52,54,1.037037037037037,0.025940896147128686,549,Is that a trending fashion nowadays? I should start wearing ropes now.
5581,0,2,52,54,1.037037037037037,0.025940896147128686,549,This is not my idea of a straight up conversation.
5581,0,2,52,54,1.037037037037037,0.025940896147128686,549,Being strapped is not such a bad thing these days.
5581,0,2,52,54,1.037037037037037,0.025940896147128686,549,"All I said was, ""Ban the box."""
5581,0,2,52,54,1.037037037037037,0.025940896147128686,549,At least I didn't violate the gag order! Tch!Tch! Now look who's NOT talking!
5581,0,2,52,54,1.037037037037037,0.025940896147128686,549,This is so my new aesthetic.
5581,0,2,52,54,1.037037037037037,0.025940896147128686,549,Then there was Larry. Larry smelled funny. I think it was rabies.
5581,0,2,52,54,1.037037037037037,0.025940896147128686,549,Don't you think fashion week is a little bit too constraining?
5581,0,2,52,54,1.037037037037037,0.025940896147128686,549,How 'bout you boldly go to your wallet and hand me your license and registration?
5581,0,2,52,54,1.037037037037037,0.025940896147128686,549,"Didn't you hear? Straightjackets are very ""in"" right now."
5581,0,2,52,54,1.037037037037037,0.025940896147128686,549,It's crazy how expensive our heating bill is.
5581,0,2,52,54,1.037037037037037,0.025940896147128686,549,We are awfully tied up right now !
5581,0,2,52,54,1.037037037037037,0.025940896147128686,549,Exactly how are you supposed to type on the computer and write things down?
5581,0,2,52,54,1.037037037037037,0.025940896147128686,549,Return to the 1950s
5581,0,2,52,54,1.037037037037037,0.025940896147128686,549,One of your tail lights is burnt off.
5581,0,2,52,54,1.037037037037037,0.025940896147128686,549,I love this new approach to our HR meetings!
5581,0,2,52,54,1.037037037037037,0.025940896147128686,549,"If you want to go to Eu-rope, then you should have just said so."
5581,0,2,52,54,1.037037037037037,0.025940896147128686,549,"I am citing you for not displaying an ""Oversize Vehicle"" sign."
5581,0,2,52,54,1.037037037037037,0.025940896147128686,549,Tell me. Do I starring role in Marat DeSade?
5581,0,2,52,54,1.037037037037037,0.025940896147128686,549,I'm waiting until Hillary runs in 2020!
5581,0,2,52,54,1.037037037037037,0.025940896147128686,549,I give you the result straight away
5581,0,2,52,54,1.037037037037037,0.025940896147128686,549,We look forward to casual Fridays here: the straightjacket is an option.
5581,1,0,53,54,1.037037037037037,0.03703703703703703,549,"So,do you think you could be happy working for a tech firm that doesn't believe in disruption?"
5581,0,2,52,54,1.037037037037037,0.025940896147128686,549,We tried the Chinese wall but decided that arms length relationships were better.
5581,1,0,53,54,1.037037037037037,0.03703703703703703,549,So you were keeping up with the flow of traffic?
5581,0,2,52,54,1.037037037037037,0.025940896147128686,549,Care to dance?
5581,0,2,52,54,1.037037037037037,0.025940896147128686,549,"I VOTED DEMOCRATIC, I VOTED REPUBLICAN .ITS TRUE WE BOTH LOST !"
5581,0,2,52,54,1.037037037037037,0.025940896147128686,549,"Yes, today so many of us stay connected through social media. Tell me how it has been helping you."
5581,0,2,52,54,1.037037037037037,0.025940896147128686,549,Lies and restraints do not a glass ceiling harden.
5581,0,2,52,54,1.037037037037037,0.025940896147128686,549,"Please, no hand gestures--emoticons are okay."
5581,0,2,52,54,1.037037037037037,0.025940896147128686,549,YourproblemsrunsodeepevenIneedastraightjacket
5581,0,2,52,54,1.037037037037037,0.025940896147128686,549,How fast was I going?
5581,0,2,52,54,1.037037037037037,0.025940896147128686,549,We should've think this true eh?
5581,0,2,52,54,1.037037037037037,0.025940896147128686,549,I followed her in middle school band and I'll follow her again.
5581,0,2,52,54,1.037037037037037,0.025940896147128686,549,"She knew she needed help, but this was just like the blind leading the blind."
5581,0,2,52,54,1.037037037037037,0.025940896147128686,549,"Honestly, I'm not crazy about working overtime either."
5581,0,2,52,54,1.037037037037037,0.025940896147128686,549,"Before I extend an offer, please tell me more about the consultancy tenure with Lance Burton"
5581,0,2,52,54,1.037037037037037,0.025940896147128686,549,"Until Trump settles down, nobody knows what we can or cannot safely say oemdo!"
5581,0,2,52,54,1.037037037037037,0.025940896147128686,549,"Just a warning, sir - get those tail lights fixed."
5581,0,2,52,54,1.037037037037037,0.025940896147128686,549,We'll just sit and wait until you give me the straight answer.
5581,0,2,52,54,1.037037037037037,0.025940896147128686,549,"Yes Sir, or Madam, I do understand, self-expression is frowned upon around here - as best I can tell."
5581,0,2,52,54,1.037037037037037,0.025940896147128686,549,"They got word I checked into my ancestry. So, you're Italian, too?"
5581,0,2,52,54,1.037037037037037,0.025940896147128686,549,Time for a Bathroom-Break?
5581,0,2,52,54,1.037037037037037,0.025940896147128686,549,I'm afraid running the asylum makes easy to stay.
5581,0,2,52,54,1.037037037037037,0.025940896147128686,549,Soccer mom-ing's not as easy as I thought it would be.
5581,0,2,52,54,1.037037037037037,0.025940896147128686,549,"Some people think our way of conducting business is a little crazy, but I can tell you will have no problem fitting in."
5581,0,2,52,54,1.037037037037037,0.025940896147128686,549,Mr. Trump wants someone with a sense of humor.
5581,0,2,52,54,1.037037037037037,0.025940896147128686,549,Pay no attention to the PC interview garb.
5581,0,2,52,54,1.037037037037037,0.025940896147128686,549,We are letting you go. You've become too tied up at home.
5581,0,2,52,54,1.037037037037037,0.025940896147128686,549,"Our misery doesn't matter, as long as the coquette is fine."
5581,0,2,52,54,1.037037037037037,0.025940896147128686,549,shes captivated by your answer
5581,0,2,52,54,1.037037037037037,0.025940896147128686,549,This is not funnyy. It's handwringing.
5581,0,2,52,54,1.037037037037037,0.025940896147128686,549,And that's how we came to an arms reach agreement...
5581,0,2,52,54,1.037037037037037,0.025940896147128686,549,Why can't you get your life strait?
5581,0,2,52,54,1.037037037037037,0.025940896147128686,549,"After the office heater conked out, I was both cold and fit to be tied."
5581,0,2,52,54,1.037037037037037,0.025940896147128686,549,"..no worries; not too small nor too large- they both fit..remarkable!"""
5581,1,0,53,54,1.037037037037037,0.03703703703703703,549,Reducing your constraints like mine takes a bit of time.
5581,0,2,52,54,1.037037037037037,0.025940896147128686,549,When we stop dreaming awake 'they'll untie us
5581,0,2,52,54,1.037037037037037,0.025940896147128686,549,This is as much for you as it is for me.
5581,0,2,52,54,1.037037037037037,0.025940896147128686,549,My performance review suggested that I needed to think more creatively.
5581,0,2,52,54,1.037037037037037,0.025940896147128686,549,They say you can pray it away too.
5581,0,2,52,54,1.037037037037037,0.025940896147128686,549,"Finally, relief."
5581,0,2,52,54,1.037037037037037,0.025940896147128686,549,We're expected to talk to each other every Friday.
5581,0,2,52,54,1.037037037037037,0.025940896147128686,549,I suggest heavily investing in Sears and K-Mart.
5581,0,2,52,54,1.037037037037037,0.025940896147128686,549,"For the moment, let's stick to the mission."
5581,1,0,53,54,1.037037037037037,0.03703703703703703,549,We do this to all our campus hires. It's a metaphor for the expression of ideas in our microagression climate.
5581,1,0,53,54,1.037037037037037,0.03703703703703703,549,I'm sure you understand that we take a dim view of anyone saying 'Well I'll be bound!'
5581,0,2,52,54,1.037037037037037,0.025940896147128686,549,It's about your proposal. You based the entire report on sound business principles.
5581,0,2,52,54,1.037037037037037,0.025940896147128686,549,T hat''s what we get for being out of step.
5581,0,2,52,54,1.037037037037037,0.025940896147128686,549,"I know, it's all the paycheck deductions that make you crazy, right?"
5581,0,2,52,54,1.037037037037037,0.025940896147128686,549,Monkey see...
5581,0,2,52,54,1.037037037037037,0.025940896147128686,549,"Tied up like this, it's going to be hard to activate our parachutes."
5581,0,2,52,54,1.037037037037037,0.025940896147128686,549,Not to worry; 'glass ceiling' is only a figure of speech.
5581,0,2,52,54,1.037037037037037,0.025940896147128686,549,"Why are you wearing hoodies at work."" ""Why do you look like anxious Jaden Smith."
5581,0,2,52,54,1.037037037037037,0.025940896147128686,549,Houdini training will empower us 'magically' create more revenue.
5581,0,2,52,54,1.037037037037037,0.025940896147128686,549,"As you see, the work here is quite Harried."
5581,1,0,53,54,1.037037037037037,0.03703703703703703,549,"Last cartoon! ""74 trombones and 110 cornets are gonna regret stopping at that arroyo."""
5581,0,2,52,54,1.037037037037037,0.025940896147128686,549,I got you doing Mach 2 in a forty-five.
5581,0,2,52,54,1.037037037037037,0.025940896147128686,549,"''I see from your resume we share a restrained itch for more cowbell"""
5581,0,2,52,54,1.037037037037037,0.025940896147128686,549,"This way, no one has to be search for weapons before entering the office."
5581,1,0,53,54,1.037037037037037,0.03703703703703703,549,As seen at Ms. Magazine; Exposure therapy in advance of the new year.....
5581,0,2,52,54,1.037037037037037,0.025940896147128686,549,Your engine is on fire.
5581,0,2,52,54,1.037037037037037,0.025940896147128686,549,"I'm going to raise the bar on you Sheila, so you need to be ready to grasp the opportunity."
5581,0,2,52,54,1.037037037037037,0.025940896147128686,549,Fortunately my notebook runs by speech input!
5581,0,2,52,54,1.037037037037037,0.025940896147128686,549,"Let's try again, using only ""I"" statements."
5581,0,2,52,54,1.037037037037037,0.025940896147128686,549,absent gesticulations your jargon will soon match my straight talk.
5581,0,2,52,54,1.037037037037037,0.025940896147128686,549,"I'm telling you, climate change is real. What you're talking about is weather...the short term."
5581,0,2,52,54,1.037037037037037,0.025940896147128686,549,I thought there was only one entry for Secret Santa.
5581,0,2,52,54,1.037037037037037,0.025940896147128686,549,Have you always dressed this way?
5581,0,2,52,54,1.037037037037037,0.025940896147128686,549,"It's an itchy question but, lets shake on it"
5581,1,0,53,54,1.037037037037037,0.03703703703703703,549,"Right, January 14th won't work for me. Will you be available the 16th?"
5581,0,2,52,54,1.037037037037037,0.025940896147128686,549,"...and since we're a ""hands-free"" company, you can be certain our products are never tested on animals--or anything else for that matter."
5581,0,2,52,54,1.037037037037037,0.025940896147128686,549,So. You disagree with my theories.
5581,0,2,52,54,1.037037037037037,0.025940896147128686,549,"Strait or gay, we go out of our way to make our interviewees feel comfortable."
5581,0,2,52,54,1.037037037037037,0.025940896147128686,549,give me the glass ceiling anytime.
5581,0,2,52,54,1.037037037037037,0.025940896147128686,549,Good your dressed to work here.
5581,0,2,52,54,1.037037037037037,0.025940896147128686,549,Hacking has gotten out of hand!
5581,0,2,52,54,1.037037037037037,0.025940896147128686,549,I'm really going to miss Google Glasses.
5581,0,2,52,54,1.037037037037037,0.025940896147128686,549,"People here are a little slow in responding to social media. In fact, we are not crazy about it."
5692,0,2,53,55,1.0363636363636364,0.02547377820791616,549,"I like that management's trying to improve lifestyle, but this feels a little prescriptive"
5692,0,2,53,55,1.0363636363636364,0.02547377820791616,549,"No emails, no cry."
5694,0,1,51,52,1.0192307692307692,0.019418390934515434,549,"Siri, grow arms."
5694,0,1,51,52,1.0192307692307692,0.019418390934515434,549,It's called analog therapy.
5694,0,1,51,52,1.0192307692307692,0.019418390934515434,549,Do you know Robert Owen?
5694,0,1,51,52,1.0192307692307692,0.019418390934515434,549,"Did you realize you were going 30,000 miles per hour in a school zone?"
5694,0,1,51,52,1.0192307692307692,0.019418390934515434,549,So are you tell me that you do not allow openly gay jackets?
5694,0,1,51,52,1.0192307692307692,0.019418390934515434,549,Welcome to Indiana. You say you're from Texas?
5694,0,1,51,52,1.0192307692307692,0.019418390934515434,549,It is the new mimic-photocopy theory of therapy.
5694,0,1,51,52,1.0192307692307692,0.019418390934515434,549,This job definitely isn't rocket science.
5694,0,1,51,52,1.0192307692307692,0.019418390934515434,549,Electroconvulsive therapy is not a spa treatment. Rubber boots is best.
5694,0,1,51,52,1.0192307692307692,0.019418390934515434,549,I'm pretty tied up at the moment. The cheetoh-puff man sitting in the leader-chair did this.
5694,0,1,51,52,1.0192307692307692,0.019418390934515434,549,"Ah, yes, Carlyle. There's a creed for humanity."
5694,0,1,51,52,1.0192307692307692,0.019418390934515434,549,OK. Perhaps we can restart the interview.
5694,0,1,51,52,1.0192307692307692,0.019418390934515434,549,It's about what we can do and what men can get away with.
5694,0,1,51,52,1.0192307692307692,0.019418390934515434,549,"If you had not left me dangling from the pole in our last team building event, we wouldn't be in the position now!"
5694,0,1,51,52,1.0192307692307692,0.019418390934515434,549,Fortunately I have a lot of influence in making you the first woman President.
5694,0,1,51,52,1.0192307692307692,0.019418390934515434,549,Don't say a word but I think this is better than Marina Abromovic.
5694,0,1,51,52,1.0192307692307692,0.019418390934515434,549,An applicant is interviewed for a job with the ISIS Suicide Prevention Hotline.
5694,0,1,51,52,1.0192307692307692,0.019418390934515434,549,You're not leaving until you tell me about your laser surgery for your eyes.
5694,0,1,51,52,1.0192307692307692,0.019418390934515434,549,We just started making plus size straight jackets this year.
5694,0,1,51,52,1.0192307692307692,0.019418390934515434,549,It would be so much easier to shake hands if we didn't have these straight jackets on!
5694,0,1,51,52,1.0192307692307692,0.019418390934515434,549,I like how you dressed for the interview. As you know we have a very hands off approach to disciplinary problems in our H.R department.
5694,0,1,51,52,1.0192307692307692,0.019418390934515434,549,"I understand that ""all tied up in knots feeling very well"". We'll work on that during our first session.."
5694,0,1,51,52,1.0192307692307692,0.019418390934515434,549,"I'd like to officially welcome you the corporate ""middle seat"" club."
5694,0,1,51,52,1.0192307692307692,0.019418390934515434,549,We should have shown more restraint in telling the client their customers needed Social Media diapers.
5694,0,1,51,52,1.0192307692307692,0.019418390934515434,549,"My dad called me gay, so I wore to prove him wrong."
5694,0,1,51,52,1.0192307692307692,0.019418390934515434,549,I see we're back to ring-around-the-posey.
5694,0,1,51,52,1.0192307692307692,0.019418390934515434,549,We're downsizing..
5694,0,1,51,52,1.0192307692307692,0.019418390934515434,549,My psychiatrist has implored me to refer all my patients to him---immediately.
5694,0,1,51,52,1.0192307692307692,0.019418390934515434,549,But I'm Gay?
5694,0,1,51,52,1.0192307692307692,0.019418390934515434,549,You look all ducted up.
5694,0,1,51,52,1.0192307692307692,0.019418390934515434,549,"Aren't we taking the ""safe space"" contest a little too far in this office lately?"
5694,0,1,51,52,1.0192307692307692,0.019418390934515434,549,Your idea was just too creative. Straighten up fly right!
5694,0,1,51,52,1.0192307692307692,0.019418390934515434,549,"Tikami, who understand shoulders. Plus, the price works for me."
5694,0,1,51,52,1.0192307692307692,0.019418390934515434,549,To get along we need more like you in the company.
5694,0,1,51,52,1.0192307692307692,0.019418390934515434,549,"We're just tied up in our conversation, we'll be right out"
5694,0,1,51,52,1.0192307692307692,0.019418390934515434,549,"Our hands are tied; we have no choice but to try to appeal to the next generation of ""crazy"" kids"
5694,0,1,51,52,1.0192307692307692,0.019418390934515434,549,Crazy is as crazy does
5694,0,1,51,52,1.0192307692307692,0.019418390934515434,549,You and I have a couple all-encompassing problems we have to straiten out!
5694,0,1,51,52,1.0192307692307692,0.019418390934515434,549,Who thought up personal use by management to create a better customer experience?
5694,0,1,51,52,1.0192307692307692,0.019418390934515434,549,"This online French course is hard. I think I get this ""Folie a deux,"" but I think we're going to have to do a ""menage a trois"" before we can move on to ""Voulez vous coucher avec moi ce soir."""
5694,0,1,51,52,1.0192307692307692,0.019418390934515434,549,"I'm sorry ma'am, I guess I don't really understand what our ""tying arrangement"" means..."
5694,0,1,51,52,1.0192307692307692,0.019418390934515434,549,How are you doing today?
5694,0,1,51,52,1.0192307692307692,0.019418390934515434,549,"""Yep, you're dying."""" """"Jinx!"""
5694,0,1,51,52,1.0192307692307692,0.019418390934515434,549,How can I throw my chair at her to show my assertiveness?
5694,0,1,51,52,1.0192307692307692,0.019418390934515434,549,"Do you hear the requiem for the presidential election which took place in the U S in 2016?"" ""Yep, it has titled 'Of woman bondage'."
5739,0,0,51,51,1.0,0.019802950859533486,549,I'm going to have to issue you a warning. You can't scramble your jets on a public highway.
5739,0,0,50,50,1.0,0.020203050891044214,549,I called you in because we've been told you've been thinking too much about getting work done.
5739,0,0,50,50,1.0,0.020203050891044214,549,We nasty women pledge four years of non-violent activism.
5739,0,0,50,50,1.0,0.020203050891044214,549,Don´t worry. Jill and Hillary will undo this with the recounts.
5739,0,0,50,50,1.0,0.020203050891044214,549,Now you know how it feels to be a marble.
5739,0,0,51,51,1.0,0.019802950859533486,549,"let the inmates, run the asylum."
5739,0,0,51,51,1.0,0.019802950859533486,549,"Now let's discuss our ""flex and maternity"" policy."
5739,0,0,51,51,1.0,0.019802950859533486,549,I'm so glad you took the time to come in for an advising session! I'm sure we're both looking forward to getting started here. Shall we?
5739,0,0,50,50,1.0,0.020203050891044214,549,Think the franking machine needs a little adjustment?
5739,0,0,50,50,1.0,0.020203050891044214,549,We just can't get away from the Internet.
5739,0,0,50,50,1.0,0.020203050891044214,549,"As two clever lesbians in charge of fall fashion, do you see the irony, Marcy?"
5739,0,0,50,50,1.0,0.020203050891044214,549,Mental institution reachout program.
5739,0,0,51,51,1.0,0.019802950859533486,549,I'm repeating Mindfulness Training
5739,0,0,50,50,1.0,0.020203050891044214,549,"I would turn the porn down, but I'm a bit tied up at the moment."
5739,0,0,51,51,1.0,0.019802950859533486,549,We don't hire Italians!
5739,0,0,50,50,1.0,0.020203050891044214,549,You're in a no afterburner zone.
5739,0,0,50,50,1.0,0.020203050891044214,549,HR says this might be less appropriate than appropriation.
5739,0,0,50,50,1.0,0.020203050891044214,549,"This is worse than detox, I think they call it detroit"
5739,0,0,51,51,1.0,0.019802950859533486,549,Yeah... I know they're terrorists. But since the furnace went out... This helps.
5739,0,0,50,50,1.0,0.020203050891044214,549,The boss doesn't want to bother with tic tacs.
5739,0,0,51,51,1.0,0.019802950859533486,549,I did a weird report on mummies when I was actually supposed to do a report about marine reptiles and got fired...
5739,0,0,51,51,1.0,0.019802950859533486,549,"Yes, Ma'am. We are bound to the company's agreement to sell."
5739,0,0,51,51,1.0,0.019802950859533486,549,"No we haven't filled the position. And yes, we wont fill it till you get the hell out of this office."
5739,0,0,50,50,1.0,0.020203050891044214,549,"One of the patients has a god complex, and no one to worship him. Tell me about your previous experience with deity worship."
5739,0,0,50,50,1.0,0.020203050891044214,549,Don't let it get you down. On Informal Fridays they give us a pack of cigarettes and a few beers and everyone's much more talkative.
5739,0,0,51,51,1.0,0.019802950859533486,549,"Hello, how are you? Well, as of now, I'm a bit tied up."
5739,0,0,51,51,1.0,0.019802950859533486,549,"Now I've got you in place, let's talk about what you have done in school."
5739,0,0,51,51,1.0,0.019802950859533486,549,"OK buddy, where's the fire? In the back? Oh yeah, I see..."
5739,0,0,50,50,1.0,0.020203050891044214,549,Pussy? Pussy.
5739,0,0,50,50,1.0,0.020203050891044214,549,they said they dont want a fight breaking out.
5739,0,0,50,50,1.0,0.020203050891044214,549,"You can wipe the smug look, I caught you with a Kia."
5739,0,0,50,50,1.0,0.020203050891044214,549,We encourage our employees to think outside the box and inside the straitjacket.
5739,0,0,50,50,1.0,0.020203050891044214,549,It's really hard trying to go straight while wearing these jackets.
5739,0,0,50,50,1.0,0.020203050891044214,549,Spooky action at a distance
5739,0,0,50,50,1.0,0.020203050891044214,549,We are We respond promptly to employee requests.
5739,0,0,50,50,1.0,0.020203050891044214,549,Has it been off long enough yet?
5739,0,0,50,50,1.0,0.020203050891044214,549,Two women are talking to each other at a psycho school in which you must where a straitjacket.
5739,0,0,50,50,1.0,0.020203050891044214,549,The in game
5739,0,0,50,50,1.0,0.020203050891044214,549,We try to walk in the other guys moccasin
5739,0,0,51,51,1.0,0.019802950859533486,549,I guess what they mean by 'The hunter becomes the hunted'
5739,0,0,51,51,1.0,0.019802950859533486,549,Our Chairman saw straight jackets in a catelog and thought it might help us win over the new client coming in this afternoon if we dressed more conservatively.
5739,0,0,50,50,1.0,0.020203050891044214,549,"Ohhhh, another Weasly...not a chance!!!"
5739,0,0,51,51,1.0,0.019802950859533486,549,i don't think he's s friend to women
5739,0,0,50,50,1.0,0.020203050891044214,549,Most of my clients live their lives as if there were shackles holding them back . My job is convince your that these shackles are no stronger than the early morning dew.
5739,0,0,50,50,1.0,0.020203050891044214,549,We seem to be at an em pass
5739,0,0,51,51,1.0,0.019802950859533486,549,Can we at least use our hands?
5739,0,0,50,50,1.0,0.020203050891044214,549,Don't gender me.
5739,0,0,51,51,1.0,0.019802950859533486,549,My boss thinks in headlines. This one is:'Armless Exec in Paperless Office!
5739,0,0,51,51,1.0,0.019802950859533486,549,We can resolve this without our armies.
5739,0,0,51,51,1.0,0.019802950859533486,549,Yeah. I too was fed up withe The Movement.
5739,0,0,50,50,1.0,0.020203050891044214,549,I got them from Glass Ceiling Express. Merry Christmas.
