rank,funny,somewhat_funny,unfunny,count,score,precision,contest,caption
1,810,733,855,2398,1.9812343619683068,0.01701525068712556,551,Row v. Wave
2,637,673,787,2097,1.9284692417739628,0.01793154766725562,551,We shall overcomb.
3,590,522,742,1854,1.9180151024811218,0.019598301061324725,551,Row v. Wave
4,404,593,551,1548,1.9050387596899225,0.019823191113115,551,"I don't know what's worse, the undertow or the combover"
5,264,250,347,861,1.9036004645760742,0.02853694225712633,551,"Don't worry, the polls show it will miss us."
6,406,494,559,1459,1.8951336531871144,0.021121098600510025,551,"Ladies and gentlemen, if you look to your right, you’ll see a gift of friendship from the people of France; straight ahead, a gift of friendship from the people of Russia"
7,292,455,447,1194,1.8701842546063652,0.02246494606528204,551,You've got it all wrong. We're emigrating.
8,362,456,539,1357,1.8695652173913044,0.021842682960761164,551,Mayday! We've been hit by a raging tycoon!
9,266,371,415,1052,1.858365019011407,0.02443029142494402,551,To think this started as a Twitter storm.
10,349,384,528,1261,1.858049167327518,0.02315115511975683,551,We shall overcomb.
11,295,406,475,1176,1.846938775510204,0.023179854906005774,551,Did you just say there will be hell toupee?
12,224,285,370,879,1.8339021615472126,0.027170670953802056,551,"I'm the perfect storm..the best storm, everybody tells me that."
13,213,296,392,901,1.8013318534961154,0.026499624844086054,551,Don't worry --if you're not a 10 it won't touch you.
14,151,208,293,652,1.7822085889570551,0.031196037805444967,551,"Huge wave, really terrific. But such tiny hands."
15,168,240,340,748,1.7700534759358288,0.028954772031976925,551,Unpresidented weather we're having.
16,173,225,346,744,1.76747311827957,0.02942956768552703,551,Attention Everyone! Small hands on deck!
17,182,185,352,719,1.7635605006954103,0.030927954629738418,551,"All together now! 'Rue, rue, rue your vote . . .'"
18,139,255,312,706,1.754957507082153,0.028652091997561434,551,"'In retrospect, maybe the Cruz ship was a safer bet.'"
19,120,236,290,646,1.736842105263158,0.02960784635786333,551,It's a great wave. The best wave. No wave has ever been better.
20,138,188,306,632,1.7341772151898733,0.03164456657520877,551,The scariest part is how shallow it is!
21,127,188,293,608,1.7269736842105263,0.03186271272545861,551,"Everybody, lean left!"
22,123,148,286,557,1.7073608617594256,0.03415614743367062,551,Relax ... it's just Alec Baldwin.
23,84,191,244,519,1.6917148362235068,0.03219585465586294,551,Don't sweat it -- he switches direction every two seconds.
24,69,95,177,341,1.683284457478006,0.04274062985574698,551,I was expecting a wall.
25,106,111,263,480,1.6729166666666666,0.037169321228898246,551,Small hands on deck!
25,94,135,251,480,1.6729166666666666,0.03573757556137985,551,Hell AND high water?!
27,98,108,251,457,1.6652078774617067,0.037801141246892954,551,"Woe, woe, woe your vote..."
28,74,149,228,451,1.6585365853658536,0.035056329158571556,551,"Ha ha ha, good one. Now do Putin riding on a seahorse!"
29,86,116,238,440,1.6545454545454545,0.0374903113797959,551,There will be hell toupee!
30,82,99,225,406,1.6477832512315271,0.03950624258703361,551,Small hands on deck!
31,79,117,230,426,1.6455399061032865,0.0375643809545156,551,Something tells me this wave is going to touch us inappropriately.
32,70,121,219,410,1.6365853658536584,0.03742336431622837,551,Everyone take a deep breath and hold it for four years!
33,73,104,221,398,1.6281407035175879,0.03888930654585983,551,It's a foam over.
34,75,95,222,392,1.625,0.039725015832936854,551,Thar he bloviates!
35,74,98,222,394,1.6243654822335025,0.039402914624480985,551,We're about to experience extreme wetting!
36,72,99,219,390,1.623076923076923,0.03940700680968326,551,Quick! Tweet something to distract him.
37,71,100,218,389,1.6221079691516709,0.0393283889319391,551,Have we huddled masses arrived at a bad time?
38,64,105,210,379,1.6147757255936674,0.03898708928637028,551,Don't worry. It's only Alec Baldwin.
39,48,133,193,374,1.6122994652406417,0.036394963343806035,551,That's a surprise. All the forecasts said we'd be seeing Hillary.
40,53,122,198,373,1.611260053619303,0.037452604676302556,551,"I thought ""tweeting up a storm"" was just a saying."
41,63,96,207,366,1.6065573770491803,0.039962579087666365,551,It's OK—we're Russian.
42,63,93,207,363,1.603305785123967,0.0402490641178883,551,"Hold on, everyone. Hell AND high water are coming."
43,54,108,197,359,1.6016713091922006,0.03885579267309923,551,"Oh for heaven's sake, Ruthie, you're seeing him everywhere now."
43,56,104,199,359,1.6016713091922006,0.039254244362358116,551,The storm suddenly appeared out of thin hair.
43,61,94,204,359,1.6016713091922006,0.04023311311558993,551,Ok stay calm! Take a deep breath and hold it for four years!
46,58,99,201,358,1.600558659217877,0.039743938897166126,551,"Whatever you do, don't mention the little hands."
47,57,95,199,351,1.5954415954415955,0.04020224679740772,551,Quick - compliment him on something!
48,56,98,199,353,1.594900849858357,0.03982469689556628,551,Quick everyone. Shout out compliments.
49,50,100,188,338,1.5917159763313609,0.03993489389369266,551,"On second thought, let's yearn to be free somewhere else."
50,55,91,196,342,1.587719298245614,0.040666829977970144,551,"Hold on, everyone. We've got hell AND high water coming."
51,52,95,192,339,1.5870206489675516,0.04030989671820838,551,It looks just like Alec Baldwin!
52,66,64,205,335,1.5850746268656717,0.043664211307792376,551,I knew there'd be hell toupee.
53,43,109,183,335,1.5820895522388059,0.03869029970662238,551,"Be careful, These waves usually come in gropes."
54,52,89,191,332,1.5813253012048192,0.0410084070458176,551,How did we not see this coming?
55,50,88,188,326,1.5766871165644172,0.041170099396778584,551,Tycoon season is early this year!
56,49,89,187,325,1.5753846153846154,0.04104557920067713,551,"Hold on, everyone. We've got hell AND high water coming."
56,54,79,192,325,1.5753846153846154,0.042186565794722936,551,"But we're trying to leave the country, not enter it."
58,47,94,186,327,1.5749235474006116,0.040391042397627155,551,Everybody lean to the right.
59,45,96,183,324,1.5740740740740742,0.04021193118570326,551,They're called twitter storms.
60,52,84,192,328,1.5731707317073171,0.041446299759701336,551,Wait! We're deplorables.
61,66,53,204,323,1.5727554179566563,0.045045711076201034,551,I think I'm about to experience extreme wetting.
62,53,66,182,301,1.5714285714285714,0.04461156156656446,551,"Looks like you've got a small dinghy, too."
62,51,82,189,322,1.5714285714285714,0.041829953402042694,551,"And to your right, you'll catch our last glimpse of Lady Liberty for quite some time."
64,50,80,187,317,1.5678233438485805,0.042129149207008165,551,"On a positive note, it's not a permanent wave."
64,43,94,180,317,1.5678233438485805,0.040436439005450464,551,"Freak wave, ahead! Hope you all have strong Constitutions."
66,46,87,183,316,1.5664556962025316,0.041278107535853426,551,Take a deep breath and hold it for four years.
67,55,68,192,315,1.565079365079365,0.04352944041626215,551,"Look, it's Alec Baldwin!"
68,40,96,176,312,1.564102564102564,0.0401885074870631,551,Just try to stay calm and look deplorable.
69,50,75,186,311,1.562700964630225,0.04279026107899183,551,Irrefutable evidence the climate has changed.
70,44,86,180,310,1.5612903225806452,0.04141957013257502,551,"Don't worry, this is almost statistically impossible."
71,45,75,174,294,1.5612244897959184,0.043419299071253796,551,They lied. It can get worse.
72,38,65,149,252,1.5595238095238095,0.04672732710475617,551,"No, I said the weather looked ""Alt-right"" today."
73,57,45,183,285,1.5578947368421052,0.047717190610296605,551,Moby Dickhead!
74,52,66,187,305,1.5573770491803278,0.04396812095684899,551,Comboverboard!
75,45,71,173,289,1.5570934256055364,0.04402331397308343,551,"Yes, we're tired, poor, and huddled. But, actually, we're headed to Canada."
76,40,89,175,304,1.555921052631579,0.04102767039431898,551,Don't panic. Just hold your breath for four years.
77,45,77,180,302,1.5529801324503312,0.04255956742493437,551,"Unfortunately, garbage from New York sometimes finds its way into the Hudson."
78,49,67,183,299,1.5518394648829432,0.04392916305212232,551,Relax. We're not immigrants. We're from the French embassy. We're taking back the statue.
79,40,84,174,298,1.5503355704697988,0.04167869346364379,551,I've never seen an anti-immigrant wave like this!
79,37,90,171,298,1.5503355704697988,0.04085733073434491,551,I would have preferred a wall.
81,42,79,176,297,1.5488215488215489,0.04233252931061743,551,Comboverboard!
81,37,89,171,297,1.5488215488215489,0.04096697357731188,551,"Hold tight, these tweet-storms are unpredictable...."
83,34,93,167,294,1.5476190476190477,0.04043386473542342,551,This wasn't in the forecast until January.
83,31,99,164,294,1.5476190476190477,0.03956317711066614,551,"Hold on, everything is going to be Alt-Right!"
85,43,74,176,293,1.546075085324232,0.04305907239273037,551,It's gonna grab us by the dinghy!
86,39,81,172,292,1.5445205479452055,0.04207427602094791,551,Oh for God sake Shirley ... you can't blame EVERYTHING on him!
87,41,76,174,291,1.5429553264604812,0.04274792923032403,551,Giant metaphor off the starboard bow!
88,44,67,176,287,1.5400696864111498,0.044052361933539785,551,I think we’re screwed. It’s a Category 4 Tweetstorm.
89,45,64,177,286,1.5384615384615385,0.04445403795305362,551,So this is what he meant by extreme wetting.
89,52,50,184,286,1.5384615384615385,0.046345653052108776,551,Get ready for extreme wetting.
91,46,60,177,283,1.5371024734982333,0.04510475379024329,551,It's a tidal weave
92,46,61,179,286,1.534965034965035,0.044739235420307964,551,Technically this is more of a hell AND high water situation!
93,44,61,174,279,1.5340501792114696,0.0450520391219854,551,Steer for the mouth! There's nothing behind it but a yuge void!
94,41,68,172,281,1.5338078291814947,0.04394281906658649,551,It's gonna be swell. Believe me.
94,41,68,172,281,1.5338078291814947,0.04394281906658649,551,"Don't worry, it'll comb over."
96,31,85,161,277,1.5306859205776173,0.04139265359974005,551,Stop laughing at his tiny whitecaps. It makes him angry.
97,44,58,174,276,1.5289855072463767,0.045447288951240096,551,This is what happens when really hot air condenses.
98,32,81,162,275,1.5272727272727273,0.04194119410609553,551,Let's hope it's not a permanent wave
99,50,44,180,274,1.5255474452554745,0.04743651364408355,551,WRONG. I tweeted Extreme Wetting
99,38,68,168,274,1.5255474452554745,0.04392466039174147,551,"Like a comb-over troubled water, he will let you down..."
101,41,59,170,270,1.5222222222222221,0.04534911566924093,551,Nobody saw it coming?
102,37,66,166,269,1.520446096654275,0.04424637998240007,551,Pray it's not a permanant wave.
103,39,61,168,268,1.5186567164179106,0.045000903155810054,551,Quick. Show him your tits.
103,30,79,159,268,1.5186567164179106,0.042113300182217435,551,Relax! We're trying to get to Canada.
105,34,72,164,270,1.5185185185185186,0.04317806635136486,551,Tidal weave!
106,39,60,168,267,1.5168539325842696,0.04513350190323502,551,Give it your phone! It needs to tweet!
107,35,58,155,248,1.5161290322580645,0.046409457312869856,551,Ladies! Cross your legs!
108,40,56,168,264,1.5151515151515151,0.045846525865241204,551,We're gonna need a bigger comb.
109,37,59,164,260,1.5115384615384615,0.0454272828284555,551,"If you think this storm is making dangerous waves now, wait until it hits the Potomac."
110,32,70,160,262,1.5114503816793894,0.04351173259312437,551,"Quick! Throw him your iPhones. Once he starts Tweeting, we break for shore."
111,27,65,141,233,1.5107296137339057,0.04556373577111715,551,"I thought you said the storm would blow over, not comb-over..."
112,38,56,165,259,1.5096525096525097,0.04589096964476593,551,Hold your breath... For four years.
113,41,51,169,261,1.5095785440613028,0.04657849027775977,551,Our choices are clear: row versus wade.
113,42,49,170,261,1.5095785440613028,0.046893797029254385,551,"#StatueofLiberty message outdated, so sad."
115,30,71,157,258,1.5077519379844961,0.04332925463659974,551,"We said we'd get there come hell or high water, not both."
115,32,67,159,258,1.5077519379844961,0.044019889516006314,551,"I vote we take our tired, huddled asses and head for Canada."
115,33,65,160,258,1.5077519379844961,0.0443611750951263,551,He’s just not happy unless he’s making waves.
118,28,72,154,254,1.5039370078740157,0.043122077877232746,551,I say we paddle to Canada until this whole thing combs over.
118,36,56,162,254,1.5039370078740157,0.045918344216290576,551,"On second thought, let's row back to Cuba."
120,34,61,161,256,1.50390625,0.0449666430272589,551,"ACTUALLY, WE'RE LEAVING!!!"
121,38,42,155,235,1.5021276595744681,0.049501779661692155,551,Oh no! We're being swept under the rug.
122,31,62,155,248,1.5,0.04499212706658476,551,No doubt this is due to political climate change.
122,31,64,157,252,1.5,0.04445471961157789,551,"Well, the forecasters were wrong."
124,35,56,162,253,1.4980237154150198,0.04571634143055987,551,"And when you’re a tsunami, they let you do it. You can do anything."
125,30,64,155,249,1.497991967871486,0.044493558034474696,551,Not tired. Not sick. Not poor. I swear!
126,29,67,156,252,1.496031746031746,0.04373694378292578,551,"Look, I'm a tremendous wave. Tremendous. And a lot of people are talking about me. A lot of people."
127,32,60,158,250,1.496,0.04507842340885617,551,I have the best surf. My surf is tremendous.
128,23,75,148,246,1.491869918699187,0.04222997154535382,551,Brace yourselves--looks like a populist wave.
128,38,45,163,246,1.491869918699187,0.047761182736224254,551,What's the worst that could happen?
128,33,55,158,246,1.491869918699187,0.04599141821922653,551,"Watch out for the little hands, they can grab your whatever."
128,32,57,157,246,1.491869918699187,0.045629229058864906,551,"So, literally caught between the devil and the deep blue sea"
132,36,48,160,244,1.4918032786885247,0.04735883424408014,551,Don't worry. There's no way he can win.
133,30,59,154,243,1.4897119341563787,0.045309210197389246,551,"Somehow, winning the popular boat isn't making me feel any safer."
134,30,57,154,241,1.4854771784232366,0.045586535989949446,551,"Don't worry, it's unpresidented."
134,37,43,161,241,1.4854771784232366,0.04816823943058691,551,We're with her.
136,34,48,157,239,1.4853556485355648,0.0473811813963402,551,"Of course, it's him. Look at the size of his hands."
136,36,44,159,239,1.4853556485355648,0.048117536989629436,551,It's The Donald...Duck!
136,38,40,161,239,1.4853556485355648,0.0488427925223755,551,It's going to grab us by the dingy!
136,35,46,158,239,1.4853556485355648,0.047750778613867916,551,"We expected amber waves of grain, not orange waves of pain."
136,28,60,151,239,1.4853556485355648,0.04510003663198629,551,Es El Gropo!
141,28,59,150,237,1.4852320675105486,0.04538296682645629,551,Huh. There actually is an anti-immigrant wave.
142,25,66,149,240,1.4833333333333334,0.043778424385249905,551,So that's what a wave of populism looks like.
142,32,52,156,240,1.4833333333333334,0.04648250171905871,551,I liked it better when he just tweeted.
144,33,48,156,237,1.481012658227848,0.04730537708671539,551,"Unless you're Mexican, Moslem, African-American, democratic, liberal or female there's nothing to be afraid of."
145,26,60,147,233,1.48068669527897,0.045143590922800146,551,"Quick, look less huddled!"
146,29,54,151,234,1.4786324786324787,0.0462038159105356,551,"Actually, we were just leaving."
146,24,64,146,234,1.4786324786324787,0.04417443156527405,551,"Relax, people. It's only a metaphor."
148,31,49,152,232,1.478448275862069,0.04729830280294505,551,"Don’t be alarmed, folks. It’s just a Trump l’oeil”"
148,27,57,148,232,1.478448275862069,0.0456930348816327,551,"ACTUALLY, WE'RE LEAVING!!!"
150,38,36,161,235,1.476595744680851,0.049478325400226564,551,Here comes the extreme wetting!
150,32,48,155,235,1.476595744680851,0.04722163899732267,551,Mayday! Mayday! Small hands on deck.
152,31,49,153,233,1.4763948497854078,0.04713961368966899,551,And he’s going to make El Niño pay for it.
152,30,51,152,233,1.4763948497854078,0.046745529313114834,551,"They're tired. They're poor. They're huddled masses yearning to breathe free. They're rapists. And some, I assume, are good people."
154,28,54,150,232,1.4741379310344827,0.046089995897056604,551,Thar he blows!
155,32,45,154,231,1.4718614718614718,0.04783415644706262,551,"Everyone, quick, stop huddling and look white!"
156,23,62,144,229,1.4716157205240175,0.04442950730049914,551,It's got small hands but a lot of wind!
156,32,44,153,229,1.4716157205240175,0.048153187357448037,551,"The American Dream may be dead, but the American Nightmare is alive and well."
156,27,54,148,229,1.4716157205240175,0.046121606656932865,551,Pretend we're a basket of deplorables.
156,25,58,146,229,1.4716157205240175,0.04528346121699367,551,Relax. The polls show we'll be just fine.
156,31,46,152,229,1.4716157205240175,0.04775378605166884,551,"Ladies! Watch the hands, not the wave!"
156,27,54,148,229,1.4716157205240175,0.046121606656932865,551,Oh God - it's the wave of the future!
162,27,48,144,219,1.4657534246575343,0.04767062616351294,551,Just wait. He's going to make tsunamis great again.
163,34,38,156,228,1.4649122807017543,0.049089259077542545,551,Hold on to your pussies.
164,24,56,144,224,1.4642857142857142,0.04556620394623741,551,We should have taken our chances with the wall.
164,27,50,147,224,1.4642857142857142,0.046865704441183556,551,"Here we go, get ready to hold your breathe for four years."
164,28,48,148,224,1.4642857142857142,0.04729093665458314,551,It’s either a sea change or a wave of regret.
164,25,54,145,224,1.4642857142857142,0.04600344964205973,551,"Don't worry, they say he's more foam than substance."
164,27,50,147,224,1.4642857142857142,0.046865704441183556,551,Tired? Poor? Yearning to breathe free? Not sending their best. Sad.
169,32,40,153,225,1.4622222222222223,0.048780543726040126,551,"He wasn't kidding about ""extreme wetting"" of immigrants."
170,30,43,150,223,1.4618834080717489,0.04828618800629983,551,I told you this river was polluted.
170,27,49,147,223,1.4618834080717489,0.04701445013573234,551,"But, we're trying to emigrate, not immigrate!"
172,23,55,141,219,1.461187214611872,0.045862740458278865,551,Don't worry! Everything is going to be Alt-Right.
173,25,53,146,224,1.4598214285714286,0.04598693361470853,551,It's not a wave. It's just a comb-over.
174,23,56,143,222,1.4594594594594594,0.045402357653011614,551,"All together now, We shall overcomb-o-o-omb."
174,26,50,146,222,1.4594594594594594,0.046729737003253946,551,Comb-overboard! Comb-overboard!
174,27,48,147,222,1.4594594594594594,0.04716389580007552,551,"Start spreading the news, we're leaving today."
177,25,51,144,220,1.459090909090909,0.046601348950321,551,I am afraid that this is the wave of the future.
178,27,47,147,221,1.4570135746606334,0.0473140407105572,551,The Alt-White Caps!
179,20,60,139,219,1.45662100456621,0.044452152638850946,551,"Nothing to worry about, folks. Just a media storm."
179,25,50,144,219,1.45662100456621,0.046748829403892266,551,"Egads, it's all foam and no substance."
179,27,46,146,219,1.45662100456621,0.047636506181675725,551,We remind our female passengers to keep their privates inside the vessel at all times
179,19,62,138,219,1.45662100456621,0.04397842697216898,551,It's called a 'So Sue Me Nami.
179,18,64,137,219,1.45662100456621,0.043499542568458074,551,Just compliment him and he'll go away.
184,24,51,142,217,1.456221198156682,0.046611156131178985,551,But we’re trying to leave!
185,24,53,145,222,1.454954954954955,0.045830059892417355,551,But we already gave him our tired and poor....they elected him!
186,26,48,146,220,1.4545454545454546,0.04702556968216572,551,Oh great... a perfect Twitter storm!
187,23,53,142,218,1.4541284403669725,0.04598662269565806,551,"Little hands, big mouth … yep we're here."
187,30,39,149,218,1.4541284403669725,0.049099032709131296,551,"Well, who saw this coming?"
187,22,55,141,218,1.4541284403669725,0.04552462555372823,551,Now that's climate change.
187,30,39,149,218,1.4541284403669725,0.049099032709131296,551,What would Sully do?
191,20,58,138,216,1.4537037037037037,0.04487926118315885,551,Which way to Canada?
192,23,52,142,217,1.4516129032258065,0.04612986176756479,551,Don't worry; it's only a foam-over.
193,26,45,144,215,1.4511627906976745,0.04782539270514275,551,"Relax! We're not coming in, we're running away!"
193,23,51,141,215,1.4511627906976745,0.04644202573119603,551,That couldn't possibly be a permanent wave.
193,26,45,144,215,1.4511627906976745,0.04782539270514275,551,Well it's no more unbelievable than him winning the election!
193,24,49,142,215,1.4511627906976745,0.046907681302160845,551,That's pretty good! Do Bill Clinton again.
193,24,49,142,215,1.4511627906976745,0.046907681302160845,551,"Oh no, it’s YUGE."
198,25,46,143,214,1.4485981308411215,0.04752082358777428,551,He's going to make drowning great again.
198,30,36,148,214,1.4485981308411215,0.04977563178258292,551,I told you the climate has changed!
198,26,44,144,214,1.4485981308411215,0.04798026306138126,551,We're fucked.
198,24,48,142,214,1.4485981308411215,0.04705689859607602,551,I don't think he gets we're trying to LEAVE America.
202,30,35,148,213,1.4460093896713615,0.04994219086601252,551,"Honest Mr. Trump, we're not coming in, we're trying to leave!"
202,28,39,146,213,1.4460093896713615,0.04904733043907724,551,"OK, who said small hands on deck?"
204,27,40,144,211,1.4454976303317535,0.04893891539054723,551,"Hold on! We're leaving, not arriving."
205,28,37,145,210,1.4428571428571428,0.04956274649295059,551,Don't worry it's Trump l'oeil.
205,24,45,141,210,1.4428571428571428,0.04768848889868595,551,We just need to make it over the toupée.
205,26,41,143,210,1.4428571428571428,0.04863464718369292,551,Trumpnami! Steer alt right and try to look white and male.
205,21,51,138,210,1.4428571428571428,0.046232959818475805,551,"You had to go and name the boat ""Democracy."""
209,20,52,137,209,1.4401913875598087,0.045878732801737536,551,I'm just glad Trump is finally reaching out to undecided boaters
209,25,42,142,209,1.4401913875598087,0.048320712414690194,551,Amnesty? We're from Jersey!
211,24,43,140,207,1.4396135265700483,0.04818237661732481,551,I didn't realize we'd all wind up in the same boat.
211,22,47,138,207,1.4396135265700483,0.04719891085526159,551,Thar he blowshard!
211,15,61,131,207,1.4396135265700483,0.043582363163613955,551,It ought to blow over in four years.
211,19,53,135,207,1.4396135265700483,0.04568403265985537,551,Did the forecast call for blowhard conditions?
211,27,37,143,207,1.4396135265700483,0.04962104152826628,551,Maybe it won't be that bad.
216,27,36,143,206,1.4368932038834952,0.04978752192648798,551,"Après Obama, le déluge."
216,17,56,133,206,1.4368932038834952,0.04477946371497902,551,"Be calm people, it's only a metaphor."
216,21,48,137,206,1.4368932038834952,0.04684697597703487,551,"Have no fear, we shall overcomb."
216,23,44,139,206,1.4368932038834952,0.04784724184306512,551,Let's wait to see what actually happens.
216,25,40,141,206,1.4368932038834952,0.04882702065234619,551,Take a deep breath and hold it for four years.
216,17,56,133,206,1.4368932038834952,0.04477946371497902,551,"Don't worry, that's just a tycoon, not a typhoon."
216,20,50,136,206,1.4368932038834952,0.04633874686798233,551,I think we're in the hair of the storm!
216,22,46,138,206,1.4368932038834952,0.04734975031709061,551,Uh oh. The forecasters didn't see this one coming.
216,19,52,135,206,1.4368932038834952,0.045824881498995745,551,I told you we should have steered left.
225,26,37,141,204,1.4362745098039216,0.049670888416423205,551,And this concludes our tour of the signs of the Apocalypse.
226,21,49,139,209,1.4354066985645932,0.04634655426619765,551,"If that's the wave of the future, I'm going overboard."
227,23,43,139,205,1.4341463414634146,0.04800191681016427,551,"Excuse me, do you know the way to America? I think we've gone too far right."
228,25,39,142,206,1.4320388349514563,0.04879522800774415,551,This thing'll be catastrophic by the time it reaches Washington.
228,27,35,144,206,1.4320388349514563,0.049756343013967766,551,"We're gonna need a whiter boat"""
230,34,20,150,204,1.4313725490196079,0.053388787143339236,551,Fuck.
230,23,42,139,204,1.4313725490196079,0.0481571968773676,551,"Careful, your next wife is on board!"
230,19,50,135,204,1.4313725490196079,0.04610786148284754,551,Oh! It's a metaphor!
230,18,52,134,204,1.4313725490196079,0.045581133272226064,551,Let's just hope it's not a permanent wave.
234,26,35,141,202,1.4306930693069306,0.05000608380560262,551,Anyone else feeling boater's remorse?
234,23,41,138,202,1.4306930693069306,0.04850600422572384,551,I still don't trust Hillary.
234,20,47,135,202,1.4306930693069306,0.046958028858960055,551,I thought we had until Inauguration Day!
234,19,49,134,202,1.4306930693069306,0.04643056985553722,551,"Give me your greedy, your rich, Your ambitious masses yearning to cash in."
234,17,53,132,202,1.4306930693069306,0.0453572541352749,551,I told it that we're just a group of models from Slovenia! We should be fine.
239,15,57,131,203,1.4285714285714286,0.044090434202829785,551,Look out! It's a wave of anti-immigrant resentment!
239,19,49,135,203,1.4285714285714286,0.0462499706936099,551,It looks like a tweet storm is brewing.
239,25,37,141,203,1.4285714285714286,0.04931226916912609,551,Is this what they mean by extreme wetting?
239,21,45,137,203,1.4285714285714286,0.0472927741800228,551,Apparently riding a wave of anti-immigrant sentiment is not just a metaphor.
243,22,42,137,201,1.427860696517413,0.04815087712232577,551,"As it turned out, rising sea levels was not the greatest oceanic threat"
243,23,40,138,201,1.427860696517413,0.048664753276169086,551,He's saying we should comb over to the dark side.
243,24,38,139,201,1.427860696517413,0.04917325955447233,551,I'm afraid this is a permanent wave!
246,18,49,133,200,1.425,0.04617940762333587,551,All hands on groins ladies!
246,22,41,137,200,1.425,0.04830675639667643,551,"So this is how we'll get a big, beautiful, forty-foot sea wall. And New Jersey is going to pay for it."
246,19,47,134,200,1.425,0.046720326890162256,551,"Oh, I thought he said he was a *tycoon*."
246,25,35,140,200,1.425,0.049842717446103,551,Don't worry. It's only a trump l'oeil.
246,20,45,135,200,1.425,0.04725505476671279,551,You know that sinking feeling I've been talking about?
251,19,46,133,198,1.4242424242424243,0.04705434710949832,551,So much for draining the swamp.
251,18,48,132,198,1.4242424242424243,0.0465063159038841,551,Remember-- just hold your breath for 4 years and we should be ok
251,14,56,128,198,1.4242424242424243,0.044246364451271065,551,I'm pretty sure it is not a permanent wave.
254,17,50,132,199,1.4221105527638191,0.045769928891549586,551,"Idiot! We are trying to leave, not enter!"
255,23,37,137,197,1.4213197969543148,0.049348405455689866,551,Even the New Yorker Cartoon Caption Contest can't make this funny.
255,21,41,135,197,1.4213197969543148,0.0482873729212081,551,"""We're trying to EMIGRATE!! EMIGRATE!!.... WITH AN E!"
255,24,35,138,197,1.4213197969543148,0.049870457083456055,551,Hold on! We're about to shoot the comb over!
255,22,39,136,197,1.4213197969543148,0.048820771730130316,551,"Show of hands, who wants to go back to Aleppo?"
255,15,53,129,197,1.4213197969543148,0.04495426755570375,551,It's ok. Just tell him we're beauty pageant contestants.
260,15,53,130,198,1.4191919191919191,0.04477723800783707,551,"Excuse me, could you point us in the direction of Canada?"
261,16,48,127,191,1.418848167539267,0.04650713850718153,551,"I hear once we get past the groping, tiny, tidal hands, there is just a lot of hot air."
262,20,42,134,196,1.4183673469387754,0.04790041713898164,551,We're having a Hate Wave...a Trumpical Hate Wave!
262,24,34,138,196,1.4183673469387754,0.05003763041069418,551,"Give me your tired, your poor — I'll deport them."
264,18,45,131,194,1.4175257731958764,0.04713364376121389,551,Somehow it's not looking like a wave of optimism.
264,15,51,128,194,1.4175257731958764,0.045401900006508594,551,"We used to call these waves, but now we call them gropes."
264,19,43,132,194,1.4175257731958764,0.04769692153810021,551,"Brace yourself, it's another twitter storm"
264,16,49,129,194,1.4175257731958764,0.04598639444665863,551,Uh oh. I thought 'impending wave of disaster' was just a metaphor.
264,22,37,135,194,1.4175257731958764,0.04934819322143112,551,I think that statue is giving him the finger
264,14,53,127,194,1.4175257731958764,0.04480978212620916,551,"I hope he realizes we're the Goldman Sachs rowing team and not the tired, poor, huddled masses."
264,20,41,133,194,1.4175257731958764,0.048253624467125354,551,"We're gonna need a whiter boat"""
264,19,43,132,194,1.4175257731958764,0.04769692153810021,551,Farmer's Almanac predicts four years of storm metaphors.
264,23,35,136,194,1.4175257731958764,0.04988647235696639,551,'Not my Tsunami'
264,15,51,128,194,1.4175257731958764,0.045401900006508594,551,"Whatever you do, don't make fun of his fingers."
264,17,47,130,194,1.4175257731958764,0.04656355252991707,551,We'll be fine we're a boatload of deplorables.
275,15,50,127,192,1.4166666666666667,0.04572313422009332,551,"If we all pull hard to the left, we will get through this. Ready?!"
276,16,50,131,197,1.416243654822335,0.04548050843245536,551,"Not to worry: In a moment, he'll change his mind."
277,21,38,134,193,1.4145077720207253,0.048963616342585,551,Attention! Attention! Small hands on deck!
277,21,38,134,193,1.4145077720207253,0.048963616342585,551,"It's not a tsunami, it's a wave of discontent."
277,20,40,133,193,1.4145077720207253,0.048409331323571544,551,But she invited us.
277,27,26,140,193,1.4145077720207253,0.05216579264455826,551,"New management, folks. Accepting only your rested and rich."
277,19,42,132,193,1.4145077720207253,0.04784862582192714,551,Maybe it won't be that bad.
277,18,44,131,193,1.4145077720207253,0.04728127141795429,551,"No, No, No! We're from Staten Island."
277,19,42,132,193,1.4145077720207253,0.04784862582192714,551,"Look, the land of the tweet and home of the depraved."
277,25,30,138,193,1.4145077720207253,0.05112069238515833,551,It's a good thing Trump doesn't have the reading level necessary for The New Yorker.
277,16,48,129,193,1.4145077720207253,0.046125631644468534,551,We call this one the groper
277,14,52,127,193,1.4145077720207253,0.04494028440390797,551,"I knew about the wall, but no one told me about the permanent wave."
277,23,34,136,193,1.4145077720207253,0.05005377565819507,551,Calm down. We're leaving.
288,20,41,135,196,1.413265306122449,0.04785441198377604,551,He's making our oceans great again.
288,21,39,136,196,1.413265306122449,0.048398071966455056,551,"We're tired, we're poor, and you're creepy!"
290,18,43,131,192,1.4114583333333333,0.047429218316062484,551,And this here folks is the Populist Wave of 2016.
290,17,45,130,192,1.4114583333333333,0.04685075483124801,551,Clear the comb-over and we're home free.
290,14,51,127,192,1.4114583333333333,0.04507084049374587,551,The media said there was no chance this storm would actually hit the U.S.
290,20,39,133,192,1.4114583333333333,0.04856547944479427,551,This isn't how I pictured the amber waves.
290,16,47,129,192,1.4114583333333333,0.04626505923958922,551,"Don't worry, It's just another Twitter storm!"
290,17,45,130,192,1.4114583333333333,0.04685075483124801,551,Just our luck to arrive on a bad hair day
296,19,40,131,190,1.4105263157894736,0.04835902217348522,551,Is it me or does the crest look fake?
296,17,44,129,190,1.4105263157894736,0.047193277492687875,551,This is not the wave of the future I was expecting.
296,18,42,130,190,1.4105263157894736,0.047779705242275594,551,Thar he blows!
296,22,34,134,190,1.4105263157894736,0.05005676181282934,551,"We're tired, poor, and yearning for impeachment."
296,18,42,130,190,1.4105263157894736,0.047779705242275594,551,"Watch out ladies, here comes another grabber wave."
296,16,46,128,190,1.4105263157894736,0.04659947046871823,551,This rising tide lifts only yachts.
296,25,28,137,190,1.4105263157894736,0.05169877929697202,551,Hold on to your pussies.
296,19,40,131,190,1.4105263157894736,0.04835902217348522,551,Which one of you made fun of his wave?
304,16,45,128,189,1.4074074074074074,0.04674163829585558,551,This doesn't look like a passing storm to me.
304,14,49,126,189,1.4074074074074074,0.04552149129719835,551,Is that a permanent wave?
304,15,47,127,189,1.4074074074074074,0.0461355986224385,551,Don't panic; it's the Statue of Liberty he's after.
304,18,41,130,189,1.4074074074074074,0.047930734724603165,551,More than half of us wanted the other wave.
304,18,41,130,189,1.4074074074074074,0.047930734724603165,551,"Hang on everyone, it's a rogue weave!!"
304,21,35,133,189,1.4074074074074074,0.04966102296801598,551,Don't worry - you can't take him literally.
304,19,39,131,189,1.4074074074074074,0.04851435479907079,551,H-u-u-g-e !
304,13,51,125,189,1.4074074074074074,0.04489898528464827,551,Maybe we should come back in four years.
304,20,37,132,189,1.4074074074074074,0.04909103698130614,551,I would have been happier with a wall
304,20,37,132,189,1.4074074074074074,0.04909103698130614,551,And the cast of 'Hamilton' set out for a three-hour tour.
304,21,35,133,189,1.4074074074074074,0.04966102296801598,551,No one saw this coming.
304,21,35,133,189,1.4074074074074074,0.04966102296801598,551,Let's just give it a chance...what's the worst that could happen?
316,15,46,126,187,1.4064171122994653,0.04647059716813083,551,Don't worry. It's only a tweet storm.
317,17,44,131,192,1.40625,0.04679767473266107,551,"Look, a wave of nausea."
318,20,37,133,190,1.4052631578947368,0.048879034714173694,551,Hey--it's Alec Baldwin!
319,18,40,130,188,1.4042553191489362,0.04808205540903504,551,"Just keep rowing, it's just a tiny-handed blowhard."
319,20,36,132,188,1.4042553191489362,0.04925101663141043,551,Looks like someone's Twitter feed is down.
321,19,37,130,186,1.403225806451613,0.049041396233148064,551,"He's saying, ""Give me your rested, your well-fed, your rich, yearning to breathe really terrific things."""
321,19,37,130,186,1.403225806451613,0.049041396233148064,551,"You may be able to stop people coming in, but you can't keep us from leaving."
321,19,37,130,186,1.403225806451613,0.049041396233148064,551,Don't worry. It's just Alec Baldwin having some fun.
321,13,49,124,186,1.403225806451613,0.04534669460820523,551,It's the imperfect storm.
321,26,23,137,186,1.403225806451613,0.0530275118770552,551,"We're tired, we're poor, we're yearning to breathe free. What could go wrong?"
321,17,41,128,186,1.403225806451613,0.04784154331709032,551,I told you it was a permanent wave.
321,13,49,124,186,1.403225806451613,0.04534669460820523,551,Everything reminds me of him.
321,18,39,129,186,1.403225806451613,0.048445184546338865,551,"Tell it we're emigrating, not immigrating."
321,17,41,128,186,1.403225806451613,0.04784154331709032,551,It's a populist wave.
321,15,45,126,186,1.403225806451613,0.04661081408241471,551,Somehow trying to see the humor in it is only makes it worse.
321,16,43,127,186,1.403225806451613,0.04723018767899646,551,Careful - these's waves can grab you by the dingy.
321,18,39,129,186,1.403225806451613,0.048445184546338865,551,Hold On! This is when it usually reverses direction.
333,17,40,128,185,1.4,0.04799138191337426,551,"You're right, it's nothing but sound and fury, signifying nothing."
333,16,42,127,185,1.4,0.04737529241466328,551,This is where they drained the swamp.
333,15,44,126,185,1.4,0.0467510847445742,551,He's delivering on his promise to make waves
333,16,42,127,185,1.4,0.04737529241466328,551,They should have never taken away his Twitter account.
333,18,38,129,185,1.4,0.0485996619796459,551,Careful ladies! This tidal wave likes to grab.
333,17,40,128,185,1.4,0.04799138191337426,551,"Just scream 'Debt Collectors"" and watch it back off"
339,12,49,122,183,1.3989071038251366,0.04514492945659098,551,It's just the overflow from draining the swamp.
340,20,33,131,184,1.3967391304347827,0.049957823586608704,551,Of course that’s him. Look at the tiny hands.
340,14,45,125,184,1.3967391304347827,0.046253702014598407,551,"I know waves, I have the best waves."
342,13,46,123,182,1.3956043956043955,0.045937664985385346,551,Looks like they built a squall.
342,21,30,131,182,1.3956043956043955,0.05095067425923042,551,Don't worry it's Trump l'oeil.
342,15,42,125,182,1.3956043956043955,0.04724081498132389,551,That's the wave of anti-immigration sentiment.
342,17,38,127,182,1.3956043956043955,0.048508969643663344,551,From a distance it looked like a welcome mat.
342,21,30,131,182,1.3956043956043955,0.05095067425923042,551,"Don't worry, we'll be fine. Look at the size of those hands!"
342,21,30,131,182,1.3956043956043955,0.05095067425923042,551,We're gonna need a bigger boat...and really big comb.
342,12,48,122,182,1.3956043956043955,0.04527202553911643,551,People told us we might run into waves of anti-immigrant sentiment.
342,17,38,127,182,1.3956043956043955,0.048508969643663344,551,I've got models aboard.
342,19,34,129,182,1.3956043956043955,0.04974480547434102,551,You Don't Understand! We Want to Leave!
342,15,42,125,182,1.3956043956043955,0.04724081498132389,551,The waves are often biggest where it's shallow. Hang on!
352,14,44,125,183,1.3934426229508197,0.04638888353699832,551,"I really though ""tweet-storm"" was just a figure of speech."
353,20,31,130,181,1.3922651933701657,0.05051884613018491,551,"Watch out below deck, ladies."
353,17,37,127,181,1.3922651933701657,0.048662015491656295,551,"Gosh, we thought we had until January 20th to escape!"
353,18,35,128,181,1.3922651933701657,0.04928873203801485,551,It's him! I'd recognize those tiny hands anywhere.
353,13,45,123,181,1.3922651933701657,0.04606997216072593,551,Such a nasty wave.
353,19,33,129,181,1.3922651933701657,0.049907579185132445,551,So do we take this seriously or literally?
353,14,43,124,181,1.3922651933701657,0.04673146358819822,551,Now hear this....small hands on deck !
353,14,43,124,181,1.3922651933701657,0.04673146358819822,551,"Everyone, compliment the wave."
353,15,41,125,181,1.3922651933701657,0.04738372129012378,551,"Quick, tell it we're with Goldman Sachs!"
353,16,39,126,181,1.3922651933701657,0.048027121478443444,551,We probably should've seen this coming.
353,19,33,129,181,1.3922651933701657,0.049907579185132445,551,Hey--it's Alec Baldwin!
353,18,35,128,181,1.3922651933701657,0.04928873203801485,551,"Not a wave, just a comb-over, folks"
353,14,43,124,181,1.3922651933701657,0.04673146358819822,551,The good news is that we're all in the same boat....
353,16,39,126,181,1.3922651933701657,0.048027121478443444,551,But the forecast on Fox News promised smooth sailing!
353,21,29,131,181,1.3922651933701657,0.051122804779573004,551,"Small hands, but big mouth."
353,21,29,131,181,1.3922651933701657,0.051122804779573004,551,Tweet me Ishmail.
353,14,43,124,181,1.3922651933701657,0.04673146358819822,551,Rogue wave from the right!
353,14,43,124,181,1.3922651933701657,0.04673146358819822,551,"Give me your wealthy, your entitled."
353,15,41,125,181,1.3922651933701657,0.04738372129012378,551,The polls say we have nothing to worry about.
353,16,39,126,181,1.3922651933701657,0.048027121478443444,551,"Relax, we're Canadians."
353,18,35,128,181,1.3922651933701657,0.04928873203801485,551,The election was not won by a landslide... just a tidal bore.
353,14,43,124,181,1.3922651933701657,0.04673146358819822,551,It's just a bad foam-over...
374,21,30,133,184,1.391304347826087,0.05048649252691773,551,Wow ... he really DOES have tiny hands!
375,18,34,128,180,1.3888888888888888,0.04944690290235517,551,"Careful, it's moving further right."
375,13,44,123,180,1.3888888888888888,0.046202055955130376,551,Just imagine when it hits Washington
375,16,38,126,180,1.3888888888888888,0.04817519811867268,551,"I thought he said ""extreme vetting !"""
378,13,43,122,178,1.3876404494382022,0.046543992137679395,551,"Boy, the tides sure are turning."
378,16,37,125,178,1.3876404494382022,0.04854671070545149,551,There's only one way it'll spare us... hoist the Russian flag!
378,19,31,128,178,1.3876404494382022,0.050470021166284795,551,"Okay, I guess the tired and the poor get off here, now."
378,19,31,128,178,1.3876404494382022,0.050470021166284795,551,",,,your huddled masses yearning to breathe free? Sad."
378,12,45,121,178,1.3876404494382022,0.045856986730961176,551,"Huddle, masses!"
383,16,36,125,177,1.384180790960452,0.048697633370103716,551,Maybe they should change it to 'Come hell AND high water'!
383,16,36,125,177,1.384180790960452,0.048697633370103716,551,don't worry - the storm will soon comb over!
385,21,27,132,180,1.3833333333333333,0.0512264237758364,551,Wow... What tiny little hands...
386,18,33,130,181,1.3812154696132597,0.049147468735831194,551,Many hands - All tiny. Sad!
386,19,31,131,181,1.3812154696132597,0.04976807246965205,551,...the land of the free and the comb-over wave
388,19,29,128,176,1.3806818181818181,0.05080338922308765,551,Don't worry -- it's just a hoax invented by the Chinese!
388,15,37,124,176,1.3806818181818181,0.04817929116137221,551,Looks like Trump has tweeted up another storm!!
388,19,29,128,176,1.3806818181818181,0.05080338922308765,551,Hold onto your pussies; it's a big one!
388,16,35,125,176,1.3806818181818181,0.04884853285153346,551,Oh no! It's an entidaled wave!
388,24,19,133,176,1.3806818181818181,0.053904171278555645,551,Prepare for swamping!
393,14,38,122,174,1.3793103448275863,0.047865028647472926,551,"On second thought, we're not THAT yearning."
393,17,32,125,174,1.3793103448275863,0.04990374005612445,551,"Keep paddling and whatever you do, don't mention the tiny hands!"
393,14,38,122,174,1.3793103448275863,0.047865028647472926,551,Let' make rowing great again!
393,13,40,121,174,1.3793103448275863,0.047165879609820965,551,Alright. Who tweeted?!
397,17,31,124,172,1.377906976744186,0.0503071101828824,551,"That's quite a feat, considering he doesn't know the meaning of the word anthropomorphic."
398,10,45,118,173,1.3757225433526012,0.045120127140458675,551,Does anyone speak Russian?
398,14,37,122,173,1.3757225433526012,0.048007074621079664,551,It's HUUUUUUUUGE!
398,15,35,123,173,1.3757225433526012,0.04870207951206601,551,"Hold on everyone, this is gonna be HUGE!"
398,16,33,124,173,1.3757225433526012,0.04938730488622849,551,It's a tweetstorm!
398,16,33,124,173,1.3757225433526012,0.04938730488622849,551,Don't worry. It's just over-compensating for its tiny hands.
398,15,35,123,173,1.3757225433526012,0.04870207951206601,551,"Small hands, big mouth, comb over: we can ride this one out."
398,17,31,125,173,1.3757225433526012,0.05006315230836925,551,Like we need reminding why we're all leaving
398,16,33,124,173,1.3757225433526012,0.04938730488622849,551,Wasn't the apocalypse scheduled for January 20th?
398,15,35,123,173,1.3757225433526012,0.04870207951206601,551,I thought he was going to build a wall.
407,16,34,126,176,1.375,0.048767271332798116,551,"Wait, wait, we're all related to your next wife!"
408,17,31,126,174,1.3735632183908046,0.04982141744727836,551,So much for draining the swamp.
408,14,37,123,174,1.3735632183908046,0.047779193508159346,551,"Stay calm, it's only a Twitter rant."
408,15,35,124,174,1.3735632183908046,0.048469496596781514,551,Hold on! Things are about to get hairy.
408,16,33,125,174,1.3735632183908046,0.04915010547700476,551,But everyone said this couldn't happen
412,20,24,128,172,1.372093023255814,0.052214018912215346,551,"None of us are immigrants, right?"
412,18,28,126,172,1.372093023255814,0.05089503766534099,551,"I don't think you understand, we are trying to get out!"
412,15,34,123,172,1.372093023255814,0.0488498361403948,551,Who's for trying Canada?
412,17,30,125,172,1.372093023255814,0.05022255870574622,551,We're gonna need a bigger comb.
412,16,32,124,172,1.372093023255814,0.04954095222084224,551,Keep rowing and it'll be over in four years.
412,16,32,124,172,1.372093023255814,0.04954095222084224,551,"You know, a wall sounds pretty good right now."
412,9,46,117,172,1.372093023255814,0.044478194150811806,551,No worries folks. It's mostly hot air.
412,10,44,118,172,1.372093023255814,0.04523614938212206,551,He's gotten real creative with 'The Wall' concept.
420,14,35,121,170,1.3705882352941177,0.04852611555218211,551,I keep having this nightmare that Trump won the election
420,16,31,123,170,1.3705882352941177,0.04994007588232406,551,It's even uglier up close.
420,15,33,122,170,1.3705882352941177,0.04923817152228551,551,"It's YUGE, it's TERRIFYING, and we're ALL in the same boat!"
420,13,37,120,170,1.3705882352941177,0.04780345433448772,551,"Quick, everyone form a huddled mass!"
420,18,27,125,170,1.3705882352941177,0.05131509005819673,551,Hairicane Donald lashes East Coast with gale-force rhetoric.
425,13,38,122,173,1.369942196531792,0.04721142359654079,551,That lady said to let us in.
425,14,36,123,173,1.369942196531792,0.04791797004400017,551,I think I prefer the wall.
427,11,40,117,168,1.369047619047619,0.04667404200257338,551,Wow! The crest of that wave never moves!
428,15,33,123,171,1.368421052631579,0.048997333486908566,551,Which way to the Statue of Limitations?
428,13,37,121,171,1.368421052631579,0.04757246881988074,551,See those tiny hands reaching out to rescue us from that nasty woman with the big torch?
428,11,41,119,171,1.368421052631579,0.04610358869339477,551,"And this, folks, is the Wave of the Future. I promise you, it's gonna be yuge!"
428,15,33,123,171,1.368421052631579,0.048997333486908566,551,I'm the biggest wave. I'm HUGE. Tremendous.
428,13,37,121,171,1.368421052631579,0.04757246881988074,551,Can't blame this on global warming.
428,12,39,120,171,1.368421052631579,0.04684378656784827,551,No worries. Forecasters say there's a 90% chance it won't amount to anything.
428,14,35,122,171,1.368421052631579,0.04829015675293391,551,What do sailors say about orange sky?
428,12,39,120,171,1.368421052631579,0.04684378656784827,551,Should've known something was up when the water turned orange.
428,22,19,130,171,1.368421052631579,0.05368738060343561,551,"Look, he does have small hands."
428,16,31,124,171,1.368421052631579,0.049694447762619665,551,And our tour ends with climate change.
428,18,27,126,171,1.368421052631579,0.05106013158659641,551,"I thought the slogan was ""huddled masses..."" not ""befuddled asses."""
428,14,35,122,171,1.368421052631579,0.04829015675293391,551,Stop tweeting and it'll go away.
440,14,34,121,169,1.3668639053254439,0.04867012709898018,551,Keep rowing. It's only a trompe l'oeil.
440,15,32,122,169,1.3668639053254439,0.04938849714220479,551,Look! a Trumpe-l'œil.
440,16,30,123,169,1.3668639053254439,0.05009656702909149,551,I was warned we might be blocked by that real estate typhoon.
440,10,42,117,169,1.3668639053254439,0.04568382382520252,551,"Don't worry, those little hands were only made for tweeting"
440,14,34,121,169,1.3668639053254439,0.04867012709898018,551,It's the tiny hands that really creaps me out.
440,19,24,126,169,1.3668639053254439,0.05216313988348779,551,'You're gonna need a bigger vote.'
440,16,30,123,169,1.3668639053254439,0.05009656702909149,551,Illegals? Actually we are the inaurgaration band
440,18,26,125,169,1.3668639053254439,0.051483500117704,551,"Look out, it's a gropenami!"
440,17,28,124,169,1.3668639053254439,0.05079476750842494,551,All women on board immediately cross your legs. This is not a drill.
440,15,32,122,169,1.3668639053254439,0.04938849714220479,551,It looks bad but it's mostly hot air.
440,11,40,118,169,1.3668639053254439,0.04644840295884055,551,Toss out Alec Baldwin now!
440,19,24,126,169,1.3668639053254439,0.05216313988348779,551,Looks like we are about to get groped!
440,16,30,123,169,1.3668639053254439,0.05009656702909149,551,Hurry ! Tweet something nice !
440,24,14,131,169,1.3668639053254439,0.05543649567908981,551,The hair looks especially angry today.
440,14,34,121,169,1.3668639053254439,0.04867012709898018,551,"Just pretend we're all rich, white, Christian males, and he'll let us pass."
455,13,34,117,164,1.3658536585365855,0.04894853591610554,551,From this close you can tell it's not real.
456,18,25,124,167,1.3652694610778444,0.051916089861324545,551,"Brace yourself, it's opening its mouth again."
456,15,31,121,167,1.3652694610778444,0.04978800845395368,551,This will be HUGE!
456,11,39,117,167,1.3652694610778444,0.04680028117693398,551,He's making waves great again!
456,12,37,118,167,1.3652694610778444,0.04756481036578198,551,"Relax, it's just a trumped up wave."
456,18,25,124,167,1.3652694610778444,0.051916089861324545,551,Hey I see a very small sea cucumber!
456,15,31,121,167,1.3652694610778444,0.04978800845395368,551,"Whatever you do, don't make fun of his hair."
456,11,39,117,167,1.3652694610778444,0.04680028117693398,551,I hope this storm combs over.
456,17,27,123,167,1.3652694610778444,0.05121655513207037,551,"Well, this trumps Moby Dick."
456,11,39,117,167,1.3652694610778444,0.04680028117693398,551,Can you blow us toward Canada?
456,12,37,118,167,1.3652694610778444,0.04756481036578198,551,That wave looks a lot like Alec Baldwin.
456,17,27,123,167,1.3652694610778444,0.05121655513207037,551,"Which of you assholes said, ""give us liberty or give us death?"""
456,15,31,121,167,1.3652694610778444,0.04978800845395368,551,"I'm a New Yorker, and I know a con when I see one."
468,16,28,121,165,1.3636363636363635,0.05092703727602758,551,"Not only didn't the swamp get drained, it looks like it overflowed into the Hudson."
469,22,17,129,168,1.3630952380952381,0.05434211036128738,551,Don't blame me - I voted for Hillary!
470,15,29,119,163,1.361963190184049,0.05061321003639147,551,Better turn back. I hear it's a four-year blow.
471,10,40,116,166,1.3614457831325302,0.046141065434040375,551,Let's come back in 4 years.
471,12,36,118,166,1.3614457831325302,0.04769734394747745,551,Hang on. We're about to get trickled down on.
471,14,32,120,166,1.3614457831325302,0.04920442378383809,551,And to think I laughed at the thought of Trump 'tweeting up a storm'.
471,15,30,121,166,1.3614457831325302,0.04994091178610294,551,"Look out, this one's a grabber!"
471,15,30,121,166,1.3614457831325302,0.04994091178610294,551,"If anyone's a constitutional lawyer, now's the time to speak up."
471,12,36,118,166,1.3614457831325302,0.04769734394747745,551,"All things considered, I'd prefer a white whale."
471,16,28,122,166,1.3614457831325302,0.05066669537432947,551,It's not a real tsunami--it's just a comb-over.
478,18,23,123,164,1.3597560975609757,0.05253359094532938,551,This is our wave of the future!
479,17,26,124,167,1.3592814371257484,0.051119462049242975,551,Is she waving goodbye?
479,16,28,123,167,1.3592814371257484,0.050408873557254506,551,We should have taken the Holland Tunnel
479,14,32,121,167,1.3592814371257484,0.04895676459413787,551,Say he's brilliant and he'll wave you in.
482,16,27,122,165,1.3575757575757577,0.050825786204929814,551,Did Mexico pay for this?
482,11,37,117,165,1.3575757575757577,0.04705009450906852,551,Maybe we can just ride this one out.
482,16,27,122,165,1.3575757575757577,0.050825786204929814,551,We're gonna need a bit bigger vote.
482,12,35,118,165,1.3575757575757577,0.04782908344636838,551,I say we shoot the curl!
482,15,29,121,165,1.3575757575757577,0.05009341986071467,551,And when a butterfly flaps its wings in Moscow...
482,12,35,118,165,1.3575757575757577,0.04782908344636838,551,Must be backwash from the swamp draining.
482,13,33,119,165,1.3575757575757577,0.04859558676800869,551,It's true! Even the ocean thinks he's a joke.
482,16,27,122,165,1.3575757575757577,0.050825786204929814,551,Let's turn around. They've ammended their constitution down to 140 characters.
482,16,27,122,165,1.3575757575757577,0.050825786204929814,551,It is a wave or a weave?
482,13,33,119,165,1.3575757575757577,0.04859558676800869,551,Look out! It's a tycoonphoon!
482,12,35,118,165,1.3575757575757577,0.04782908344636838,551,This wasn't in the forecast.
493,16,26,121,163,1.3558282208588956,0.05125183022954163,551,Are you sure he said we're not getting in without 'extreme wetting?'
493,14,30,119,163,1.3558282208588956,0.04975207913042324,551,"Keep rowing, people. This boat's been seaworthy for two hundred years."
493,14,30,119,163,1.3558282208588956,0.04975207913042324,551,"Oh, Trump said ""extreme wetting""."
493,8,42,113,163,1.3558282208588956,0.04495361170769611,551,"See, I told you we'd be welcomed with open arms."
493,11,36,116,163,1.3558282208588956,0.04741358762720982,551,"No more huddled masses! Oh, you're trying to leave."
493,14,30,119,163,1.3558282208588956,0.04975207913042324,551,Here's where we conclude our tour.
493,16,26,121,163,1.3558282208588956,0.05125183022954163,551,"It's every man for himself. Women, lotsa luck!"
493,14,30,119,163,1.3558282208588956,0.04975207913042324,551,"Don't worry. The mouth is big, but the hands are tiny."
493,16,26,121,163,1.3558282208588956,0.05125183022954163,551,"Hold on, everybody! We're about to be extremely wetted."
493,7,44,112,163,1.3558282208588956,0.044103138703808616,551,Look out for the foam-over.
493,13,32,118,163,1.3558282208588956,0.04898498765704616,551,"Relax. This, too, shall comb over."
493,14,30,119,163,1.3558282208588956,0.04975207913042324,551,Now that's a sea change!
493,10,38,115,163,1.3558282208588956,0.046608024305307916,551,The tide has obviously turned on illegal immigration.
493,13,32,118,163,1.3558282208588956,0.04898498765704616,551,All in favor of diverting to Canada say aye!
493,20,18,125,163,1.3558282208588956,0.05412680990076433,551,"The New Yorker used to be funny, now a failing magazine that never picks the funny captions for their contest. Sad!"
508,13,33,120,166,1.355421686746988,0.04834996270005834,551,He's going to make Staten Island great again!
508,14,31,121,166,1.355421686746988,0.049099269273837634,551,Rogue weave dead ahead!
510,14,29,118,161,1.3540372670807452,0.05016273044284242,551,Geez-- The Circle Line Tours were a lot safer during the Obama administration!
510,12,33,116,161,1.3540372670807452,0.04859032848598247,551,Just keep rowing and bailing for four more years and we should be okay.
510,13,31,117,161,1.3540372670807452,0.04938278823566441,551,"Whoa, we're not coming to America, we're leaving!"
510,17,23,121,161,1.3540372670807452,0.05243299324032202,551,"Don't be afraid! Check out his hands, he's overcompensating for a tiny under tow."
514,13,32,119,164,1.353658536585366,0.04873370493441961,551,"Wow, that's quite the pour-over!"
514,18,22,124,164,1.353658536585366,0.05243145517789159,551,Angry white squall!
516,16,25,121,162,1.3518518518518519,0.051413739517433395,551,Let's give it a chance.
516,14,29,119,162,1.3518518518518519,0.04990000139241922,551,tell him we are a basket of deplorable
516,16,25,121,162,1.3518518518518519,0.051413739517433395,551,'Not my Tsunami'
516,13,31,118,162,1.3518518518518519,0.04912564404526331,551,"Don't worry, all the forecasts say it won't affect us."
516,10,37,115,162,1.3518518518518519,0.04672563744409847,551,Looks like it's blowing over.
516,12,33,117,162,1.3518518518518519,0.04833888359033945,551,I think the new immigration policy is about to take effect.
516,14,29,119,162,1.3518518518518519,0.04990000139241922,551,"I said we're emigrating, not immigrating."
516,17,23,122,162,1.3518518518518519,0.052154135476182695,551,Work visas? Hell no! We're with Melania.
524,17,24,124,165,1.3515151515151516,0.05144336548699238,551,I told you we should have just climbed the wall.
525,16,24,120,160,1.35,0.051852475787401105,551,"Okay, can we all agree this is the last Trump cartoon until the next election?"
525,14,28,118,160,1.35,0.0503134826948056,551,"Folks, let's all try to give the Apocalypse a fair chance."
527,12,32,117,161,1.3478260869565217,0.04847108823633957,551,"give me your fat, your rich, your overfed."
527,16,24,121,161,1.3478260869565217,0.051575240193587044,551,"Don't you worry your pretty little hands, Putin sent us."
527,9,38,114,161,1.3478260869565217,0.04600572942750317,551,Once we cross the Sea of Tiny Hands it should be smooth sailing.
527,18,20,123,161,1.3478260869565217,0.05305925842048479,551,Wow!! I never saw a tidal wave with such small hands!
531,14,29,121,164,1.3475609756097562,0.049382322857452664,551,Quick everyone paddle left
531,12,33,119,164,1.3475609756097562,0.04784329015257228,551,But we're not immigrants! We're just out on a boat ride!
531,13,31,120,164,1.3475609756097562,0.048618896652540926,551,"Recalculating, ..."
534,11,33,115,159,1.3459119496855345,0.048038859048025684,551,"Ladies, batten down your hatches."
534,10,35,114,159,1.3459119496855345,0.047202971121912136,551,Off the bow you'll see a hoax perpetrated by the Russians.
534,12,31,116,159,1.3459119496855345,0.04886044898009111,551,OMG! It's the GRIM GROPER!
534,13,29,117,159,1.3459119496855345,0.049668450453342054,551,We're about to go comb-overboard.
534,12,31,116,159,1.3459119496855345,0.04886044898009111,551,The doomed boat of deplorables
534,10,35,114,159,1.3459119496855345,0.047202971121912136,551,Holy Crap! It's the wave of the future!
534,13,29,117,159,1.3459119496855345,0.049668450453342054,551,"See, it's a wave, not a comb-over."
534,14,27,118,159,1.3459119496855345,0.05046351619076997,551,Heads up! It's the Orange Crush!
534,17,21,121,159,1.3459119496855345,0.05277689791979182,551,When is this fucking acid going to wear off?
543,14,28,120,162,1.345679012345679,0.04978366484456014,551,How do we stop him from grabbing Lady Liberty?
544,14,26,117,157,1.3439490445859872,0.05088902256563434,551,The weather started getting rough - the tiny ship was tossed. If not for the courage of the fearless crew democracy would be lost.
545,12,31,117,160,1.34375,0.04860221916278278,551,Maybe we should have climbed the wall!
545,16,23,121,160,1.34375,0.05173626500195198,551,"Don't fret, ladies! The hands may be all over the place, but they are rather small."
545,11,33,116,160,1.34375,0.0477866022578077,551,"Quick, break out the hair net!"
545,14,27,119,160,1.34375,0.050193708888163324,551,I say we wait and see what happens.
545,14,27,119,160,1.34375,0.050193708888163324,551,I guess the huddled masses aren't as welcome as they used to be.
545,13,29,118,160,1.34375,0.04940437288083341,551,Making boating great again!
545,13,29,118,160,1.34375,0.04940437288083341,551,"It can't be Trump, he doesn't believe in global warming."
545,13,29,118,160,1.34375,0.04940437288083341,551,"Don't worry, folks. Climate change is just a hoax."
545,13,29,118,160,1.34375,0.04940437288083341,551,"We're tired, we're poor...What the hell do we have to lose?!"
545,13,29,118,160,1.34375,0.04940437288083341,551,Hang on. We are in for a rough four years.
555,15,24,119,158,1.3417721518987342,0.05140307593257131,551,"Just think - the ""Make America Wetter"" theme all started because of a typo!"
555,15,24,119,158,1.3417721518987342,0.05140307593257131,551,"Small hands, small dinghy."
555,16,22,120,158,1.3417721518987342,0.0521814322380398,551,It's not funny anymore.
555,12,30,116,158,1.3417721518987342,0.04899386951527047,551,We've reached the first security checkpoint.
555,9,36,113,158,1.3417721518987342,0.04645989975052686,551,"No more ""Give me your tired..."" Now it's ""You're Fired!"""
555,16,22,120,158,1.3417721518987342,0.0521814322380398,551,"Yes, it is as bad as it looks."
561,9,37,115,161,1.3416149068322982,0.04587451665265008,551,"Oh no, a wave of the future."
562,16,21,119,156,1.3397435897435896,0.052636678497273943,551,"Give me your tiared, your rich, Your hubric massahs yearning to be tax free, The wealthy refuse you from our teeming shore. Spurn these, the homeless, tempest-tossed we see. I lift my lamp to block the golden door."
562,9,35,112,156,1.3397435897435896,0.04681483762285024,551,We got past the damn wall and now this?
562,10,33,113,156,1.3397435897435896,0.047690061937395584,551,Who would've thought that THIS was the face of global warming?
562,14,25,117,156,1.3397435897435896,0.05104110060870354,551,Those little hands really creep me out.
562,12,29,115,156,1.3397435897435896,0.04939400752591565,551,It's yuge!
562,12,29,115,156,1.3397435897435896,0.04939400752591565,551,"Not to worry, it's just a passing tweetstorm."
562,10,33,113,156,1.3397435897435896,0.047690061937395584,551,Keep calm. It'll blow over in four years.
562,9,35,112,156,1.3397435897435896,0.04681483762285024,551,you call that a boat...sad.
562,9,35,112,156,1.3397435897435896,0.04681483762285024,551,"It may be just hyperbole, folks."
562,9,35,112,156,1.3397435897435896,0.04681483762285024,551,"Remember the drill, ladies—arms and legs crossed."
562,8,37,111,156,1.3397435897435896,0.045922935835103595,551,Brace yourselves; I don't think we can ride the populist wave
562,13,27,116,156,1.3397435897435896,0.05022430651994116,551,"Take back your tired, your poor, your huddled masses"
562,13,27,116,156,1.3397435897435896,0.05022430651994116,551,I guess all of that drained swamp water from Washington had to go somewhere!
562,13,27,116,156,1.3397435897435896,0.05022430651994116,551,Quick everyone paddle to the left
562,6,41,109,156,1.3397435897435896,0.04408503219730544,551,Wow! The first wave of immigration control!
562,13,27,116,156,1.3397435897435896,0.05022430651994116,551,Another alt-whitecap!
562,13,27,116,156,1.3397435897435896,0.05022430651994116,551,The Great Trump L'Oeil off Manhattan
562,10,33,113,156,1.3397435897435896,0.047690061937395584,551,You just had to mention his comb-over.
580,17,20,122,159,1.3396226415094339,0.052658175274445655,551,The worst red tide we've seen in years.
581,12,28,115,155,1.335483870967742,0.04952850110648353,551,Looks like the new immigration screening is in effect.
581,12,28,115,155,1.335483870967742,0.04952850110648353,551,Who tweeted?
581,15,22,118,155,1.335483870967742,0.05200417255893091,551,Twitter was bad enough. Now it's surfing the internet.
581,14,24,117,155,1.335483870967742,0.051192253153945946,551,It's a good likeness; note the tiny hands and huge mouth!
581,16,20,119,155,1.335483870967742,0.05280360919577787,551,Tiny hands for such a big wave.
581,13,26,116,155,1.335483870967742,0.050367247318235636,551,Such small hands...
581,11,30,114,155,1.335483870967742,0.04867530422394468,551,Tweet for help!
581,13,26,116,155,1.335483870967742,0.050367247318235636,551,We're supposed to take it seriously but not literally.
581,8,36,111,155,1.335483870967742,0.04602090502814394,551,"Keep rowing, everyone - things are about to get real hairy."
581,13,26,116,155,1.335483870967742,0.050367247318235636,551,Um--I think this will swamp the drain.
581,14,24,117,155,1.335483870967742,0.051192253153945946,551,I told you not to bring up the Electoral College.
581,14,24,117,155,1.335483870967742,0.051192253153945946,551,We're safe.....it's just the swamp draining.
581,11,30,114,155,1.335483870967742,0.04867530422394468,551,Wait! We are emigrating not immigratiing.
581,10,32,113,155,1.335483870967742,0.047806882984902835,551,But we're from Staten Island!
595,15,22,119,156,1.3333333333333333,0.051714471333992075,551,Twitter must be down he's now resorting to theatrics.
595,13,25,115,153,1.3333333333333333,0.05079349722321863,551,"I knew he wanted to be God, but Moses too?"
595,12,27,114,153,1.3333333333333333,0.049939764198077816,551,We're the mariachi band Little Marco hired for the Inauguration.
598,9,33,112,154,1.3311688311688312,0.04702795395330427,551,Now he's making ocean travel great again.
598,12,27,115,154,1.3311688311688312,0.049661612604756905,551,It doesn't look like we're gonna make it to Canada.
598,15,21,118,154,1.3311688311688312,0.052162468116221196,551,"It's called a Trump Wave. It will drown and kill us, but our deaths will be fantastic. They will be marvelous deaths. Great deaths. Believe me."
598,10,31,113,154,1.3311688311688312,0.04792192494941873,551,Get out your Green Cards!
598,13,25,116,154,1.3311688311688312,0.05050899132163069,551,It's yuge!
598,10,31,113,154,1.3311688311688312,0.04792192494941873,551,"If we're lucky, it'll just be another one of those blow-overs."
598,20,11,123,154,1.3311688311688312,0.05608328867937279,551,There's really nothing funny about this.
598,15,21,118,154,1.3311688311688312,0.052162468116221196,551,Trumpocalypse
598,13,25,116,154,1.3311688311688312,0.05050899132163069,551,The other ride won the popular vote.
598,13,25,116,154,1.3311688311688312,0.05050899132163069,551,Making low tide great again
598,14,23,117,154,1.3311688311688312,0.05134238640881605,551,All small hands on deck!
598,12,27,115,154,1.3311688311688312,0.049661612604756905,551,Nobody in this boat said your hair looked funny
598,15,21,118,154,1.3311688311688312,0.052162468116221196,551,' Super Storm Asshole '
598,9,33,112,154,1.3311688311688312,0.04702795395330427,551,"Give me your money, you tired and huddled masses, then go back you came from."
598,11,29,114,154,1.3311688311688312,0.048799521807916676,551,"I will build a great wave–and nobody builds waves better than me, believe me, and I will make Mexico pay for that wave."
598,15,21,118,154,1.3311688311688312,0.052162468116221196,551,I'll only let you in if you call me the 'perfect' storm.
614,12,26,114,152,1.3289473684210527,0.05007515769017118,551,They're cutting back on huddled masses.
614,10,30,112,152,1.3289473684210527,0.04830367135336772,551,We shouldn't have said we'd leave if he was elected!!!
614,12,26,114,152,1.3289473684210527,0.05007515769017118,551,"OK. I'll take your tired and huddled masses, but no poor."
614,16,18,118,152,1.3289473684210527,0.053442257817743956,551,Sure has small hands for such a big wave.
614,15,20,117,152,1.3289473684210527,0.05262068552306724,551,Man--his hands ARE tiny.
614,14,22,116,152,1.3289473684210527,0.05178608084395712,551,First a wall. Now this!
614,9,32,111,152,1.3289473684210527,0.04739310382823097,551,"Well, doesn't this just sum up 2016 perfectly."
614,11,28,113,152,1.3289473684210527,0.049197388568447756,551,Watch out for the little hands!
614,9,32,111,152,1.3289473684210527,0.04739310382823097,551,You think the election was surreal? How about being stuck with him in a Japanese woodblock print?
614,9,32,111,152,1.3289473684210527,0.04739310382823097,551,That wave does not look natural.
614,10,30,112,152,1.3289473684210527,0.04830367135336772,551,And amber waves of insane…
614,12,26,114,152,1.3289473684210527,0.05007515769017118,551,I guess this is what he meant by 'extreme vetting.'
614,9,32,111,152,1.3289473684210527,0.04739310382823097,551,"On second thought, maybe it wasn't so bad back home."
614,15,20,117,152,1.3289473684210527,0.05262068552306724,551,"Ladies, hold on to your p---sies."
614,13,24,115,152,1.3289473684210527,0.050937803186201364,551,The wave is bad but I assure the the undertow will be worse.
614,11,28,113,152,1.3289473684210527,0.049197388568447756,551,I think we're heading in the wrong direction.
614,19,12,121,152,1.3289473684210527,0.05583448797902819,551,Have you ever seen such little hands on a tidal wave?
614,13,24,115,152,1.3289473684210527,0.050937803186201364,551,"Give me your tired, your poor, your huddled masses, and I'll send them back to wherever they came from."
614,8,34,110,152,1.3289473684210527,0.04646469535822661,551,"Oh, here comes 2017."
614,16,18,118,152,1.3289473684210527,0.053442257817743956,551,Quick - get out the hair spray>
614,15,20,117,152,1.3289473684210527,0.05262068552306724,551,The last one this bad was in 2000.
614,13,24,115,152,1.3289473684210527,0.050937803186201364,551,"My, what small whitecaps you have!"
614,15,20,117,152,1.3289473684210527,0.05262068552306724,551,"Batten down your panties, ladies!"
614,7,36,109,152,1.3289473684210527,0.04551735426177722,551,"Populist wave, dead ahead!"
614,9,32,111,152,1.3289473684210527,0.04739310382823097,551,Comb-over? I thought they said come over!
614,10,30,112,152,1.3289473684210527,0.04830367135336772,551,Uh oh! Looks like the new immigration policy's already been put in place!
640,12,26,115,153,1.326797385620915,0.04979323032289373,551,Big mouth--yet such tiny hands.
640,9,32,112,153,1.326797385620915,0.04713138922175149,551,The Art of the Wave.
640,10,30,113,153,1.326797385620915,0.048035061798416955,551,"Don't worry, it's mostly bluster."
640,16,18,119,153,1.326797385620915,0.05313532755155237,551,A wave? I thought he was building a wall.
640,11,28,114,153,1.326797385620915,0.04892204486714798,551,"Don't worry, it's going to pivot to the mainstream any second now."
645,13,23,114,150,1.3266666666666667,0.051376285815741204,551,Entitled wave!
646,13,23,115,151,1.3245033112582782,0.0510807427970181,551,I think it wants us to throw Rosie O'Donnell overboard
646,10,29,112,151,1.3245033112582782,0.04841840169236755,551,"Brace yourselves, ladies. This one's looking grabby!"
646,9,31,111,151,1.3245033112582782,0.04749780417759235,551,That wave is Yuge! There has never been one that is Yuger! Ask Anyone.
646,12,25,114,151,1.3245033112582782,0.05020898389675462,551,"All things considered, it's amazing how small it's hands are."
646,11,27,113,151,1.3245033112582782,0.04932181913913976,551,"I'm sure you said tycoon, not typhoon!"
646,9,31,111,151,1.3245033112582782,0.04749780417759235,551,The wave of the future?
646,8,33,110,151,1.3245033112582782,0.04655900751672395,551,Don't worry - I always wake up from this dream right about now.
646,9,31,111,151,1.3245033112582782,0.04749780417759235,551,"Take it literally or seriously - either way, we're sunk."
654,12,25,115,152,1.3223684210526316,0.04992323637165031,551,"Gives you a slight feeling of impending doom, doesn't it?"
654,11,27,114,152,1.3223684210526316,0.049042748231303196,551,It's OK. We've been accepted for kitchen work at Mar-a-Lago.
654,9,31,112,152,1.3223684210526316,0.047232556596034904,551,He thinks everything south of 57th street is on the border with Mexico.
657,6,36,107,149,1.3221476510067114,0.044940309864732325,551,At least we're not without a paddle.
657,12,24,113,149,1.3221476510067114,0.05063397851385358,551,The last view of liberty.
657,12,24,113,149,1.3221476510067114,0.05063397851385358,551,"You know what they say, ""Small hands, yuge wave."""
657,16,16,117,149,1.3221476510067114,0.054097861939361384,551,Time for another 'Miracle on the Hudson'!
657,9,30,110,149,1.3221476510067114,0.04787186663834796,551,They weren't kidding about these new immigration policies making waves.
657,11,26,112,149,1.3221476510067114,0.04973032333068207,551,Who would have thought that global warming had a sense of humor?
657,13,22,114,149,1.3221476510067114,0.05152178667038431,551,#notourwave
657,13,22,114,149,1.3221476510067114,0.05152178667038431,551,That fucking Comey!
657,12,24,113,149,1.3221476510067114,0.05063397851385358,551,The tides have turned.
657,11,26,112,149,1.3221476510067114,0.04973032333068207,551,Don't worry. A wave like this can't possibly win.
657,11,26,112,149,1.3221476510067114,0.04973032333068207,551,"I even made the Wave Great again. Look, I am the Great Wave...OK?"
668,14,20,116,150,1.32,0.052088377831771775,551,"Yeah, but her emails..."
668,4,40,106,150,1.32,0.04264205106483106,551,We're sightseers. Not immigrants.
668,14,20,116,150,1.32,0.052088377831771775,551,I still say it's a toupee.
668,10,28,112,150,1.32,0.04853099288798357,551,Stay away from the hands!
668,6,36,108,150,1.32,0.04469133513603739,551,None of the mainstream forecasts predicted this.
668,12,24,114,150,1.32,0.05034111826250448,551,Look! We made the ocean great again!
668,12,24,114,150,1.32,0.05034111826250448,551,Guard your pussies
668,14,20,116,150,1.32,0.052088377831771775,551,"Give me your glitzy, your rich, your huddled asses yearning to be rich"
668,14,20,116,150,1.32,0.052088377831771775,551,'I had the craziest nightmare! Donald Trump became President and people were trying to escape New York'
677,6,35,106,147,1.3197278911564625,0.045264414932032815,551,"'Tired' is fine, but 'poor' is a deal breaker."
678,13,22,116,151,1.3178807947019868,0.05092596099732736,551,"Ladies, guard your pussies!"
679,10,27,111,148,1.3175675675675675,0.04892403821418605,551,"'Just give me your Eastern European Supermodels"""
679,12,23,113,148,1.3175675675675675,0.05076828578844874,551,do you think he'll send the statue back also ?
679,12,23,113,148,1.3175675675675675,0.05076828578844874,551,Swamp the drain.
679,9,29,110,148,1.3175675675675675,0.047975335869860275,551,And straight ahead we have the terrible tide of bigotry.
679,7,33,108,148,1.3175675675675675,0.04601929513922864,551,"The land of the free, and the home of the wave."
679,13,21,114,148,1.3175675675675675,0.051665728536959984,551,That wave looks like Alec Baldwin
679,10,27,111,148,1.3175675675675675,0.04892403821418605,551,"Not to worry, the undertow is really small."
679,12,23,113,148,1.3175675675675675,0.05076828578844874,551,We're going to need a huger boat.
679,14,19,115,148,1.3175675675675675,0.05254784646978481,551,"Gee, his hands really ARE small."
679,8,31,109,148,1.3175675675675675,0.047007490769755696,551,"What do you know, the hands ARE small!"
679,11,25,112,148,1.3175675675675675,0.04985469063729482,551,"We all remembered to bring our birth certificates, right?"
679,10,27,111,148,1.3175675675675675,0.04892403821418605,551,Brace yourselves! We're about to be swamped by a tiny-handed metaphor with a bad foam-over!
679,12,23,113,148,1.3175675675675675,0.05076828578844874,551,I don't just blow hard—I'm a perfect storm.
679,6,35,107,148,1.3175675675675675,0.04500940859147338,551,Behold--the perfect tweetstorm!
679,9,29,110,148,1.3175675675675675,0.047975335869860275,551,Just admit that it's a foam-over.
679,5,37,106,148,1.3175675675675675,0.04397633680056768,551,Hang on tight! It's the wave of the future.
679,12,23,113,148,1.3175675675675675,0.05076828578844874,551,Who's brilliant idea was it to comb over here?
679,9,29,110,148,1.3175675675675675,0.047975335869860275,551,"Despite what he says, the climate is changing."
679,10,27,111,148,1.3175675675675675,0.04892403821418605,551,"O Large-Handed One, we are Russian billionaires!"
679,11,25,112,148,1.3175675675675675,0.04985469063729482,551,What a blowhard.
679,5,37,106,148,1.3175675675675675,0.04397633680056768,551,"Hold on, we're about to be hit by the orange tide."
679,13,21,114,148,1.3175675675675675,0.051665728536959984,551,"Relax, it's a Weave."
701,9,29,111,149,1.3154362416107384,0.04769990567563531,551,Hair we go!!!
702,9,28,109,146,1.3150684931506849,0.04835843249272996,551,[No Caption Required!]
702,9,28,109,146,1.3150684931506849,0.04835843249272996,551,We're hoping it's not a permanent wave.
702,9,28,109,146,1.3150684931506849,0.04835843249272996,551,"No, it's natural."
702,11,24,111,146,1.3150684931506849,0.050274094877312735,551,It's going to be Yuge!
702,7,32,107,146,1.3150684931506849,0.04636368590367681,551,"You're right, Mavis, they *are* small."
702,9,28,109,146,1.3150684931506849,0.04835843249272996,551,"I'm tired of politics, let's talk about the weather."
702,10,26,110,146,1.3150684931506849,0.049325564410794956,551,"If you just roll with it, you'll be alt right."
702,11,24,111,146,1.3150684931506849,0.050274094877312735,551,He's fit to be tide.
702,10,26,110,146,1.3150684931506849,0.049325564410794956,551,I told you to bring enough supplies for 4 years.
702,7,32,107,146,1.3150684931506849,0.04636368590367681,551,Look! He's distracted by that shapely statue in the harbor. We're saved!
702,10,26,110,146,1.3150684931506849,0.049325564410794956,551,"It's a big wave. The biggest, believe me. It'll crash down so fast your head will spin. Sad."
702,12,22,112,146,1.3150684931506849,0.05120505763127899,551,"""This tsunami started on an escalator in a tacky hotel""."
702,4,38,104,146,1.3150684931506849,0.04319920643606914,551,It's the new administration's welcome to Ellis Island.
702,9,28,109,146,1.3150684931506849,0.04835843249272996,551,Sure it's scary but look at those tiny hands!
702,12,22,112,146,1.3150684931506849,0.05120505763127899,551,It's not those little hands I'm worried about.
702,10,26,110,146,1.3150684931506849,0.049325564410794956,551,"Shutting down Fifth Avenue wasn't enough, eh?"
702,11,24,111,146,1.3150684931506849,0.050274094877312735,551,Is anyone else experiencing a Great Wave of anxiety?
702,10,26,110,146,1.3150684931506849,0.049325564410794956,551,"I can't say the kind of storm this is, but you're all thinking it."
702,11,24,111,146,1.3150684931506849,0.050274094877312735,551,"Welcome to America, our first stop will be your deportation interview."
702,13,20,113,146,1.3150684931506849,0.05211939407084626,551,"Let's take this seriously, but not literally."
702,10,26,110,146,1.3150684931506849,0.049325564410794956,551,"Well, I heard it'll lift all boats."
702,12,22,112,146,1.3150684931506849,0.05120505763127899,551,Anyone know how to part the waters?
702,7,32,107,146,1.3150684931506849,0.04636368590367681,551,But we are deplorables!!!
702,9,28,109,146,1.3150684931506849,0.04835843249272996,551,We were told there would be AMBER waves of GRAIN!
702,7,32,107,146,1.3150684931506849,0.04636368590367681,551,This must be the rogue wave that swept across America in November.
702,9,28,109,146,1.3150684931506849,0.04835843249272996,551,Are you the ghost of America Yet to Come?
702,10,26,110,146,1.3150684931506849,0.049325564410794956,551,10 percent chance the Times said.
702,12,22,112,146,1.3150684931506849,0.05120505763127899,551,"Sorry, no way to make this funny."
702,13,20,113,146,1.3150684931506849,0.05211939407084626,551,Not as scary as his Twitter account.
702,6,34,106,146,1.3150684931506849,0.04533340996754203,551,I was hoping it was all a fake news story.
702,8,30,108,146,1.3150684931506849,0.04737155984200183,551,He'd better keep all his hands off my deck!
733,8,31,111,150,1.3133333333333332,0.04647451652309233,551,I've never seen an orange wave before...
734,7,32,108,147,1.3129251700680271,0.04609706133057938,551,Now I get why the masses huddled.
734,10,26,111,147,1.3129251700680271,0.04903573129526933,551,"Okay, ladies--batten down your hatches!"
734,8,30,109,147,1.3129251700680271,0.047096995906647274,551,"Don't worry, we're from Slovenia."
734,5,36,106,147,1.3129251700680271,0.044029116991873576,551,That big wave behind it looks like Putin!
738,8,29,107,144,1.3125,0.04774311074023794,551,"Don't worry, it is a hoax!"
739,6,33,106,145,1.3103448275862069,0.04539866128306092,551,"Relax, we're from New Jersey!"
739,10,25,110,145,1.3103448275862069,0.0494386509600151,551,"Oh, it's only The Donald making waves again."
739,7,31,107,145,1.3103448275862069,0.04644161804790097,551,Trump wavers on his immigration policy.
739,9,27,109,145,1.3103448275862069,0.04846023904329379,551,The rain of Donald Trump.
739,10,25,110,145,1.3103448275862069,0.0494386509600151,551,"I don't know, let's see what he does"
739,9,27,109,145,1.3103448275862069,0.04846023904329379,551,But we're only going to Staten Island!
739,12,21,112,145,1.3103448275862069,0.05133956651523516,551,I told you we couldn't escape the election results.
739,7,31,107,145,1.3103448275862069,0.04644161804790097,551,I didn't realize my two greatest fears were the same thing
739,11,23,111,145,1.3103448275862069,0.05039807188136495,551,Oh my! It's the dreaded maelstrump!
739,10,25,110,145,1.3103448275862069,0.0494386509600151,551,But we are trying to go back to where we came from... New Jersey.
739,18,9,118,145,1.3103448275862069,0.056660954224672364,551,Is this what they mean by extreme wetting?
739,13,19,113,145,1.3103448275862069,0.052264103652366244,551,It's not too late! Reverse bigly!
739,10,25,110,145,1.3103448275862069,0.0494386509600151,551,Oh swell no.
739,12,21,112,145,1.3103448275862069,0.05133956651523516,551,--Then he made the ocean pay for it!
739,15,15,115,145,1.3103448275862069,0.054065769316743624,551,"""If we can make it here, we'll make it anywhere""!"
739,7,31,107,145,1.3103448275862069,0.04644161804790097,551,"Is it just me, or does that wave have a comb over?"
739,8,29,108,145,1.3103448275862069,0.04746166165991397,551,I told you he was wet behind the ears.
739,8,29,108,145,1.3103448275862069,0.04746166165991397,551,"It's not due to climate change, it's extreme vetting."
739,8,29,108,145,1.3103448275862069,0.04746166165991397,551,The wave of the future?
758,7,30,106,143,1.3076923076923077,0.04679290976306432,551,"Give me your fired, your poorly tanned, your befuddled masses.."
758,10,24,109,143,1.3076923076923077,0.049850331722195045,551,We're going to need a bigger selfie stick.
760,12,20,112,144,1.3055555555555556,0.05147190317079292,551,Talk about thin skinned. All I said was the statue wasn't a 10!
760,13,18,113,144,1.3055555555555556,0.05240688803152291,551,I still don't believe its real.
760,9,26,109,144,1.3055555555555556,0.04855905193316886,551,"It's OK; we're going, not coming."
760,10,24,110,144,1.3055555555555556,0.049549032500880254,551,He thinks we're immigrants.
760,11,22,111,144,1.3055555555555556,0.05051961716896106,551,I'm not going to dignify this cartoon with a caption.
760,11,22,111,144,1.3055555555555556,0.05051961716896106,551,"Small hands, no worries, trust me."
760,11,22,111,144,1.3055555555555556,0.05051961716896106,551,"Wow, it's a Populist Wave, hampered by small hands."
760,9,26,109,144,1.3055555555555556,0.04855905193316886,551,Aim for the mouth.
760,12,20,112,144,1.3055555555555556,0.05147190317079292,551,Hold on to your wallets
760,8,28,108,144,1.3055555555555556,0.047548463987000605,551,No need to panic. We get one of these storms every four years.
770,9,26,110,145,1.303448275862069,0.04826901976688751,551,Looks like a wave of nationalism.
770,7,30,108,145,1.303448275862069,0.046242052160669976,551,"Anyone here tired, hungry or poor?"
772,7,29,106,142,1.3028169014084507,0.04686712581054992,551,It's okay. We're New Yorkers. We're trying to get out of the country.
772,11,21,110,142,1.3028169014084507,0.05095182003824887,551,Is THIS the crime wave they told us about?
772,10,23,109,142,1.3028169014084507,0.049961963976039345,551,"Watch the water, but fear the hands."
772,9,25,108,142,1.3028169014084507,0.048952096211255416,551,They won't have waves like this in Canada.
772,8,27,107,142,1.3028169014084507,0.047920951603750116,551,"Hold on tight, everyone. It's gonna move on us like a bitch."
772,9,25,108,142,1.3028169014084507,0.048952096211255416,551,These new barriers to immigration are YUGE!
772,10,23,109,142,1.3028169014084507,0.049961963976039345,551,It appears that our new President-elect has decided to take immigration matters into his own hands.
772,11,21,110,142,1.3028169014084507,0.05095182003824887,551,"The New Yorker is subverting its own caption contest by providing a cartoon that is, itself, a standalone allegory."
772,10,23,109,142,1.3028169014084507,0.049961963976039345,551,I think it's called a Trumpnami.....
772,5,33,104,142,1.3028169014084507,0.044684977789049216,551,We call it a killer comb over.
772,10,23,109,142,1.3028169014084507,0.049961963976039345,551,This wave trumps them all.
772,8,27,107,142,1.3028169014084507,0.047920951603750116,551,It looks like red tide to me
772,7,29,106,142,1.3028169014084507,0.04686712581054992,551,"Okay! Okay! We'll change it to, ""the land of the free and the home of the wave."""
772,9,25,108,142,1.3028169014084507,0.048952096211255416,551,Do any of you have experience building a wall?
772,7,29,106,142,1.3028169014084507,0.04686712581054992,551,"Mexico isn't paying for this, either."
772,10,23,109,142,1.3028169014084507,0.049961963976039345,551,"All women 19 to 50, below deck immediately!"
772,11,21,110,142,1.3028169014084507,0.05095182003824887,551,I bet the epicenter was in Russia.
772,8,27,107,142,1.3028169014084507,0.047920951603750116,551,"The deluge is going to be huge, believe me!"
772,10,23,109,142,1.3028169014084507,0.049961963976039345,551,"Row faster, it's only 2,000 miles until we reach Cuba!"
772,9,25,108,142,1.3028169014084507,0.048952096211255416,551,Stop tweeting and keep rowing!
772,8,27,107,142,1.3028169014084507,0.047920951603750116,551,"Look alive, ladies! Those aren't waves--they're locker-room hands!"
772,7,29,106,142,1.3028169014084507,0.04686712581054992,551,"Give me your tired, your poor, your huddled masses... gimme, gimme, gimme..."
772,9,25,108,142,1.3028169014084507,0.048952096211255416,551,You guys think we should've just flown to Canada?
772,12,19,111,142,1.3028169014084507,0.051922808919367465,551,"Wow, he really does have small hands!"
772,11,21,110,142,1.3028169014084507,0.05095182003824887,551,"Oh golly, Trump l'oeil!"
772,13,17,112,142,1.3028169014084507,0.05287597003312745,551,I thought El Niño would have bigger hands.
772,11,21,110,142,1.3028169014084507,0.05095182003824887,551,If this isn't proof of climate change I don't know what is.
772,10,23,109,142,1.3028169014084507,0.049961963976039345,551,"Women, prepare to be groped by the tiny, watery hands of the wave of the future."
772,6,31,105,142,1.3028169014084507,0.04578905284972455,551,How'd he get Mexico to pay for that?
772,11,21,110,142,1.3028169014084507,0.05095182003824887,551,See that chick over there? Totally splashed her.
772,7,29,106,142,1.3028169014084507,0.04686712581054992,551,Hang on. By tomorrow it will be just a swamp.
772,9,25,108,142,1.3028169014084507,0.048952096211255416,551,"So much for being tired, poor, and huddled."
772,7,29,106,142,1.3028169014084507,0.04686712581054992,551,This must be the new Trump immigration policy.
772,10,23,109,142,1.3028169014084507,0.049961963976039345,551,Sure has small hands for such a big wave.
772,7,29,106,142,1.3028169014084507,0.04686712581054992,551,The good news is that it'll all be over in a New York minute.
772,11,21,110,142,1.3028169014084507,0.05095182003824887,551,"We're NOT in the same boat, it seems."
772,10,23,109,142,1.3028169014084507,0.049961963976039345,551,Straight ahead is an example of overwhelming hyperbole overstating irony.
772,13,17,112,142,1.3028169014084507,0.05287597003312745,551,Ah! The Great Weave!
810,10,23,110,143,1.3006993006993006,0.04965652242297689,551,"The hair. The small hands. Tell me you don't see it, too."
810,9,25,109,143,1.3006993006993006,0.048654672570104425,551,It's the dreaded American comb-over wave!
810,12,19,112,143,1.3006993006993006,0.05160190240313507,551,Coming into view next is the Mouth of the Hudson.
810,10,23,110,143,1.3006993006993006,0.04965652242297689,551,"Ladies, prepare your flotation chastity devices!"
810,9,25,109,143,1.3006993006993006,0.048654672570104425,551,Whoa! Guess we shouldn't have ignored the hairricane warnings.
815,6,30,105,141,1.297872340425532,0.0458452982644327,551,What did he call us? A ship of what?
815,6,30,105,141,1.297872340425532,0.0458452982644327,551,It did say wail watching - I just thought it was a typo
815,10,22,109,141,1.297872340425532,0.05007054886187757,551,I thought he only claimed to walk on water.
815,7,28,106,141,1.297872340425532,0.046937282575246236,551,"If you're feeling a bit queasy, try focusing on the horizon."
815,7,28,106,141,1.297872340425532,0.046937282575246236,551,"Don't worry, the Times says there's only a 10% chance of it breaking"
815,13,16,112,141,1.297872340425532,0.05301897048331686,551,"Brace yourselves, it's an American en(tidal)ment wave!"
815,7,28,106,141,1.297872340425532,0.046937282575246236,551,"""...And we end our tour with The Big Eastern Border Wave. Careful, ladies... it's a bit 'gropey' today."
815,6,30,105,141,1.297872340425532,0.0458452982644327,551,It's the wave of populism!
815,8,26,107,141,1.297872340425532,0.04800443331758258,551,Yes! It is the BIGGEST wave. It's Y-U-G-E!
815,10,22,109,141,1.297872340425532,0.05007054886187757,551,"Cover your ""wherevers""."
815,13,16,112,141,1.297872340425532,0.05301897048331686,551,Nothing says New York like jazz hands!
815,7,28,106,141,1.297872340425532,0.046937282575246236,551,Making the sea great again?
815,10,22,109,141,1.297872340425532,0.05007054886187757,551,"It's okay, we're white."
815,10,22,109,141,1.297872340425532,0.05007054886187757,551,"The one with the big tits can stay, the rest of you paddle back -you're disgusting!"
829,6,30,106,142,1.295774647887324,0.045569606006042214,551,Keep paddling. The Trump wave of anti-immigrant hysteria is just metaphorical.
829,12,18,112,142,1.295774647887324,0.05172938929417393,551,"Throw out a pussy, that'll distract it!"
829,8,26,108,142,1.295774647887324,0.04771131137665376,551,This too shall pass. Just like the Black Plague.
832,10,21,108,139,1.2949640287769784,0.050493588529071806,551,We were warned about a wave of fascism engulfing our country.
832,12,17,110,139,1.2949640287769784,0.05251791419747967,551,"No worries, it's only El Ninconpoopo"
832,9,23,107,139,1.2949640287769784,0.04945035963456586,551,Don't worry. It's just populist posturing.
832,9,23,107,139,1.2949640287769784,0.04945035963456586,551,Remember: I voted to take the ferry.
832,9,23,107,139,1.2949640287769784,0.04945035963456586,551,"Hold on, our only hope is to ride this one out!"
832,9,23,107,139,1.2949640287769784,0.04945035963456586,551,Oh no. PoseiDon.
832,9,23,107,139,1.2949640287769784,0.04945035963456586,551,"Row faster, Hillary."
832,10,21,108,139,1.2949640287769784,0.050493588529071806,551,Maybe it won't be so bad.
832,9,23,107,139,1.2949640287769784,0.04945035963456586,551,"Send back your immigrants, your tired, your hungry and your poor."
832,8,25,106,139,1.2949640287769784,0.0483846427436701,551,GIVE ME LIBERTY or GIVE ME DEPTH
842,8,25,107,140,1.292857142857143,0.048083975629902284,551,This—this wasn't in the forecast.
842,12,17,111,140,1.292857142857143,0.052183986088188666,551,It's the Trump effect.
842,7,27,106,140,1.292857142857143,0.04700312531585776,551,and to think it just started as a ripple....
842,10,21,109,140,1.292857142857143,0.05017587625756677,551,This wasn't in the forecast.
842,8,25,107,140,1.292857142857143,0.048083975629902284,551,Who has a H-1B temporary fashion model visa handy?
842,7,27,106,140,1.292857142857143,0.04700312531585776,551,He sure makes a big splash for having such tiny hands!
842,9,23,108,140,1.292857142857143,0.049141058548792416,551,Don't worry. Nate Silver said the weather would be fine today.
842,9,23,108,140,1.292857142857143,0.049141058548792416,551,"Let's wait four years, then try again."""
850,10,21,110,141,1.2907801418439717,0.049862025529338536,551,It certainly does take the threat of freak storm to a whole new level.
850,6,29,106,141,1.2907801418439717,0.04561746485189126,551,Even up close his hands are tiny.
852,13,14,111,138,1.289855072463768,0.0536441986395602,551,Look at those small hands!
852,8,24,106,138,1.289855072463768,0.04846408395601442,551,"Go home you tired, you poor, you huddled masses yearning to breathe free."
852,7,26,105,138,1.289855072463768,0.04736011941389737,551,Nothing to worry about. It's just a wave over
852,8,24,106,138,1.289855072463768,0.04846408395601442,551,Global climate change never looked so ugly.
852,10,20,108,138,1.289855072463768,0.05059980710723713,551,He does have little hands!
852,6,28,104,138,1.289855072463768,0.04622979978435579,551,It's going to grab us by the poop deck.
852,10,20,108,138,1.289855072463768,0.05059980710723713,551,We shouldn't have turned right after that nice black guy.
852,9,22,107,138,1.289855072463768,0.049543455233689644,551,Talk about a rogue wave.
852,10,20,108,138,1.289855072463768,0.05059980710723713,551,Don't worry. No one takes him literally.
852,8,24,106,138,1.289855072463768,0.04846408395601442,551,You can't scare us. We are legal immigrants.
862,9,22,108,139,1.2877697841726619,0.049229920380137036,551,Yo! It's time we begin to think outside the boat.
862,6,28,105,139,1.2877697841726619,0.04594335443748851,551,That wave sure looks Bigly
862,7,26,106,139,1.2877697841726619,0.04706438389614813,551,Up close it does look a little worse than the last one
862,12,16,111,139,1.2877697841726619,0.05231040340410853,551,Relax. He's selling water vests.
862,10,20,109,139,1.2877697841726619,0.05027772344875953,551,He never mentioned anything about building a wave!
862,8,24,107,139,1.2877697841726619,0.04815932563978985,551,"They say it's a populist tidal wave, but you can't trust the media."
862,8,24,107,139,1.2877697841726619,0.04815932563978985,551,Intelligence reports tell us--and we can only hope--that this squall is just a lot of hot air.
862,8,24,107,139,1.2877697841726619,0.04815932563978985,551,Get ready for some extreme wetting.
862,8,24,107,139,1.2877697841726619,0.04815932563978985,551,The forecast said threats of Trump l'oeil.
862,9,22,108,139,1.2877697841726619,0.049229920380137036,551,"And ahead, folks there's the new monster in the swamp."
862,5,30,104,139,1.2877697841726619,0.04479427867946288,551,A sea change in America
862,11,18,110,139,1.2877697841726619,0.051304131312646314,551,Now I'm not sure if the nausea is from the sea sickness.
862,9,22,108,139,1.2877697841726619,0.049229920380137036,551,"'And, to our right, Lady Liberty."""
862,8,24,107,139,1.2877697841726619,0.04815932563978985,551,Sosueme!
862,12,16,111,139,1.2877697841726619,0.05231040340410853,551,"""mirar las pequeñas manos!"" (""Look at the tiny hands!"")"
862,9,22,108,139,1.2877697841726619,0.049229920380137036,551,Huddled masses! What were we thinking? Give us your models and billionaires.
862,6,28,105,139,1.2877697841726619,0.04594335443748851,551,The election results continue to wash over New York City.
862,9,22,108,139,1.2877697841726619,0.049229920380137036,551,Maybe it wasn't so bad back home.
880,14,11,111,136,1.286764705882353,0.05513707244365909,551,Fuck.
880,8,23,105,136,1.286764705882353,0.048851837083322476,551,Does anyone know the difference between a typhoon and a tycoon?
880,10,19,107,136,1.286764705882353,0.05103299824782743,551,"Wow, that wave is bigly!"
880,11,17,108,136,1.286764705882353,0.05208934029181399,551,Forget the Lady. I'm in charge now.
880,10,19,107,136,1.286764705882353,0.05103299824782743,551,Let's make the ocean great again !
880,12,15,109,136,1.286764705882353,0.05312468196526013,551,Mexico gets a wall. Manhattan gets a Trum-phoon.
880,7,25,104,136,1.286764705882353,0.04772388840551284,551,Thank goodness it's a populist wave!
880,7,25,104,136,1.286764705882353,0.04772388840551284,551,"Don't worry folks--unless you're poor, a member of the huddled masses, or yearning to be free--he won't hurt you."
880,12,15,109,136,1.286764705882353,0.05312468196526013,551,We've been Trumped!
880,8,23,105,136,1.286764705882353,0.048851837083322476,551,We Should Have Voted
880,11,17,108,136,1.286764705882353,0.05208934029181399,551,Don't worry - it might grab but it won't get you wet.
880,9,21,106,136,1.286764705882353,0.04995432361957391,551,"Quick, huddle into a mass!"
880,13,13,110,136,1.286764705882353,0.05414022807288193,551,"My my, what small hands you have."
880,6,27,103,136,1.286764705882353,0.04656862745098039,551,The tides have changed and they have small hands.
880,9,21,106,136,1.286764705882353,0.04995432361957391,551,"There's got to be a ""little dingy"" joke here somewhere...anyone?"
880,11,17,108,136,1.286764705882353,0.05208934029181399,551,How did we wind up in the New Yorker Capsize Contest?”
880,10,19,107,136,1.286764705882353,0.05103299824782743,551,Hurricane Donald about to make landfall
880,4,31,101,136,1.286764705882353,0.044167546218019944,551,Did we come at a bad time?
880,6,27,103,136,1.286764705882353,0.04656862745098039,551,"It looks really bad, but we are hoping it will just blow over."
880,4,31,101,136,1.286764705882353,0.044167546218019944,551,The crest appears to be receding.
880,12,15,109,136,1.286764705882353,0.05312468196526013,551,"For Gods sake , where's the EZ PASS ?"
880,8,23,105,136,1.286764705882353,0.048851837083322476,551,And so it begins.
880,3,33,100,136,1.286764705882353,0.04291665966786429,551,It's a tso-sue-me!
880,10,19,107,136,1.286764705882353,0.05103299824782743,551,The Old Man-Elect and the Sea
880,11,17,108,136,1.286764705882353,0.05208934029181399,551,Look out...it's the Great Weave!
880,9,21,106,136,1.286764705882353,0.04995432361957391,551,This is the result when you combine the new climate change policy with the new immigration plan.
880,7,25,104,136,1.286764705882353,0.04772388840551284,551,"Okay masses, start huddling!"
880,6,27,103,136,1.286764705882353,0.04656862745098039,551,I thought he was only building a wall!
880,6,27,103,136,1.286764705882353,0.04656862745098039,551,Hold on tight - we might get swamped by a huge metaphor!
880,7,25,104,136,1.286764705882353,0.04772388840551284,551,"If we can make it through there, we'll make it anywhere"
880,10,19,107,136,1.286764705882353,0.05103299824782743,551,Oh no! We're stuck in a hackneyed political cartoon about Donald Trump!
880,9,21,106,136,1.286764705882353,0.04995432361957391,551,Does anyone else smell tic tacs?
880,7,25,104,136,1.286764705882353,0.04772388840551284,551,Who knew coming to America could be so hairy!
880,5,29,102,136,1.286764705882353,0.04538396854390949,551,"Don’t worry, the pundits said don’t take him seriously."
880,8,23,105,136,1.286764705882353,0.048851837083322476,551,All in favor of waiting this out back on the island?
880,9,21,106,136,1.286764705882353,0.04995432361957391,551,It's not the size of the wave that frightens me...it's all of those little hands.
916,8,24,108,140,1.2857142857142858,0.04785825496092456,551,"Well, look who's come to drain the swamp!"
917,4,31,102,137,1.2846715328467153,0.04389390717277673,551,"""Don't worry kids, he moves to D.C. next month""."
917,5,29,103,137,1.2846715328467153,0.04510008086298866,551,"Still, it's heartening to know he lost the popular vote."
917,13,13,111,137,1.2846715328467153,0.053784337399416904,551,¡Muchas manos - todas pequeñas!
917,5,29,103,137,1.2846715328467153,0.04510008086298866,551,"""Do you still think the Circle Line Tour was too expensive?""."
921,8,23,107,138,1.2826086956521738,0.04823021509412167,551,"I will build a seawall, and Atlantis will pay for it."
922,7,24,104,135,1.2814814814814814,0.04778319825611717,551,I hope this isn't some kind of visual metaphor.
922,9,20,106,135,1.2814814814814814,0.05004348783418763,551,Deploy the liberal media!
922,9,20,106,135,1.2814814814814814,0.05004348783418763,551,It's gonna be huge.
922,5,28,102,135,1.2814814814814814,0.04541054279081359,551,This is what you call an Imperfect Storm.
922,12,14,109,135,1.2814814814814814,0.05325434849053283,551,Where's Sully when you need him?
922,5,28,102,135,1.2814814814814814,0.04541054279081359,551,"The tides, they are a-changin'..."
922,4,30,101,135,1.2814814814814814,0.04417645387582359,551,It's called a rogue wave.
922,10,18,107,135,1.2814814814814814,0.051136180871512386,551,"""If we can make it here, we'll make it anywhere""!"
922,10,18,107,135,1.2814814814814814,0.051136180871512386,551,"Abandon ship, Ladies. It's a Donald Wave looming over us for a group grope!"
922,8,22,105,135,1.2814814814814814,0.04892639732390831,551,All of the sudden New Jersey don't seem so bad.
922,9,20,106,135,1.2814814814814814,0.05004348783418763,551,Welcome to Trump's America . we now have an extreme wetting process
922,7,24,104,135,1.2814814814814814,0.04778319825611717,551,"Please Sir, there are no Mexicans or Muslims aboard."
922,7,24,104,135,1.2814814814814814,0.04778319825611717,551,"The big wave grabs your attention, while the little ones ... ."
922,8,22,105,135,1.2814814814814814,0.04892639732390831,551,"Look, that wave is going to gently embrace us and move us forward."
922,8,22,105,135,1.2814814814814814,0.04892639732390831,551,In hindsight we should have seen this coming.
922,7,24,104,135,1.2814814814814814,0.04778319825611717,551,I'm sure it won't be so bad once it hits.
922,10,18,107,135,1.2814814814814814,0.051136180871512386,551,OMG! This is going to be yuuuuge. We may not survive. So sad.
922,3,32,100,135,1.2814814814814814,0.042906884733446046,551,He's mad he lost New York.
922,6,26,103,135,1.2814814814814814,0.04661196966520355,551,It's the uncharted waters we've been hearing about!
922,15,8,112,135,1.2814814814814814,0.056282329302292974,551,Don't worry. He is only dangerous if you smell a Tic Tac.
922,6,26,103,135,1.2814814814814814,0.04661196966520355,551,"No worries, this comb over will blow over. ."
922,11,16,108,135,1.2814814814814814,0.05220600840552333,551,Losers!
922,12,14,109,135,1.2814814814814814,0.05325434849053283,551,Just our luck...he's making the wave great again!
922,10,18,107,135,1.2814814814814814,0.051136180871512386,551,Did he say come-over or comb-over?
922,7,24,104,135,1.2814814814814814,0.04778319825611717,551,"On second thought, the orange water should have been warning enough."
922,8,22,105,135,1.2814814814814814,0.04892639732390831,551,I thought you said we'd be greeted by trumpets!
922,8,22,105,135,1.2814814814814814,0.04892639732390831,551,Maybe we should have taken a train to Canada!
922,5,28,102,135,1.2814814814814814,0.04541054279081359,551,"I know I've said Trump is overexposed, but I'm starting to see him everywhere now."
922,9,20,106,135,1.2814814814814814,0.05004348783418763,551,My god! A hair wave.
922,11,16,108,135,1.2814814814814814,0.05220600840552333,551,Even as a tidal wave he has short fingers.
922,10,18,107,135,1.2814814814814814,0.051136180871512386,551,Avec moi le déluge.
922,9,20,106,135,1.2814814814814814,0.05004348783418763,551,Notice the very small hands.
922,8,22,105,135,1.2814814814814814,0.04892639732390831,551,Now even Neptune is on the take
922,6,26,103,135,1.2814814814814814,0.04661196966520355,551,All we need now is Charlton Heston.
922,4,30,101,135,1.2814814814814814,0.04417645387582359,551,"I think it said, ""Bring me. You're fired, you're poor, you're huddled masses..."""
922,5,28,102,135,1.2814814814814814,0.04541054279081359,551,OMG a #twitterstorm
922,8,22,105,135,1.2814814814814814,0.04892639732390831,551,"Is that a rogue wave, or is the tide really turning?"
922,9,20,106,135,1.2814814814814814,0.05004348783418763,551,"Hey, its not the 20th yet!"
922,6,26,103,135,1.2814814814814814,0.04661196966520355,551,Wave goodbye to freedom
922,8,22,105,135,1.2814814814814814,0.04892639732390831,551,Losers!
922,9,20,106,135,1.2814814814814814,0.05004348783418763,551,We need to wait for this comb-over to blow over.
922,9,20,106,135,1.2814814814814814,0.05004348783418763,551,That's one hell of a permanent wave.
922,9,20,106,135,1.2814814814814814,0.05004348783418763,551,"Merrily, merrily, merrily, merrily -- if only this were a dream."
965,7,24,105,136,1.2794117647058822,0.04747568632471863,551,"""What's this? Wasn't he just going to build a wall?"
965,6,26,104,136,1.2794117647058822,0.04631423463827765,551,But Vladimir sent us!
965,8,22,106,136,1.2794117647058822,0.048609394707985344,551,It's not bad enough he is all over the AIR waves.
965,12,14,110,136,1.2794117647058822,0.052901825123253234,551,Let's give it a chance.
965,9,20,107,136,1.2794117647058822,0.049717257725566,551,"On second thought, let's go back were we came from."
965,4,30,102,136,1.2794117647058822,0.043899241523996296,551,Brace yourself for this next comb over!
965,6,26,104,136,1.2794117647058822,0.04631423463827765,551,"I told you, small hands."
965,7,24,105,136,1.2794117647058822,0.04747568632471863,551,"It's going to be hell AND high water, but we'll get through this."
965,8,22,106,136,1.2794117647058822,0.048609394707985344,551,I was warned about a big bag of wind.
965,7,24,105,136,1.2794117647058822,0.04747568632471863,551,Quick! Throw the Muslims overboard.
965,9,20,107,136,1.2794117647058822,0.049717257725566,551,Brace yourselves for a sea change!
965,6,26,104,136,1.2794117647058822,0.04631423463827765,551,We should have taken the land route to Canada.
965,12,14,110,136,1.2794117647058822,0.052901825123253234,551,Selfie time!
965,11,16,109,136,1.2794117647058822,0.05186203466407415,551,I'd still take this over what's happening on land.
965,8,22,106,136,1.2794117647058822,0.048609394707985344,551,Climate Change
980,4,29,100,133,1.2781954887218046,0.04446254251891293,551,I didn't elect this either but we'll just have to ride it out
980,11,15,107,133,1.2781954887218046,0.05267224936449324,551,"Stop yelling ""all hands on deck""!"
980,11,15,107,133,1.2781954887218046,0.05267224936449324,551,Tiny hands! Lookout!
980,4,29,100,133,1.2781954887218046,0.04446254251891293,551,On your right is the Statue of Liberty. Directly before you is what used to be the United Nations.
980,4,29,100,133,1.2781954887218046,0.04446254251891293,551,It's not as bad as it looks. Right?
980,6,25,102,133,1.2781954887218046,0.04695487216840901,551,"""I guess it's protecting Ellis Island from immigrants, huh?"
980,4,29,100,133,1.2781954887218046,0.04446254251891293,551,It really is huge!
980,10,17,106,133,1.2781954887218046,0.05157949870406471,551,The press are already calling it Trump's Watergate.
980,7,23,103,133,1.2781954887218046,0.04815268618576098,551,I thought he was just going to build the wall.
980,8,21,104,133,1.2781954887218046,0.04932141881026054,551,Let's go back to Syria.
980,8,21,104,133,1.2781954887218046,0.04932141881026054,551,Get down! Deadly comb-over to the starboard.
980,8,21,104,133,1.2781954887218046,0.04932141881026054,551,Abandon ship! Every woman for herself!
980,7,23,103,133,1.2781954887218046,0.04815268618576098,551,Don't worry. It's not a wave. Just a big gust of wind.
980,6,25,102,133,1.2781954887218046,0.04695487216840901,551,I thought storm Donald wasn't due until the 20th!!
980,10,17,106,133,1.2781954887218046,0.05157949870406471,551,"Not worried about the hair, but the big mouth and small hands are scary."
980,8,21,104,133,1.2781954887218046,0.04932141881026054,551,Why do I see a comb-over in everything I look at nowadays?
980,9,19,105,133,1.2781954887218046,0.05046309067040849,551,"On second thought, let's go back."
980,11,15,107,133,1.2781954887218046,0.05267224936449324,551,The President-Elect welcomes you to the United States.
980,5,27,101,133,1.2781954887218046,0.04572569139771301,551,Populist wave!
980,4,29,100,133,1.2781954887218046,0.04446254251891293,551,Merely the storm before the calm.
980,7,23,103,133,1.2781954887218046,0.04815268618576098,551,I guess we underestimated the changing tides again.
980,8,21,104,133,1.2781954887218046,0.04932141881026054,551,Hold on -- it's a great white wail!
980,11,15,107,133,1.2781954887218046,0.05267224936449324,551,Give me your racist and your ill-read masses
980,7,23,103,133,1.2781954887218046,0.04815268618576098,551,And here we have the Great White Wave.
980,8,21,104,133,1.2781954887218046,0.04932141881026054,551,"Give me your tired, your poor....never mind."
980,5,27,101,133,1.2781954887218046,0.04572569139771301,551,It's definitely headed toward Wall Street.
980,11,15,107,133,1.2781954887218046,0.05267224936449324,551,Now over here on your far right is the infamous Trump Twitter Tsunami...
980,10,17,106,133,1.2781954887218046,0.05157949870406471,551,And here we have a striking example of Trump l'oeil.
980,7,23,103,133,1.2781954887218046,0.04815268618576098,551,Is this what they mean by climate change?
980,10,17,106,133,1.2781954887218046,0.05157949870406471,551,"It won't hit us, I voted for it."
980,3,31,99,133,1.2781954887218046,0.043162443405041315,551,"Look on the bright side, he said he'd make surfing great again."
980,6,25,102,133,1.2781954887218046,0.04695487216840901,551,But we're immigrants from New Jersey.
980,7,23,103,133,1.2781954887218046,0.04815268618576098,551,Look out...it's the Great Weave!
980,10,17,106,133,1.2781954887218046,0.05157949870406471,551,"'I thought Trump said, ""...a wall.""'"
980,9,19,105,133,1.2781954887218046,0.05046309067040849,551,It's the rogue wave. Protect your privates.
980,8,21,104,133,1.2781954887218046,0.04932141881026054,551,You should have seen what all those hands did to Lady Liberty last November.
980,9,19,105,133,1.2781954887218046,0.05046309067040849,551,We should have acted sooner when when we saw the water turned orange.
980,10,17,106,133,1.2781954887218046,0.05157949870406471,551,Don't worry. He lies like a rug.
980,5,27,101,133,1.2781954887218046,0.04572569139771301,551,"Yes, I know folks, we have to thank our best experts for not seeing this one coming."
980,9,19,105,133,1.2781954887218046,0.05046309067040849,551,"Small hands, but a big under tow"
980,12,13,108,133,1.2781954887218046,0.05374278574532682,551,Does everything in this town have a comb-over?
980,9,19,105,133,1.2781954887218046,0.05046309067040849,551,Please tell me we're all in the same nightmare.
980,10,17,106,133,1.2781954887218046,0.05157949870406471,551,"I thought this was about ""huddled masses"", not ""muddled asses""."
980,6,25,102,133,1.2781954887218046,0.04695487216840901,551,Don't panic. Small hands. All tweet ... no threat.
980,8,21,104,133,1.2781954887218046,0.04932141881026054,551,"But we're tired, we're poor!"
980,11,15,107,133,1.2781954887218046,0.05267224936449324,551,Looks like we're going to need a bigger boat.
980,8,21,104,133,1.2781954887218046,0.04932141881026054,551,Hang on tight! We've got four years of this.
980,6,25,102,133,1.2781954887218046,0.04695487216840901,551,Argh! They warned us Trump was the wave of the future.
980,6,25,102,133,1.2781954887218046,0.04695487216840901,551,"I thought it was, 'give me liberty OR give me death.'"
980,6,25,102,133,1.2781954887218046,0.04695487216840901,551,Why'd he sink the ferry? He carried Staten Island!
980,7,23,103,133,1.2781954887218046,0.04815268618576098,551,Just riding the weave...
980,5,27,101,133,1.2781954887218046,0.04572569139771301,551,Just keep the bow pointed into the tantrum!
980,4,29,100,133,1.2781954887218046,0.04446254251891293,551,Don't worry folks. This tweet storm shall pass soon.
980,4,29,100,133,1.2781954887218046,0.04446254251891293,551,I thought he said he was going to drain the swamp.
980,8,21,104,133,1.2781954887218046,0.04932141881026054,551,I think we're gonna need a bigger boat...
1035,8,21,105,134,1.2761194029850746,0.0489959690957387,551,Stow the oars and ready the hairspray!
1035,8,21,105,134,1.2761194029850746,0.0489959690957387,551,"Don't worry, it'll blow itself out in two years!"
1035,8,21,105,134,1.2761194029850746,0.0489959690957387,551,"Wow, so this is what they mean by 'life imitating art'."
1035,11,15,108,134,1.2761194029850746,0.052318902315823916,551,A wave with a comb-over . . . only in America.
1035,8,21,105,134,1.2761194029850746,0.0489959690957387,551,I will build a seawall...You will pay
1035,7,23,104,134,1.2761194029850746,0.04783705819755782,551,"When you’re a wave, they let you do it. You can do anything."
1035,10,17,107,134,1.2761194029850746,0.05123520946476824,551,The Hugely Imperfect Storm
1035,8,21,105,134,1.2761194029850746,0.0489959690957387,551,Entitled wave!
1035,8,21,105,134,1.2761194029850746,0.0489959690957387,551,He's more scared of us than we are of him.
1044,9,19,107,135,1.2740740740740741,0.04979741116928703,551,Guard your booty!
1044,8,21,106,135,1.2740740740740741,0.04867467349299314,551,"If you think this looks scary, you should read his twitter."
1046,7,22,103,132,1.2727272727272727,0.04820501015253788,551,Should we take this literally or seriously?
1046,9,18,105,132,1.2727272727272727,0.050547441535790355,551,Let's bail.
1046,10,16,106,132,1.2727272727272727,0.05167885705796982,551,"Watch your pockets, people!"
1046,8,20,104,132,1.2727272727272727,0.04939011464665993,551,"Hair today, gone tomorrow."
1046,8,20,104,132,1.2727272727272727,0.04939011464665993,551,Claims he's got the whole world in his hands.
1046,8,20,104,132,1.2727272727272727,0.04939011464665993,551,That wave is yuuuuuge.
1046,4,28,100,132,1.2727272727272727,0.04446056388300178,551,"First the wall, now this?"
1046,7,22,103,132,1.2727272727272727,0.04820501015253788,551,We were just leaving!
1046,7,22,103,132,1.2727272727272727,0.04820501015253788,551,Tropical depression? Just one more stage to acceptance.
1046,8,20,104,132,1.2727272727272727,0.04939011464665993,551,We're going to need a huger boat.
1046,10,16,106,132,1.2727272727272727,0.05167885705796982,551,We are the ghosts of immigrants past.
1046,5,26,101,132,1.2727272727272727,0.04574278261975778,551,Hold on tight. We're entering the mouth of the Donald.
1046,7,22,103,132,1.2727272727272727,0.04820501015253788,551,There must be an easier way to get to Jersey.
1046,6,24,102,132,1.2727272727272727,0.04699002641840444,551,Wow. I wasn’t taking ’a sea change’ so literally.
1046,9,18,105,132,1.2727272727272727,0.050547441535790355,551,i think the small hands make it less intimidating...
1046,4,28,100,132,1.2727272727272727,0.04446056388300178,551,"Ok, ok it was a landslide, not a tsunami!"
1046,9,18,105,132,1.2727272727272727,0.050547441535790355,551,Drain the harbor!
1046,10,16,106,132,1.2727272727272727,0.05167885705796982,551,"Wow, an orange tsunami!"
1046,7,22,103,132,1.2727272727272727,0.04820501015253788,551,"I said we're from East Palestine, OHIO!"
1046,7,22,103,132,1.2727272727272727,0.04820501015253788,551,It's the new welcome mat for immigrants.
1046,5,26,101,132,1.2727272727272727,0.04574278261975778,551,I thought you said he was building a wall.
1046,6,24,102,132,1.2727272727272727,0.04699002641840444,551,"Holy guacamole, I didn't know he was going to build a wave, too."
1046,6,24,102,132,1.2727272727272727,0.04699002641840444,551,"You are supposed to build a wall, not a breakwater!"
1046,9,18,105,132,1.2727272727272727,0.050547441535790355,551,It Came from Queens
1046,10,16,106,132,1.2727272727272727,0.05167885705796982,551,It's a sue-nami!
1046,8,20,104,132,1.2727272727272727,0.04939011464665993,551,The wave is huge . . . but look at those tiny hands!
1046,9,18,105,132,1.2727272727272727,0.050547441535790355,551,Did we bring enough supplies to last us four years?
1046,6,24,102,132,1.2727272727272727,0.04699002641840444,551,We'll be ok if we can just stay away from the little groping hands.
1046,9,18,105,132,1.2727272727272727,0.050547441535790355,551,Who is going to pay for the wave?
1046,5,26,101,132,1.2727272727272727,0.04574278261975778,551,"Oh thanks, we know, we were actually just leaving."
1046,7,22,103,132,1.2727272727272727,0.04820501015253788,551,"I don't care what she says, go back!"
1046,10,16,106,132,1.2727272727272727,0.05167885705796982,551,He acts like he won the popular vote.
1046,8,20,104,132,1.2727272727272727,0.04939011464665993,551,Let's go back and try the wall again.
1046,9,18,105,132,1.2727272727272727,0.050547441535790355,551,"""Here be orange-haired dragons""."
1046,4,28,100,132,1.2727272727272727,0.04446056388300178,551,You women in the boat??? --Careful!-- this one's a grabber!
1046,4,28,100,132,1.2727272727272727,0.04446056388300178,551,"It's true, Trump towers!"
1046,9,18,105,132,1.2727272727272727,0.050547441535790355,551,I think we should just let it crash into us and see what happens.
1046,10,16,106,132,1.2727272727272727,0.05167885705796982,551,"Every man for himself! And, ladies, guard your vaginas!"
1046,7,22,103,132,1.2727272727272727,0.04820501015253788,551,"If you're legal, relax."
1046,6,24,102,132,1.2727272727272727,0.04699002641840444,551,"We better turn back, gang. This storm's gonna be Yuuuuge!"
1046,11,14,107,132,1.2727272727272727,0.052786027391934026,551,I thought he moved to Washington
1046,8,20,104,132,1.2727272727272727,0.04939011464665993,551,"Well, maybe not Australia but how hard can it be to row to Canada?"
1046,9,18,105,132,1.2727272727272727,0.050547441535790355,551,"So many tiny hands! Quick, everybody - cover your privates! You too, Miss Liberty!"
1046,10,16,106,132,1.2727272727272727,0.05167885705796982,551,"Oh no, a rogue comb-over, we're doomed !"
1046,6,24,102,132,1.2727272727272727,0.04699002641840444,551,But they're Russian refugees!
1046,8,20,104,132,1.2727272727272727,0.04939011464665993,551,I never trusted the popular boat.
1046,7,22,103,132,1.2727272727272727,0.04820501015253788,551,Comb! Who's got the comb!?
1046,8,20,104,132,1.2727272727272727,0.04939011464665993,551,The president is up early today.
1046,7,22,103,132,1.2727272727272727,0.04820501015253788,551,"OK, we're leaving, we're leaving!"
1046,8,20,104,132,1.2727272727272727,0.04939011464665993,551,YOU did not vote for me ! SO SAD...
1096,7,22,104,133,1.2706766917293233,0.047885119642438766,551,Cover up ladies.
1096,8,20,105,133,1.2706766917293233,0.04906022675980432,551,I guess we know how Hillary felt on election night.
1096,7,22,104,133,1.2706766917293233,0.047885119642438766,551,"You hired us, remember!?"
1096,7,22,104,133,1.2706766917293233,0.047885119642438766,551,I get the feeling immigrants are not really welcome in this country any more.
1096,10,16,107,133,1.2706766917293233,0.051329798195871676,551,Hairicane Donnie nears the coast.
1096,6,24,103,133,1.2706766917293233,0.046680440407283315,551,This still beats what's happening on land.
1096,7,22,104,133,1.2706766917293233,0.047885119642438766,551,Going with the flow just got a lot more difficult.
1096,8,20,105,133,1.2706766917293233,0.04906022675980432,551,"Ladies, get ready to be groped."
1096,6,24,103,133,1.2706766917293233,0.046680440407283315,551,"Look, our first celebrity sighting!"
1096,10,16,107,133,1.2706766917293233,0.051329798195871676,551,Somehow it's always the comb-over in the wind that's the scariest.
1096,9,18,106,133,1.2706766917293233,0.050207838195606126,551,"Feeling a bit more tired, poor, homeless, huddled, and tempest-tossed than usual these days."
1096,6,24,103,133,1.2706766917293233,0.046680440407283315,551,What's the likelihood of us getting a bailout?
1096,12,12,109,133,1.2706766917293233,0.05350318229726529,551,Wave goodby!
1096,8,20,105,133,1.2706766917293233,0.04906022675980432,551,Please fasten your chastity belts
1096,8,20,105,133,1.2706766917293233,0.04906022675980432,551,"Ladies and gentlemen, not to worry. This is how he always looks after seeing one of Alec Baldwins SNL skits!"
1096,6,24,103,133,1.2706766917293233,0.046680440407283315,551,Try to avoid the tiny hands!
1112,7,21,102,130,1.2692307692307692,0.04857966124826323,551,This is not the time to lean too far Left or Right.
1112,6,23,101,130,1.2692307692307692,0.047336274701534606,551,I told you we should have waited until xenophobia was at low tide.
1112,10,15,105,130,1.2692307692307692,0.052132190056879434,551,Don't blame me - I voted for Hillary!
1112,9,17,104,130,1.2692307692307692,0.050975529970268434,551,Cover your p_ _ _ys!
1112,5,25,100,130,1.2692307692307692,0.04605933475683601,551,"See, ladies and gentlemen, we call this a wave over, a beautiful wave over."
1112,4,27,99,130,1.2692307692307692,0.04474596891190779,551,Brace for heavy petting.
1112,9,17,104,130,1.2692307692307692,0.050975529970268434,551,"This one, he got Dali to pay for."
1112,6,23,101,130,1.2692307692307692,0.047336274701534606,551,It's OK. He's making us great again.
1112,10,15,105,130,1.2692307692307692,0.052132190056879434,551,It's part of the new anti immigration policy.
1112,10,15,105,130,1.2692307692307692,0.052132190056879434,551,At least it's not Hilary!
1112,10,15,105,130,1.2692307692307692,0.052132190056879434,551,"Sorry, Pussy's on the next boat"
1112,5,25,100,130,1.2692307692307692,0.04605933475683601,551,Don't fret folks. He's assured us climate change is nothing to worry about.
1112,11,13,106,130,1.2692307692307692,0.053263738363951346,551,Here at our sea-washed gates stands A mighty blowhard with tiny hands.
1112,8,19,103,130,1.2692307692307692,0.04979200810745508,551,"Last stop on the Victory Tour, folks."
1112,9,17,104,130,1.2692307692307692,0.050975529970268434,551,"Sure, the wave of anti-immigrant sentiment is huge, but look how tiny its hands are."
1112,5,25,100,130,1.2692307692307692,0.04605933475683601,551,Who knew he also built a wall of water!
1112,10,15,105,130,1.2692307692307692,0.052132190056879434,551,It's a real pussy-grabber
1112,13,9,108,130,1.2692307692307692,0.055457614384836186,551,Snap a picture !
1112,6,23,101,130,1.2692307692307692,0.047336274701534606,551,....and no trip to New York would be complete without a sighting of the President Elect.
1112,6,23,101,130,1.2692307692307692,0.047336274701534606,551,"Small hands, big toupee."
1112,8,19,103,130,1.2692307692307692,0.04979200810745508,551,They said he would have turned back Noah's Ark.
1112,5,25,100,130,1.2692307692307692,0.04605933475683601,551,Any chance that one of you lovely ladies is a virgin?
1112,8,19,103,130,1.2692307692307692,0.04979200810745508,551,Is that a toupee?
1112,8,19,103,130,1.2692307692307692,0.04979200810745508,551,Look at all those little hands !
1112,10,15,105,130,1.2692307692307692,0.052132190056879434,551,Anyone else see another opportunity for the New Yorker to take a dig at Trump?
1112,8,19,103,130,1.2692307692307692,0.04979200810745508,551,That thing can drown our hopes and dreams..hang on!
1112,9,17,104,130,1.2692307692307692,0.050975529970268434,551,I'm fired? That's all you've got?
1112,11,13,106,130,1.2692307692307692,0.053263738363951346,551,Nobody panic! Fivethirtyeight still has Hillary up by three.
1112,10,15,105,130,1.2692307692307692,0.052132190056879434,551,Look at those tiny hands!
1141,8,20,106,134,1.2686567164179106,0.04873460969450579,551,America has the best waves. No waves are better.
1141,10,16,108,134,1.2686567164179106,0.05098533007977798,551,"Now we want only your rested, your rich, your comfortable elite yearning to breathe free."
1141,10,16,108,134,1.2686567164179106,0.05098533007977798,551,"I thought a fence to keep out immigrants was ridiculous, but this is too much!"
1141,6,24,104,134,1.2686567164179106,0.04637478281143451,551,So this is what he meant by extreme wetting.
1141,3,30,101,134,1.2686567164179106,0.04259058497961232,551,What do you expect? It's Jersey.
1146,8,19,104,131,1.2671755725190839,0.049453178364709964,551,I lift my lamp beside the golden boor.
1146,4,27,100,131,1.2671755725190839,0.04445061981555055,551,Hold on tight! We're about to be in for a Trumpy ride!
1148,10,16,109,135,1.2666666666666666,0.05064536516517782,551,We're entering an oxymoron.
1149,4,26,99,129,1.2635658914728682,0.044731352277456546,551,"Sure it looks bad, but let's give it a chance."
1149,7,20,102,129,1.2635658914728682,0.04862371817943557,551,See? This is why I stopped coming to Staten Island.
1149,4,26,99,129,1.2635658914728682,0.044731352277456546,551,"Sorry guys, I guess he built a 'sea wall,' too."
1149,9,16,104,129,1.2635658914728682,0.051054030512866236,551,"Hold on everyone, lets give the tsunami a chance."
1149,9,16,104,129,1.2635658914728682,0.051054030512866236,551,"Like I told you, America welcomes refugees with open arms."
1149,6,22,101,129,1.2635658914728682,0.047361819418023005,551,Ignore the sound and fury but watch out for its hands.
1149,5,24,100,129,1.2635658914728682,0.046065365596917485,551,"First Putin, now Poseidon!?"
1149,7,20,102,129,1.2635658914728682,0.04862371817943557,551,"No no, we're LEAVING.....and you can keep our jobs."
1149,8,18,103,129,1.2635658914728682,0.0498536859279324,551,I wish he really had drained the swamp.
1149,5,24,100,129,1.2635658914728682,0.046065365596917485,551,Wake me when it's over.
1149,7,20,102,129,1.2635658914728682,0.04862371817943557,551,America 2017: The New Wave
1149,6,22,101,129,1.2635658914728682,0.047361819418023005,551,It's one of those New York swells I read about!
1149,7,20,102,129,1.2635658914728682,0.04862371817943557,551,Go home! Pay no attention to that woman across the water! The Great Comb-Over has spoken!
1149,9,16,104,129,1.2635658914728682,0.051054030512866236,551,Forget about free. In a couple of seconds we're gonna be yearning just to breathe.
1149,8,18,103,129,1.2635658914728682,0.0498536859279324,551,Wow! A tidal wave from a shitstorm.
1149,6,22,101,129,1.2635658914728682,0.047361819418023005,551,Here we go with the extreme vetting
1149,9,16,104,129,1.2635658914728682,0.051054030512866236,551,Don't let its small whitewater hands deceive you. This wave is unpresidented.
1149,8,18,103,129,1.2635658914728682,0.0498536859279324,551,Donnie Tsunami
1149,10,14,105,129,1.2635658914728682,0.05222679448919327,551,"""So this is 'extreme vetting'!"
1149,8,18,103,129,1.2635658914728682,0.0498536859279324,551,"POTUS, float us!"
1149,7,20,102,129,1.2635658914728682,0.04862371817943557,551,I never thought I would be drowned by a comb over.
1149,9,16,104,129,1.2635658914728682,0.051054030512866236,551,"No, Canada is the other way."
1149,6,22,101,129,1.2635658914728682,0.047361819418023005,551,"Give me your fears, your prejudices and your huddled minds..."
1149,6,22,101,129,1.2635658914728682,0.047361819418023005,551,I think we should have taken the Circle Line
1149,7,20,102,129,1.2635658914728682,0.04862371817943557,551,Hang on. Let's give this wave a chance.
1149,11,12,106,129,1.2635658914728682,0.053373795945427946,551,"I knew they were small, but why so many?"
1149,9,16,104,129,1.2635658914728682,0.051054030512866236,551,Oh no! it's the great weave!!
1149,7,20,102,129,1.2635658914728682,0.04862371817943557,551,"No, give ME your tired, your poor, your hungry..."
1149,7,20,102,129,1.2635658914728682,0.04862371817943557,551,"What an unpresidented, bigly wave!"
1178,5,24,101,130,1.2615384615384615,0.04575458392739736,551,Hold on tight. Huuge climate change straight ahead!
1178,7,20,103,130,1.2615384615384615,0.04829081816580638,551,Something is telling me this isn't going to end well.
1178,9,16,105,130,1.2615384615384615,0.050700338143613036,551,It's been doing this ever since we took Trump Tower off the guided tour.
1181,8,17,102,127,1.2598425196850394,0.050261904269257536,551,"Wow, the little hands, too."
1181,6,21,100,127,1.2598425196850394,0.04771048382553092,551,Who knew waves could be orange?
1181,7,19,101,127,1.2598425196850394,0.04900280240781264,551,Hold tight as we enter the mouth of lies.
1181,6,21,100,127,1.2598425196850394,0.04771048382553092,551,"Don't be afraid, he just wants to make us great again!"
1181,9,15,103,127,1.2598425196850394,0.05149022623493599,551,Quick! Drop the anchor babies!
1181,5,23,99,127,1.2598425196850394,0.04638217211292898,551,It's the populist wave that was rejected by New York.
1181,7,19,101,127,1.2598425196850394,0.04900280240781264,551,"So, is that the wretched refuse of their teeming shore?"
1181,6,21,100,127,1.2598425196850394,0.04771048382553092,551,9/11 a liberty threat; 11/9 a comb-over regret.
1181,7,19,101,127,1.2598425196850394,0.04900280240781264,551,This wave is not 'unpresidented'...
1181,6,21,100,127,1.2598425196850394,0.04771048382553092,551,"I've decided to take him literarily, but not seriously."
1181,3,27,97,127,1.2598425196850394,0.04360432473972742,551,It's called the new wave of politics.
1181,6,21,100,127,1.2598425196850394,0.04771048382553092,551,Trump-nami!
1181,6,21,100,127,1.2598425196850394,0.04771048382553092,551,Is this what they meant by Trumped up trickle down?
1181,7,19,101,127,1.2598425196850394,0.04900280240781264,551,Welcome to 2017!
1181,6,21,100,127,1.2598425196850394,0.04771048382553092,551,What little hands for such a bigly wave!
1181,7,19,101,127,1.2598425196850394,0.04900280240781264,551,"Ha, ha! We all know not to take him seriously! Don't we..........................."
1181,5,23,99,127,1.2598425196850394,0.04638217211292898,551,'According to the polls there's no way the trump wave will crash into us...I'm sure we'll be just fine'
1181,7,19,101,127,1.2598425196850394,0.04900280240781264,551,"Man, that wave is yuge."
1181,7,19,101,127,1.2598425196850394,0.04900280240781264,551,Looks like getting out of the US will be as hard as getting in from now on.
1181,9,15,103,127,1.2598425196850394,0.05149022623493599,551,"That hair looks all too familiar. Ladies, cover your laps."
1181,9,15,103,127,1.2598425196850394,0.05149022623493599,551,"Tremendous wave, tiny hands - It's the Tsunami-Elect!"
1181,9,15,103,127,1.2598425196850394,0.05149022623493599,551,It is that orange hair monster with small hands. Speaking Russian.
1181,5,23,99,127,1.2598425196850394,0.04638217211292898,551,Did we decide on Canada or Cuba?
1181,7,19,101,127,1.2598425196850394,0.04900280240781264,551,"Just remember, it's more afraid of you than you are of it."
1181,7,19,101,127,1.2598425196850394,0.04900280240781264,551,I guess we'll have to yearn to breathe free someplace else.
1181,7,19,101,127,1.2598425196850394,0.04900280240781264,551,"Hurry, huddle your masses!"
1181,11,11,105,127,1.2598425196850394,0.05386290144088649,551,Wave goodbye everybody!
1181,5,23,99,127,1.2598425196850394,0.04638217211292898,551,I still think we should have waited for Christie to reopen the George Washington Bridge!
1181,6,21,100,127,1.2598425196850394,0.04771048382553092,551,so this is how Hillary felt during the compaign.
1181,4,25,98,127,1.2598425196850394,0.04501468108251446,551,"California, here we come!"
1181,4,25,98,127,1.2598425196850394,0.04501468108251446,551,I didn't think it would be a water wall.
1181,9,15,103,127,1.2598425196850394,0.05149022623493599,551,I lift my lamp beside the golden boor.
1181,3,27,97,127,1.2598425196850394,0.04360432473972742,551,On your right is the Statue of Liberty.
1181,6,21,100,127,1.2598425196850394,0.04771048382553092,551,What changed? We're huddled and yearning.
1181,6,21,100,127,1.2598425196850394,0.04771048382553092,551,They call it El Blanco.
1181,9,15,103,127,1.2598425196850394,0.05149022623493599,551,What's that tweeting noise?
1181,11,11,105,127,1.2598425196850394,0.05386290144088649,551,Make salt water great again!
1181,4,25,98,127,1.2598425196850394,0.04501468108251446,551,"It's ""give me your masses"" not misses."
1181,8,17,102,127,1.2598425196850394,0.050261904269257536,551,Steady now. He alone will save us.
1181,7,19,101,127,1.2598425196850394,0.04900280240781264,551,He made the wave great again.
1181,7,19,101,127,1.2598425196850394,0.04900280240781264,551,Are we sure Canada is full?
1181,8,17,102,127,1.2598425196850394,0.050261904269257536,551,It was the perfect storm.
1181,3,27,97,127,1.2598425196850394,0.04360432473972742,551,Let's just wait and see if he's all talk.
1181,8,17,102,127,1.2598425196850394,0.050261904269257536,551,Was he saying vetting or wetting?
1181,10,13,104,127,1.2598425196850394,0.05268992099707278,551,I'm scared. Let's row back to Syria.
1181,8,17,102,127,1.2598425196850394,0.050261904269257536,551,He's trying to brand the ocean!
1227,6,21,101,128,1.2578125,0.04737978694937442,551,Anyone here named Hilary?
1227,9,15,104,128,1.2578125,0.05112669263268539,551,No worries. Some scientists say that is a small wave and this is a big boat. Believe me.
1227,7,19,102,128,1.2578125,0.048660823127348575,551,Here we have our new face of government
1227,7,19,102,128,1.2578125,0.048660823127348575,551,Tiny hands. We know what that means.
1227,4,25,99,128,1.2578125,0.04470773109029495,551,I think it's another Chinese hoax.
1227,7,19,102,128,1.2578125,0.048660823127348575,551,"Don't worry, Lady Liberty has weathered more than this..."
1227,8,17,103,128,1.2578125,0.049908989205293415,551,REVERSE! We need to rethink this!
1234,6,21,102,129,1.255813953488372,0.047053529233251866,551,Brace yourselves: Angry white squall!
1234,9,15,105,129,1.255813953488372,0.0507681662691075,551,"So we beat on, boats against the current, borne back ceaselessly into the past. Sad!"
1234,10,13,106,129,1.255813953488372,0.051947384316589955,551,Hold on. I need to tweet about this!
1234,8,17,104,129,1.255813953488372,0.04956089865327294,551,We're getting mixed messages here.
1238,7,18,101,126,1.253968253968254,0.04903708727530064,551,"Huddle up, things are about to get hairy."
1238,8,16,102,126,1.253968253968254,0.05031520699976876,551,"See, I told you he was all wet."
1238,5,22,99,126,1.253968253968254,0.04637529163765117,551,I saw the exact same wave in West Palm Beach!
1238,6,20,100,126,1.253968253968254,0.04772475040753304,551,Beware the Trumpnami!
1238,11,10,105,126,1.253968253968254,0.053968253968253964,551,"That hair...Oh my God, it's him!"
1238,5,22,99,126,1.253968253968254,0.04637529163765117,551,"Now, do you believe in climate change?"
1238,5,22,99,126,1.253968253968254,0.04637529163765117,551,"Wave back, everyone!"
1238,6,20,100,126,1.253968253968254,0.04772475040753304,551,We thought it was fake news!
1238,6,20,100,126,1.253968253968254,0.04772475040753304,551,A wall of water? This guy is serious.
1238,11,10,105,126,1.253968253968254,0.053968253968253964,551,I thought the wall was in Texas.
1238,1,30,95,126,1.253968253968254,0.040530620110487955,551,This'll be great. Just wait and see.
1238,7,18,101,126,1.253968253968254,0.04903708727530064,551,Don't worry - he can't win.
1238,7,18,101,126,1.253968253968254,0.04903708727530064,551,Onward! It's just an old rug on an oil slick.
1238,6,20,100,126,1.253968253968254,0.04772475040753304,551,Avoid eye contact.
1238,7,18,101,126,1.253968253968254,0.04903708727530064,551,We'll be back in four years.
1238,6,20,100,126,1.253968253968254,0.04772475040753304,551,"Don't worry, it's just another Chinese hoax."
1238,10,12,104,126,1.253968253968254,0.0527786728650677,551,"Big,BIG hands!!!"
1238,6,20,100,126,1.253968253968254,0.04772475040753304,551,Passports?
1238,6,20,100,126,1.253968253968254,0.04772475040753304,551,Land of the free-for-all
1238,5,22,99,126,1.253968253968254,0.04637529163765117,551,Hang on -- it looks like the dreaded Orange Tide is headed our way.
1238,9,14,103,126,1.253968253968254,0.05156165418616539,551,Come on--let's give it a chance!
1238,9,14,103,126,1.253968253968254,0.05156165418616539,551,This wave is bigly….REAL bigly!
1238,3,26,97,126,1.253968253968254,0.04355111273560004,551,We're not going back unless we get a really good deal!
1238,9,14,103,126,1.253968253968254,0.05156165418616539,551,"Gimme, you muddled asses!"
1238,6,20,100,126,1.253968253968254,0.04772475040753304,551,"Uh, oh! I think this is what they meant by ""extreme vetting."""
1238,6,20,100,126,1.253968253968254,0.04772475040753304,551,Try to look beyond the obvious.
1238,9,14,103,126,1.253968253968254,0.05156165418616539,551,It's true. He does have small hands.
1238,7,18,101,126,1.253968253968254,0.04903708727530064,551,And this concludes the optimists' rowing club tour.
1238,9,14,103,126,1.253968253968254,0.05156165418616539,551,Such tiny hands!
1238,6,20,100,126,1.253968253968254,0.04772475040753304,551,This area is famous for its yuge and terrifying weaves!
1238,4,24,98,126,1.253968253968254,0.04498537037185613,551,It's the wave of the future.
1238,7,18,101,126,1.253968253968254,0.04903708727530064,551,The last Thanksgiving.
1238,7,18,101,126,1.253968253968254,0.04903708727530064,551,What do we have to lose?
1238,10,12,104,126,1.253968253968254,0.0527786728650677,551,You're angry? We're heading for Canada.
1238,6,20,100,126,1.253968253968254,0.04772475040753304,551,That can't be real foam!
1238,6,20,100,126,1.253968253968254,0.04772475040753304,551,"Wow, the bluster has turned gale-force."
1238,6,20,100,126,1.253968253968254,0.04772475040753304,551,"Small hands, but Great Wave!"
1238,6,20,100,126,1.253968253968254,0.04772475040753304,551,Oh my god it's the dread Trump Tidal Hair!
1238,7,18,101,126,1.253968253968254,0.04903708727530064,551,"Alright, we've got seven people and five lifejackets. Will all climate change deniers please raise your hands."
1238,6,20,100,126,1.253968253968254,0.04772475040753304,551,Grab 'em by the dingey.
1238,8,16,102,126,1.253968253968254,0.05031520699976876,551,The other ninety percent of it is hidden under water.
1279,13,6,108,127,1.2519685039370079,0.05586298334328808,551,Nothing funny about this!
1279,7,18,102,127,1.2519685039370079,0.048690519059619776,551,Heeeere's Donnie!
1279,7,18,102,127,1.2519685039370079,0.048690519059619776,551,Keep ajar the golden door oh mighty molded pompadour.
1279,7,18,102,127,1.2519685039370079,0.048690519059619776,551,Looks like Orange is the new Blue.
1279,8,16,103,127,1.2519685039370079,0.04995749216331898,551,"...and if you look to your right, you'll see Lady Liberty..."
1279,6,20,101,127,1.2519685039370079,0.047389685263170035,551,The sea was very grabby that day.
1279,8,16,103,127,1.2519685039370079,0.04995749216331898,551,"Oh no, it's a Trumpnami !"""
1286,8,15,101,124,1.25,0.050729015290999296,551,"Okay ladies, guard your pu$$ies!"
1286,4,23,97,124,1.25,0.04526490492808352,551,"Remember to take it seriously, not literally"
1286,5,21,98,124,1.25,0.04669091947809488,551,This must be the tidal wave that struck America.
1286,5,21,98,124,1.25,0.04669091947809488,551,"Uh-oh, let's catch the next wave."
1286,7,17,100,124,1.25,0.04941965852606572,551,Yoo-hoo...huddled masses! Pay no attention to the man behind the wave!
1286,6,19,99,124,1.25,0.04807465345971242,551,"Here comes the latest threat to our life, liberty and the pursuit of happiness."
1286,4,23,97,124,1.25,0.04526490492808352,551,This is where we get combed over
1286,4,23,97,124,1.25,0.04526490492808352,551,Maybe now he'll liquidate his assets.
1286,7,17,100,124,1.25,0.04941965852606572,551,He really DOES have small hands.
1286,6,19,99,124,1.25,0.04807465345971242,551,Is it possible to drown in a comb-over?
1286,3,25,96,124,1.25,0.043792479657892625,551,We're never buying another Groupon tour!
1286,7,17,100,124,1.25,0.04941965852606572,551,"Co-opted iconic symbology everywhere, and not a drop to drink"
1286,10,11,103,124,1.25,0.05325123171831277,551,"November 9th, 2016."
1286,4,23,97,124,1.25,0.04526490492808352,551,"Oh great, he can control water now!"
1286,5,21,98,124,1.25,0.04669091947809488,551,"Row everyone,...Row; we don't want to get caught in that ""Comb-Over""!"
1286,5,21,98,124,1.25,0.04669091947809488,551,He said he would make waves great again.
1286,6,19,99,124,1.25,0.04807465345971242,551,"I think, maybe, we are not welcome!"
1286,9,13,102,124,1.25,0.05200541640979274,551,Now THAT'S a comb-over!
1286,3,25,96,124,1.25,0.043792479657892625,551,"Donald, calm down. We know you won."
1286,8,15,101,124,1.25,0.050729015290999296,551,"The hands, so tiny, how much damage can they cause?"
1286,3,25,96,124,1.25,0.043792479657892625,551,"Hold tight, our only hope is to ride this one out!"
1286,7,17,100,124,1.25,0.04941965852606572,551,Welcome! Now get out
1286,8,15,101,124,1.25,0.050729015290999296,551,Clearly we've crossed over to the Jersey side.
1286,4,23,97,124,1.25,0.04526490492808352,551,I guess it's time to show your green card Juan
1286,8,15,101,124,1.25,0.050729015290999296,551,"Donald Trump? Wave goodbye, everybody."
1286,4,23,97,124,1.25,0.04526490492808352,551,Fear not people; just a simple blowhard.
1286,7,17,100,124,1.25,0.04941965852606572,551,Believe me! This is going be a total disaster!
1286,8,15,101,124,1.25,0.050729015290999296,551,"They're not sending us their best people! Some are tired, some are poor, some are just huddled masses. Sad! #he-who-must-not-be named-on-buildings"
1286,4,23,97,124,1.25,0.04526490492808352,551,I'm sure it will calm down after the inauguration.
1286,4,23,97,124,1.25,0.04526490492808352,551,The experts only gave Hurricane Donald a 20% chance of making landfall.
1286,7,17,100,124,1.25,0.04941965852606572,551,"Deb, I told you that pot was a lot stronger today than when we were in college!"
1286,5,21,98,124,1.25,0.04669091947809488,551,Tell him he has great hair.
1286,6,19,99,124,1.25,0.04807465345971242,551,I told you we should have just waited for the next Staten Island ferry.
1286,5,21,98,124,1.25,0.04669091947809488,551,"Just as he predicted, it's HUGE!"
1286,7,17,100,124,1.25,0.04941965852606572,551,"If we make it through this, we really are great again."
1286,9,13,102,124,1.25,0.05200541640979274,551,Who said I wouldn't know a rogue wave if I saw one right in front of me?
1286,8,15,101,124,1.25,0.050729015290999296,551,"Looks like this tired, poor, huddled mass won't be breathing free anytime soon."
1286,6,19,99,124,1.25,0.04807465345971242,551,Welcome to America
1286,6,19,99,124,1.25,0.04807465345971242,551,I just knew Canada by boat would be a bad idea.
1286,8,15,101,124,1.25,0.050729015290999296,551,Yep. The hands really are tiny.
1286,4,23,97,124,1.25,0.04526490492808352,551,Wait! We're just passing by on our way to Canada!
1286,7,17,100,124,1.25,0.04941965852606572,551,"Wave back, you idiots!"
1286,10,11,103,124,1.25,0.05325123171831277,551,Oh my! the tsunamis from November 8th has arrived
1286,6,19,99,124,1.25,0.04807465345971242,551,It wants to see our ID's.
1286,7,17,100,124,1.25,0.04941965852606572,551,"The tired, the poor and the huddled masses are in the boat to your left."
1286,3,25,96,124,1.25,0.043792479657892625,551,And that's the president. You'll get used to him.
1286,8,15,101,124,1.25,0.050729015290999296,551,With hair like that how dangerous can it be?
1286,5,21,98,124,1.25,0.04669091947809488,551,"Ladies and Gentlemen,- - -a bit premature---this wasn't supposed to happen until January 20, 2017."
1286,7,17,100,124,1.25,0.04941965852606572,551,Maybe it's waving goodbye
1286,6,19,99,124,1.25,0.04807465345971242,551,That's the dumbest looking wave I've ever seen.
1286,6,19,99,124,1.25,0.04807465345971242,551,But we're huddled masses.
1286,7,17,100,124,1.25,0.04941965852606572,551,We are documented and LEAVING - Let us pass!
1286,6,19,99,124,1.25,0.04807465345971242,551,"Big hair, big mouth, small hands SCARY"
1286,7,17,100,124,1.25,0.04941965852606572,551,"Am I the huuuuugest wave you've ever seen?"" ""Am I the huuuuuuugest wave you've ever seen?"
1286,7,17,100,124,1.25,0.04941965852606572,551,"Ever since the debunking of global warming, the waves seem huge! HUGE!"
1286,4,23,97,124,1.25,0.04526490492808352,551,"But we're not terrorists or wretched refuse. We're fit, rich, and coddled classes learning to freeze brie."""
1286,6,19,99,124,1.25,0.04807465345971242,551,"Don't worry, folks, it'll blow itself out!"
1343,5,21,99,125,1.248,0.04635904755624927,551,"Relax, we're smuggling beauty queens."
1343,7,17,101,125,1.248,0.04906348750804017,551,Making America swell again is starting to look violent
1343,6,19,100,125,1.248,0.04773042581401404,551,So much for huddled masses yearning to be free....
1343,9,13,103,125,1.248,0.051626449835144056,551,"Wow, the Wave of Revulsion appearing during a Storm of Controversy."
1343,2,27,96,125,1.248,0.04197695220152403,551,"Don't worry, folks. Your pre-existing conditions are still covered."
1343,8,15,102,125,1.248,0.05036127544568475,551,I think we should have stayed in the swamp.
1343,4,23,98,125,1.248,0.04494584555059639,551,A rising tide swamps all boats.
1343,5,21,99,125,1.248,0.04635904755624927,551,"As you can see, climate change is a myth."
1343,7,17,101,125,1.248,0.04906348750804017,551,We should have tried the wall.
1343,3,25,97,125,1.248,0.043486742510718705,551,"Land of the free, home of the wave...."
1343,5,21,99,125,1.248,0.04635904755624927,551,And I thought the wall idea was bad.
1343,7,17,101,125,1.248,0.04906348750804017,551,I'm mostly just so distracted by those tiny hands.
1343,7,17,101,125,1.248,0.04906348750804017,551,"The secret password is ""comb-over""."
1343,6,19,100,125,1.248,0.04773042581401404,551,Whoa! Looks like the swamp is coming here.
1357,5,21,100,126,1.246031746031746,0.046031746031746035,551,Stroke! It's the big ugly wave of populism!
1357,7,17,102,126,1.246031746031746,0.04871231771019955,551,"Wave, everybody!"
1357,5,21,100,126,1.246031746031746,0.046031746031746035,551,Look! Donald is making waves already!
1357,6,19,101,126,1.246031746031746,0.047390988275359834,551,If we all row really fast we can get out of here by Inauguration Day.
1357,6,19,101,126,1.246031746031746,0.047390988275359834,551,"Yes, he has taken us by storm."
1357,6,19,101,126,1.246031746031746,0.047390988275359834,551,We should have expected this.
1363,8,14,101,123,1.2439024390243902,0.050772341450393485,551,This is unprecedented.
1363,7,16,100,123,1.2439024390243902,0.04944239714081975,551,I thought we would make it before Trump became President.
1363,3,24,96,123,1.2439024390243902,0.043719910220988874,551,Your tiny hands are no match for our diversity!
1363,5,20,98,123,1.2439024390243902,0.04666894676742699,551,And over here we have the inevitable wave of hate crimes.
1363,7,16,100,123,1.2439024390243902,0.04944239714081975,551,Is it my imagination or is this what the next four years will really look like?
1363,4,22,97,123,1.2439024390243902,0.045218475992188534,551,"Don't blame me, I voted for Clinton."
1363,4,22,97,123,1.2439024390243902,0.045218475992188534,551,This is the last time I rely on CNN's hurricane tracking poll.
1363,8,14,101,123,1.2439024390243902,0.050772341450393485,551,Global warming!
1363,6,18,99,123,1.2439024390243902,0.04807567590482465,551,Nothing to worry about--he's all show. Believe me.
1363,7,16,100,123,1.2439024390243902,0.04944239714081975,551,And this is where global warming submerged Ellis Island.
1363,5,20,98,123,1.2439024390243902,0.04666894676742699,551,"Is this what you call ""wait and sea""?"
1363,5,20,98,123,1.2439024390243902,0.04666894676742699,551,My nausea comes in waves.
1363,9,12,102,123,1.2439024390243902,0.05206832701057475,551,The Wave of Tyranny!
1363,7,16,100,123,1.2439024390243902,0.04944239714081975,551,Maybe it'll pivot.
1363,3,24,96,123,1.2439024390243902,0.043719910220988874,551,Let's just wait and see if it goes away in four years.
1363,5,20,98,123,1.2439024390243902,0.04666894676742699,551,"But we are giving you our tired, our poor and our huddled masses."
1363,6,18,99,123,1.2439024390243902,0.04807567590482465,551,Oh boy! It's telling us things are going to be fantastic!
1363,7,16,100,123,1.2439024390243902,0.04944239714081975,551,The sea is angry today.
1363,7,16,100,123,1.2439024390243902,0.04944239714081975,551,"If we weren't facing imminent doom, I'd almost think it was funny....."
1363,6,18,99,123,1.2439024390243902,0.04807567590482465,551,Don't take it literally.
1363,3,24,96,123,1.2439024390243902,0.043719910220988874,551,"No, wait...it's receding!! Must have thought we were going to hold a press conference."
1363,2,26,95,123,1.2439024390243902,0.04216812218259812,551,This too shall pass!
1363,7,16,100,123,1.2439024390243902,0.04944239714081975,551,"I feel it: ""Make the Ocean Great Again!"""
1363,6,18,99,123,1.2439024390243902,0.04807567590482465,551,I think we can avoid this if we head north
1363,6,18,99,123,1.2439024390243902,0.04807567590482465,551,"""Give me your tired, your poor""… yeah, right... get outta here!"
1363,8,14,101,123,1.2439024390243902,0.050772341450393485,551,Winslow Homer's: The Fraud Warning.
1363,7,16,100,123,1.2439024390243902,0.04944239714081975,551,Pay no attention to that lady behind the curtain
1390,5,20,99,124,1.2419354838709677,0.0463328244815081,551,Those idiots said that hurricane Trump wasn't going to develop!
1390,3,24,97,124,1.2419354838709677,0.04341048188296504,551,"I've heard of Red Tide, but this looks more orange to me!"
1392,5,19,97,121,1.2396694214876034,0.04698161147287437,551,"Oh, no! Trump Tower sewer has sprung a leak."
1392,7,15,99,121,1.2396694214876034,0.04982724064457145,551,Moby Trump!
1392,8,13,100,121,1.2396694214876034,0.05119077023335348,551,Why did we decide against landing in Canada?
1392,9,11,101,121,1.2396694214876034,0.05251891091707771,551,He also managed a hostile takeover of the Hudson River.
1392,8,13,100,121,1.2396694214876034,0.05119077023335348,551,"""That wave is huuuuge. Tremendous wave, believe me""."
1392,1,27,93,121,1.2396694214876034,0.04069775951155416,551,Anyone got a green card?
1392,4,21,96,121,1.2396694214876034,0.04549209568437318,551,Calm down! That lady with a torch invited us!
1392,6,17,98,121,1.2396694214876034,0.0484253328684489,551,"Everybody call it ""The Great Wave"", nobody mention the little hands."
1392,3,23,95,121,1.2396694214876034,0.043952129902021915,551,Did he tweet about this?
1392,6,17,98,121,1.2396694214876034,0.0484253328684489,551,"Moses! Get your red staff out and let God part his comb over, so we can cross to freedom!"
1392,8,13,100,121,1.2396694214876034,0.05119077023335348,551,He's ready for the new wave of immigrants.
1392,6,17,98,121,1.2396694214876034,0.0484253328684489,551,This is what you get when squall line meets hairline.
1392,5,19,97,121,1.2396694214876034,0.04698161147287437,551,Looks like we're in for a Don-easter folks!
1392,3,23,95,121,1.2396694214876034,0.043952129902021915,551,Look out - those tiny hands aren't just for waving.
1392,12,5,104,121,1.2396694214876034,0.05631570957034824,551,"It'll never happen, this is all just a joke."
1392,6,17,98,121,1.2396694214876034,0.0484253328684489,551,"Oh great, he's franchising weather now."
1392,4,21,96,121,1.2396694214876034,0.04549209568437318,551,His immigration policy is even scarier than I thought!
1392,3,23,95,121,1.2396694214876034,0.043952129902021915,551,"We should have built a larger vessel for at least 1,460 days and nights of reign."
1392,5,19,97,121,1.2396694214876034,0.04698161147287437,551,I thought New York was a sanctuary city!
1392,5,19,97,121,1.2396694214876034,0.04698161147287437,551,"We're not immigrants, we're tourist!"
1392,4,21,96,121,1.2396694214876034,0.04549209568437318,551,Hope overcome by a wave of discontent.
1392,8,13,100,121,1.2396694214876034,0.05119077023335348,551,Swim for Liberty Island! What the hell have you got to lose?
1392,3,23,95,121,1.2396694214876034,0.043952129902021915,551,Let's just give it a chance -- it may pass
1392,5,19,97,121,1.2396694214876034,0.04698161147287437,551,What's really scary is that bad comb over.
1392,7,15,99,121,1.2396694214876034,0.04982724064457145,551,This isn't exactly what I pictured when he said a 'wall'.
1392,7,15,99,121,1.2396694214876034,0.04982724064457145,551,These must be the so-called 'amber waves of grain'.
1392,4,21,96,121,1.2396694214876034,0.04549209568437318,551,I had no idea that waves could be orange.
1392,6,17,98,121,1.2396694214876034,0.0484253328684489,551,It's so bigly!
1392,4,21,96,121,1.2396694214876034,0.04549209568437318,551,"If life is but a dream, I would like to wake up now."
1392,4,21,96,121,1.2396694214876034,0.04549209568437318,551,"This is why you signed waivers, people."
1392,5,19,97,121,1.2396694214876034,0.04698161147287437,551,We’re gonna need a bigger boat.
1392,4,21,96,121,1.2396694214876034,0.04549209568437318,551,I didn't see this coming!
1392,4,21,96,121,1.2396694214876034,0.04549209568437318,551,That wall sounds pretty good right about now.
1392,6,17,98,121,1.2396694214876034,0.0484253328684489,551,"Relax, its only Trump L'oeil!"
1392,5,19,97,121,1.2396694214876034,0.04698161147287437,551,Wow... Look at those tiny little hands
1392,8,13,100,121,1.2396694214876034,0.05119077023335348,551,Look to your right and you'll be able to catch a brief glimpse of Lady Liberty.
1392,4,21,96,121,1.2396694214876034,0.04549209568437318,551,I guess he really is a force of nature.
1392,7,15,99,121,1.2396694214876034,0.04982724064457145,551,"As we feared, this is a result of the seismic convergence of politics and climate change denial."
1392,6,17,98,121,1.2396694214876034,0.0484253328684489,551,"Don't worry, he's got small wavelets."
1392,6,17,98,121,1.2396694214876034,0.0484253328684489,551,So is it us or him that's going against the tide?
1392,7,15,99,121,1.2396694214876034,0.04982724064457145,551,Shalom!
1392,6,17,98,121,1.2396694214876034,0.0484253328684489,551,Attack of the Great White Groper!
1392,8,13,100,121,1.2396694214876034,0.05119077023335348,551,Who wants to try Canada?
1392,5,19,97,121,1.2396694214876034,0.04698161147287437,551,And over here we have a monstrous Trump weave!
1392,6,17,98,121,1.2396694214876034,0.0484253328684489,551,Ask him how to get to Carnegie Hall.
1392,8,13,100,121,1.2396694214876034,0.05119077023335348,551,I THOUGHT YOU SAID HE WANTS TO DRAIN SWAMPS!?
1392,9,11,101,121,1.2396694214876034,0.05251891091707771,551,I've never seen a wave with such tiny hands before.
1392,7,15,99,121,1.2396694214876034,0.04982724064457145,551,"And as we approach January 20, 2017, we have a small craft advisory warning throughout the East Coast."
1392,3,23,95,121,1.2396694214876034,0.043952129902021915,551,"Relax Marge, it's just a lot of bluster. It'll blow over."
1392,5,19,97,121,1.2396694214876034,0.04698161147287437,551,This must be a sea wall that Trump has built to keep us out!
1392,5,19,97,121,1.2396694214876034,0.04698161147287437,551,"We were just on our way to Canada, Mr. Trump"
1392,5,19,97,121,1.2396694214876034,0.04698161147287437,551,"Dramamine, anyone?"
1392,4,21,96,121,1.2396694214876034,0.04549209568437318,551,"okay everyone, brace for 4 year impact!"
1392,6,17,98,121,1.2396694214876034,0.0484253328684489,551,"Hang on tight, this one's bigly."
1446,4,21,97,122,1.2377049180327868,0.045160417509692276,551,"Let us pass, Mr. Trump. We're refugees from America."
1446,3,23,96,122,1.2377049180327868,0.04363462286723502,551,I recognize those small hands and comb over anywhere.
1446,7,15,100,122,1.2377049180327868,0.04945616544275742,551,The hands really are quite small.
1446,4,21,97,122,1.2377049180327868,0.045160417509692276,551,"Watch out, ladies, he's got lots of hands."
1446,7,15,100,122,1.2377049180327868,0.04945616544275742,551,"Look at those hands, they really are small!"
1451,9,11,103,123,1.2357723577235773,0.05173428457597066,551,It's trying to make America wet again.
1451,6,17,100,123,1.2357723577235773,0.04771368919516814,551,"It's what I've been saying all year long....""Yikes! this can't be happening!'"
1453,6,16,98,120,1.2333333333333334,0.04841078504124872,551,These happen every 16 years or so.
1453,7,14,99,120,1.2333333333333334,0.049836333439760135,551,So this is the new immigration policy I've been hearing about.
1453,10,8,102,120,1.2333333333333334,0.05388718027458707,551,"""...Give me your tired, your poor, your huddled masses yearning to breathe free...The wretched refuse of your teeming shore...Send these, the homeless, tempest-tost to me, I lift my lamp beside the golden door."" NOT!"
1453,4,20,96,120,1.2333333333333334,0.0454256762579498,551,Quick! Denounce Hillary!
1453,7,14,99,120,1.2333333333333334,0.049836333439760135,551,It's a Trumphoon!!!
1453,7,14,99,120,1.2333333333333334,0.049836333439760135,551,"As for you poor and tired huddled masses, ""Fagettaboutit!"""
1453,8,12,100,120,1.2333333333333334,0.05122222323491941,551,"I guess we were too tired, too poor, and too homeless!"
1453,6,16,98,120,1.2333333333333334,0.04841078504124872,551,Who called me Ishmael?
1453,5,18,97,120,1.2333333333333334,0.04694196508350526,551,I'm more concerned with the tiny hands.
1453,5,18,97,120,1.2333333333333334,0.04694196508350526,551,"You are right Jane, Trump World is a scary ride!"
1453,4,20,96,120,1.2333333333333334,0.0454256762579498,551,"The sea was angry that day, my friends."
1453,9,10,101,120,1.2333333333333334,0.05257159095497189,551,"Despite the terrific rain of half-truths and tremendous flood of reckless lies, the scientists bravely clung to their facts."
1453,6,16,98,120,1.2333333333333334,0.04841078504124872,551,"Is it just me, or does that sea monster have really small hands?"
1453,4,20,96,120,1.2333333333333334,0.0454256762579498,551,As if the wall weren't enough...
1453,4,20,96,120,1.2333333333333334,0.0454256762579498,551,Don't think this Trump-nami will blow over anytime soon.
1453,3,22,95,120,1.2333333333333334,0.0438569953494662,551,"Don't worry, it's just a big weave."
1453,4,20,96,120,1.2333333333333334,0.0454256762579498,551,Don't worry. He doesn't have a mandate.
1453,8,12,100,120,1.2333333333333334,0.05122222323491941,551,Uh oh. Who brought the sacrificial virgins?
1453,8,12,100,120,1.2333333333333334,0.05122222323491941,551,Let's bail.
1453,6,16,98,120,1.2333333333333334,0.04841078504124872,551,You think this was the wall he had in mind?
1453,4,20,96,120,1.2333333333333334,0.0454256762579498,551,That's not a big wave. It's a combover.
1453,4,20,96,120,1.2333333333333334,0.0454256762579498,551,This is our final stop. Now shake hands with your greatest fear.
1453,5,18,97,120,1.2333333333333334,0.04694196508350526,551,I'm more worried about the rogue pompadour.
1453,6,16,98,120,1.2333333333333334,0.04841078504124872,551,Looks like a bad wave day!
1453,7,14,99,120,1.2333333333333334,0.049836333439760135,551,Quick! Let's huddle our masses.
1453,3,22,95,120,1.2333333333333334,0.0438569953494662,551,Let's hope it blows over without too much damage.
1453,7,14,99,120,1.2333333333333334,0.049836333439760135,551,The Perverted Storm
1453,6,16,98,120,1.2333333333333334,0.04841078504124872,551,Trying to escape Trump is going to be harder than I thought.
1453,6,16,98,120,1.2333333333333334,0.04841078504124872,551,The hair is the least of it.
1453,8,12,100,120,1.2333333333333334,0.05122222323491941,551,In terms of storms this one looks like a loser. Sad.
1453,5,18,97,120,1.2333333333333334,0.04694196508350526,551,A dam might have been more useful than that wall.
1453,9,10,101,120,1.2333333333333334,0.05257159095497189,551,"Wow, yes, exactly like an old man trying to send back soup in a deli."
1453,4,20,96,120,1.2333333333333334,0.0454256762579498,551,"Well, 'the huddled masses' are about to be 'tempest tossed'!"
1453,2,24,94,120,1.2333333333333334,0.04223008428447825,551,It looks like we're going to have a bad hair day
1453,6,16,98,120,1.2333333333333334,0.04841078504124872,551,That's the second scariest comb-over I've ever seen.
1453,3,22,95,120,1.2333333333333334,0.0438569953494662,551,Get ready for the ride of your life.
1453,7,14,99,120,1.2333333333333334,0.049836333439760135,551,This is our wave of the future!
1453,4,20,96,120,1.2333333333333334,0.0454256762579498,551,"Relax, my shrink says post-election comb over hallucinations are normal."
1453,6,16,98,120,1.2333333333333334,0.04841078504124872,551,Just remember that it's only a hoax create by China
1453,3,22,95,120,1.2333333333333334,0.0438569953494662,551,Extreme vetting!
1453,6,16,98,120,1.2333333333333334,0.04841078504124872,551,"Sorry, Trumpie, sanctuary city."
1453,6,16,98,120,1.2333333333333334,0.04841078504124872,551,Clearly its form over substance
1453,4,20,96,120,1.2333333333333334,0.0454256762579498,551,"Don't worry, it's the wave of the future."
1453,5,18,97,120,1.2333333333333334,0.04694196508350526,551,"Quick! Say the magic words: ""Radical Islamic Terrorism."""
1453,6,16,98,120,1.2333333333333334,0.04841078504124872,551,"You keep comparing it to Hitler, but I don't think it looks anything like Hitler."
1453,8,12,100,120,1.2333333333333334,0.05122222323491941,551,"Mary, look how small his hands are!"
1453,7,14,99,120,1.2333333333333334,0.049836333439760135,551,It's not an effect of global warming - but it'll probably be another cause.
1453,7,14,99,120,1.2333333333333334,0.049836333439760135,551,Inaugural poster considered for new immigration policy.
1453,5,18,97,120,1.2333333333333334,0.04694196508350526,551,Warning Ladies...guard your pussies!
1453,5,18,97,120,1.2333333333333334,0.04694196508350526,551,I've never seen an orange and yellow wave before.
1453,6,16,98,120,1.2333333333333334,0.04841078504124872,551,"Not your normal wave, it's what we call a comb-over."
1453,5,18,97,120,1.2333333333333334,0.04694196508350526,551,No thanks Mr. Trump. We're headin' for Cuba.
1453,6,16,98,120,1.2333333333333334,0.04841078504124872,551,"Uh, I think we may headed in the wrong direction."
1453,6,16,98,120,1.2333333333333334,0.04841078504124872,551,Let's make America bait again!
1453,3,22,95,120,1.2333333333333334,0.0438569953494662,551,The mouth that roared
1453,4,20,96,120,1.2333333333333334,0.0454256762579498,551,"Well, if this doesn't Trump all!"
1509,3,22,96,121,1.2314049586776858,0.043535759309308836,551,The wave is terrific! But we're still voting for Hillary.
1509,2,24,95,121,1.2314049586776858,0.0419239942253373,551,"But we are tired, poor and huddled!"
1509,4,20,97,121,1.2314049586776858,0.04508994772086154,551,Waves of fear are everywhere in these tides of change.
1512,6,16,100,122,1.2295081967213115,0.047690014903129664,551,Making sea-level rise great again.
1513,5,17,96,118,1.228813559322034,0.04724944508372923,551,Make America Great Again. Go Home.
1513,5,17,96,118,1.228813559322034,0.04724944508372923,551,"As our tour nears its end, I would like to thank you again for joining us on today's Ellis Island ""Immigrant Experience"" adventure."
1513,7,13,98,118,1.228813559322034,0.050221899247328054,551,"She's confused. No tired, no poor, no huddled masses are allowed."
1513,5,17,96,118,1.228813559322034,0.04724944508372923,551,I thought he said he would only build a wall.
1513,4,19,95,118,1.228813559322034,0.04569075955897573,551,"You know, he will make us pay for this!"
1513,4,19,95,118,1.228813559322034,0.04569075955897573,551,Back off! Supermodels onboard!
1513,5,17,96,118,1.228813559322034,0.04724944508372923,551,But we're not illegal; we're only coming from Williamsburg!
1513,6,15,97,118,1.228813559322034,0.048758328646135496,551,"Don't worry, it won't rock the boat until next month."
1513,9,9,100,118,1.228813559322034,0.053027995128018895,551,"Beware the brazen giant with tiny hands, who extinguished the torch of the mighty woman!"
1513,7,13,98,118,1.228813559322034,0.050221899247328054,551,This wave is going to grab us by the prow and do whatever it wants!
1513,7,13,98,118,1.228813559322034,0.050221899247328054,551,Maybe we should give it a chance..
1513,7,13,98,118,1.228813559322034,0.050221899247328054,551,Uh oh. I thought 'huge wave of disaster' was just a metaphor.
1513,6,15,97,118,1.228813559322034,0.048758328646135496,551,Looks like we have to pay the toll.
1513,6,15,97,118,1.228813559322034,0.048758328646135496,551,Anyone else feel like things have been stranger since the election?
1513,6,15,97,118,1.228813559322034,0.048758328646135496,551,Let's don't go to Jersey.
1513,7,13,98,118,1.228813559322034,0.050221899247328054,551,"No, there aren't any tired or poor aboard, just a huddled mass of hedge fund managers."
1513,2,23,93,118,1.228813559322034,0.0424018443677596,551,"No, it's totally fine. He just likes to wave."
1513,1,25,92,118,1.228813559322034,0.04065774039642998,551,"Quick, there's no time to lose: SELFIE positions!"
1513,5,17,96,118,1.228813559322034,0.04724944508372923,551,Don't be scared. He's just pretending to be something he's not.
1513,6,15,97,118,1.228813559322034,0.048758328646135496,551,I can't even part my own hair. What makes you think I can part this sea?
1513,5,17,96,118,1.228813559322034,0.04724944508372923,551,"Relax, ladies. I have enough small hands to grab all of you."
1513,5,17,96,118,1.228813559322034,0.04724944508372923,551,"This must be the ""life is but a dream"" part."
1513,6,15,97,118,1.228813559322034,0.048758328646135496,551,Don't let my comb-over and small hands bother you. I love immigrants.
1513,6,15,97,118,1.228813559322034,0.048758328646135496,551,President-Elect Trump's welcome wave towards immigrants.
1513,7,13,98,118,1.228813559322034,0.050221899247328054,551,"Who said ""Give me liberty or give me death?"""
1513,5,17,96,118,1.228813559322034,0.04724944508372923,551,"Well, at least the wave is great again."
1513,6,15,97,118,1.228813559322034,0.048758328646135496,551,"Let it wash over us, it'll be tremendous."
1513,4,19,95,118,1.228813559322034,0.04569075955897573,551,Nature imitates politics.
1513,8,11,99,118,1.228813559322034,0.05164400948467288,551,"With that hair, and those tiny hands, it was the second scariest thing to happen in New York."
1513,8,11,99,118,1.228813559322034,0.05164400948467288,551,Tsunami Trump swamps the American dream
1513,6,15,97,118,1.228813559322034,0.048758328646135496,551,Donald Trump has definitely made it harder to get into the country!
1513,8,11,99,118,1.228813559322034,0.05164400948467288,551,"Red rover, red rover, let no one comb over"
1513,4,19,95,118,1.228813559322034,0.04569075955897573,551,"No, we're the Brooklyn Rowing Club."
1513,4,19,95,118,1.228813559322034,0.04569075955897573,551,"And to your right, you'll see the land of the free, home of the wave."
1513,6,15,97,118,1.228813559322034,0.048758328646135496,551,"But we're tired, poor and a huddled mass yearning to be free."
1513,7,13,98,118,1.228813559322034,0.050221899247328054,551,I told you not to trust the polls!
1513,3,21,94,118,1.228813559322034,0.044076988978739455,551,"I'm not really getting that ""Give me your tired, your poor, your huddled masses"" vibe."
1513,5,17,96,118,1.228813559322034,0.04724944508372923,551,"Quick, set the GPS for Havana!"
1513,5,17,96,118,1.228813559322034,0.04724944508372923,551,It's blowing hard today .
1513,8,11,99,118,1.228813559322034,0.05164400948467288,551,"From every ocean wide, let freedom sink!"
1513,8,11,99,118,1.228813559322034,0.05164400948467288,551,"We should wait and see, give this wave a chance."
1513,7,13,98,118,1.228813559322034,0.050221899247328054,551,"Yes, 'grab them by the dinghy' is a good immigration slogan for you."
1513,6,15,97,118,1.228813559322034,0.048758328646135496,551,Do you think that this is a welcoming or a groping?
1513,4,19,95,118,1.228813559322034,0.04569075955897573,551,"No worries, only attacks immigrants!"
1513,5,17,96,118,1.228813559322034,0.04724944508372923,551,"Everyone! Cheer wildly and show no fear, he's desperate for our approval."
1513,3,21,94,118,1.228813559322034,0.044076988978739455,551,Courage! We will over comb if we just keep rowing.
1513,6,15,97,118,1.228813559322034,0.048758328646135496,551,Oh swell no.
1513,6,15,97,118,1.228813559322034,0.048758328646135496,551,Did anyone even bother to read the reviews before booking this trip?
1513,5,17,96,118,1.228813559322034,0.04724944508372923,551,"Merrily, merrily, merrily, merrily, life is but a...what?!"
1513,5,17,96,118,1.228813559322034,0.04724944508372923,551,What have we got to lose?
1513,4,19,95,118,1.228813559322034,0.04569075955897573,551,Let's keep rowing to Canada
1513,6,15,97,118,1.228813559322034,0.048758328646135496,551,Oh NO! ... it's the Trump sea wall!
1513,4,19,95,118,1.228813559322034,0.04569075955897573,551,Looks like one of those 4-year storm cycles!
1513,5,17,96,118,1.228813559322034,0.04724944508372923,551,"Quick, fasten your wallets!"
1513,4,19,95,118,1.228813559322034,0.04569075955897573,551,Just hold your breathe; it'll be gone in about four years.
1513,4,19,95,118,1.228813559322034,0.04569075955897573,551,Hang on for greatness.
1513,2,23,93,118,1.228813559322034,0.0424018443677596,551,I guess some combovers are worse than others.
1513,5,17,96,118,1.228813559322034,0.04724944508372923,551,"It just wants to tweet, hide your phones, folks!"
1513,6,15,97,118,1.228813559322034,0.048758328646135496,551,Uh oh! We're going to get drenched....bigly!
1513,7,13,98,118,1.228813559322034,0.050221899247328054,551,Is that a wig?
1513,6,15,97,118,1.228813559322034,0.048758328646135496,551,"Oh, but look at those adorable tiny hands!"
1513,1,25,92,118,1.228813559322034,0.04065774039642998,551,"Just stay calm, we've been in business since 1776"
1513,5,17,96,118,1.228813559322034,0.04724944508372923,551,"Not to worry, the experts say that there's an 89% chance that it won't hit us."
1576,8,11,100,119,1.226890756302521,0.051244273968638177,551,LEFT FULL RUDDER !
1576,7,13,99,119,1.226890756302521,0.049835185976131326,551,You were right; it was 'amber waves of pain.'
1576,2,23,94,119,1.226890756302521,0.04208796139977964,551,"No, he only tweets at low tide."
1576,3,21,95,119,1.226890756302521,0.04374730103773937,551,He never said what would be great
1576,4,19,96,119,1.226890756302521,0.04534596124666279,551,"I'd say he was a nightmare, if we weren't all in the same boat."
1576,7,13,99,119,1.226890756302521,0.049835185976131326,551,So tell me again why they didn't do something about climate change when they had the chance?
1576,5,17,97,119,1.226890756302521,0.04689014880207883,551,...and this we received from China.
1576,7,13,99,119,1.226890756302521,0.049835185976131326,551,Even Lady Liberty flirted with me.
1576,4,19,96,119,1.226890756302521,0.04534596124666279,551,"Alex Baldwin, ladies and gentlemen."
1576,6,15,98,119,1.226890756302521,0.048385079394151514,551,I vote to ride the wave...
1576,5,17,97,119,1.226890756302521,0.04689014880207883,551,"Don't give me your tired, your poor!"
1576,5,17,97,119,1.226890756302521,0.04689014880207883,551,"Women and children grab the life jacket! Everybody else, prepare to make America great again!"
1588,5,17,98,120,1.225,0.046536182122071425,551,"Now this wave takes credit for putting the ""sue"" in tsunami."
1588,6,15,99,120,1.225,0.04801741630812266,551,Don't worry. It can't grab us with those tiny hands.
1588,7,13,100,120,1.225,0.04945430508374905,551,"Go on, pull it! It's real!"
1588,7,13,100,120,1.225,0.04945430508374905,551,It's just hair.
1592,3,20,94,117,1.2222222222222223,0.04395545918145444,551,Not so much a cruel sea as ironic.
1592,7,12,98,117,1.2222222222222223,0.050214850962274515,551,Forget the Trump wave—it's the tiny hands that should worry you.
1592,6,14,97,117,1.2222222222222223,0.04872544551705718,551,Haircules is upon us!
1592,3,20,94,117,1.2222222222222223,0.04395545918145444,551,"Wave to Ms Liberty, Darling. It may be your last chance"
1592,3,20,94,117,1.2222222222222223,0.04395545918145444,551,"No, Dramamine won't help."
1592,6,14,97,117,1.2222222222222223,0.04872544551705718,551,He certainly is making America wet again.
1592,3,20,94,117,1.2222222222222223,0.04395545918145444,551,"Don't worry, we'll get by. He's not gonna mess up that hair."
1592,9,8,100,117,1.2222222222222223,0.05306840575916059,551,But we're from Slovenia!
1592,6,14,97,117,1.2222222222222223,0.04872544551705718,551,And this is where our economy tour ends.
1592,5,16,96,117,1.2222222222222223,0.04718905407515576,551,"I know he's draining the swamp, but isn't this going too far?"
1592,4,18,95,117,1.2222222222222223,0.04560092771183762,551,It must be the wave that swept Trump to the White House.
1592,8,10,99,117,1.2222222222222223,0.05166133441454232,551,Wave goodby!
1592,4,18,95,117,1.2222222222222223,0.04560092771183762,551,It's a wall and waterboarding combo.
1592,5,16,96,117,1.2222222222222223,0.04718905407515576,551,Help! It's a trumped up wave!
1592,7,12,98,117,1.2222222222222223,0.050214850962274515,551,"Oh no, another Chris Christie shenanigan!"
1592,5,16,96,117,1.2222222222222223,0.04718905407515576,551,What very nicely formed and astonishingly above average size hands you have!
1592,3,20,94,117,1.2222222222222223,0.04395545918145444,551,"It's not just the sea that is angry these days, my friends."
1592,6,14,97,117,1.2222222222222223,0.04872544551705718,551,I think it's more afraid of us than we are of him
1592,6,14,97,117,1.2222222222222223,0.04872544551705718,551,Look how small those hands are.
1592,3,20,94,117,1.2222222222222223,0.04395545918145444,551,Orange Crush
1592,3,20,94,117,1.2222222222222223,0.04395545918145444,551,He's asking us if we are bad hombres.
1592,4,18,95,117,1.2222222222222223,0.04560092771183762,551,We should've waited after the impeachment.
1592,4,18,95,117,1.2222222222222223,0.04560092771183762,551,We should've taken the Circle Line.
1592,8,10,99,117,1.2222222222222223,0.05166133441454232,551,Pat Robertson still blames this one on gays somehow.
1592,4,18,95,117,1.2222222222222223,0.04560092771183762,551,The 2016 election results as foretold by a famous Chinese artist.
1592,3,20,94,117,1.2222222222222223,0.04395545918145444,551,Looks like we're in for some Extreme Wetting!
1592,4,18,95,117,1.2222222222222223,0.04560092771183762,551,Don't worry: it's just a splash over.
1592,7,12,98,117,1.2222222222222223,0.050214850962274515,551,"Sorry, no inauguration performers here, either."
1592,8,10,99,117,1.2222222222222223,0.05166133441454232,551,Where you folks from?
1592,4,18,95,117,1.2222222222222223,0.04560092771183762,551,Wow! The Trump Water Tower!
1592,5,16,96,117,1.2222222222222223,0.04718905407515576,551,Maybe Canada wasn't the best idea
1592,5,16,96,117,1.2222222222222223,0.04718905407515576,551,Thank goodness this is just a cartoon!
1592,4,18,95,117,1.2222222222222223,0.04560092771183762,551,Rogue waves .... another phenomenon brought about by extreme climate change.
1592,9,8,100,117,1.2222222222222223,0.05306840575916059,551,Don't worry--comb-over waves always fizzle out.
1592,6,14,97,117,1.2222222222222223,0.04872544551705718,551,"- On the bright side, it cannot possibly be as bad as it looks."
1592,4,18,95,117,1.2222222222222223,0.04560092771183762,551,Hold on tight. Here comes an unprecedented YUGE wave!
1592,5,16,96,117,1.2222222222222223,0.04718905407515576,551,I think my fear of tsunamis and my fear of politics are starting to merge.
1592,5,16,96,117,1.2222222222222223,0.04718905407515576,551,No worries ! It's just a new administration coming in.
1592,8,10,99,117,1.2222222222222223,0.05166133441454232,551,How is this making America great again?
1592,6,14,97,117,1.2222222222222223,0.04872544551705718,551,He's everywhere.
1592,4,18,95,117,1.2222222222222223,0.04560092771183762,551,Wow-look at all those little finger waves!
1592,7,12,98,117,1.2222222222222223,0.050214850962274515,551,Watch out for the Trumpnami!
1592,5,16,96,117,1.2222222222222223,0.04718905407515576,551,Must be a tsunami from the earthquake in D. C.
1592,5,16,96,117,1.2222222222222223,0.04718905407515576,551,His face looks more orange on television.
1592,5,16,96,117,1.2222222222222223,0.04718905407515576,551,What do we have to lose?
1592,7,12,98,117,1.2222222222222223,0.050214850962274515,551,"Here on your right is New York's largest nocturnal swamp creature. Notice the large mouth which is used to make up for its tiny hands. If you listen closely, you can hear it calling us all losers."
1592,6,14,97,117,1.2222222222222223,0.04872544551705718,551,He must have drained the swamp.
1639,7,12,99,118,1.2203389830508475,0.04982308730921858,551,""" "" no caption necessary"
1639,4,18,96,118,1.2203389830508475,0.04525203171228205,551,"Give me your tired, your poor, your huddled masses caught in a never-ending nightmare..."
1639,3,20,95,118,1.2203389830508475,0.043622033680757795,551,I think I paid too much to get into this country.
1639,5,16,97,118,1.2203389830508475,0.04682532355183029,551,I take back my vote for change.
1639,4,18,96,118,1.2203389830508475,0.04525203171228205,551,Don't worry. Tsunamis can't happen in America.
1639,5,16,97,118,1.2203389830508475,0.04682532355183029,551,Looks like an unfolding tragedy!
1639,5,16,97,118,1.2203389830508475,0.04682532355183029,551,My goodness! He's having a huge bad hair day.
1646,7,12,100,119,1.218487394957983,0.049437317959208596,551,"Oh, that's just Trump draining the swamp"
1647,5,15,95,115,1.2173913043478262,0.04748858098023914,551,He really is all sound and fury!
1647,7,11,97,115,1.2173913043478262,0.05059916922351761,551,It's a sue-nami!
1647,6,13,96,115,1.2173913043478262,0.049068529882333456,551,"Send me your tempest tossed, and I'll waterboard em good...."
1647,4,17,94,115,1.2173913043478262,0.045854225783672445,551,Now THIS would make a great musical!
1647,5,15,95,115,1.2173913043478262,0.04748858098023914,551,That is the HUGE bad hair wave they were warning us about!
1647,6,13,96,115,1.2173913043478262,0.049068529882333456,551,"Keep your hands, feet and combs inside the boat at all times."
1647,3,19,93,115,1.2173913043478262,0.044159423919739836,551,"Don't give me your tired, your poor, your muddled asses...."
1647,3,19,93,115,1.2173913043478262,0.044159423919739836,551,Huddle up. This too shall pass.
1647,4,17,94,115,1.2173913043478262,0.045854225783672445,551,"Huddled masses, hard on starboard."
1647,6,13,96,115,1.2173913043478262,0.049068529882333456,551,up close his hands are small
1647,5,15,95,115,1.2173913043478262,0.04748858098023914,551,O come on! What a big bag of wind
1647,7,11,97,115,1.2173913043478262,0.05059916922351761,551,The hands are small but the wave is huge.
1647,6,13,96,115,1.2173913043478262,0.049068529882333456,551,Believe me! It's going to be juge!
1647,4,17,94,115,1.2173913043478262,0.045854225783672445,551,"This must be his East Coast version of ""Build a Wall""."
1647,1,23,91,115,1.2173913043478262,0.040557910675105675,551,"Don't Worry, no one respects boaters more than I do."
1647,5,15,95,115,1.2173913043478262,0.04748858098023914,551,"Look at those hands,it must be him."
1647,4,17,94,115,1.2173913043478262,0.045854225783672445,551,is there any way this is metaphorical?
1647,9,7,99,115,1.2173913043478262,0.05352930532618195,551,"Of course, you're right. We'll wake up tomorrow morning and Hillary will be the next President."
1647,1,23,91,115,1.2173913043478262,0.040557910675105675,551,And up ahead is the rarely seen wave-over.
1647,4,17,94,115,1.2173913043478262,0.045854225783672445,551,It too scary here. Let's row back to Syria.
1647,6,13,96,115,1.2173913043478262,0.049068529882333456,551,And we thought Super Storm Sandy was a disaster!
1647,7,11,97,115,1.2173913043478262,0.05059916922351761,551,Small hands. Ha ha!
1647,3,19,93,115,1.2173913043478262,0.044159423919739836,551,"sorry Mr. trump, but were not immigrants. just tourists."
1647,3,19,93,115,1.2173913043478262,0.044159423919739836,551,Anyone have a couple of rubles? He built a sea wall and we have to pay for it.
1647,3,19,93,115,1.2173913043478262,0.044159423919739836,551,That is definitely not an amber wave of grain.
1647,7,11,97,115,1.2173913043478262,0.05059916922351761,551,A full-blown tweetstorm. Wow!
1647,3,19,93,115,1.2173913043478262,0.044159423919739836,551,Liberty or death?
1647,6,13,96,115,1.2173913043478262,0.049068529882333456,551,This is way cooler than a big wall.
1647,7,11,97,115,1.2173913043478262,0.05059916922351761,551,"I admit it looks bad, Vern, but just give it a chance."
1647,3,19,93,115,1.2173913043478262,0.044159423919739836,551,"Well, I mean it probably won't end up doing all the things it says it will."
1647,6,13,96,115,1.2173913043478262,0.049068529882333456,551,Prepare yourself for the Entitle Wave
1647,6,13,96,115,1.2173913043478262,0.049068529882333456,551,And I use to think Medusa was scary!
1647,3,19,93,115,1.2173913043478262,0.044159423919739836,551,I already miss 2016.
1647,8,9,98,115,1.2173913043478262,0.052084846427794054,551,That'll make your masses huddle!
1647,4,17,94,115,1.2173913043478262,0.045854225783672445,551,I'm getting mixed messages.
1647,6,13,96,115,1.2173913043478262,0.049068529882333456,551,Xenonami
1647,6,13,96,115,1.2173913043478262,0.049068529882333456,551,Look out! It’s a Trumpnami!
1647,3,19,93,115,1.2173913043478262,0.044159423919739836,551,Stay calm. It's part of the extreme vetting process.
1647,7,11,97,115,1.2173913043478262,0.05059916922351761,551,Quick! Get the sump pump for the Trump Dump!
1647,5,15,95,115,1.2173913043478262,0.04748858098023914,551,This is not normal.
1647,5,15,95,115,1.2173913043478262,0.04748858098023914,551,Is that a toupee?
1647,6,13,96,115,1.2173913043478262,0.049068529882333456,551,And this is a sight to see! It's the new presidential wave.
1647,5,15,95,115,1.2173913043478262,0.04748858098023914,551,Hang on. Another small-handed blowhard.
1647,4,17,94,115,1.2173913043478262,0.045854225783672445,551,"Unless one of you is named Moses, you're about to get soaked"
1647,5,15,95,115,1.2173913043478262,0.04748858098023914,551,"We are going to go low when he goes high, so get in battle positions now!"
1647,4,17,94,115,1.2173913043478262,0.045854225783672445,551,"Are we huddled masses yearning to breath free? Yes, but some, I assume, are good people."
1647,4,17,94,115,1.2173913043478262,0.045854225783672445,551,Yet another depiction of the impending Trump apocalypse.
1647,3,19,93,115,1.2173913043478262,0.044159423919739836,551,"Give me your tired, your poor, your huddled masses--but just the perfect 10's--yearning to be groped."
1647,3,19,93,115,1.2173913043478262,0.044159423919739836,551,"Oh no, it's the rogue wave!"
1647,8,9,98,115,1.2173913043478262,0.052084846427794054,551,"First it was the wall on the border with Mexico ,now this..."
1647,8,9,98,115,1.2173913043478262,0.052084846427794054,551,Small hands!!!
1647,5,15,95,115,1.2173913043478262,0.04748858098023914,551,"It's going to be O. K. ! Look, Lady Liberty is holding up a giant can of hair spray!"
1647,4,17,94,115,1.2173913043478262,0.045854225783672445,551,Stupid GPS!
1647,5,15,95,115,1.2173913043478262,0.04748858098023914,551,Don't worry. He's just testing a new anti-immigrant plan.
1647,3,19,93,115,1.2173913043478262,0.044159423919739836,551,"Just a very bad dream, folks, which, trust me, you will wake up from in four years, I promise."
1702,5,15,96,116,1.2155172413793103,0.047114703382027195,551,Isn't it a bit early in the season for a Trumphoon?
1702,7,11,98,116,1.2155172413793103,0.05019606906660046,551,Let us Liberals go!
1702,2,21,93,116,1.2155172413793103,0.042071607555840156,551,Relax. A squall like this can't last.
1702,5,15,96,116,1.2155172413793103,0.047114703382027195,551,SUE-nami!
1702,7,11,98,116,1.2155172413793103,0.05019606906660046,551,Tsunami? No. in New York we consider it a yuge monster wave.
1702,6,13,97,116,1.2155172413793103,0.048679773132767,551,"Wall if by land, wall if by sea.."
1702,6,13,97,116,1.2155172413793103,0.048679773132767,551,"Tidal wave, sure, but whoever heard of a tidal combover?"
1702,3,19,94,116,1.2155172413793103,0.04381717927724109,551,Wow! Even the Wall was created in his image.
1702,5,15,96,116,1.2155172413793103,0.047114703382027195,551,"A rising tide lifts all boats, right?"
1702,5,15,96,116,1.2155172413793103,0.047114703382027195,551,That's A Bigly Wave!
1702,4,17,95,116,1.2155172413793103,0.045495826592063866,551,Oh no! Not a beachcomb-over!
1702,4,17,95,116,1.2155172413793103,0.045495826592063866,551,"""It's called 'The Suenami'""."
1702,5,15,96,116,1.2155172413793103,0.047114703382027195,551,"Don't worry, it's just trompe l'œil."
1702,5,15,96,116,1.2155172413793103,0.047114703382027195,551,"Wave goodbye, ye huddled masses."
1702,2,21,93,116,1.2155172413793103,0.042071607555840156,551,"He calls it ""vetting."""
1702,4,17,95,116,1.2155172413793103,0.045495826592063866,551,"Dame Liberty was aglow with promise, but The Trump was angry that day..."
1702,5,15,96,116,1.2155172413793103,0.047114703382027195,551,The tide has really turned to Trump.
1702,4,17,95,116,1.2155172413793103,0.045495826592063866,551,"""Huddled mass"" is bad enough, but you're also tired and poor. so GET LOST!"
1702,6,13,97,116,1.2155172413793103,0.048679773132767,551,"Such little hands, but oh so many."
1702,6,13,97,116,1.2155172413793103,0.048679773132767,551,Anyone know how to throw this thing in reverse?
1702,6,13,97,116,1.2155172413793103,0.048679773132767,551,I have a recurring nightmare ....
1702,3,19,94,116,1.2155172413793103,0.04381717927724109,551,Don't worry: You'll be waking up any minute now.
1702,2,21,93,116,1.2155172413793103,0.042071607555840156,551,Poseidon is looking very presidential today.
1702,6,13,97,116,1.2155172413793103,0.048679773132767,551,"We've gone over this before. When I ask for a show of hands, I'm asking the people in the boat."
1702,5,15,96,116,1.2155172413793103,0.047114703382027195,551,"We will eat your tired, your poor, your huddled masses."
1702,3,19,94,116,1.2155172413793103,0.04381717927724109,551,Can I take a look at that harbor cruise brochure again?
1702,4,17,95,116,1.2155172413793103,0.045495826592063866,551,We're the ones you assume are good people.
1702,5,15,96,116,1.2155172413793103,0.047114703382027195,551,Don't worry this wave will pass.
1702,6,13,97,116,1.2155172413793103,0.048679773132767,551,Thy Trump runneth over me.
1702,3,19,94,116,1.2155172413793103,0.04381717927724109,551,Wow! Another rogue wave.
1702,6,13,97,116,1.2155172413793103,0.048679773132767,551,Anyone here vote for Hillary?
1702,6,13,97,116,1.2155172413793103,0.048679773132767,551,"Wave, everybody!"
1702,4,17,95,116,1.2155172413793103,0.045495826592063866,551,Look Out!! It's his rogue weave !
1735,8,9,100,117,1.2136752136752136,0.05125748502853041,551,"You just had to call her ""The Minnow"""
1735,4,17,96,117,1.2136752136752136,0.04514289430396643,551,A rising tide lifts all boats...I think.
1735,4,17,96,117,1.2136752136752136,0.04514289430396643,551,"I know eleven looks like a lot, but they are tiny!"
1735,5,15,97,117,1.2136752136752136,0.04674658407270865,551,"First I'll take Manhattan, then I'll take . . ."
1735,4,17,96,117,1.2136752136752136,0.04514289430396643,551,140 characters won't get us out of this one! It will take another miracle on the Hudson.
1735,4,17,96,117,1.2136752136752136,0.04514289430396643,551,"Well, so much for wanting huddled masses."
1741,3,18,92,113,1.2123893805309736,0.044358269149919076,551,They weren't kidding about his overseas operations.
1741,3,18,92,113,1.2123893805309736,0.044358269149919076,551,This wave is Yuge
1741,3,18,92,113,1.2123893805309736,0.044358269149919076,551,So many tiny hands
1741,5,14,94,113,1.2123893805309736,0.04778819590408077,551,Not to worry. The consensus forecast is for calm seas.
1741,7,10,96,113,1.2123893805309736,0.05098791321045548,551,"Ooh look, it's the Loch Ness Trumpster!"
1741,5,14,94,113,1.2123893805309736,0.04778819590408077,551,George Washington never faced these problems crossing the Delaware.
1741,7,10,96,113,1.2123893805309736,0.05098791321045548,551,"But look, his fingers really are short!"
1741,3,18,92,113,1.2123893805309736,0.044358269149919076,551,Watch out for waves from the right!
1741,6,12,95,113,1.2123893805309736,0.04941396038228338,551,I never thought crossing Trump Harbor would be this treacherous
1741,7,10,96,113,1.2123893805309736,0.05098791321045548,551,Even Lady Liberty can't save us now!
1741,1,22,90,113,1.2123893805309736,0.040639887010011776,551,I really need to stop eating pepperoni pizza and reading Shakespeare before bed.
1741,5,14,94,113,1.2123893805309736,0.04778819590408077,551,"Beware, his Twitter feed can capsize any size boat."
1741,6,12,95,113,1.2123893805309736,0.04941396038228338,551,Beware its a Trumpnami
1741,5,14,94,113,1.2123893805309736,0.04778819590408077,551,I wouldn't worry. His grabby hands are pretty small.
1741,1,22,90,113,1.2123893805309736,0.040639887010011776,551,Hold on! We're about to get hit by New York's most turbulent tide!
1741,5,14,94,113,1.2123893805309736,0.04778819590408077,551,"Look, Trump's waving!"
1741,4,16,93,113,1.2123893805309736,0.04610513913732104,551,Well...we were all warned that the Trump wave was coming.
1741,4,16,93,113,1.2123893805309736,0.04610513913732104,551,My bad. I thought you said we should have BOATED!
1741,4,16,93,113,1.2123893805309736,0.04610513913732104,551,"It's weird. Despite how ominous this is, those waves are really small."
1741,4,16,93,113,1.2123893805309736,0.04610513913732104,551,Watch out! That wave is 'pussy grabber'!
1741,6,12,95,113,1.2123893805309736,0.04941396038228338,551,James Cameron is off to a strong start at Homeland Security
1741,5,14,94,113,1.2123893805309736,0.04778819590408077,551,Poseidon uses Trumps hairdresser too?
1741,4,16,93,113,1.2123893805309736,0.04610513913732104,551,"In hindsight, I think we should have taken the Trojan Horse option."
1741,5,14,94,113,1.2123893805309736,0.04778819590408077,551,"Told you not to sign us up for the ""Deplorables"" tour!!"
1741,3,18,92,113,1.2123893805309736,0.044358269149919076,551,This tsunami is going to be huge.
1741,4,16,93,113,1.2123893805309736,0.04610513913732104,551,Oh I get it! 'WAVE' your rights! This guy is hilarious! What will he do next?
1741,5,14,94,113,1.2123893805309736,0.04778819590408077,551,"New policy: the tired, poor, and huddled masses are low energy and no longer welcome."
1741,7,10,96,113,1.2123893805309736,0.05098791321045548,551,"Careful, it might try to grab you"
1741,3,18,92,113,1.2123893805309736,0.044358269149919076,551,How does THAT grab you?
1741,6,12,95,113,1.2123893805309736,0.04941396038228338,551,"Just ignore the finger-waving. Small hands, small undercurrent."
1741,5,14,94,113,1.2123893805309736,0.04778819590408077,551,"Donald's first hairpiece, lost at sea, grew to fit the size of its tank."
1741,5,14,94,113,1.2123893805309736,0.04778819590408077,551,"They did say it would likely be a ""toss-up""..."
1741,5,14,94,113,1.2123893805309736,0.04778819590408077,551,Everyone! Put on your popular vote life jacket metaphor!
1741,6,12,95,113,1.2123893805309736,0.04941396038228338,551,Beware the grabbing!
1741,6,12,95,113,1.2123893805309736,0.04941396038228338,551,It's part of his new welcome to Ellis Island.
1741,6,12,95,113,1.2123893805309736,0.04941396038228338,551,The mouth is OK -- it's the hair that terrifies me.
1741,6,12,95,113,1.2123893805309736,0.04941396038228338,551,"Now this is really, off..off Broadway..."
1741,2,20,91,113,1.2123893805309736,0.04253972530566686,551,"Oh terrible, for Russian spies, for amber waves, afraid!"
1741,4,16,93,113,1.2123893805309736,0.04610513913732104,551,Ignore the small hands; down there I'm all business!
1741,4,16,93,113,1.2123893805309736,0.04610513913732104,551,"Brace yourselves, it's a yuge bigly wave!"
1741,6,12,95,113,1.2123893805309736,0.04941396038228338,551,"Don't worry, he promised to keep us safe."
1741,4,16,93,113,1.2123893805309736,0.04610513913732104,551,And he's working on a thinner Lady Liberty
1741,6,12,95,113,1.2123893805309736,0.04941396038228338,551,Some admirers do call him a force of nature.
1741,4,16,93,113,1.2123893805309736,0.04610513913732104,551,Why don't we give him a chance?
1741,5,14,94,113,1.2123893805309736,0.04778819590408077,551,Trump wants to replace Miss Liberty with his personally designed immigrant welcome center.
1741,4,16,93,113,1.2123893805309736,0.04610513913732104,551,OK! All those with a Selfie Stick....NOW!!
1741,4,16,93,113,1.2123893805309736,0.04610513913732104,551,Throw in the Beauty Queens!
1741,6,12,95,113,1.2123893805309736,0.04941396038228338,551,"Ladies and gentlemen, our 45th president."
1741,7,10,96,113,1.2123893805309736,0.05098791321045548,551,Blond waves.....a sure sign of global warming....
1741,5,14,94,113,1.2123893805309736,0.04778819590408077,551,The hair says Scylla but the hands are all Charybdis!
1741,4,16,93,113,1.2123893805309736,0.04610513913732104,551,"OK everyone, hold for the extreme vetting!"
1741,3,18,92,113,1.2123893805309736,0.044358269149919076,551,"Moses, can you see the parting?"
1741,5,14,94,113,1.2123893805309736,0.04778819590408077,551,"Well Dorothy, I don't think we're in New York anymore either!"
1741,4,16,93,113,1.2123893805309736,0.04610513913732104,551,This'll make Hokusai great again!
1741,6,12,95,113,1.2123893805309736,0.04941396038228338,551,"Luckily, none of us are Muslims or Mexicans, so this wave shouldn't affect us."
1741,3,18,92,113,1.2123893805309736,0.044358269149919076,551,It would be orange if it was.
1741,7,10,96,113,1.2123893805309736,0.05098791321045548,551,"Aw...look at all the cute, tiny hands!"
1741,5,14,94,113,1.2123893805309736,0.04778819590408077,551,Even Poseidon thinksTrump has small hands.
1741,4,16,93,113,1.2123893805309736,0.04610513913732104,551,I just figured out that other part of 'give me liberty...'
1741,5,14,94,113,1.2123893805309736,0.04778819590408077,551,Tired? Poor? Huddled? No room in my inns.
1741,3,18,92,113,1.2123893805309736,0.044358269149919076,551,Who knew that even New Yorker cartoonists suffered from Trump Derangement Syndrome?
1741,8,8,97,113,1.2123893805309736,0.052514713237834694,551,"Stop moving forward and in unison shout ""MAKE AMERICA GREAT AGAIN"" ."
1741,4,16,93,113,1.2123893805309736,0.04610513913732104,551,The Great Trumpsunami of 2016
1741,6,12,95,113,1.2123893805309736,0.04941396038228338,551,"Wait for it, wait for it..."
1741,4,16,93,113,1.2123893805309736,0.04610513913732104,551,"I believe he's going to renegotiate that ""huddled masses"" thing..."
1741,7,10,96,113,1.2123893805309736,0.05098791321045548,551,"How many ""Nina""s do you see?"
1741,6,12,95,113,1.2123893805309736,0.04941396038228338,551,He does have small hands.
1741,7,10,96,113,1.2123893805309736,0.05098791321045548,551,At least he has baby hands.
1741,4,16,93,113,1.2123893805309736,0.04610513913732104,551,Give it a chance.
1741,1,22,90,113,1.2123893805309736,0.040639887010011776,551,It could be worse. At least we have a paddle
1741,4,16,93,113,1.2123893805309736,0.04610513913732104,551,I didn't think the popular boat could lose.
1741,4,16,93,113,1.2123893805309736,0.04610513913732104,551,Let's hope it's only as deep as its logic
1741,5,14,94,113,1.2123893805309736,0.04778819590408077,551,"We were once welcome to ""come over"". but now we are met by the ""Comb-over""."
1741,6,12,95,113,1.2123893805309736,0.04941396038228338,551,Gaaaaah! Trumped again!
1741,6,12,95,113,1.2123893805309736,0.04941396038228338,551,It's hands are everywhere
1741,3,18,92,113,1.2123893805309736,0.044358269149919076,551,"Oh no...a wave! A great wave! It's the best wave! It's got the best water! It's, like, a wet wave!"
1741,3,18,92,113,1.2123893805309736,0.044358269149919076,551,Even Emma Lazarus couldn't find words for it.
1741,6,12,95,113,1.2123893805309736,0.04941396038228338,551,Prepare for extreme vetting.
1741,4,16,93,113,1.2123893805309736,0.04610513913732104,551,You didn't say it was going to be a wall of water!
1741,3,18,92,113,1.2123893805309736,0.044358269149919076,551,I call it 'Trumped-up global warming'.
1741,7,10,96,113,1.2123893805309736,0.05098791321045548,551,"Permission to drain the Trump, Sir."
1741,7,10,96,113,1.2123893805309736,0.05098791321045548,551,"Hurry, we must get back to Cuba!"
1741,6,12,95,113,1.2123893805309736,0.04941396038228338,551,We're looking for pre-2017 America.
1741,5,14,94,113,1.2123893805309736,0.04778819590408077,551,It's just a Chinese hoax.
1741,3,18,92,113,1.2123893805309736,0.044358269149919076,551,I think it wants to see our green cards....
1741,4,16,93,113,1.2123893805309736,0.04610513913732104,551,"Don't worry, it's overcompensating"
1741,6,12,95,113,1.2123893805309736,0.04941396038228338,551,"That's just another immigrant wave, keep rowing."
1741,6,12,95,113,1.2123893805309736,0.04941396038228338,551,Don't criticize its hands and we'll be OK.
1741,6,12,95,113,1.2123893805309736,0.04941396038228338,551,Loose lips sink ships!
1741,4,16,93,113,1.2123893805309736,0.04610513913732104,551,Brace yourselves! Comb over waves will grope without warning!
1741,4,16,93,113,1.2123893805309736,0.04610513913732104,551,Canada: Now accepting befuddled masses
1741,3,18,92,113,1.2123893805309736,0.044358269149919076,551,Don't say anything about the comb-over.
1741,5,14,94,113,1.2123893805309736,0.04778819590408077,551,Please get your little hands off us! We're leaving -- not coming in!
1741,2,20,91,113,1.2123893805309736,0.04253972530566686,551,Don't read too much into this
1741,6,12,95,113,1.2123893805309736,0.04941396038228338,551,"He said he'd drain the swamp, not swamp us down the drain!"
1741,5,14,94,113,1.2123893805309736,0.04778819590408077,551,He's got such TINY waves!
1741,5,14,94,113,1.2123893805309736,0.04778819590408077,551,Shit! It's a Tweet wave!
1741,5,14,94,113,1.2123893805309736,0.04778819590408077,551,"We're tired, poor and a huddled mass yearning to be free. You'll love us."
1839,6,12,96,114,1.2105263157894737,0.04901400775435974,551,Don't you just hate it when the cartoonist gets surreal?
1839,3,18,93,114,1.2105263157894737,0.04400689458220717,551,This immigration-themed ride is terrifying.
1839,3,18,93,114,1.2105263157894737,0.04400689458220717,551,I don't think even Sully can get us out of this one.....
1839,2,20,92,114,1.2105263157894737,0.042206058518233065,551,-and beyond that we have a nice view of the statue of liberty and lower Manhattan.
1843,7,10,98,115,1.208695652173913,0.05016472054618863,551,"It's nothing, just the wretched refuse of the teeming shore."
1844,4,15,93,112,1.2053571428571428,0.04597435224702924,551,"you tired, you poor, you huddled masses- go back from where you came"
1844,1,21,90,112,1.2053571428571428,0.040385833926123646,551,"No, no. Let's see where this goes."
1844,4,15,93,112,1.2053571428571428,0.04597435224702924,551,Trump-nami!
1844,4,15,93,112,1.2053571428571428,0.04597435224702924,551,"No worries, look at its hands"
1844,5,13,94,112,1.2053571428571428,0.047691888465535556,551,"Our nightmare, His dream"
1844,4,15,93,112,1.2053571428571428,0.04597435224702924,551,"Yeah, it's real...native to New York City... it's called a comb-over wave."
1844,6,11,95,112,1.2053571428571428,0.04934968476377782,551,And I thought I was having a bad hair day.
1844,6,11,95,112,1.2053571428571428,0.04934968476377782,551,"You, Huddled Masses: You're drowned!"
1844,4,15,93,112,1.2053571428571428,0.04597435224702924,551,"See, I told you Trump was back in New York!"
1844,5,13,94,112,1.2053571428571428,0.047691888465535556,551,"Row, row, row your boat, gently back to sea...."
1844,6,11,95,112,1.2053571428571428,0.04934968476377782,551,"OK, now everybody, ""Michael row the boat ashore..."""
1844,4,15,93,112,1.2053571428571428,0.04597435224702924,551,"Look, the President-elect is personally welcoming us!"
1844,5,13,94,112,1.2053571428571428,0.047691888465535556,551,Did anyone remember to bring the Trump card?
1844,6,11,95,112,1.2053571428571428,0.04934968476377782,551,"Don't worry, it's post-factual"
1844,3,17,92,112,1.2053571428571428,0.044190110926074416,551,"It's okay, they say a rising tide lifts all boats."
1844,8,7,97,112,1.2053571428571428,0.052508491770708536,551,"Oh, My God! Did I really just scream 'Oh, My God'?"
1844,5,13,94,112,1.2053571428571428,0.047691888465535556,551,Oh no!! It's the creature from the Trump Tower. Compliment it.
1844,3,17,92,112,1.2053571428571428,0.044190110926074416,551,What happened to the Ship of State?
1844,6,11,95,112,1.2053571428571428,0.04934968476377782,551,Huddled masses on the way out.
1844,5,13,94,112,1.2053571428571428,0.047691888465535556,551,"Trump, Trump everywhere and not a drop of sanity."
1844,6,11,95,112,1.2053571428571428,0.04934968476377782,551,Still seems better than the subway.
1844,3,17,92,112,1.2053571428571428,0.044190110926074416,551,"So, this is how President -Elect Trump will handle immigration."
1844,1,21,90,112,1.2053571428571428,0.040385833926123646,551,I would have preferred a wall.
1844,6,11,95,112,1.2053571428571428,0.04934968476377782,551,Hurricane Deplorable!!
1844,4,15,93,112,1.2053571428571428,0.04597435224702924,551,"Not to worry, this wave is powerless in New York City."
1844,5,13,94,112,1.2053571428571428,0.047691888465535556,551,"'Oops' is an understatement, Hajib."
1844,5,13,94,112,1.2053571428571428,0.047691888465535556,551,Give it a chance.
1844,5,13,94,112,1.2053571428571428,0.047691888465535556,551,Where's a mythical Biblical whale when you need one.
1844,4,15,93,112,1.2053571428571428,0.04597435224702924,551,It seems we've hit a wall.
1844,4,15,93,112,1.2053571428571428,0.04597435224702924,551,"And on your right, you will see what scientists call ""global waving."""
1844,4,15,93,112,1.2053571428571428,0.04597435224702924,551,Let us pass....we have H1B visas
1844,4,15,93,112,1.2053571428571428,0.04597435224702924,551,"Let's turn around, this dictator is worse than ours!"
1844,6,11,95,112,1.2053571428571428,0.04934968476377782,551,That's not a welcome wave.
1844,3,17,92,112,1.2053571428571428,0.044190110926074416,551,"Oh, so this is what you meant by, ""We have an either-oar choice""."
1844,6,11,95,112,1.2053571428571428,0.04934968476377782,551,This must be the part he made the Japanese pay for.
1844,7,9,96,112,1.2053571428571428,0.05095357246709405,551,"Okay, I guess this is a bad hair day!"
1844,4,15,93,112,1.2053571428571428,0.04597435224702924,551,Next time we row around Manhattan Island I'm skipping the LSD.
1844,1,21,90,112,1.2053571428571428,0.040385833926123646,551,Have mercy! We just rowed over from Atlantic City.
1844,8,7,97,112,1.2053571428571428,0.052508491770708536,551,"""Comb-over"" to the Dark Side !"
1844,6,11,95,112,1.2053571428571428,0.04934968476377782,551,Middle America warned us about living near the coast.
1844,6,11,95,112,1.2053571428571428,0.04934968476377782,551,This wave is going to be hUGE.
1844,2,19,91,112,1.2053571428571428,0.04233073047779356,551,Well I think we should give him a chance.
1844,4,15,93,112,1.2053571428571428,0.04597435224702924,551,Must be his idea of a sea wall
1844,3,17,92,112,1.2053571428571428,0.044190110926074416,551,"No, Ahmed. It wouldn't help if our masses were more huddled."
1844,5,13,94,112,1.2053571428571428,0.047691888465535556,551,"No matter what happens, don't look at his tiny hands!"
1844,2,19,91,112,1.2053571428571428,0.04233073047779356,551,"No worries, folks, it's only a common short-fingered Vulgarious wave."
1844,6,11,95,112,1.2053571428571428,0.04934968476377782,551,This is Not the Open Arms welcome I was hoping for.
1844,4,15,93,112,1.2053571428571428,0.04597435224702924,551,I guess we should have bought those Trump™ life jackets back at the tower...
1844,6,11,95,112,1.2053571428571428,0.04934968476377782,551,"Luckily, We have a paddle."
1844,5,13,94,112,1.2053571428571428,0.047691888465535556,551,We're getting Trumped!
1844,3,17,92,112,1.2053571428571428,0.044190110926074416,551,Trump towers over us
1844,3,17,92,112,1.2053571428571428,0.044190110926074416,551,"Think of it as a wall, of water."
1844,3,17,92,112,1.2053571428571428,0.044190110926074416,551,The event that caused this tsunami must've been huge.
1844,6,11,95,112,1.2053571428571428,0.04934968476377782,551,Next time I'm taking the subway into the city.
1844,4,15,93,112,1.2053571428571428,0.04597435224702924,551,I think we're gonna need a bigger boat...
1844,4,15,93,112,1.2053571428571428,0.04597435224702924,551,"Oh, I get it now, it's home of the free and land of the wave!"
1844,3,17,92,112,1.2053571428571428,0.044190110926074416,551,"This wave of Donald Trump support is going to break soon, so row faster!!"
1844,2,19,91,112,1.2053571428571428,0.04233073047779356,551,Maybe let's keep going north.
1844,2,19,91,112,1.2053571428571428,0.04233073047779356,551,"Nothing to worry about folks...that's Trump wave. Actually, it's mostly hot air."
1844,4,15,93,112,1.2053571428571428,0.04597435224702924,551,We were just tired and hungry. We aren't 'longing' anymore.
1844,9,5,98,112,1.2053571428571428,0.05401867148412414,551,"It is said that in an alternative universe, the same monster was elected President."
1844,3,17,92,112,1.2053571428571428,0.044190110926074416,551,I told you Trump's hair was alive!
1844,2,19,91,112,1.2053571428571428,0.04233073047779356,551,Don't worry guys. It's just a YUGE metaphor.
1844,1,21,90,112,1.2053571428571428,0.040385833926123646,551,This is because of Global Warming isn't it?
1844,7,9,96,112,1.2053571428571428,0.05095357246709405,551,Extreme wetting? I prepared for extreme vetting.
1844,4,15,93,112,1.2053571428571428,0.04597435224702924,551,And on your right is the Liberal reaction to the election.
1844,2,19,91,112,1.2053571428571428,0.04233073047779356,551,Oh my God! I thought he was in Washington!
1844,3,17,92,112,1.2053571428571428,0.044190110926074416,551,Think climbing over his damn wall would be easier?
1844,6,11,95,112,1.2053571428571428,0.04934968476377782,551,This wave will pass
1844,3,17,92,112,1.2053571428571428,0.044190110926074416,551,Apparently you're unaware of my new immigrant screening process.
1844,4,15,93,112,1.2053571428571428,0.04597435224702924,551,"The sea was angry that day, my friends."
1844,3,17,92,112,1.2053571428571428,0.044190110926074416,551,I've seen this movie and it doesn't end well for us.
1844,5,13,94,112,1.2053571428571428,0.047691888465535556,551,A three-hour cruise...a three-hour cruise.
1844,4,15,93,112,1.2053571428571428,0.04597435224702924,551,So who'd he get to pay for THIS wall? Atlantis?
1844,4,15,93,112,1.2053571428571428,0.04597435224702924,551,"Don't worry, it's headed inland in a few weeks."
1844,4,15,93,112,1.2053571428571428,0.04597435224702924,551,"Oh Lord, It's an ""Election Tsunami"""
1844,4,15,93,112,1.2053571428571428,0.04597435224702924,551,I heard this place had recently gotten really unpredictable.
1844,4,15,93,112,1.2053571428571428,0.04597435224702924,551,Not to worry. Just a Chinese hoax.
1844,0,23,89,112,1.2053571428571428,0.03834241021419074,551,I knew we'd get swallowed up by this new wave in politics!
1844,5,13,94,112,1.2053571428571428,0.047691888465535556,551,"Well, you can't blame me...I voted for Gary Johnson!"
1844,4,15,93,112,1.2053571428571428,0.04597435224702924,551,Just wave back at it!
1844,7,9,96,112,1.2053571428571428,0.05095357246709405,551,"Well, at least we were part of the popular boat."
1844,1,21,90,112,1.2053571428571428,0.040385833926123646,551,"I said: ""No more huddled masses!"""
1844,3,17,92,112,1.2053571428571428,0.044190110926074416,551,This deportation is gonna be YUGE!
1844,3,17,92,112,1.2053571428571428,0.044190110926074416,551,Let's hope it's just one wave.
1844,4,15,93,112,1.2053571428571428,0.04597435224702924,551,"It is the new wave of immigration enforcement, but it may grab for more than your passport."
1930,5,13,95,113,1.2035398230088497,0.04730287467476537,551,The Yuge Wave off Manhattan
1930,4,15,94,113,1.2035398230088497,0.04560190938547957,551,No worries. We're all employees of The New York Times.
1930,5,13,95,113,1.2035398230088497,0.04730287467476537,551,Don't worry-they're small hands.
1933,3,17,94,114,1.2017543859649122,0.04348543980269309,551,"Seems over the top aggressive, even by New York standards."
1934,6,10,94,110,1.2,0.04968625500693169,551,Are any of you rich?
1934,4,14,92,110,1.2,0.046207278580632616,551,"You don't look tired or poor so, no."
1934,4,14,92,110,1.2,0.046207278580632616,551,We have officially entered New Jersey.
1934,4,14,92,110,1.2,0.046207278580632616,551,I didn't think he meant a wall of hair.
1934,6,10,94,110,1.2,0.04968625500693169,551,At least we know that the incantation is no more than 140 characters.
1934,2,18,90,110,1.2,0.04244409559694416,551,Trump really is on the frontline of the immigration battle.
1934,6,10,94,110,1.2,0.04968625500693169,551,Women need not worry. Those hands are small.
1934,3,16,91,110,1.2,0.0443656051737758,551,Yes! Angry like an old man trying to send back soup in a deli.
1934,5,12,93,110,1.2,0.047978310362298264,551,"Some forecasters are predicting that this storm will last four years, and make ""Sandy"" look like a gentle rain."
1934,7,8,95,110,1.2,0.05133740943996563,551,This is turning so 2016.
1934,5,12,93,110,1.2,0.047978310362298264,551,"Please stop! We are tired, poor, and huddled."
1934,5,12,93,110,1.2,0.047978310362298264,551,Our tour of the Statue of Liberty is about to end!
1934,4,14,92,110,1.2,0.046207278580632616,551,"Who put up the sign: ""no huddled asses wanted"""
1934,4,14,92,110,1.2,0.046207278580632616,551,And Britain's going to pay for this wave-- believe me.
1934,7,8,95,110,1.2,0.05133740943996563,551,Welcome to Jersey.
1934,3,16,91,110,1.2,0.0443656051737758,551,Reminds me in so many ways of our new President.
1934,4,14,92,110,1.2,0.046207278580632616,551,Don't look now but I think we are about to become wretched refuse.
1934,4,14,92,110,1.2,0.046207278580632616,551,Keep rowing! This is just a Trump scare tactic to prevent Americans from emigrating to Canada.
1934,2,18,90,110,1.2,0.04244409559694416,551,Last stop on the 'God Bless America' tour
1934,7,8,95,110,1.2,0.05133740943996563,551,My God! There's just no getting away from the big orange turd.
1934,6,10,94,110,1.2,0.04968625500693169,551,sweet JESUS-- better yet MOSES help us!
1934,5,12,93,110,1.2,0.047978310362298264,551,"It's not the wave that you need to worry about, the real problem is the wave's chief strategist."
1934,8,6,96,110,1.2,0.05293708793841515,551,This looks bigly bad for us. Sad!
1934,4,14,92,110,1.2,0.046207278580632616,551,Maybe it'll pivot before it hits
1934,3,16,91,110,1.2,0.0443656051737758,551,"Wow, Trump wasn't kidding when he said he alone could wash away the immigration problem."
1934,4,14,92,110,1.2,0.046207278580632616,551,"Don't blame me,"" Myrtl implored. ""I voted for Bernie!"
1934,5,12,93,110,1.2,0.047978310362298264,551,"What an honor . The President , himself , is welcoming us to America !"
1934,3,16,91,110,1.2,0.0443656051737758,551,Surprise! Narcissus is leaving the pond.
1934,6,10,94,110,1.2,0.04968625500693169,551,Oh what a shock! The New Yorker is publishing an anti Trump Cartoon!
1934,5,12,93,110,1.2,0.047978310362298264,551,All the forecasts were wrong! Hurricane Trump is making landfall!
1934,5,12,93,110,1.2,0.047978310362298264,551,"For God's sake, Sydney! Show him your EZPass."
1934,7,8,95,110,1.2,0.05133740943996563,551,An unnatural disaster born of ignorance? Hold hard!
1934,4,14,92,110,1.2,0.046207278580632616,551,Wasn't this thing supposed to just eat oil spills?
1934,3,16,91,110,1.2,0.0443656051737758,551,"Watch your crotch, ladies! It's a tsunami wave of Trump hands !"
1934,1,20,89,110,1.2,0.04043136875805354,551,Even Al Gore doesn't know about this.
1934,4,14,92,110,1.2,0.046207278580632616,551,Huddle together ... here comes the 'tempest-tossed' part!
1934,3,16,91,110,1.2,0.0443656051737758,551,This is my favorite ride in the Make America Gasp Again theme park.
1934,2,18,90,110,1.2,0.04244409559694416,551,Trump's New Wave Order.
1934,1,20,89,110,1.2,0.04043136875805354,551,"""Holy tweet""!"
1934,5,12,93,110,1.2,0.047978310362298264,551,Now on your right is the Statue of Trump. Watch your pockets.
1934,6,10,94,110,1.2,0.04968625500693169,551,Looks like welcoming the huddled masses was just a fad.
1934,2,18,90,110,1.2,0.04244409559694416,551,"Believe me, its a YUGE hoax!"
1934,7,8,95,110,1.2,0.05133740943996563,551,"Some call him Scylla, some Charybdis."
1934,4,14,92,110,1.2,0.046207278580632616,551,I wonder if Mexico is going to pay for this.
1934,5,12,93,110,1.2,0.047978310362298264,551,And this my friends is New Jersey.
1934,8,6,96,110,1.2,0.05293708793841515,551,Don't worry. He's Making America Great again!
1934,2,18,90,110,1.2,0.04244409559694416,551,Drain the swamp. Bigly.
1934,4,14,92,110,1.2,0.046207278580632616,551,I told you he had tiny hands.
1934,1,20,89,110,1.2,0.04043136875805354,551,Welcome to Circle Line's economy tour of New York City.
1934,5,12,93,110,1.2,0.047978310362298264,551,Damn those forecasters!
1934,4,14,92,110,1.2,0.046207278580632616,551,"It came from the sea ... No, it was elected."
1934,4,14,92,110,1.2,0.046207278580632616,551,"(in this case, no caption necessary; only apologies to Hiroshige) ;-)"
1934,4,14,92,110,1.2,0.046207278580632616,551,We're from Pennsylvania!
1934,4,14,92,110,1.2,0.046207278580632616,551,Who told you we accept the tired and the poor? Her? She's just a statue.
1934,6,10,94,110,1.2,0.04968625500693169,551,So when did Trump get to rule the waves?
1934,6,10,94,110,1.2,0.04968625500693169,551,"""So this is 'extreme vetting'!"
1934,4,14,92,110,1.2,0.046207278580632616,551,Swamp the drain.
1934,4,14,92,110,1.2,0.046207278580632616,551,Maybe we're not the huddled masses they were talking about.
1934,6,10,94,110,1.2,0.04968625500693169,551,"Hold on, it's a President-elect tsunami!"
1993,4,14,93,111,1.1981981981981982,0.04582454131112576,551,SUE-nami!
1993,4,14,93,111,1.1981981981981982,0.04582454131112576,551,I thought this tide would be over by now.
1993,3,16,92,111,1.1981981981981982,0.04400100479051482,551,"""Five times quickly, people! 'Holy Donald, Full of Face. The wall is with thee. Blessed art thou amongst men, and blessed is the fruit of thy comb-over...'"
1996,6,10,96,112,1.1964285714285714,0.048859722436360505,551,Perhaps we should've scheduled the Ellis Island re-enactment for before the election.
1997,4,13,92,109,1.1926605504587156,0.046041140838475915,551,Is this Trump's new immigration policy?
1997,1,19,89,109,1.1926605504587156,0.0401260844561969,551,"Evidently, he got the tsunami vote."
1997,4,13,92,109,1.1926605504587156,0.046041140838475915,551,Try to keep your backs dry!
1997,4,13,92,109,1.1926605504587156,0.046041140838475915,551,Hurricane Trump! So sad!
1997,3,15,91,109,1.1926605504587156,0.044157581278879685,551,"This ""Sea Trump in New York "" tour is terrifying!!"
1997,3,15,91,109,1.1926605504587156,0.044157581278879685,551,"Don't worry ladies, America still has a tremendous amount of respect for immigrants with big tits."
1997,6,9,94,109,1.1926605504587156,0.04959411235543382,551,The Trump Wave ... it could drown us all!
1997,2,17,90,109,1.1926605504587156,0.042190014447655216,551,This is how Trump waves hello to immigrants.
1997,3,15,91,109,1.1926605504587156,0.044157581278879685,551,"So, when some of us choose not to paddle guess what happens to our liberty."
1997,4,13,92,109,1.1926605504587156,0.046041140838475915,551,I hope none of you are ticklish.
1997,3,15,91,109,1.1926605504587156,0.044157581278879685,551,"No worries, it's only a comb-over wave."
1997,6,9,94,109,1.1926605504587156,0.04959411235543382,551,"""Is it just me or does that comb over look familiar?"
1997,5,11,93,109,1.1926605504587156,0.047850614573021776,551,Hold on to your wallets. Ladies duck and cover.
1997,6,9,94,109,1.1926605504587156,0.04959411235543382,551,Everybody wave!!!!!!!!!!!!
1997,3,15,91,109,1.1926605504587156,0.044157581278879685,551,So much for the land of the free and the home of the ...wave?
1997,2,17,90,109,1.1926605504587156,0.042190014447655216,551,"Well, at least he's not Tweeting...."
1997,3,15,91,109,1.1926605504587156,0.044157581278879685,551,Yearning to be free?! I'll show you yearning to be free!!
1997,4,13,92,109,1.1926605504587156,0.046041140838475915,551,He just wants to Make America Hydrate Again.
1997,3,15,91,109,1.1926605504587156,0.044157581278879685,551,So many hand waves. Such little fingers.
1997,3,15,91,109,1.1926605504587156,0.044157581278879685,551,"This is what an oceanic personality disorder will do to you, folks!"
1997,5,11,93,109,1.1926605504587156,0.047850614573021776,551,Mr. Trump is here to save us.
1997,5,11,93,109,1.1926605504587156,0.047850614573021776,551,I told you we should have taken The Circle Line tour!
1997,3,15,91,109,1.1926605504587156,0.044157581278879685,551,Just don't make eye contact
1997,3,15,91,109,1.1926605504587156,0.044157581278879685,551,I'm Donald Trump and I approve this message.
1997,3,15,91,109,1.1926605504587156,0.044157581278879685,551,"Behold, the legendary Trump Towering Wave!"
1997,2,17,90,109,1.1926605504587156,0.042190014447655216,551,Looks like we should have emigrated before the election.
1997,5,11,93,109,1.1926605504587156,0.047850614573021776,551,Global warming seems to have brought the Bermuda Triangle farther north.
1997,1,19,89,109,1.1926605504587156,0.0401260844561969,551,Now that's what I call a wave of populism.
1997,2,17,90,109,1.1926605504587156,0.042190014447655216,551,He's expanding his appeal to the unemployed art history majors
1997,2,17,90,109,1.1926605504587156,0.042190014447655216,551,You're Fired!
1997,3,15,91,109,1.1926605504587156,0.044157581278879685,551,This is a strange way to greet and interview prospective cabinet members.
1997,3,15,91,109,1.1926605504587156,0.044157581278879685,551,Wave? I thought you said Weave!
1997,4,13,92,109,1.1926605504587156,0.046041140838475915,551,This is nothing next to applying for asylum.
1997,5,11,93,109,1.1926605504587156,0.047850614573021776,551,My thirst for adventure is suddenly quenched.
1997,2,17,90,109,1.1926605504587156,0.042190014447655216,551,It's the wave of the future. And it's going to change things-- bigly!
1997,4,13,92,109,1.1926605504587156,0.046041140838475915,551,So much for amber waves of grain.
1997,3,15,91,109,1.1926605504587156,0.044157581278879685,551,Let's hope Miss Liberty took her Dramamine.
1997,2,17,90,109,1.1926605504587156,0.042190014447655216,551,"Wow, a wave election causing our boat to sink. Has anyone else been a part of a metaphor before?"
1997,4,13,92,109,1.1926605504587156,0.046041140838475915,551,"I told you immigration was going to become a lot harder,"
1997,4,13,92,109,1.1926605504587156,0.046041140838475915,551,Anyone know Nearer My God to Thee?
1997,1,19,89,109,1.1926605504587156,0.0401260844561969,551,President-Elect Trump certainly has a hands-on approach to securing the borders.
1997,4,13,92,109,1.1926605504587156,0.046041140838475915,551,This is going to be a bit longer than a three-hour tour.
1997,6,9,94,109,1.1926605504587156,0.04959411235543382,551,"Screw the tired, the poor, and the huddled masses yearning to be free."
1997,4,13,92,109,1.1926605504587156,0.046041140838475915,551,"It's pronounced ""Rumpnami."" The ""T"" is silent."
1997,4,13,92,109,1.1926605504587156,0.046041140838475915,551,Sure we will be smashed to bits but it will sound compassionate in the tweets.
1997,5,11,93,109,1.1926605504587156,0.047850614573021776,551,I think I have the best large wave. Certainly one of the best large waves of anybody that’s ever run for the office of president. Ever. Winning wave.
1997,4,13,92,109,1.1926605504587156,0.046041140838475915,551,"Well, it won't be the small hands that finish us off."
1997,5,11,93,109,1.1926605504587156,0.047850614573021776,551,"Don't worry, this wave is going to make America great again!"
1997,5,11,93,109,1.1926605504587156,0.047850614573021776,551,It appears they've decided to drown us tired and poor.
1997,4,13,92,109,1.1926605504587156,0.046041140838475915,551,Looks like Trump's still not crazy about asylum seekers.
1997,3,15,91,109,1.1926605504587156,0.044157581278879685,551,Oh! Tempest tossed! Now I get it.
1997,3,15,91,109,1.1926605504587156,0.044157581278879685,551,"... and some have ""greatness"" thrust upon them."
1997,4,13,92,109,1.1926605504587156,0.046041140838475915,551,This trumps everything!
1997,1,19,89,109,1.1926605504587156,0.0401260844561969,551,"On the other hand, imagine if Bernie had won!"
1997,3,15,91,109,1.1926605504587156,0.044157581278879685,551,Does he have to be everywhere?
1997,4,13,92,109,1.1926605504587156,0.046041140838475915,551,"Liberty "" Trumped """
1997,4,13,92,109,1.1926605504587156,0.046041140838475915,551,"That wave it Yuge, it must have come from Jina."
1997,4,13,92,109,1.1926605504587156,0.046041140838475915,551,Ready to yearn to breathe free?
1997,5,11,93,109,1.1926605504587156,0.047850614573021776,551,Those small hands can't stop us.
1997,3,15,91,109,1.1926605504587156,0.044157581278879685,551,We must be on the Jersey side.
1997,5,11,93,109,1.1926605504587156,0.047850614573021776,551,No worries -- his part is worse than his bite.
1997,3,15,91,109,1.1926605504587156,0.044157581278879685,551,„Thank god this is just a cartoon and not reality.“
1997,2,17,90,109,1.1926605504587156,0.042190014447655216,551,Mon Dieu! It's the wave of the future.
1997,3,15,91,109,1.1926605504587156,0.044157581278879685,551,Maybe it just wants to lend us a hand?
1997,2,17,90,109,1.1926605504587156,0.042190014447655216,551,I told you his hair was the real problem.
1997,3,15,91,109,1.1926605504587156,0.044157581278879685,551,"Roe, Roe, Roe your boat..."
1997,3,15,91,109,1.1926605504587156,0.044157581278879685,551,Edmond Fitzgerald Scenic Boat Tours.
1997,4,13,92,109,1.1926605504587156,0.046041140838475915,551,You said he was going to build a wall!
1997,5,11,93,109,1.1926605504587156,0.047850614573021776,551,"Gather the women and minorities, two by two!"
1997,2,17,90,109,1.1926605504587156,0.042190014447655216,551,It wants the socialist first.
1997,5,11,93,109,1.1926605504587156,0.047850614573021776,551,Oh no!!! We are going to be TRUMPED!!!
1997,1,19,89,109,1.1926605504587156,0.0401260844561969,551,This wave is Yuge
1997,2,17,90,109,1.1926605504587156,0.042190014447655216,551,"Give me your drug addicts, rapists, murderers and overweight beauty queens."
2070,4,13,93,110,1.190909090909091,0.04565427345619578,551,"Not the great white whale, it's the great orange wave."
2070,3,15,92,110,1.190909090909091,0.04378934817304632,551,"I thought I read somewhere, "" ""Give me your tired, your poor, Your huddled masses..."" I guess not"
2070,5,11,94,110,1.190909090909091,0.04744595194751529,551,"Send these, the homeless, tempest-tossed anywhere else."
2070,2,17,91,110,1.190909090909091,0.041841383127562214,551,That wave is yuuuuuge.
2070,3,15,92,110,1.190909090909091,0.04378934817304632,551,Is this the new Homeland Security?
2070,3,15,92,110,1.190909090909091,0.04378934817304632,551,"Trump seems to be taking the ""tempest-tossed"" part a bit literally."
2070,5,11,94,110,1.190909090909091,0.04744595194751529,551,Quick! Everyone grab a tiny hand and put an Android in it!
2070,6,9,95,110,1.190909090909091,0.04917239090789421,551,There's nothing to be afraid of. We're leaving.
2070,2,17,91,110,1.190909090909091,0.041841383127562214,551,They say that this will be our wave of the future!
2070,5,11,94,110,1.190909090909091,0.04744595194751529,551,Hold onto your cats!
2070,2,17,91,110,1.190909090909091,0.041841383127562214,551,Don't worry it's just Japanese Line Art.
2070,2,17,91,110,1.190909090909091,0.041841383127562214,551,"When he said he planned to stay in New York, didn't you think he meant on Fifth Avenue?!"
2070,6,9,95,110,1.190909090909091,0.04917239090789421,551,"Too tired, too poor, too wretched. No lamp for you!"
2070,4,13,93,110,1.190909090909091,0.04565427345619578,551,You have to admit ... global warming has made the Circle Line pretty darn exciting!
2070,2,17,91,110,1.190909090909091,0.041841383127562214,551,And now on your right the President Elect
2070,2,17,91,110,1.190909090909091,0.041841383127562214,551,"On three, everyone wave back at Donald!"
2070,4,13,93,110,1.190909090909091,0.04565427345619578,551,"Now, hold on everyone. Let's give this a chance."
2070,5,11,94,110,1.190909090909091,0.04744595194751529,551,"'Welcome girls, says Liberty, guard thy pussy!"""
2070,4,13,93,110,1.190909090909091,0.04565427345619578,551,Wave goodbye. It was great.
2070,5,11,94,110,1.190909090909091,0.04744595194751529,551,"Hold on Folks, its going to be a bumpy ride!"
2070,2,17,91,110,1.190909090909091,0.041841383127562214,551,Who said climate change isn't real?
2070,2,17,91,110,1.190909090909091,0.041841383127562214,551,I think it may be time for an offering to Poseidon.
2070,4,13,93,110,1.190909090909091,0.04565427345619578,551,"Just watch, you losers, he's gonna lift all boats!"
2070,3,15,92,110,1.190909090909091,0.04378934817304632,551,"Oh-oh, a deal breaker!"
2070,2,17,91,110,1.190909090909091,0.041841383127562214,551,And you thought mullets were the end of the world!
2095,4,13,94,111,1.1891891891891893,0.04527378450305516,551,There's nothing funny about this.
2095,7,7,97,111,1.1891891891891893,0.05040948377666219,551,"""Once again, the tired, poor, huddled masses have sailed right into my trap!"" Lady Liberty cackled, maniacally."
2097,3,14,90,107,1.1869158878504673,0.04430310533375682,551,"Land of the Free, Home of the Bad Comb-Over."
2097,5,10,92,107,1.1869158878504673,0.04811898407826445,551,"Look at those hands, are they small hands?"
2097,4,12,91,107,1.1869158878504673,0.046250414976182756,551,Pundits predicted a YUGE rogue wave.
2097,3,14,90,107,1.1869158878504673,0.04430310533375682,551,What is that saying about: 'rising tides?'
2097,4,12,91,107,1.1869158878504673,0.046250414976182756,551,Into the welcoming arms of the new administration.
2097,5,10,92,107,1.1869158878504673,0.04811898407826445,551,I think Neptune is trying to make the ocean great again.
2097,2,16,89,107,1.1869158878504673,0.042266173223498654,551,"A sea change is bad enough, but this Trumps everything."
2097,3,14,90,107,1.1869158878504673,0.04430310533375682,551,They call it the Orange Wave.
2097,3,14,90,107,1.1869158878504673,0.04430310533375682,551,Help! New Jersey ahead. Turn back now!
2097,3,14,90,107,1.1869158878504673,0.04430310533375682,551,Kind of rethinking this stay-cation thing.
2097,6,8,93,107,1.1869158878504673,0.04991765591430978,551,It's hard not to take it personally.
2097,2,16,89,107,1.1869158878504673,0.042266173223498654,551,"Note the unruly crest, empty barrel, & tiny hands crashing on the starboard side"
2097,2,16,89,107,1.1869158878504673,0.042266173223498654,551,I've never seen an orange-colored wave before.
2097,6,8,93,107,1.1869158878504673,0.04991765591430978,551,Quick. Give it the pussy cat!
2097,2,16,89,107,1.1869158878504673,0.042266173223498654,551,Keep going north to Canada?
2097,5,10,92,107,1.1869158878504673,0.04811898407826445,551,"Quick, Aisha, you're the hair stylist! Do something!"
2097,5,10,92,107,1.1869158878504673,0.04811898407826445,551,I'm not sure that this is the way to Cuba.
2097,3,14,90,107,1.1869158878504673,0.04430310533375682,551,I knew he wanted to keep us out - but a wall of water??
2097,6,8,93,107,1.1869158878504673,0.04991765591430978,551,"Dude, you need a new look for 2017."
2097,3,14,90,107,1.1869158878504673,0.04430310533375682,551,Maybe we should have tried our luck with the 'crooked' wave.
2097,5,10,92,107,1.1869158878504673,0.04811898407826445,551,Look! It's the wave of harassment after Trump's victory!
2097,3,14,90,107,1.1869158878504673,0.04430310533375682,551,New York City sewer system backs-up!!!
2097,6,8,93,107,1.1869158878504673,0.04991765591430978,551,What do you mean no more wretched refuse?
2097,2,16,89,107,1.1869158878504673,0.042266173223498654,551,He's waving us through!
2097,2,16,89,107,1.1869158878504673,0.042266173223498654,551,Wow! That's overwhelming! It's Yuge!
2097,5,10,92,107,1.1869158878504673,0.04811898407826445,551,Oh NO! ... it's the Trump sea wall!
2097,3,14,90,107,1.1869158878504673,0.04430310533375682,551,"He's called Donny Tsunami, but not to worry. This too shall pass."
2097,4,12,91,107,1.1869158878504673,0.046250414976182756,551,Bad hair days ahead!
2097,2,16,89,107,1.1869158878504673,0.042266173223498654,551,How's that welcome grab you?
2097,3,14,90,107,1.1869158878504673,0.04430310533375682,551,I voted for him and look what I got.
2097,3,14,90,107,1.1869158878504673,0.04430310533375682,551,"Back off, you rogue. We're emigrating!"
2097,2,16,89,107,1.1869158878504673,0.042266173223498654,551,"Oh no, and there's one tiny hand for each of us!"
2097,6,8,93,107,1.1869158878504673,0.04991765591430978,551,Google Maps says this is the fastest route
2097,4,12,91,107,1.1869158878504673,0.046250414976182756,551,"Glad you enjoyed the huddled masses thing. And now, on to capitalism..."
2097,5,10,92,107,1.1869158878504673,0.04811898407826445,551,I have a bad feeling about this.
2097,1,18,88,107,1.1869158878504673,0.04012597233343557,551,Immigrating to the U.S. is going to be tougher than I thought.
2097,4,12,91,107,1.1869158878504673,0.046250414976182756,551,"So, about those jobs..."
2097,3,14,90,107,1.1869158878504673,0.04430310533375682,551,What small hands you have!
2097,5,10,92,107,1.1869158878504673,0.04811898407826445,551,This is your classic triumphant wave!
2097,4,12,91,107,1.1869158878504673,0.046250414976182756,551,It's the volatile reaction you get when you mix over treated hair and hot air.
2097,3,14,90,107,1.1869158878504673,0.04430310533375682,551,This place has gotten far too hairy.
2097,2,16,89,107,1.1869158878504673,0.042266173223498654,551,At least there's no wall.
2097,7,6,94,107,1.1869158878504673,0.051653732829627944,551,This wave of populism will consume us all!
2097,3,14,90,107,1.1869158878504673,0.04430310533375682,551,"Quick, toss your Tic Tacs overboard."
2097,4,12,91,107,1.1869158878504673,0.046250414976182756,551,Does that comb-over look familiar to you?
2097,2,16,89,107,1.1869158878504673,0.042266173223498654,551,We should have gone with Liberty Mutual
2143,2,16,90,108,1.1851851851851851,0.04190874258156364,551,It's a rare comb-over wave.
2143,2,16,90,108,1.1851851851851851,0.04190874258156364,551,Forget about us. We're heading upriver to Canada.
2143,3,14,91,108,1.1851851851851851,0.043925083623096,551,They said Trump rode a tidal wave to victory.
2143,6,8,94,108,1.1851851851851851,0.049483570716760204,551,""" You don't bother me; I'm a Republican and there's no global warming ! ""  Submitted by Neil L. Sachs, Monmouth Junction, NJ ."
2143,1,18,89,108,1.1851851851851851,0.039790356095912936,551,Hang on folks! Looks like that unprecedented wave we've been hearing so much about.
2143,8,4,96,108,1.1851851851851851,0.05286553039492774,551,"Yeah, but what about the statue's emails?"
2143,4,12,92,108,1.1851851851851851,0.0458528432905113,551,Swamped!
2143,4,12,92,108,1.1851851851851851,0.0458528432905113,551,Shoot! I wanted to meet Ivanka!
2143,3,14,91,108,1.1851851851851851,0.043925083623096,551,That's the last time I have the taco bowl at Trump Tower.
2143,3,14,91,108,1.1851851851851851,0.043925083623096,551,"Sure it looks like Trump,... that's the scariest part of it!"
2143,5,10,93,108,1.1851851851851851,0.047702762020163963,551,Hurricane Donald!
2143,2,16,90,108,1.1851851851851851,0.04190874258156364,551,"Not a beach comber, a comb-over. As waves go it's a four."
2143,3,14,91,108,1.1851851851851851,0.043925083623096,551,Donald is doing the wave!
2143,3,14,91,108,1.1851851851851851,0.043925083623096,551,"Don’t worry, what doesn't kill you, makes you greater!"
2143,4,12,92,108,1.1851851851851851,0.0458528432905113,551,Now watch as the Trump wave slowly trickles down.
2143,4,12,92,108,1.1851851851851851,0.0458528432905113,551,"Don't huddle in a mass! And ladies, watch out for those tiny hands! They're grabbers."
2143,2,16,90,108,1.1851851851851851,0.04190874258156364,551,Does he think he’s fooling the other waves with that comb over?
2143,3,14,91,108,1.1851851851851851,0.043925083623096,551,Looks like the hair is real.
2143,3,14,91,108,1.1851851851851851,0.043925083623096,551,"Don't worry, he will never be President."
2162,3,14,92,109,1.18348623853211,0.0435533846923308,551,I'm not sure but I know it's not one of compassion.
2162,5,10,94,109,1.18348623853211,0.04729362164999815,551,I still say we should give it a chance.
2162,4,12,93,109,1.18348623853211,0.04546198393675384,551,Even his wall has a comb-over.
2162,7,6,96,109,1.18348623853211,0.05075899899907594,551,It looks like Donald Trump.
2162,5,10,94,109,1.18348623853211,0.04729362164999815,551,Very small hands. We should be fine.
2162,3,14,92,109,1.18348623853211,0.0435533846923308,551,"Quick, we must waterboard a minority to appease the sea of anger"
2162,2,16,91,109,1.18348623853211,0.04155722142841897,551,Turns out Mexico didn't want to pay for the wall... this is the backup plan.
2162,5,10,94,109,1.18348623853211,0.04729362164999815,551,The YUGE wave reached out with a thousand tiny hands.
2162,2,16,91,109,1.18348623853211,0.04155722142841897,551,I'm not sure why we rowed out here it's only ONE big wave created by a blast of hot air!
2162,4,12,93,109,1.18348623853211,0.04546198393675384,551,But we're the huddled masses yearning to breathe free.
2162,1,18,90,109,1.18348623853211,0.039460207646984526,551,Look ! We can ride the wave of discontent to liberty tower .
2162,2,16,91,109,1.18348623853211,0.04155722142841897,551,"Okay everybody, this is it - start yearning to breathe free."
2162,6,8,95,109,1.18348623853211,0.04905691912544736,551,We'd have been safe with Jonah
2162,4,12,93,109,1.18348623853211,0.04546198393675384,551,She's fired!
2162,3,14,92,109,1.18348623853211,0.0435533846923308,551,After a half hour Sandy began to wonder if the mushrooms used in the salad were actually portabellas.
2162,2,16,91,109,1.18348623853211,0.04155722142841897,551,Oh no! There's that deplorable wave again.
2162,2,16,91,109,1.18348623853211,0.04155722142841897,551,"""Is it saying 'come over' or 'comb-over'?"
2179,3,14,93,110,1.1818181818181819,0.04318785349158611,551,How did it get so big with such tiny hands?
2179,2,16,92,110,1.1818181818181819,0.0412114670670419,551,Looks like a Trumpest brewing.
2179,3,14,93,110,1.1818181818181819,0.04318785349158611,551,He really DOES have small hands.
2179,6,8,96,110,1.1818181818181819,0.048637513334762385,551,"... and this short-fingered creature emerged, just as the Washington swamps were being drained."
2179,2,16,92,110,1.1818181818181819,0.0412114670670419,551,It's gonna be tremendous!
2184,2,15,88,105,1.180952380952381,0.04232473532055043,551,"Don't worry, it's not a Tsunami it's a Trumpnami. They look scary but are 80% hair."
2184,4,11,90,105,1.180952380952381,0.04645087282554565,551,"This is going to be ""uge."""
2184,4,11,90,105,1.180952380952381,0.04645087282554565,551,"Farewell liberal elite, enjoy Canada."
2184,4,11,90,105,1.180952380952381,0.04645087282554565,551,"All hands were saved; the ship's cat however, was indeed… Grabbed"
2184,5,9,91,105,1.180952380952381,0.048382163752825266,551,"All right, everyone. Please calmly form a huddled mass at the rear of the boat."
2184,1,17,87,105,1.180952380952381,0.04010278091110972,551,What would Captain Ahab do?
2184,5,9,91,105,1.180952380952381,0.048382163752825266,551,Now Trump is colluding with the weather?!
2184,3,13,89,105,1.180952380952381,0.04443572215126961,551,"Oh shit, we should have come here before he became President."
2184,2,15,88,105,1.180952380952381,0.04232473532055043,551,"Quick, ladies - tops off and forward!"
2184,7,5,93,105,1.180952380952381,0.05203012719286361,551,Anybody else see that?
2184,1,17,87,105,1.180952380952381,0.04010278091110972,551,"Hold on, everyone! This one's going to be hairy!"
2184,4,11,90,105,1.180952380952381,0.04645087282554565,551,"...a three hour tour, a three hour tour...."
2184,4,11,90,105,1.180952380952381,0.04645087282554565,551,Give me your poor and your drowning
2184,5,9,91,105,1.180952380952381,0.048382163752825266,551,WHO KNOWS THE KADISH ?
2184,2,15,88,105,1.180952380952381,0.04232473532055043,551,"So is this his idea of a ""great, big, beautiful wall""?"
2184,6,7,92,105,1.180952380952381,0.050239267038397185,551,The next one's a biggly.
2184,3,13,89,105,1.180952380952381,0.04443572215126961,551,Weather forecast for tonight: dark and Trumpy.
2184,7,5,93,105,1.180952380952381,0.05203012719286361,551,Oh No! It's the dreaded tsuDONNY!
2184,2,15,88,105,1.180952380952381,0.04232473532055043,551,"A dangerous wave, but with such small curls, we can ride it out."
2184,3,13,89,105,1.180952380952381,0.04443572215126961,551,Time and toupee wait for no man.
2184,5,9,91,105,1.180952380952381,0.048382163752825266,551,We're in luck. The Lusitania is just leaving and will pick us up.
2184,1,17,87,105,1.180952380952381,0.04010278091110972,551,This still beats traffic on the East River Drive.
2184,5,9,91,105,1.180952380952381,0.048382163752825266,551,"We're about to do so much swimming, folks, that pretty soon you're gonna be tired of swimming."
2184,2,15,88,105,1.180952380952381,0.04232473532055043,551,"It's OK, he doesn't mean half the things he says."
2184,3,13,89,105,1.180952380952381,0.04443572215126961,551,He says he's going to make America wave again.
2184,0,19,86,105,1.180952380952381,0.03775026958386235,551,"Don't panic;, we can handle any Trumped-up wave."
2184,5,9,91,105,1.180952380952381,0.048382163752825266,551,The huddled masses had it easy.
2184,4,11,90,105,1.180952380952381,0.04645087282554565,551,Don't recognize him without the hat.
2184,4,11,90,105,1.180952380952381,0.04645087282554565,551,I hope this isn't practice for emptying the swamp in Washington!
2184,2,15,88,105,1.180952380952381,0.04232473532055043,551,"Hey Muhammad,...quick question...did you put down ""Proud Muslim"" on your visa again?"
2184,3,13,89,105,1.180952380952381,0.04443572215126961,551,The hair looks familiar.
2184,4,11,90,105,1.180952380952381,0.04645087282554565,551,"Oh my God...It's Trump , the self proclaimed god of the sea and his little hands pushing us away."
2184,2,15,88,105,1.180952380952381,0.04232473532055043,551,Looks like the statue has changed her mind.
2184,5,9,91,105,1.180952380952381,0.048382163752825266,551,Beware all ye who enter here
2184,2,15,88,105,1.180952380952381,0.04232473532055043,551,I told you we should've used our air miles.
2184,3,13,89,105,1.180952380952381,0.04443572215126961,551,Oh my God! He wasn't kidding!
2184,2,15,88,105,1.180952380952381,0.04232473532055043,551,Looks real to me!
2184,3,13,89,105,1.180952380952381,0.04443572215126961,551,"Women, don't let it grab your-"
2184,3,13,89,105,1.180952380952381,0.04443572215126961,551,We're tired and poor huddled masses who'd rather breathe free in Canada.
2184,3,13,89,105,1.180952380952381,0.04443572215126961,551,We're taking the next wave out.
2184,2,15,88,105,1.180952380952381,0.04232473532055043,551,Don't blame me; I voted third-party.
2184,4,11,90,105,1.180952380952381,0.04645087282554565,551,Immigration is about to get hairy!
2184,6,7,92,105,1.180952380952381,0.050239267038397185,551,I guess climate change IS real!
2184,4,11,90,105,1.180952380952381,0.04645087282554565,551,Donald J. Tsunami
2184,6,7,92,105,1.180952380952381,0.050239267038397185,551,We're Saved!
2184,5,9,91,105,1.180952380952381,0.048382163752825266,551,We want to call this part of the wall 'Death by Small Hands.'
2184,6,7,92,105,1.180952380952381,0.050239267038397185,551,That's sure one ugly looking squall!
2184,3,13,89,105,1.180952380952381,0.04443572215126961,551,"Let's take heart and pull together. This may look overwhelming because it's big, disgusting, ugly and orange but don't worry folks; it's not a permanent wave."
2184,4,11,90,105,1.180952380952381,0.04645087282554565,551,Just soak it all in.
2184,2,15,88,105,1.180952380952381,0.04232473532055043,551,Hold on to your you know what!
2184,4,11,90,105,1.180952380952381,0.04645087282554565,551,Where's Molly Brown when you need her?
2184,3,13,89,105,1.180952380952381,0.04443572215126961,551,"You were right, Margaret, we should have taken the ferry to Staten Island."
2184,5,9,91,105,1.180952380952381,0.048382163752825266,551,"You were right, honey – this totally beats the thing that I wanted to do."
2184,1,17,87,105,1.180952380952381,0.04010278091110972,551,Yes! We're all Trump supporters.
2184,2,15,88,105,1.180952380952381,0.04232473532055043,551,Give. Me. Your. Huddled. Masses. Bwahahahaha
2184,4,11,90,105,1.180952380952381,0.04645087282554565,551,"I know it says poor and huddled, but what about wet?"
2184,3,13,89,105,1.180952380952381,0.04443572215126961,551,It's either a wave of grief or a hot air Tweet Storm .. get ready for a bumpy ride .
2184,2,15,88,105,1.180952380952381,0.04232473532055043,551,Swamped! By hands...and a wave-over!
2184,1,17,87,105,1.180952380952381,0.04010278091110972,551,"And this, ladies and gentlemen, will soon replace the Statue of Liberty"
2184,4,11,90,105,1.180952380952381,0.04645087282554565,551,The waves of nausea are especially choppy lately.
2184,4,11,90,105,1.180952380952381,0.04645087282554565,551,"Oh no, its the trumpocalypse!"
2184,4,11,90,105,1.180952380952381,0.04645087282554565,551,"Don't panic, it's just a title weave."
2184,4,11,90,105,1.180952380952381,0.04645087282554565,551,Don't worry...this wave will crash bigly.
2184,5,9,91,105,1.180952380952381,0.048382163752825266,551,The dangers of hand wavey immigration policy
2184,5,9,91,105,1.180952380952381,0.048382163752825266,551,"The tired, the poor and the huddled masses flee the Trump tsunami."
2184,3,13,89,105,1.180952380952381,0.04443572215126961,551,"If you ask me, this is more of an American nightmare."
2184,4,11,90,105,1.180952380952381,0.04645087282554565,551,There's a pretty funny joke about small hands and a big mouth but I just can't remember it.
2184,4,11,90,105,1.180952380952381,0.04645087282554565,551,Blimey! It's Don the Beachcombover!
2184,1,17,87,105,1.180952380952381,0.04010278091110972,551,You'd think he'd be pleased to se us leave.
2184,3,13,89,105,1.180952380952381,0.04443572215126961,551,Welcome to the new Ellis Island!
2184,4,11,90,105,1.180952380952381,0.04645087282554565,551,And this had to be Jonah's day off?
2184,3,13,89,105,1.180952380952381,0.04443572215126961,551,"No, this isn't global warming, it's more corporate."
2184,3,13,89,105,1.180952380952381,0.04443572215126961,551,"Sure, you're tired, you're poor, you're in huddled masses yearning to breathe free, but you've got to go back where you came from, fill out your paperwork and get in line. You'll come back legally, BELIEVE ME."
2184,3,13,89,105,1.180952380952381,0.04443572215126961,551,"Quick, show the Donald your ID."
2184,4,11,90,105,1.180952380952381,0.04645087282554565,551,"It was inevitable. From Business Tycoon, to Presidency, and now he's King of the Seas."
2184,3,13,89,105,1.180952380952381,0.04443572215126961,551,A rising tide lifts and separates.
2184,4,11,90,105,1.180952380952381,0.04645087282554565,551,"Finally, a rising tide to lift our boat."
2184,3,13,89,105,1.180952380952381,0.04443572215126961,551,With hair like that how dangerous can it be?
2184,4,11,90,105,1.180952380952381,0.04645087282554565,551,He says he wants to play Hide the Tsunami.
2184,4,11,90,105,1.180952380952381,0.04645087282554565,551,See I told you this was New York. The Statue of Liberty is on the right and that's Donald Trump right in front of us.
2184,6,7,92,105,1.180952380952381,0.050239267038397185,551,Don't worry. Hillary's got this.
2184,2,15,88,105,1.180952380952381,0.04232473532055043,551,Don't worry. He doesn't mean it literally.
2184,2,15,88,105,1.180952380952381,0.04232473532055043,551,I'm afraidwe're about to become huddled masses yearning to breathe.
2184,3,13,89,105,1.180952380952381,0.04443572215126961,551,I'm thinking we should keep paddling to Halifax.
2184,6,7,92,105,1.180952380952381,0.050239267038397185,551,"Coming to deport your tired, your poor, your huddled masses yearning to breathe free."
2184,3,13,89,105,1.180952380952381,0.04443572215126961,551,Welcome to the U.S.A.
2184,5,9,91,105,1.180952380952381,0.048382163752825266,551,Great. From tempest-tossed to Trumpest-tossed.
2184,3,13,89,105,1.180952380952381,0.04443572215126961,551,The Lady is a Trump!
2184,4,11,90,105,1.180952380952381,0.04645087282554565,551,No more poor or tempest tossed
2184,4,11,90,105,1.180952380952381,0.04645087282554565,551,"Well, at least the billionaires are safe."
2184,3,13,89,105,1.180952380952381,0.04443572215126961,551,I'm confused-- Is Trump welcoming us or trying to drown us?
2184,5,9,91,105,1.180952380952381,0.048382163752825266,551,See? It only looks scary to spineless liberal types.
2276,5,10,96,111,1.1801801801801801,0.046495881825511086,551,"New York, New York, a helluva town. The waves are up, and the City is down. The people sail in a hole in the groun'. New York, New York, it's a helluva town!!"
2277,2,15,89,106,1.179245283018868,0.041958285473954755,551,We should have left when we said we were going to.
2277,4,11,91,106,1.179245283018868,0.0460422279928785,551,OH NO...that wave is HUGE!
2277,5,9,92,106,1.179245283018868,0.047953949554394006,551,Ahhh...the fickle fingers of fate.
2277,3,13,90,106,1.179245283018868,0.04404761332048586,551,And the next mile is sponsored by Trump Enterprises.
2277,7,5,94,106,1.179245283018868,0.051565204513311945,551,"Jeez, talk about plagiarism."
2277,1,17,88,106,1.179245283018868,0.039759315896991006,551,Quick! Everyone praise its fabulous hair style and enormous hands!
2277,3,13,90,106,1.179245283018868,0.04404761332048586,551,"Ahoy! We bring tired, poor, huddled hands to help your tiny ones..."
2277,2,15,89,106,1.179245283018868,0.041958285473954755,551,"Quick, somebody tell him what the statue says!"
2277,3,13,90,106,1.179245283018868,0.04404761332048586,551,Poseidon has been Trumped.
2286,2,15,90,107,1.1775700934579438,0.04159804659525817,551,He's making sailing great again!
2286,1,17,89,107,1.1775700934579438,0.039421589735652615,551,"nobody, not even that wave, has such small hands."
2288,4,10,90,104,1.1730769230769231,0.046220700895214704,551,"Ladies, remember, we asked for this."
2288,3,12,89,104,1.1730769230769231,0.04415480374612475,551,"Straight ahead, the yang of Trump's coiffure, and to your right, ladies and gentlemen, the ying of Lady Liberty. Now, paddle desperately in a circle for 2020, please."
2288,3,12,89,104,1.1730769230769231,0.04415480374612475,551,...and on your right...
2288,4,10,90,104,1.1730769230769231,0.046220700895214704,551,Do any of you have a comb?
2288,4,10,90,104,1.1730769230769231,0.046220700895214704,551,"Yes, I see what you mean, there is a resemblance."
2288,2,14,88,104,1.1730769230769231,0.04198738139575608,551,"Excuse me sir, is that a Mexican wave?"
2288,1,16,87,104,1.1730769230769231,0.039701809770923226,551,"If you can make it here, you can make it anywhere."
2288,4,10,90,104,1.1730769230769231,0.046220700895214704,551,I'm sure you'll be happy to learn it was all a bad dream.
2288,4,10,90,104,1.1730769230769231,0.046220700895214704,551,"For God's Sake,somebody grab the Hair!"
2288,2,14,88,104,1.1730769230769231,0.04198738139575608,551,Is our boat being swamped or trumped?
2288,4,10,90,104,1.1730769230769231,0.046220700895214704,551,Just a hoax folks.
2288,7,4,93,104,1.1730769230769231,0.05192757151459356,551,But your hair ISN'T good.
2288,5,8,91,104,1.1730769230769231,0.04819812951382046,551,The Donald just gets more power hungry every day!
2288,6,6,92,104,1.1730769230769231,0.05009756666762488,551,"Donald Trump is building a wave, too."
2288,2,14,88,104,1.1730769230769231,0.04198738139575608,551,To make your deportation memorable Trump sends his farewell.
2288,3,12,89,104,1.1730769230769231,0.04415480374612475,551,"Steady, mates - make the comb-over wash-over."
2288,2,14,88,104,1.1730769230769231,0.04198738139575608,551,"Take it in, people -- classic lesson in branding!"
2288,4,10,90,104,1.1730769230769231,0.046220700895214704,551,Wait! We are wearing Trump life vests!
2288,4,10,90,104,1.1730769230769231,0.046220700895214704,551,Here we have an example of the government's new immigration reform initiative.
2288,3,12,89,104,1.1730769230769231,0.04415480374612475,551,Bernie would've won.
2288,3,12,89,104,1.1730769230769231,0.04415480374612475,551,Don't leave. I'm going to make America great again.
2288,2,14,88,104,1.1730769230769231,0.04198738139575608,551,"She was supposed to lift her lamp beside the golden door, not the orange wave."
2288,5,8,91,104,1.1730769230769231,0.04819812951382046,551,"O Captain, My Captain--get back in the boat!"
2288,4,10,90,104,1.1730769230769231,0.046220700895214704,551,"Hey, it looks just like Trump! We have nothing to worry about!"
2288,2,14,88,104,1.1730769230769231,0.04198738139575608,551,We're going to need a much bigger boat!
2288,4,10,90,104,1.1730769230769231,0.046220700895214704,551,Isn't this how The Perfect Storm ended?
2288,4,10,90,104,1.1730769230769231,0.046220700895214704,551,"On the count of three, 'Row row row your boat,'"
2288,4,10,90,104,1.1730769230769231,0.046220700895214704,551,"It's not a perfect storm, but it's certainly a bigly wall of water."
2288,3,12,89,104,1.1730769230769231,0.04415480374612475,551,"Grab me some tired, poor, huddled masses to clean my golden commode."
2288,3,12,89,104,1.1730769230769231,0.04415480374612475,551,I told you this would be more exciting than the Circle Line cruise.
2288,2,14,88,104,1.1730769230769231,0.04198738139575608,551,I'm initiating a strongly worded rebuttal about this.
2288,4,10,90,104,1.1730769230769231,0.046220700895214704,551,"Oh no, it's a dreaded suTrumpi!"
2288,4,10,90,104,1.1730769230769231,0.046220700895214704,551,Relax. It's just a trickle-down squall.
2288,5,8,91,104,1.1730769230769231,0.04819812951382046,551,They're a lot less amber than I was expecting.
2288,3,12,89,104,1.1730769230769231,0.04415480374612475,551,It's the new Wave Wall.
2288,5,8,91,104,1.1730769230769231,0.04819812951382046,551,Wow! Didn't I tell you this beats the Staten Island Ferry?
2288,4,10,90,104,1.1730769230769231,0.046220700895214704,551,"Since November, Lady Liberty shares NY's Harbor with Munch's less well-known work: 'Wave'."
2288,6,6,92,104,1.1730769230769231,0.05009756666762488,551,Next time we'll spend the extra money for the guided boat tour.
2288,4,10,90,104,1.1730769230769231,0.046220700895214704,551,"Meh, he's not gonna get us. He doesn't even have experience being a wave."
2288,3,12,89,104,1.1730769230769231,0.04415480374612475,551,A word to the wise--don't rock the boat.
2288,2,14,88,104,1.1730769230769231,0.04198738139575608,551,"Oh, no -- it's Hurricane Donald! Watch out for those tiny hands, ladies."
2288,4,10,90,104,1.1730769230769231,0.046220700895214704,551,I've a feeling we're not in Kansas any more.
2288,1,16,87,104,1.1730769230769231,0.039701809770923226,551,Et tu Kraken?
2288,4,10,90,104,1.1730769230769231,0.046220700895214704,551,What the hell do you have to lose?
2288,3,12,89,104,1.1730769230769231,0.04415480374612475,551,Now I feel wretched.
2288,3,12,89,104,1.1730769230769231,0.04415480374612475,551,Even hurricane Trump has a bad wave.
2288,4,10,90,104,1.1730769230769231,0.046220700895214704,551,We always knew the Hudson would eventually avenge for Sully.
2288,4,10,90,104,1.1730769230769231,0.046220700895214704,551,"Oh, no. It's the Trumpusami!"
2288,5,8,91,104,1.1730769230769231,0.04819812951382046,551,"Women, children and immigrants first"
2288,5,8,91,104,1.1730769230769231,0.04819812951382046,551,"On second thought, maybe those 'teeming shores' weren't so bad."
2288,2,14,88,104,1.1730769230769231,0.04198738139575608,551,These little town blues...
2288,2,14,88,104,1.1730769230769231,0.04198738139575608,551,New Secretary of the Navy.
2288,2,14,88,104,1.1730769230769231,0.04198738139575608,551,'Hard left rudder - Trumpnami ahead'
2288,5,8,91,104,1.1730769230769231,0.04819812951382046,551,We come to TWEET your greatness oh wavy haired one
2288,1,16,87,104,1.1730769230769231,0.039701809770923226,551,You think this is bad? You should see the security at Trump Tower.
2288,4,10,90,104,1.1730769230769231,0.046220700895214704,551,First a wall and now a wave?
2288,1,16,87,104,1.1730769230769231,0.039701809770923226,551,"Damnit Jane, I told you not to tweet at @realdonaldtrump until after we got to Canada!"
2288,3,12,89,104,1.1730769230769231,0.04415480374612475,551,Who said this was the best way to get to Ellis Island?
2288,4,10,90,104,1.1730769230769231,0.046220700895214704,551,"It does look like Trump, right down to the small hands."
2288,4,10,90,104,1.1730769230769231,0.046220700895214704,551,Hokusai influences Trump in securing our borders.
2288,4,10,90,104,1.1730769230769231,0.046220700895214704,551,We're looking for Ellis Island
2288,1,16,87,104,1.1730769230769231,0.039701809770923226,551,"I thought it was a symbol to come over here, not comb over here."
2288,2,14,88,104,1.1730769230769231,0.04198738139575608,551,"Oh, Oh!!!! We're in for another HAIRY experience!!"
2288,2,14,88,104,1.1730769230769231,0.04198738139575608,551,"I can't decide if it's art deco, oil spill, or paisley."
2288,3,12,89,104,1.1730769230769231,0.04415480374612475,551,Don't worry. He only eats immigrants.
2288,2,14,88,104,1.1730769230769231,0.04198738139575608,551,I think we should have taken the Circle Line tour.
2288,1,16,87,104,1.1730769230769231,0.039701809770923226,551,"It's his latest version of ""THE WALL""."
2288,3,12,89,104,1.1730769230769231,0.04415480374612475,551,We're tourists Mr. President-elect!
2288,5,8,91,104,1.1730769230769231,0.04819812951382046,551,At least my economic anxiety is gone!
2288,3,12,89,104,1.1730769230769231,0.04415480374612475,551,I have a feeling this isn't going to be a tempest in a teacup...
2288,2,14,88,104,1.1730769230769231,0.04198738139575608,551,He's not the regular sea monster
2288,2,14,88,104,1.1730769230769231,0.04198738139575608,551,"OK everyone, hold for the extreme vetting!"
2288,2,14,88,104,1.1730769230769231,0.04198738139575608,551,"""It's OK, Mr. Trump. We're all naturalized."
2288,2,14,88,104,1.1730769230769231,0.04198738139575608,551,"And, up ahead is that killer wave I mentioned earlier."
2288,2,14,88,104,1.1730769230769231,0.04198738139575608,551,And ahead we have the new Wave of Immigration
2288,3,12,89,104,1.1730769230769231,0.04415480374612475,551,It'll run its course.
2288,3,12,89,104,1.1730769230769231,0.04415480374612475,551,"It's HUGE! Quick, yearn to be free."
2288,2,14,88,104,1.1730769230769231,0.04198738139575608,551,Hold on everyone! This one is bad! Very bad!
2288,3,12,89,104,1.1730769230769231,0.04415480374612475,551,I guess this rising tide is meant for other boats!
2288,3,12,89,104,1.1730769230769231,0.04415480374612475,551,"Oh, that's right... It inauguration day!"
2288,3,12,89,104,1.1730769230769231,0.04415480374612475,551,Maybe you could give us a push towards France?
2288,1,16,87,104,1.1730769230769231,0.039701809770923226,551,This might be more than just a one hour tour.
2288,3,12,89,104,1.1730769230769231,0.04415480374612475,551,Tweets from Trump theme park: Wretched refuse enter at your own risk. Crooked statue.
2288,3,12,89,104,1.1730769230769231,0.04415480374612475,551,Change course to the West Coast!
2288,7,4,93,104,1.1730769230769231,0.05192757151459356,551,This work was funded by the government and dates back to 2018 right before the midterms
2288,5,8,91,104,1.1730769230769231,0.04819812951382046,551,The right kind of headwind combs through any flyaway.
2288,6,6,92,104,1.1730769230769231,0.05009756666762488,551,I am now getting a distinct feeling that the environment here no longer welcomes our yearning to breathe free.
2288,5,8,91,104,1.1730769230769231,0.04819812951382046,551,Maybe we should head back.
2288,5,8,91,104,1.1730769230769231,0.04819812951382046,551,Quick. Throw the ex-mayor overboard.
2288,3,12,89,104,1.1730769230769231,0.04415480374612475,551,"Don't be afraid. On land, he used to be far more dangerous."
2288,4,10,90,104,1.1730769230769231,0.046220700895214704,551,It is a wig!
2288,3,12,89,104,1.1730769230769231,0.04415480374612475,551,Extreme vetting!
2288,6,6,92,104,1.1730769230769231,0.05009756666762488,551,Tiny hands and a comb-over don't scare us. We'll trump this wave. -USA
2288,4,10,90,104,1.1730769230769231,0.046220700895214704,551,Lying Lady Liberty--she never wanted your huddled masses.
2288,3,12,89,104,1.1730769230769231,0.04415480374612475,551,"Oh my .., it looks just like the evil border god of American political mythology"
2288,5,8,91,104,1.1730769230769231,0.04819812951382046,551,I didn't expect the wall to be so fluid!
2288,1,16,87,104,1.1730769230769231,0.039701809770923226,551,Even the waves look like him.
2385,3,12,90,105,1.1714285714285715,0.043763313740087635,551,And what if you can't make it there?
2385,3,12,90,105,1.1714285714285715,0.043763313740087635,551,It's heading to the Potomac River...
2385,3,12,90,105,1.1714285714285715,0.043763313740087635,551,Roll your eyes at it
2385,2,14,89,105,1.1714285714285715,0.04161823454164244,551,And now we're just seconds away from yearning to breathe free!
2389,1,16,89,106,1.169811320754717,0.03901689019197877,551,On the count of three you will wake up.
2390,3,11,88,102,1.1666666666666667,0.04424419392469564,551,"Who needs this?, the Staten Island Ferry is free!"
2390,2,13,87,102,1.1666666666666667,0.04199299507395459,551,Something tells me we're not in Kansas anymore
2390,2,13,87,102,1.1666666666666667,0.04199299507395459,551,I think that our days of riding the crest of a wave are about over...
2390,3,11,88,102,1.1666666666666667,0.04424419392469564,551,"Weather alert: Hurricane Donald expected historic category 6, gale force words, bombast to 20 feet, take cover"
2390,4,9,89,102,1.1666666666666667,0.04638626689884598,551,I guess Americans want climate change?
2390,4,9,89,102,1.1666666666666667,0.04638626689884598,551,"In America, asylum seeks you."
2390,4,9,89,102,1.1666666666666667,0.04638626689884598,551,Imagine what he'd do if he didn't want us to immigrate.
2390,2,13,87,102,1.1666666666666667,0.04199299507395459,551,I thought they were called white caps.
2390,3,11,88,102,1.1666666666666667,0.04424419392469564,551,"Don't worry, it won't be as bad as it looks."
2390,3,11,88,102,1.1666666666666667,0.04424419392469564,551,"On second thought, I don't think I'm THAT wretched."
2390,5,7,90,102,1.1666666666666667,0.04843369506424091,551,Look out! Its ignorance and intolerance!
2390,2,13,87,102,1.1666666666666667,0.04199299507395459,551,"Si, we are U.S. citizen."
2390,5,7,90,102,1.1666666666666667,0.04843369506424091,551,"Someday, this will be a Hollywood movie. So why don't we sing a song as we're drowning?"
2390,4,9,89,102,1.1666666666666667,0.04638626689884598,551,It's a rogue permanent wave!
2390,4,9,89,102,1.1666666666666667,0.04638626689884598,551,We should have listened to the weather briefing.
2390,3,11,88,102,1.1666666666666667,0.04424419392469564,551,Would you kindly point the way to Ellis Island?
2390,5,7,90,102,1.1666666666666667,0.04843369506424091,551,It's one thing to snarl traffic on the GWB but this is ridiculous!
2390,4,9,89,102,1.1666666666666667,0.04638626689884598,551,Trump's Immigration Poli-SEA
2390,5,7,90,102,1.1666666666666667,0.04843369506424091,551,"To your right you'll notice one of our famous trump-waves. They're great, they're huge, everybody loves them. This is not scripted, it's my honest opinion."
2390,3,11,88,102,1.1666666666666667,0.04424419392469564,551,I'll introduce you to my friend Davy Jones for some locker room talk. He's one of the good ones.
2390,3,11,88,102,1.1666666666666667,0.04424419392469564,551,"Quick, throw him a sweet tweet!"
2390,4,9,89,102,1.1666666666666667,0.04638626689884598,551,If we can just make it thru to the other side we will all be ok.
2390,2,13,87,102,1.1666666666666667,0.04199299507395459,551,No worries. Mr. Tiny Hands ain't gonna drain this swamp.
2390,5,7,90,102,1.1666666666666667,0.04843369506424091,551,"Where there is no Wall, there is The Wave."
2390,3,11,88,102,1.1666666666666667,0.04424419392469564,551,"Wait, didn't he say Great Wall?"
2390,5,7,90,102,1.1666666666666667,0.04843369506424091,551,"Don't give me your tired, your poor, Your huddled masses yearning to breathe free, Keep the wretched refuse of your teeming shore. Send these, the homeless, tempest-tossed, somewhere else"
2390,3,11,88,102,1.1666666666666667,0.04424419392469564,551,A Trumpnami ahead!
2390,4,9,89,102,1.1666666666666667,0.04638626689884598,551,Trump....you suck!
2390,2,13,87,102,1.1666666666666667,0.04199299507395459,551,"Okay, liberal New Yorkers! Welcome to the inaugural Trump Reality Cruise."
2390,6,5,91,102,1.1666666666666667,0.05039801462697489,551,"He may grab you by the p**** but don't worry girls, he won't get you wet!"
2390,6,5,91,102,1.1666666666666667,0.05039801462697489,551,Could that really be the golden door?
2390,2,13,87,102,1.1666666666666667,0.04199299507395459,551,Now that's a problem of biblical proportions!
2390,1,15,86,102,1.1666666666666667,0.03961407041085622,551,I don't think anyone of us are ready for the Republican wave
2390,5,7,90,102,1.1666666666666667,0.04843369506424091,551,Really scary....but did you know you can save 15% on your car insurance?
2390,3,11,88,102,1.1666666666666667,0.04424419392469564,551,"And to your right is Trump Tower, offering the ""huddled masses"" a different perspective."
2390,2,13,87,102,1.1666666666666667,0.04199299507395459,551,Derivative of James Cameron and Katsushika Hokusai while still evoking that Fukashima glow. How cliche.
2390,5,7,90,102,1.1666666666666667,0.04843369506424091,551,This wave in particular was inspired by Donald Trump.
2390,6,5,91,102,1.1666666666666667,0.05039801462697489,551,Ice hole straight ahead!
2390,2,13,87,102,1.1666666666666667,0.04199299507395459,551,"I thought he said a wall, not a wave!"
2390,2,13,87,102,1.1666666666666667,0.04199299507395459,551,Now do you understand how he’ll fix our trade deals?
2390,4,9,89,102,1.1666666666666667,0.04638626689884598,551,Which way do we row to get to Ellis Island?
2390,3,11,88,102,1.1666666666666667,0.04424419392469564,551,Please don't leave. It will be great!
2390,3,11,88,102,1.1666666666666667,0.04424419392469564,551,"I thought the tweet was about being tired, huddled, and yearning, but maybe that was only the Cabinet."
2390,4,9,89,102,1.1666666666666667,0.04638626689884598,551,"I say we let it drown us, it's the only way to start over!"
2390,4,9,89,102,1.1666666666666667,0.04638626689884598,551,I wish he'd stay in Washington!
2390,3,11,88,102,1.1666666666666667,0.04424419392469564,551,"Don't worry, the size of the hands doesn't correlate with the size of the waves."
2390,3,11,88,102,1.1666666666666667,0.04424419392469564,551,"Give me your terrified, your fool-hardy, yearning to capsize."
2390,4,9,89,102,1.1666666666666667,0.04638626689884598,551,"Give me your tired your poor, your -- Hey, hey, get the hell away from them!"
2390,5,7,90,102,1.1666666666666667,0.04843369506424091,551,"It's just a comb over, no worry..."
2390,2,13,87,102,1.1666666666666667,0.04199299507395459,551,I see the orange curl!
2390,2,13,87,102,1.1666666666666667,0.04199299507395459,551,He even finds a way to take credit for bringing water back to America!
2390,3,11,88,102,1.1666666666666667,0.04424419392469564,551,Don't be an alarmist--give the wave a chance.
2390,4,9,89,102,1.1666666666666667,0.04638626689884598,551,"Hold that pose, I want to get this on Instagram!"
2390,4,9,89,102,1.1666666666666667,0.04638626689884598,551,I didn't think that Trump had this much influence.
2390,5,7,90,102,1.1666666666666667,0.04843369506424091,551,The hair...tiny hands...everyone's trying to make their million capitalizing on Trump around here!
2390,4,9,89,102,1.1666666666666667,0.04638626689884598,551,It's the wave of the future. We all have the DTs.
2390,4,9,89,102,1.1666666666666667,0.04638626689884598,551,Attention My Fellow New York Row Boat Enthusiasts...we have the privilege of watching our new President Donald J. Trump make the Hudson River Great Again!
2390,5,7,90,102,1.1666666666666667,0.04843369506424091,551,Build the wall! Such big hands! We're Episcopalians!
2390,2,13,87,102,1.1666666666666667,0.04199299507395459,551,"Remember, a rising tide floats all boats"
2390,4,9,89,102,1.1666666666666667,0.04638626689884598,551,Keep your hands to yourself; these aren't no nasty women!!
2390,4,9,89,102,1.1666666666666667,0.04638626689884598,551,Yes by golly..............It's definitely a rouge wave.
2390,1,15,86,102,1.1666666666666667,0.03961407041085622,551,"Trust me, swimming is great cardio."
2390,0,17,85,102,1.1666666666666667,0.03708284662416539,551,"Gee, this is turning out to be a swell day."
2390,2,13,87,102,1.1666666666666667,0.04199299507395459,551,"2016 just keeps coming in waves, kids."
2390,5,7,90,102,1.1666666666666667,0.04843369506424091,551,So that's the dreaded wall.
2390,1,15,86,102,1.1666666666666667,0.03961407041085622,551,Not to worry -- a rising tide floats all boats!
2390,3,11,88,102,1.1666666666666667,0.04424419392469564,551,Donald has renamed this New York Hairbor.
2390,4,9,89,102,1.1666666666666667,0.04638626689884598,551,"Yeah, I guess I'm the only one who saw this coming."
2390,2,13,87,102,1.1666666666666667,0.04199299507395459,551,Get ready . . . We're about to be swamped!
2390,4,9,89,102,1.1666666666666667,0.04638626689884598,551,Where in hell did that come from?
2390,2,13,87,102,1.1666666666666667,0.04199299507395459,551,...But incredibly tiny hands.
2390,3,11,88,102,1.1666666666666667,0.04424419392469564,551,We knew that he opposed immigration!
2390,1,15,86,102,1.1666666666666667,0.03961407041085622,551,"Everyone take a deep breath and hold on, we're about to hit some strange white water!"
2390,2,13,87,102,1.1666666666666667,0.04199299507395459,551,They say it comes every eight years.
2390,4,9,89,102,1.1666666666666667,0.04638626689884598,551,Oh look! A rogue nationalist with small hands!
2390,2,13,87,102,1.1666666666666667,0.04199299507395459,551,Wow! Trump's Tsunami really is Disney's scariest ride!
2390,2,13,87,102,1.1666666666666667,0.04199299507395459,551,"Nope, nope, the water’s actually calm. Good day for boating. He said so on Twitter."
2390,4,9,89,102,1.1666666666666667,0.04638626689884598,551,At least there's only one!
2390,4,9,89,102,1.1666666666666667,0.04638626689884598,551,My! What big eyes you have.
2390,3,11,88,102,1.1666666666666667,0.04424419392469564,551,Get outta my hair!
2390,1,15,86,102,1.1666666666666667,0.03961407041085622,551,""" Lady Liberty Battles Trump World,"" Disney's newest and scariest ride is drawing mixed reviews."
2390,4,9,89,102,1.1666666666666667,0.04638626689884598,551,"Love trumps hate. And in an unexpected turn of events, Trump drowns love"
2390,3,11,88,102,1.1666666666666667,0.04424419392469564,551,There may be some lingering resentment.
2390,3,11,88,102,1.1666666666666667,0.04424419392469564,551,"Before she helps us come over, we have to make it through this awful comb-over."
2390,3,11,88,102,1.1666666666666667,0.04424419392469564,551,Thank goodness it's not real!
2390,2,13,87,102,1.1666666666666667,0.04199299507395459,551,"Ok, ok, you're gonna need a bigger boat"
2390,2,13,87,102,1.1666666666666667,0.04199299507395459,551,So much for the old huddled masses
2390,3,11,88,102,1.1666666666666667,0.04424419392469564,551,"He hasn’t swamped any of our boats yet, but several female passengers report being grabbed by the pussy."
2390,1,15,86,102,1.1666666666666667,0.03961407041085622,551,It'll pass by just like Bush did.
2390,4,9,89,102,1.1666666666666667,0.04638626689884598,551,"And on your right is the portion of the tour we call ""the opposite of Mount Rushmore."""
2390,4,9,89,102,1.1666666666666667,0.04638626689884598,551,"And on your right, ladies, we have the ghost of 2016."
2390,4,9,89,102,1.1666666666666667,0.04638626689884598,551,"He says the Mexicans will pay for this wall, too."
2390,3,11,88,102,1.1666666666666667,0.04424419392469564,551,"Women and Chicanos first, my ass!"
2390,4,9,89,102,1.1666666666666667,0.04638626689884598,551,"Policy change'; Tired, hungry, poor - out; best and brightest - in."
2390,3,11,88,102,1.1666666666666667,0.04424419392469564,551,"And this, ladies and gentlemen, is the repository of The Swamp."
2390,4,9,89,102,1.1666666666666667,0.04638626689884598,551,"He may appear menacing, but what harm could he do with such small hands?"
2390,3,11,88,102,1.1666666666666667,0.04424419392469564,551,"As you can see we have the most marvelous,most fantastic and the greatest waves ever! Period! Bigly!"
2390,5,7,90,102,1.1666666666666667,0.04843369506424091,551,"Trumpest in a teapot, this is not!"
2390,3,11,88,102,1.1666666666666667,0.04424419392469564,551,It's Trump's choice for Director of Immigration.
2390,1,15,86,102,1.1666666666666667,0.03961407041085622,551,"Quick, put on your tweet jackets."
2390,3,11,88,102,1.1666666666666667,0.04424419392469564,551,"Don't worry, he promised to keep us safe."
2390,6,5,91,102,1.1666666666666667,0.05039801462697489,551,I'm open to suggestions.
2390,2,13,87,102,1.1666666666666667,0.04199299507395459,551,He can't reach us. We're in the popular boat.
2390,1,15,86,102,1.1666666666666667,0.03961407041085622,551,Our only hope is extreme rowing!
2390,2,13,87,102,1.1666666666666667,0.04199299507395459,551,"Welcome, to the land of Extreme Vetting. He, he, he."
2390,1,15,86,102,1.1666666666666667,0.03961407041085622,551,"Take back your tired, your poor, your huddled masses yearning to breathe free ..."
2390,0,17,85,102,1.1666666666666667,0.03708284662416539,551,"""Is he trying to keep us out? Or is he trying to keep us in?"
2390,3,11,88,102,1.1666666666666667,0.04424419392469564,551,I knew nature would have the upper hand!
2390,6,5,91,102,1.1666666666666667,0.05039801462697489,551,"Row, wade, row, wade, we can row for Roe v. Wade!"
2390,4,9,89,102,1.1666666666666667,0.04638626689884598,551,"Last but not least on our Manhattan tour, the angry wave over"
2390,5,7,90,102,1.1666666666666667,0.04843369506424091,551,It was more effective than a wall.
2390,3,11,88,102,1.1666666666666667,0.04424419392469564,551,This is the moment the rise of the oceans will begin to be YUGE
2390,4,9,89,102,1.1666666666666667,0.04638626689884598,551,"First Trump wanted to keep people out, now he wants to keep people in?"
2390,3,11,88,102,1.1666666666666667,0.04424419392469564,551,"Wait! We're rested, rich, well-separated elites yearning for a strong leader."
2390,3,11,88,102,1.1666666666666667,0.04424419392469564,551,Hang on: It's Hurricane Donald.
2390,1,15,86,102,1.1666666666666667,0.03961407041085622,551,"Er, this concludes this part of the tour."
2390,5,7,90,102,1.1666666666666667,0.04843369506424091,551,"Watch out, ladies! This wave will grab you by the pussies!"
2390,2,13,87,102,1.1666666666666667,0.04199299507395459,551,We'll be fine if we don't rock the boat!
2390,2,13,87,102,1.1666666666666667,0.04199299507395459,551,Don't worry. It's just a bad hairpiece.
2390,3,11,88,102,1.1666666666666667,0.04424419392469564,551,"Prepare yourself for the deluge, folks!"
2390,4,9,89,102,1.1666666666666667,0.04638626689884598,551,Not so great!
2511,3,11,89,103,1.1650485436893203,0.043842403717448415,551,It looks like there is a new guardian of freedom at the entrance to New York Harbor.
2511,2,13,88,103,1.1650485436893203,0.04161476846774679,551,"I'd been considering leaving the Press Pool already, honestly."
2511,1,15,87,103,1.1650485436893203,0.0392609417299765,551,I don't think we're invited to help MAKE AMERICA GREAT AGAIN!
2511,0,17,86,103,1.1650485436893203,0.03675668832233187,551,Maybe we should try our luck with Germany..
2511,3,11,89,103,1.1650485436893203,0.043842403717448415,551,It's a bad hair day no matter where we go.
2511,1,15,87,103,1.1650485436893203,0.0392609417299765,551,"Look, Trump is waving at us!"
2511,7,3,93,103,1.1650485436893203,0.05180372573591578,551,We're Saved!
2511,1,15,87,103,1.1650485436893203,0.0392609417299765,551,He's taller in person than I thought he'd be.
2511,0,17,86,103,1.1650485436893203,0.03675668832233187,551,I don't like the look of that comb-over.
2511,2,13,88,103,1.1650485436893203,0.04161476846774679,551,"I turned her lamp off. If your yearning to breath free, you might try Canada."
2511,2,13,88,103,1.1650485436893203,0.04161476846774679,551,Looks like it was a ROGUE wave election!
2511,3,11,89,103,1.1650485436893203,0.043842403717448415,551,The Fake News Colossus
2511,4,9,90,103,1.1650485436893203,0.04596219939062204,551,We're going to pay for that wave
2524,3,11,91,105,1.161904761904762,0.043060162197363853,551,Who told him we're moving to Canada!
2525,2,12,87,101,1.1584158415841583,0.04158415841584158,551,So much for a welcoming party.
2525,2,12,87,101,1.1584158415841583,0.04158415841584158,551,Don't worry. All of his hands are really small.
2525,1,14,86,101,1.1584158415841583,0.03913083731756337,551,"Never mind the eye, I don't want to look at the hands!"
2525,4,8,89,101,1.1584158415841583,0.046100779116129954,551,Who checked the tide table?
2525,4,8,89,101,1.1584158415841583,0.046100779116129954,551,Grab them by Nyuyoku ichi. Yu Kando Oni thing.
2525,3,10,88,101,1.1584158415841583,0.043900592628505666,551,We know we're tired and poor but he didn't need to call us 'wretched refuse'.
2525,2,12,87,101,1.1584158415841583,0.04158415841584158,551,I hear there are calmer waters further north!
2525,1,14,86,101,1.1584158415841583,0.03913083731756337,551,This nice friendly wave will definitely help us. Yay!
2525,2,12,87,101,1.1584158415841583,0.04158415841584158,551,No way we can escape the Trump tsunami!
2525,3,10,88,101,1.1584158415841583,0.043900592628505666,551,We're the lucky ones.
2525,2,12,87,101,1.1584158415841583,0.04158415841584158,551,I see Voldemort. Or maybe Sauron. Who do you see?
2525,4,8,89,101,1.1584158415841583,0.046100779116129954,551,AND I thought when coming to America the beautiful we'd see amber waves of grain...!
2525,6,4,91,101,1.1584158415841583,0.050212761715271156,551,Make the wave great!
2525,0,16,85,101,1.1584158415841583,0.03651304735561539,551,Hair we go!!!
2525,2,12,87,101,1.1584158415841583,0.04158415841584158,551,Darn. I thought the Electoral College would save us.
2525,2,12,87,101,1.1584158415841583,0.04158415841584158,551,"Give me your tired, your poor, your huddled masses yearning to breathe free, the wretched refuse of your teeming shore. Send these, the homeless, tempest-tossed to me, I lift my JAWS beside the golden door!"
2525,2,12,87,101,1.1584158415841583,0.04158415841584158,551,This is a swell howdy-do.
2525,3,10,88,101,1.1584158415841583,0.043900592628505666,551,Who wants a tickle?
2525,2,12,87,101,1.1584158415841583,0.04158415841584158,551,"Quick, bring out the taco bowl to appease it!"
2525,3,10,88,101,1.1584158415841583,0.043900592628505666,551,Who you gonna call?
2525,3,10,88,101,1.1584158415841583,0.043900592628505666,551,That? It's Poisidon's last warning to turn back from Trumpland.
2525,1,14,86,101,1.1584158415841583,0.03913083731756337,551,A rising tide lifts all ships! A rising tide lifts all ships! A ris---
2525,2,12,87,101,1.1584158415841583,0.04158415841584158,551,"Man, I miss the L train."
2525,2,12,87,101,1.1584158415841583,0.04158415841584158,551,"I swear I just heard that tsunami yell, ""you're fired!"""
2525,2,12,87,101,1.1584158415841583,0.04158415841584158,551,I thought he was building a wall in Mexico?
2525,3,10,88,101,1.1584158415841583,0.043900592628505666,551,"Told ya. New York--Home of the ""Swells!"""
2525,3,10,88,101,1.1584158415841583,0.043900592628505666,551,"Compared to the Statue of Liberty's, I suppose they are."
2525,3,10,88,101,1.1584158415841583,0.043900592628505666,551,You had to bid one NO Trump!
2525,4,8,89,101,1.1584158415841583,0.046100779116129954,551,"Amigos, it looks like we have a waiver."
2525,3,10,88,101,1.1584158415841583,0.043900592628505666,551,It's the new Trumpnami water feature at Ellis Island.
2525,2,12,87,101,1.1584158415841583,0.04158415841584158,551,"Don't worry, it is a hoax!"
2525,2,12,87,101,1.1584158415841583,0.04158415841584158,551,I think we just got Fukushima-ed.
2525,2,12,87,101,1.1584158415841583,0.04158415841584158,551,Making the Wave Great Again
2525,2,12,87,101,1.1584158415841583,0.04158415841584158,551,It's gonna be great!
2525,3,10,88,101,1.1584158415841583,0.043900592628505666,551,"It's just a wave of social regression, don't worry I know the magic words to tame it: You're hands are enormous; you're hair is poetry in motion!"
2525,3,10,88,101,1.1584158415841583,0.043900592628505666,551,"Oh Lord, be good to me; my boat is so small and its hands are so tiny."
2525,3,10,88,101,1.1584158415841583,0.043900592628505666,551,The watery depths of hell? I've seen worse.
2525,4,8,89,101,1.1584158415841583,0.046100779116129954,551,We've got enough food on board for four years.
2525,4,8,89,101,1.1584158415841583,0.046100779116129954,551,"Hold on for dear life, this is a category-five denier wave!"
2525,4,8,89,101,1.1584158415841583,0.046100779116129954,551,I DON'T FEEL SO WELCOME.
2525,2,12,87,101,1.1584158415841583,0.04158415841584158,551,Was the Red Sea EVER this angry Mort?
2525,1,14,86,101,1.1584158415841583,0.03913083731756337,551,New York City has the best Tsunamis.
2525,4,8,89,101,1.1584158415841583,0.046100779116129954,551,"Don't be frightened, its just New Jersey"
2525,1,14,86,101,1.1584158415841583,0.03913083731756337,551,"FAKE NEWS - I never said 'wall,' I said 'wave.'"
2525,3,10,88,101,1.1584158415841583,0.043900592628505666,551,"Notice the small hands, grasping as if for a mother's love it can never find."
2525,2,12,87,101,1.1584158415841583,0.04158415841584158,551,Not my tidalwave!
2525,1,14,86,101,1.1584158415841583,0.03913083731756337,551,Don't worry it'll blow over.
2525,3,10,88,101,1.1584158415841583,0.043900592628505666,551,Here comes the ripple effect!
2525,2,12,87,101,1.1584158415841583,0.04158415841584158,551,That is one 'UGE wave!!
2525,1,14,86,101,1.1584158415841583,0.03913083731756337,551,A Trump wave! Darn forecast called for calm sunny days.
2525,4,8,89,101,1.1584158415841583,0.046100779116129954,551,NO! I said look at all those BIG hands.
2525,4,8,89,101,1.1584158415841583,0.046100779116129954,551,Now don't forget to wave back...
2525,3,10,88,101,1.1584158415841583,0.043900592628505666,551,Oh no! Looks like we're trumped!
2525,3,10,88,101,1.1584158415841583,0.043900592628505666,551,At least we've had the peaceful and orderly transfer of power
2525,5,6,90,101,1.1584158415841583,0.048200639384705285,551,"I hate to say it, but Aleppo is looking quite good right now."
2525,2,12,87,101,1.1584158415841583,0.04158415841584158,551,"Donald, give us a hand!"
2525,4,8,89,101,1.1584158415841583,0.046100779116129954,551,Small hands can leave a big wake.
2525,3,10,88,101,1.1584158415841583,0.043900592628505666,551,If we throw one minority out of the boat can the rest of us come in?
2525,4,8,89,101,1.1584158415841583,0.046100779116129954,551,And this is only the beginning!
2525,2,12,87,101,1.1584158415841583,0.04158415841584158,551,Maybe ocean levels ARE rising.
2525,1,14,86,101,1.1584158415841583,0.03913083731756337,551,"Welcome to Trump Country, can I see your passport or Green card ?"
2525,3,10,88,101,1.1584158415841583,0.043900592628505666,551,Move to the back of the boat and you will be amazed. Trust me.
2587,2,12,88,102,1.1568627450980393,0.04120373319778469,551,"When he promised the new border control would be beautiful AND effective, this isn't what we envisioned."
2587,2,12,88,102,1.1568627450980393,0.04120373319778469,551,I didn't know a Wall of Water was one of his campaign promises.
2587,2,12,88,102,1.1568627450980393,0.04120373319778469,551,"It's virtual realty, keep rowing!"
2587,5,6,91,102,1.1568627450980393,0.047751008489129575,551,"Rule the Donald, the Donald rule the waves!"
2587,3,10,89,102,1.1568627450980393,0.04349580083409345,551,Does anyone have bad hair colored crayons?
2587,2,12,88,102,1.1568627450980393,0.04120373319778469,551,"It's a cartoon dream, obviously: three short fingers instead of four. Still, I really want to wake up."
2587,3,10,89,102,1.1568627450980393,0.04349580083409345,551,"Watch out, it's The Donald hair tsunami!"
2587,3,10,89,102,1.1568627450980393,0.04349580083409345,551,Let's all doo the wave!!
2587,3,10,89,102,1.1568627450980393,0.04349580083409345,551,"In this depiction of America circa 2016, we see the world through the eyes of Donald J. Trump."
2587,3,10,89,102,1.1568627450980393,0.04349580083409345,551,Must be the Hairicane Donald's rogue wave we were warned about back on the dock!
2587,1,14,87,102,1.1568627450980393,0.03877641768742085,551,I can't tell which part I least want to fall on me.
2587,3,10,89,102,1.1568627450980393,0.04349580083409345,551,That hair - that face! It looks SO familiar!
2587,3,10,89,102,1.1568627450980393,0.04349580083409345,551,Bluster away - the climate has definitely changed!
2587,5,6,91,102,1.1568627450980393,0.047751008489129575,551,"United, we can ride this out."
2587,3,10,89,102,1.1568627450980393,0.04349580083409345,551,Trump sends waves to drown illegals.
2587,3,10,89,102,1.1568627450980393,0.04349580083409345,551,"Excuse me, which way to Ellis Island?"
2587,2,12,88,102,1.1568627450980393,0.04120373319778469,551,It's Donald!
2587,3,10,89,102,1.1568627450980393,0.04349580083409345,551,"Looks like they changed the part about ""yearning to breathe free."""
2587,1,14,87,102,1.1568627450980393,0.03877641768742085,551,"Not to worry folks, these Trump Tsunamis are all hair."
2587,3,10,89,102,1.1568627450980393,0.04349580083409345,551,"I swear, we're just coming from Statin Island."
2587,2,12,88,102,1.1568627450980393,0.04120373319778469,551,"Look, he's waving to us"
2587,2,12,88,102,1.1568627450980393,0.04120373319778469,551,"Nice work on the yearning, everyone. Now, into huddled mass formation, quickly."
2609,3,10,90,103,1.1553398058252426,0.04309835738372565,551,It never even wanted to be a wave.
2609,3,10,90,103,1.1553398058252426,0.04309835738372565,551,"Hopeless, Lady Liberty can only stand and watch."
2609,1,14,88,103,1.1553398058252426,0.03842829154381203,551,Just wave him off.
2609,3,10,90,103,1.1553398058252426,0.04309835738372565,551,A wave of support for president Trump's proposed immigration reform evidences itself in New York City's harbor.
2609,6,4,93,103,1.1553398058252426,0.04928052999384266,551,"Oh nooooo! That wave looks like a really, really, really crappy caricature of Donald Trump!"
2609,2,12,89,103,1.1553398058252426,0.04083014817602034,551,Looks like the last Trump storm of the year then the depressions moves to Washington
2609,2,12,89,103,1.1553398058252426,0.04083014817602034,551,"Hokusai, shumkusai, it still looks like him"
2609,2,12,89,103,1.1553398058252426,0.04083014817602034,551,Anyone you know?
2609,2,12,89,103,1.1553398058252426,0.04083014817602034,551,"If we pull together, the storm will pass."
2609,2,12,89,103,1.1553398058252426,0.04083014817602034,551,But the forecast said smooth sailing until 2017.
2609,4,8,91,103,1.1553398058252426,0.0452530199906581,551,We came all this way only to be featured in a racist cartoon?
2609,3,10,90,103,1.1553398058252426,0.04309835738372565,551,These Trump-Tsunamis occur only when there is seismic activity around our electoral process.
2621,2,12,90,104,1.1538461538461537,0.040463222334529564,551,"Give me your investment bankers. Your tired, poor and huddled masses? Not!"
2622,3,9,87,99,1.1515151515151516,0.04393459551987973,551,Japanese art really does come alive at MOMA!
2622,4,7,88,99,1.1515151515151516,0.046221117974161514,551,"We are tired and we are poor, we are leaving the lamp beside your golden door."
2622,1,13,85,99,1.1515151515151516,0.038961038961038946,551,Have you noticed how short the fingers are?
2622,4,7,88,99,1.1515151515151516,0.046221117974161514,551,"""Row, row, row your boat"" were their final words."
2622,2,11,86,99,1.1515151515151516,0.041522350851192366,551,"On our right, there's Lady Liberty!"
2622,1,13,85,99,1.1515151515151516,0.038961038961038946,551,"The inscription reads: 'Give me your wretched losers yearning to breathe free, and work for me for free, and then get em the hell outta here.'"
2622,2,11,86,99,1.1515151515151516,0.041522350851192366,551,"And just off the prow here you'll see President Trump's more understated younger brother, Tsunami Trump."
2622,2,11,86,99,1.1515151515151516,0.041522350851192366,551,Cover your laps and hold your breath!
2622,2,11,86,99,1.1515151515151516,0.041522350851192366,551,Look out! We're about to be quaffed by the coiffed wave!
2622,2,11,86,99,1.1515151515151516,0.041522350851192366,551,Hurricane Trump! Let's hope it's not as scary as it looks!
2622,4,7,88,99,1.1515151515151516,0.046221117974161514,551,I told you global warming was a hoax. It's global waiving we have to worry about.
2622,2,11,86,99,1.1515151515151516,0.041522350851192366,551,"We are too strong for it to capsize us. But, ladies, be on the lookout for those tiny waving hands."
2622,3,9,87,99,1.1515151515151516,0.04393459551987973,551,Is it too late to move inland?
2622,2,11,86,99,1.1515151515151516,0.041522350851192366,551,Is the top of that really his crest?
2622,2,11,86,99,1.1515151515151516,0.041522350851192366,551,You want to grab me by the WHAT?
2622,2,11,86,99,1.1515151515151516,0.041522350851192366,551,Hard to trump this welcome.
2622,4,7,88,99,1.1515151515151516,0.046221117974161514,551,"It's new for 2017. Our ""Swirling Eddy of Despair""."
2622,3,9,87,99,1.1515151515151516,0.04393459551987973,551,No torch. No torch . She's waving bye bye. Except....Any super models?
2622,1,13,85,99,1.1515151515151516,0.038961038961038946,551,"Give me your tired, your poor, your huddled masses yearning to be free... ""Hey did anybody read the fine print?"""
2622,3,9,87,99,1.1515151515151516,0.04393459551987973,551,I don't care what that nasty woman said. You are not welcomed here.
2622,2,11,86,99,1.1515151515151516,0.041522350851192366,551,Don't catch this wave.
2622,4,7,88,99,1.1515151515151516,0.046221117974161514,551,FORGET freedom . . . we're about to be Trumped!
2622,2,11,86,99,1.1515151515151516,0.041522350851192366,551,Rogue wave ahead.
2622,4,7,88,99,1.1515151515151516,0.046221117974161514,551,"Trump could no longer deny the existence of climate ""change""."
2622,2,11,86,99,1.1515151515151516,0.041522350851192366,551,And while the Statue of Liberty was a beacon of hope for new immigrants way back when; this is what new immigrants can expect!
2622,4,7,88,99,1.1515151515151516,0.046221117974161514,551,"Don't worry. It may look scary, but it couldn't possibly tip a boat like this..."
2622,4,7,88,99,1.1515151515151516,0.046221117974161514,551,Yes I agree the CIRCLE LINE would have been the better choice.
2622,1,13,85,99,1.1515151515151516,0.038961038961038946,551,It's the Trump-ocalypse.
2622,5,5,89,99,1.1515151515151516,0.048399739772722716,551,He's got it wrong! We're not chasing our jobs abroad; we're content to wander the seas for the next four years....
2622,2,11,86,99,1.1515151515151516,0.041522350851192366,551,Everyone who bought travel insurance gets rescued.
2622,1,13,85,99,1.1515151515151516,0.038961038961038946,551,And over here is New Jersey...
2622,3,9,87,99,1.1515151515151516,0.04393459551987973,551,We have our birth certificates and tax returns right here for your inspection.
2622,3,9,87,99,1.1515151515151516,0.04393459551987973,551,"No, son, the amber waves are actually amber."
2622,2,11,86,99,1.1515151515151516,0.041522350851192366,551,"Don't worry, that ""Trump"" wave will never last..."
2622,2,11,86,99,1.1515151515151516,0.041522350851192366,551,There's no escaping The Donald effect !
2622,1,13,85,99,1.1515151515151516,0.038961038961038946,551,Where's Hillary's Ark when you need it?
2622,3,9,87,99,1.1515151515151516,0.04393459551987973,551,Just hold your breath and prepare to bail.
2622,1,13,85,99,1.1515151515151516,0.038961038961038946,551,Hold on! 2017 is about to grab us!
2622,1,13,85,99,1.1515151515151516,0.038961038961038946,551,"Hmmm...little hands, a comb over, all wet from New York. ..it's the President elect!"
2622,4,7,88,99,1.1515151515151516,0.046221117974161514,551,"sure the A train from 59th will work. but your a wave, why don't you just take the east river?"
2622,2,11,86,99,1.1515151515151516,0.041522350851192366,551,Neptune Tests a New Spray
2622,3,9,87,99,1.1515151515151516,0.04393459551987973,551,Such small hands...
2622,0,15,84,99,1.1515151515151516,0.036219048767708886,551,a hair's breadth away from the american dream
2622,3,9,87,99,1.1515151515151516,0.04393459551987973,551,"""That's sure is one Trumped up wave"
2622,1,13,85,99,1.1515151515151516,0.038961038961038946,551,Putting some wave in his hair is a YUGE improvement.
2622,4,7,88,99,1.1515151515151516,0.046221117974161514,551,The Trumpback wail is not on everybody's wavelength.
2622,3,9,87,99,1.1515151515151516,0.04393459551987973,551,"Uh oh, it's the Tempest Tosser."
2622,3,9,87,99,1.1515151515151516,0.04393459551987973,551,"He makes the best splashes, you'll see!"
2622,4,7,88,99,1.1515151515151516,0.046221117974161514,551,Bring me your poor...
2622,2,11,86,99,1.1515151515151516,0.041522350851192366,551,I know you folks are going to enjoy this three hour tour.
2622,2,11,86,99,1.1515151515151516,0.041522350851192366,551,I see the whitecaps of their eyes!
2622,3,9,87,99,1.1515151515151516,0.04393459551987973,551,We're gonna need a bigger boat again.
2622,0,15,84,99,1.1515151515151516,0.036219048767708886,551,Wow--look at that amazing comb over!
2622,2,11,86,99,1.1515151515151516,0.041522350851192366,551,"(In the very, very near future) ""I see the president's plan for immigration reform is now in effect."""
2622,2,11,86,99,1.1515151515151516,0.041522350851192366,551,Up ahead is the President's new beach combover.
2622,3,9,87,99,1.1515151515151516,0.04393459551987973,551,Not being on the same wavelength can be a good thing.
2622,2,11,86,99,1.1515151515151516,0.041522350851192366,551,Now I understand why the masses required so much huddling!
2622,3,9,87,99,1.1515151515151516,0.04393459551987973,551,"And finaly,as a thank you for using Trump boats your, families will all be issued refunds."
2622,4,7,88,99,1.1515151515151516,0.046221117974161514,551,...and finally the Towering Trump-nami.
2622,4,7,88,99,1.1515151515151516,0.046221117974161514,551,I feel a hug coming on.
2622,2,11,86,99,1.1515151515151516,0.041522350851192366,551,My God!! It's the Trump tsunami!!
2622,5,5,89,99,1.1515151515151516,0.048399739772722716,551,What the fuck...!
2622,4,7,88,99,1.1515151515151516,0.046221117974161514,551,I had hoped that we would avoid the 'tempest-tost' part.
2622,4,7,88,99,1.1515151515151516,0.046221117974161514,551,Not climate change; climatic change!
2622,1,13,85,99,1.1515151515151516,0.038961038961038946,551,Don't take it literally.
2622,2,11,86,99,1.1515151515151516,0.041522350851192366,551,"Oh, what a metaphor!"
2622,2,11,86,99,1.1515151515151516,0.041522350851192366,551,"Honest, we have our immigration documents coming in the next boat."
2622,3,9,87,99,1.1515151515151516,0.04393459551987973,551,lt's grabby and huge!
2622,2,11,86,99,1.1515151515151516,0.041522350851192366,551,Why did we refuse the teeming shore?
2622,2,11,86,99,1.1515151515151516,0.041522350851192366,551,I asked for a sign!
2622,3,9,87,99,1.1515151515151516,0.04393459551987973,551,The 2017 Inauguration.
2622,4,7,88,99,1.1515151515151516,0.046221117974161514,551,Oops! Too late. We've been intercepted by President Trump
2622,3,9,87,99,1.1515151515151516,0.04393459551987973,551,"Now, if you look to your left...."
2622,1,13,85,99,1.1515151515151516,0.038961038961038946,551,This phenomenon is obviously caused by feelings of inferiority.
2622,3,9,87,99,1.1515151515151516,0.04393459551987973,551,"Oh, no! It's a tidal wave with groping hands and a nightmarish political disaster, all wrapped in a comb-over."
2622,1,13,85,99,1.1515151515151516,0.038961038961038946,551,"The poor, huddled masses are tired of you."
2622,2,11,86,99,1.1515151515151516,0.041522350851192366,551,Those hands are surprisingly big!
2622,3,9,87,99,1.1515151515151516,0.04393459551987973,551,Maybe leaving because of the election results was a mistake.
2622,2,11,86,99,1.1515151515151516,0.041522350851192366,551,"I told you the ""2016"" ride was realistic."
2622,3,9,87,99,1.1515151515151516,0.04393459551987973,551,He didn't say anything about a waterwall!
2622,2,11,86,99,1.1515151515151516,0.041522350851192366,551,This is the comb-over I was telling you about.
2622,2,11,86,99,1.1515151515151516,0.041522350851192366,551,Put your hand in the hand of the man that stills the water...
2622,4,7,88,99,1.1515151515151516,0.046221117974161514,551,Hopefully the calm comes after this storm.
2622,5,5,89,99,1.1515151515151516,0.048399739772722716,551,"Bye Bye, you Deplorables..."
2622,3,9,87,99,1.1515151515151516,0.04393459551987973,551,"Another ""Gropenami""!!!"
2622,4,7,88,99,1.1515151515151516,0.046221117974161514,551,That's a really hairy wave!
2622,1,13,85,99,1.1515151515151516,0.038961038961038946,551,The comber's comb over was magnified by its tiny hands.
2622,3,9,87,99,1.1515151515151516,0.04393459551987973,551,Happy New Year World.
2622,2,11,86,99,1.1515151515151516,0.041522350851192366,551,I told you there would be some surprises!
2622,4,7,88,99,1.1515151515151516,0.046221117974161514,551,Donald?
2622,3,9,87,99,1.1515151515151516,0.04393459551987973,551,These are not the immigrants you are looking for
2622,3,9,87,99,1.1515151515151516,0.04393459551987973,551,Merrily we row along...oblivious to our fate.
2622,4,7,88,99,1.1515151515151516,0.046221117974161514,551,"As we row sharply to the Left, nothing can possibly go wrong!"
2622,3,9,87,99,1.1515151515151516,0.04393459551987973,551,I actually prefer this nightmare.
2622,3,9,87,99,1.1515151515151516,0.04393459551987973,551,Global warming has made the 'orange tide' ferocious this year...
2622,2,11,86,99,1.1515151515151516,0.041522350851192366,551,Does anybody know what a killer wave looks like?!
2622,4,7,88,99,1.1515151515151516,0.046221117974161514,551,This is what happens to Liberty with too many hair implants and too much testosterone.
2622,2,11,86,99,1.1515151515151516,0.041522350851192366,551,Where have I seen that comb over ...oh I know.
2622,2,11,86,99,1.1515151515151516,0.041522350851192366,551,"That's just water, just like they're just words. Not gonna hurt us, folks."
2622,2,11,86,99,1.1515151515151516,0.041522350851192366,551,That wave has far-reaching political significance for us.
2622,4,7,88,99,1.1515151515151516,0.046221117974161514,551,Couldn't he have just tweeted about Hokusai !?
2622,2,11,86,99,1.1515151515151516,0.041522350851192366,551,"""Anyone here tire? Poor? Tempest tossed?"
2622,3,9,87,99,1.1515151515151516,0.04393459551987973,551,I'm demanding a refund--this tour sucks.
2622,2,11,86,99,1.1515151515151516,0.041522350851192366,551,Trump's water wall? We're gonna pay!
2622,5,5,89,99,1.1515151515151516,0.048399739772722716,551,"And, finally, the newest feature of our tour: This bigly wave washes us all back to Ellis Island."
2622,3,9,87,99,1.1515151515151516,0.04393459551987973,551,The unholy See.
2622,1,13,85,99,1.1515151515151516,0.038961038961038946,551,"To the right, behold the Trump wave tower."
2622,4,7,88,99,1.1515151515151516,0.046221117974161514,551,The waters surrounding the statue are not supposed to be so treacherous!
2622,1,13,85,99,1.1515151515151516,0.038961038961038946,551,Why is the lady so angry?
2622,1,13,85,99,1.1515151515151516,0.038961038961038946,551,So this is what the new comb-over control approach to immigration reform looks like!
2622,2,11,86,99,1.1515151515151516,0.041522350851192366,551,"Only in New York, folks-a tsunami with a combover!"
2622,4,7,88,99,1.1515151515151516,0.046221117974161514,551,This is not my ocean!
2622,1,13,85,99,1.1515151515151516,0.038961038961038946,551,"Oh, I get it! It's a cartoon about Tru--"
2622,4,7,88,99,1.1515151515151516,0.046221117974161514,551,"Gimme your tired, your poor, your huddled masses yearning to breathe my extreme vetting."
2622,4,7,88,99,1.1515151515151516,0.046221117974161514,551,"And this is the 'Great Seawall of America', dating back to the twenty first century."
2622,4,7,88,99,1.1515151515151516,0.046221117974161514,551,Rain is the death of his do.
2622,3,9,87,99,1.1515151515151516,0.04393459551987973,551,And that leads us to the Hurricane Sandy part of our tour.
2622,4,7,88,99,1.1515151515151516,0.046221117974161514,551,Hair Ho!!!
2622,3,9,87,99,1.1515151515151516,0.04393459551987973,551,Don't miss your chance to photograph the Swell Of Swill.
2622,2,11,86,99,1.1515151515151516,0.041522350851192366,551,I love how climate change is trying to prove itself.
2622,3,9,87,99,1.1515151515151516,0.04393459551987973,551,"Then the Trumpmendous wave huffed and he puffed and blew the boat load of immigrates right out of the water and clear over the huge, tall wall."
2622,2,11,86,99,1.1515151515151516,0.041522350851192366,551,"They let him brand this water, too."
2622,3,9,87,99,1.1515151515151516,0.04393459551987973,551,We're with Sully Sullenberger.
2622,3,9,87,99,1.1515151515151516,0.04393459551987973,551,I think we're about to be swamped.
2622,3,9,87,99,1.1515151515151516,0.04393459551987973,551,Does that wave look like Donald Trump to anyone else?
2622,3,9,87,99,1.1515151515151516,0.04393459551987973,551,"Uh-oh! Here comes the ""tempest-tost"" part of the invitation!"
2622,2,11,86,99,1.1515151515151516,0.041522350851192366,551,Oh Crump!
2622,0,15,84,99,1.1515151515151516,0.036219048767708886,551,"'The shores of America are not as welcoming as we were led to believe."""
2622,3,9,87,99,1.1515151515151516,0.04393459551987973,551,A Perfect Storm. Wait - didn't they all drown in the movie?
2622,3,9,87,99,1.1515151515151516,0.04393459551987973,551,"Avast, Ishmael, Big Hair High Up; Tiny Hands at the Bow. Hard to Starboard!"
2622,3,9,87,99,1.1515151515151516,0.04393459551987973,551,"Merrily, merrily, merrily, merrily, life is but a dream ..."
2622,1,13,85,99,1.1515151515151516,0.038961038961038946,551,Get ready huddled masses for this entitled wave.
2622,2,11,86,99,1.1515151515151516,0.041522350851192366,551,Now that's what I call a trumped-up welcome wave.
2622,3,9,87,99,1.1515151515151516,0.04393459551987973,551,"Look, the Statue of Gibberish."
2622,2,11,86,99,1.1515151515151516,0.041522350851192366,551,"It's okay, kids. You know what they say about waves with tiny, ineffectual hands."
2622,3,9,87,99,1.1515151515151516,0.04393459551987973,551,"I know, we were told!"
2622,4,7,88,99,1.1515151515151516,0.046221117974161514,551,"Send these, the homeless, tempest-tost to ME, I'll throw them back into the sea!"
2622,1,13,85,99,1.1515151515151516,0.038961038961038946,551,We're still pretty sure her hands are bigger
2622,1,13,85,99,1.1515151515151516,0.038961038961038946,551,"Hang on! Its not the wave that will kill you, but the cabinet behind it."
2622,3,9,87,99,1.1515151515151516,0.04393459551987973,551,"Uch, another performance piece about the election."
2622,3,9,87,99,1.1515151515151516,0.04393459551987973,551,does he think his new policy of scare tactics on immigration will work!
2622,1,13,85,99,1.1515151515151516,0.038961038961038946,551,"Wave or wall, what difference does it make."
2622,2,11,86,99,1.1515151515151516,0.041522350851192366,551,"The wavelets look small, but they can really grab you."
2765,1,13,86,100,1.15,0.03859920970562726,551,"It's a Trumphoon, we are all doomed!"
2765,2,11,87,100,1.15,0.041132945334843116,551,"They were divided on whether it was a breaker or a comber, but they all agreed it had small ripples."
2765,2,11,87,100,1.15,0.041132945334843116,551,Look out for the orange wave!
2765,2,11,87,100,1.15,0.041132945334843116,551,Hey! This sort of thing doesn't happen in November!
2765,1,13,86,100,1.15,0.03859920970562726,551,Welcome to Trump's America!
2765,2,11,87,100,1.15,0.041132945334843116,551,"....and that's what we call a ""Trumpnami""!"
2765,2,11,87,100,1.15,0.041132945334843116,551,Is this what they mean by an immersive experience?
2765,3,9,88,100,1.15,0.04351941398892446,551,"I spy, with my little eye..."
2765,3,9,88,100,1.15,0.04351941398892446,551,"Watch out, I’m licensed to carry small arms"
2765,3,9,88,100,1.15,0.04351941398892446,551,""" I am told that in America you can over comb anything""."
2765,3,9,88,100,1.15,0.04351941398892446,551,I prefer the classic Pirates of the Caribbean attraction.
2765,3,9,88,100,1.15,0.04351941398892446,551,You are not President yet!
2765,2,11,87,100,1.15,0.041132945334843116,551,"OK folks, in the next few minutes, to really experience New York like a New Yorker, we're going to practice paying as much attention to style as to substance."
2765,2,11,87,100,1.15,0.041132945334843116,551,Not to worry! I hear they welcome the tempest tossed refuse from teeming foreign shores.
2765,2,11,87,100,1.15,0.041132945334843116,551,What do you mean Emma Lazarus sent you? Who in the hell is Emma Lazarus?
2765,1,13,86,100,1.15,0.03859920970562726,551,"Ok, maybe my Trump metaphor DID come true."
2765,3,9,88,100,1.15,0.04351941398892446,551,"Calm down, Colossus. We're tourists."
2765,5,5,90,100,1.15,0.047937248544110224,551,"Look, it's the new Trump Tower!"
2783,1,13,87,101,1.1485148514851484,0.03824397607094648,551,I thought we would only see this on the Potomac!
2783,2,11,88,101,1.1485148514851484,0.04075072401436967,551,I thought Poseidon lived in Greece.
2785,1,12,84,97,1.1443298969072164,0.038745609222610576,551,These orangecaps think they can foam women whenever they want.
2785,3,8,86,97,1.1443298969072164,0.043940590558571885,551,I wonder if they are still welcoming the tempest-tossed.
2785,4,6,87,97,1.1443298969072164,0.046320105040235635,551,It must have come from the Far East Side.
2785,2,10,85,97,1.1443298969072164,0.041424616670931926,551,Hashtag Twitter tsunami
2785,0,14,83,97,1.1443298969072164,0.035867054544928,551,Welcome to America. First you are going to be BIGLY vetted! It is going to be great.
2785,4,6,87,97,1.1443298969072164,0.046320105040235635,551,"You all recognize the irony in describing this so hyperbolically, right?"
2785,1,12,84,97,1.1443298969072164,0.038745609222610576,551,Is the hair real?
2785,2,10,85,97,1.1443298969072164,0.041424616670931926,551,"Oh, my goodness! Its not a tsunami, but a trumpnami!"
2785,2,10,85,97,1.1443298969072164,0.041424616670931926,551,It's not really the motion of the ocean. Check out the tiny sea hands.
2785,3,8,86,97,1.1443298969072164,0.043940590558571885,551,I thought he promised a wall not a wave?
2785,1,12,84,97,1.1443298969072164,0.038745609222610576,551,Relax! It's only one of our daily Trumpunamis blowing through.
2785,2,10,85,97,1.1443298969072164,0.041424616670931926,551,I thought his hair was orange.
2785,1,12,84,97,1.1443298969072164,0.038745609222610576,551,Talk about making tidal waves great again...
2785,2,10,85,97,1.1443298969072164,0.041424616670931926,551,"Oh crap, it's the big Donald."
2785,3,8,86,97,1.1443298969072164,0.043940590558571885,551,"It's a total disaster, but I have the best life jackets."
2785,2,10,85,97,1.1443298969072164,0.041424616670931926,551,Welcome to the Trump Americana.
2785,2,10,85,97,1.1443298969072164,0.041424616670931926,551,ROGUE METAPHOR!
2785,5,4,88,97,1.1443298969072164,0.048583214830236046,551,"Oh look, that wave has Trump hair!"
2785,4,6,87,97,1.1443298969072164,0.046320105040235635,551,I'll never watch porn again!
2785,2,10,85,97,1.1443298969072164,0.041424616670931926,551,Oh no! The tiny hands are gesticulating at us again!
2785,1,12,84,97,1.1443298969072164,0.038745609222610576,551,This wave of the future may swamp us!
2785,2,10,85,97,1.1443298969072164,0.041424616670931926,551,We're safe! It's only the wave of the future!
2785,4,6,87,97,1.1443298969072164,0.046320105040235635,551,That's why we need the second avenue subway.
2785,2,10,85,97,1.1443298969072164,0.041424616670931926,551,The New York Experience is far more scarier than the Jaws ride at Universal Studios.
2785,4,6,87,97,1.1443298969072164,0.046320105040235635,551,We've brought more hairspray!
2785,1,12,84,97,1.1443298969072164,0.038745609222610576,551,Alt Right art collectors seek little known Japanese woodblock print 'The Great Wave of Illegal Immigrants.'
2785,1,12,84,97,1.1443298969072164,0.038745609222610576,551,"Not to worry, we are just in the new Climate Change Reality Show !!"
2785,3,8,86,97,1.1443298969072164,0.043940590558571885,551,Uncanny how Hiroshige prefigured an imminent maelstrom.
2785,3,8,86,97,1.1443298969072164,0.043940590558571885,551,I've never seen a wall with a toupee before!
2785,0,14,83,97,1.1443298969072164,0.035867054544928,551,"Since he's a star, we better let him do it."
2785,3,8,86,97,1.1443298969072164,0.043940590558571885,551,"Forget the Lady; give ME your tired, your poor, your huddled masses..."
2785,1,12,84,97,1.1443298969072164,0.038745609222610576,551,"Oh NO! Just like he promised, it's the Trump sea wall!"
2785,1,12,84,97,1.1443298969072164,0.038745609222610576,551,I thought it was the other side of the country that had the wall to keep out immigrants.
2785,3,8,86,97,1.1443298969072164,0.043940590558571885,551,"The highlight of our tour, the meaner, scarier rogue waves due to climate change!!"
2785,4,6,87,97,1.1443298969072164,0.046320105040235635,551,"Nobody, not even the rain, has such small hands."
2785,1,12,84,97,1.1443298969072164,0.038745609222610576,551,Ok. Who was on tweet duty this morning?
2785,1,12,84,97,1.1443298969072164,0.038745609222610576,551,Looks like Super Storm Donnie.
2785,3,8,86,97,1.1443298969072164,0.043940590558571885,551,They're not longer admitting the tired and the poor but maybe we can get in on the tempest tossed exception.
2785,2,10,85,97,1.1443298969072164,0.041424616670931926,551,"Oh great, another boatload of climate deniers."
2785,2,10,85,97,1.1443298969072164,0.041424616670931926,551,"Hey huddled masses, this must be the ""tempest-tossed"" part they told us about."
2785,0,14,83,97,1.1443298969072164,0.035867054544928,551,I don't remember seeing this in our guide book.
2785,3,8,86,97,1.1443298969072164,0.043940590558571885,551,That's a huuuuuuge wave!
2785,3,8,86,97,1.1443298969072164,0.043940590558571885,551,Anybody! How many NINAs in that curl?
2785,2,10,85,97,1.1443298969072164,0.041424616670931926,551,Hurricane Donald!
2785,2,10,85,97,1.1443298969072164,0.041424616670931926,551,I told you trickle down was a bad idea.
2785,3,8,86,97,1.1443298969072164,0.043940590558571885,551,A big wave of anger and resentment blocked their push for freedom.
2785,4,6,87,97,1.1443298969072164,0.046320105040235635,551,"It's all right folks, she didn't get elected."
2785,2,10,85,97,1.1443298969072164,0.041424616670931926,551,I told you we should have headed for Canada!
2785,3,8,86,97,1.1443298969072164,0.043940590558571885,551,Should have switched from good hands to Liberty Mutual.
2785,4,6,87,97,1.1443298969072164,0.046320105040235635,551,pussy grabs back.
2785,2,10,85,97,1.1443298969072164,0.041424616670931926,551,Ya think maybe that bit about the teeming masses was a bad translation?
2785,1,12,84,97,1.1443298969072164,0.038745609222610576,551,No need for alarm. It’s just Lord Poseidon sporting his new Manhattan combover.
2785,4,6,87,97,1.1443298969072164,0.046320105040235635,551,"Well, he did manage to make American waves again."
2785,3,8,86,97,1.1443298969072164,0.043940590558571885,551,"I feel it appropriate to repeat, people, that Tweeting on the Miss Liberty Tour is not encouraged."
2785,2,10,85,97,1.1443298969072164,0.041424616670931926,551,"Holy crap, it's a Trump-sami!"
2785,1,12,84,97,1.1443298969072164,0.038745609222610576,551,"Pay no attention to the lady with the lamp. I, Tsunami Donald, am sending you wretched refuse back to your teeming shore."
2785,3,8,86,97,1.1443298969072164,0.043940590558571885,551,"Welcome to Oz, I am the Wizard."
2785,1,12,84,97,1.1443298969072164,0.038745609222610576,551,Hey Marge did you ever feel like you were just a character in a satire of a classic Japanese painting?
2785,1,12,84,97,1.1443298969072164,0.038745609222610576,551,Don't let the size of the hands fool you. Dangerous!
2785,3,8,86,97,1.1443298969072164,0.043940590558571885,551,It's not a Trump tsunami. It's just another comb over wave.
2785,3,8,86,97,1.1443298969072164,0.043940590558571885,551,I told you not to made fun of his orange hair!
2785,3,8,86,97,1.1443298969072164,0.043940590558571885,551,"Not the worst version of Singin' In the Rain, but he's no Gene Kelly..."
2785,2,10,85,97,1.1443298969072164,0.041424616670931926,551,Was it something I said?
2785,2,10,85,97,1.1443298969072164,0.041424616670931926,551,Don't make me make you go back there and make America great again.
2785,3,8,86,97,1.1443298969072164,0.043940590558571885,551,"That reminds me, did you turn off the sprinklers?"
2785,2,10,85,97,1.1443298969072164,0.041424616670931926,551,Who will pay fore the dike?
2785,2,10,85,97,1.1443298969072164,0.041424616670931926,551,"So close, yet so far."
2785,2,10,85,97,1.1443298969072164,0.041424616670931926,551,My sources tell me Russian hackers caused this mess.
2785,4,6,87,97,1.1443298969072164,0.046320105040235635,551,"And as you call see, dumping trash in the ocean can can cause a huge increase in hot air and the color of seaweed to change to a strange hue of pink."
2785,2,10,85,97,1.1443298969072164,0.041424616670931926,551,How did we get out of Central Park?
2785,3,8,86,97,1.1443298969072164,0.043940590558571885,551,"I heard they're changing the words from ""white with foam"" to ""white with fear."""
2785,4,6,87,97,1.1443298969072164,0.046320105040235635,551,The only thing to fear is fear itself.
2785,3,8,86,97,1.1443298969072164,0.043940590558571885,551,Too adult coloring book.
2785,3,8,86,97,1.1443298969072164,0.043940590558571885,551,"Don't you dare enter my golden door, you huddled wretches, or I'll make sure you stay tired and poor."
2785,3,8,86,97,1.1443298969072164,0.043940590558571885,551,"Row, row, row the boat, Into the abyss we go, Warily, warily, warily, warily, Or is this only another show?"
2785,2,10,85,97,1.1443298969072164,0.041424616670931926,551,Even the waters are taxing here.
2785,0,14,83,97,1.1443298969072164,0.035867054544928,551,We were warned a Trump wave was wave was sweeping the country.
2785,3,8,86,97,1.1443298969072164,0.043940590558571885,551,Oh my goodness ... look at all those small hands!
2785,2,10,85,97,1.1443298969072164,0.041424616670931926,551,The waves are really hands on today..
2785,2,10,85,97,1.1443298969072164,0.041424616670931926,551,"Sorry, new immigration laws start today."
2785,1,12,84,97,1.1443298969072164,0.038745609222610576,551,Hurricane Donald is bringing 100 mph tweets.
2785,3,8,86,97,1.1443298969072164,0.043940590558571885,551,This is a not a Pacific tsunami. This one is much worse: it came from Atlantic City!
2785,3,8,86,97,1.1443298969072164,0.043940590558571885,551,"And here we have it, folks, Trump's Reign Storm."
2785,3,8,86,97,1.1443298969072164,0.043940590558571885,551,Resist or row people. Resist or row?
2785,4,6,87,97,1.1443298969072164,0.046320105040235635,551,Everyone wearing fresh underwear?
2785,4,6,87,97,1.1443298969072164,0.046320105040235635,551,...and look over there folks. You can tell its a Trump wave by its hair and hands.
2785,1,12,84,97,1.1443298969072164,0.038745609222610576,551,"Merrily, merrily, merrily, merrily, life is but a dream ..."
2785,1,12,84,97,1.1443298969072164,0.038745609222610576,551,"Think of how much we're saving on cab fare, though."
2785,2,10,85,97,1.1443298969072164,0.041424616670931926,551,It's a mongoon!
2785,1,12,84,97,1.1443298969072164,0.038745609222610576,551,They should have warned us about the climate change.
2785,4,6,87,97,1.1443298969072164,0.046320105040235635,551,I didn't vote for him!
2785,5,4,88,97,1.1443298969072164,0.048583214830236046,551,Was it something I said?
2785,2,10,85,97,1.1443298969072164,0.041424616670931926,551,"Look! We're being waved at … that's a good sign, right?"
2785,1,12,84,97,1.1443298969072164,0.038745609222610576,551,"Well, we're being welcome with open arms somewhere."
2785,2,10,85,97,1.1443298969072164,0.041424616670931926,551,Is this the famous Trump Wall we've heard so much about???
2785,3,8,86,97,1.1443298969072164,0.043940590558571885,551,So this is why Hilary is in the woods.
2785,0,14,83,97,1.1443298969072164,0.035867054544928,551,Wow. Even the whitecaps have comb-overs!
2785,4,6,87,97,1.1443298969072164,0.046320105040235635,551,"That reminds me, I forgot to pack my hand lotion."
2785,5,4,88,97,1.1443298969072164,0.048583214830236046,551,Great.
2785,3,8,86,97,1.1443298969072164,0.043940590558571885,551,Trump'eau.
2785,1,12,84,97,1.1443298969072164,0.038745609222610576,551,Here he's promised to build a wall of water.
2785,3,8,86,97,1.1443298969072164,0.043940590558571885,551,WATCH OUT FOR THE OVERTOE!!
2785,1,12,84,97,1.1443298969072164,0.038745609222610576,551,"If we row faster, we can be in Montreal in a week!"
2785,1,12,84,97,1.1443298969072164,0.038745609222610576,551,Can we go back to the Bridge over Troubled Waters?
2785,2,10,85,97,1.1443298969072164,0.041424616670931926,551,The Trump winds look powerful but are nothing but hot air!
2785,3,8,86,97,1.1443298969072164,0.043940590558571885,551,We're waiting for his tiny hands to pick us up and deliver us into the lap of Lady Liberte
2891,2,10,86,98,1.1428571428571428,0.04102618049244218,551,"At first, only the hair bothered me, but . . ."
2891,1,12,85,98,1.1428571428571428,0.03837647782266681,551,HAIR he goes again!
2891,5,4,89,98,1.1428571428571428,0.048107460886777836,551,Alexa. stop the wave!
2891,2,10,86,98,1.1428571428571428,0.04102618049244218,551,Everybody wave!!!!!!!!!!!!
2891,2,10,86,98,1.1428571428571428,0.04102618049244218,551,Does this cost extra ?
2891,1,12,85,98,1.1428571428571428,0.03837647782266681,551,"Oh look, Donald Trump has personally come to send us back."
2891,4,6,88,98,1.1428571428571428,0.04586866421913825,551,"All I can tell you is it's formed by a lame groundswell, has a harmless combover but will leave you feeling groped as it passes by."
2898,4,6,89,99,1.1414141414141414,0.04542590545078555,551,"""Relax, folks! Just a Trump-made special effect aimed at illegal aliens -- not Ellis Island tourists!"
2899,2,10,89,101,1.1386138613861385,0.03987530805069755,551,"Don't worry, all he wants is a cheese snack—he loves those."
2900,1,11,84,96,1.1354166666666667,0.03810129523822529,551,We're all in the same boat; it's gonna be an epic adventure.
2900,3,7,86,96,1.1354166666666667,0.043477640116023765,551,Looks like a deadly Trumpnami.
2900,3,7,86,96,1.1354166666666667,0.043477640116023765,551,"It’s not a tsunami, it’s just hair."
2900,2,9,85,96,1.1354166666666667,0.04087795181322621,551,I thought Bridgegate was bad. Now this??
2900,4,5,87,96,1.1354166666666667,0.045930419502466055,551,Climate change will affect everyone.
2900,0,13,83,96,1.1354166666666667,0.035105703998301666,551,Let's try again in 4 years. He can't possibly get re-elected!
2900,2,9,85,96,1.1354166666666667,0.04087795181322621,551,Still not as scary as Times Square.
2900,4,5,87,96,1.1354166666666667,0.045930419502466055,551,"The wave just got ten feet taller, folks."
2900,1,11,84,96,1.1354166666666667,0.03810129523822529,551,This wave of change is no friend of Lady Liberty.
2900,1,11,84,96,1.1354166666666667,0.03810129523822529,551,I told you it was a combover!
2900,2,9,85,96,1.1354166666666667,0.04087795181322621,551,Be honest - is my hair too wavy?
2900,1,11,84,96,1.1354166666666667,0.03810129523822529,551,"They lied, this is no hoax."
2900,4,5,87,96,1.1354166666666667,0.045930419502466055,551,President-elect Trump what is your position on immigration?
2900,1,11,84,96,1.1354166666666667,0.03810129523822529,551,Wave goodbye! -Or- Hair you go!
2900,0,13,83,96,1.1354166666666667,0.035105703998301666,551,"Sorry, our bad. We're looking for Ellis Island, not Staten Island."
2900,4,5,87,96,1.1354166666666667,0.045930419502466055,551,"Oohh, there's the Statue of Liberty, everyone!! Waaave!!!"
2900,2,9,85,96,1.1354166666666667,0.04087795181322621,551,Guys with big hair and tiny hands often have an evil twin.
2900,0,13,83,96,1.1354166666666667,0.035105703998301666,551,"Frightened, just another wave of Trump tweets."
2900,1,11,84,96,1.1354166666666667,0.03810129523822529,551,"Ever since secession of the four other boroughs, the headwaters of Staten Island have been like this."
2900,2,9,85,96,1.1354166666666667,0.04087795181322621,551,"I do not care what you say, I have a good feeling about this"
2900,1,11,84,96,1.1354166666666667,0.03810129523822529,551,Is this Cilla or Charybdis?
2900,2,9,85,96,1.1354166666666667,0.04087795181322621,551,"The Donald doing the wave, his way."
2900,2,9,85,96,1.1354166666666667,0.04087795181322621,551,"Just sign the waiver, he said. What could possibly go wrong, he said."
2900,3,7,86,96,1.1354166666666667,0.043477640116023765,551,Your mother is a wave?
2900,4,5,87,96,1.1354166666666667,0.045930419502466055,551,"Brace yourselves, it's a rogue wave with ambition!"
2900,2,9,85,96,1.1354166666666667,0.04087795181322621,551,Looks like we're being swamped!
2900,3,7,86,96,1.1354166666666667,0.043477640116023765,551,The tidal waves. The sushi.... I love New York!
2900,3,7,86,96,1.1354166666666667,0.043477640116023765,551,I guess he couldn't built a wall here.
2900,3,7,86,96,1.1354166666666667,0.043477640116023765,551,I've built a wall...of water!
2900,2,9,85,96,1.1354166666666667,0.04087795181322621,551,"I know it looks old school, but not at all; it's the very newest wave!"
2900,1,11,84,96,1.1354166666666667,0.03810129523822529,551,And this is one of the more recent American landmarks: the Trumpian Wave.
2900,0,13,83,96,1.1354166666666667,0.035105703998301666,551,I KNEW we should have taken that left turn in Albuquerque.....
2900,1,11,84,96,1.1354166666666667,0.03810129523822529,551,These Presidential tides are not good for tourists.
2900,3,7,86,96,1.1354166666666667,0.043477640116023765,551,"Instead of Ellis Island, we now have the Trump Wave to greet new immigrants."
2900,2,9,85,96,1.1354166666666667,0.04087795181322621,551,"Please, someone tell the all hands, Trump coiffed wave we're trying to LEAVE America."
2900,3,7,86,96,1.1354166666666667,0.043477640116023765,551,We can pay.
2900,1,11,84,96,1.1354166666666667,0.03810129523822529,551,I'm beginning to harbor some doubts about this voyage.
2900,1,11,84,96,1.1354166666666667,0.03810129523822529,551,...and on you right is the infamous Staten Island Faerie
2900,1,11,84,96,1.1354166666666667,0.03810129523822529,551,I think we shoulda stuck to the Mediterranean ...
2900,1,11,84,96,1.1354166666666667,0.03810129523822529,551,I told you we'd be better off rowing to Jersey.
2900,2,9,85,96,1.1354166666666667,0.04087795181322621,551,"Don't worry, it's just a comb over."
2900,2,9,85,96,1.1354166666666667,0.04087795181322621,551,'Trump Harbor'
2900,2,9,85,96,1.1354166666666667,0.04087795181322621,551,...and how the sea did stink...
2900,1,11,84,96,1.1354166666666667,0.03810129523822529,551,I'm tired. I'm poor. I'm weary. Turn right.
2900,1,11,84,96,1.1354166666666667,0.03810129523822529,551,It's a 'yuge 'Trumpest'
2900,3,7,86,96,1.1354166666666667,0.043477640116023765,551,"That's not a Tsunami, it's a Trumpami!"
2900,1,11,84,96,1.1354166666666667,0.03810129523822529,551,I knew that last tweet was a bad idea.
2900,3,7,86,96,1.1354166666666667,0.043477640116023765,551,"It's the new authority to check on those ""huddled masses""....."
2900,1,11,84,96,1.1354166666666667,0.03810129523822529,551,I always knew it would be hard to leave New York.
2900,2,9,85,96,1.1354166666666667,0.04087795181322621,551,"On second thought, let’s keep going."
2900,4,5,87,96,1.1354166666666667,0.045930419502466055,551,Wow! It's the PEOTUS hair wave!
2900,1,11,84,96,1.1354166666666667,0.03810129523822529,551,Did we wait too long?
2900,2,9,85,96,1.1354166666666667,0.04087795181322621,551,Brace for Drumping!!!
2900,2,9,85,96,1.1354166666666667,0.04087795181322621,551,It's the Immigration Monster - The horrible little hands makes one wonder what lies below!
2900,1,11,84,96,1.1354166666666667,0.03810129523822529,551,"Oh No! The Land of the Freak, Home of the Rave!"
2900,2,9,85,96,1.1354166666666667,0.04087795181322621,551,That's water over the bridge.
2900,5,3,88,96,1.1354166666666667,0.048258695395612894,551,You sure you want to stop off in New Jersey?
2900,1,11,84,96,1.1354166666666667,0.03810129523822529,551,Looks like stormy weather.
2900,4,5,87,96,1.1354166666666667,0.045930419502466055,551,I thought we were approaching Japan
2900,2,9,85,96,1.1354166666666667,0.04087795181322621,551,I've never seen such a socially backward wave.
2900,3,7,86,96,1.1354166666666667,0.043477640116023765,551,Cuba here we come!
2900,2,9,85,96,1.1354166666666667,0.04087795181322621,551,No matter how you foam and threaten; you will never make our pussies wetten.
2900,1,11,84,96,1.1354166666666667,0.03810129523822529,551,"Ladies! Beware those tiny hands...er, waves!"
2900,4,5,87,96,1.1354166666666667,0.045930419502466055,551,Small hands and a combover. Nothing to worry about. Good for business.
2900,2,9,85,96,1.1354166666666667,0.04087795181322621,551,We're trapped in a climate change nightmare.
2900,4,5,87,96,1.1354166666666667,0.045930419502466055,551,"Whoever said ""nobody, not even the rain, has such small hands"" was full of it!"
2900,2,9,85,96,1.1354166666666667,0.04087795181322621,551,So tsunami...
2900,3,7,86,96,1.1354166666666667,0.043477640116023765,551,Even you can't scare me. I choose lady liberty!
2900,3,7,86,96,1.1354166666666667,0.043477640116023765,551,"That's your cue, Miss New Jersey."
2900,2,9,85,96,1.1354166666666667,0.04087795181322621,551,He's trying to stop the immigrant wave.
2900,2,9,85,96,1.1354166666666667,0.04087795181322621,551,"Don't worry folks, this tidal wave has very small hands and very bad hair."
2900,1,11,84,96,1.1354166666666667,0.03810129523822529,551,It;s only a dream...Nightmare on 57th Street!
2900,4,5,87,96,1.1354166666666667,0.045930419502466055,551,I knew Trump would morph into something like this!
2900,3,7,86,96,1.1354166666666667,0.043477640116023765,551,Great! The Donald Trump Welcome Committee is here!
2900,2,9,85,96,1.1354166666666667,0.04087795181322621,551,I'll take Lonely Planet over New Wave anytime.
2900,2,9,85,96,1.1354166666666667,0.04087795181322621,551,I thought he was moving to the White House.
2900,4,5,87,96,1.1354166666666667,0.045930419502466055,551,"I know it looks bad, but the rent is real cheap out here."
2900,1,11,84,96,1.1354166666666667,0.03810129523822529,551,"Go back, you are making a yuge mistake..."
2900,3,7,86,96,1.1354166666666667,0.043477640116023765,551,Who knew Trump would watch out for immigrants personally?
2900,3,7,86,96,1.1354166666666667,0.043477640116023765,551,"Guess I shouldn't have named the boat ""The Ark""."
2900,1,11,84,96,1.1354166666666667,0.03810129523822529,551,Don't look at him. It will only fuel his rage.
2900,3,7,86,96,1.1354166666666667,0.043477640116023765,551,But we're yearning to breathe free!
2900,4,5,87,96,1.1354166666666667,0.045930419502466055,551,"We're doomed - that wave has rolling eyes, a big mouth, octopus hands and a terrible combover!"
2900,3,7,86,96,1.1354166666666667,0.043477640116023765,551,"Is it just me, or does the new wave need a haircut?"
2900,2,9,85,96,1.1354166666666667,0.04087795181322621,551,It's the Trumpness monster here to save us.
2900,4,5,87,96,1.1354166666666667,0.045930419502466055,551,We've been tempest-tost for a while now. I think we're on the verge of becoming wretched refuse.
2900,1,11,84,96,1.1354166666666667,0.03810129523822529,551,Don't you just hate it when mother nature does the wave?
2900,1,11,84,96,1.1354166666666667,0.03810129523822529,551,Just close your eyes and say 'recount.'
2900,2,9,85,96,1.1354166666666667,0.04087795181322621,551,"My name is not Jonah and that is not a whale. Still, I think it's a sign."
2900,3,7,86,96,1.1354166666666667,0.043477640116023765,551,Hold on tight! It looks like 'The Apprentice' has morphed into 'Orange Is The New Black.'
2900,1,11,84,96,1.1354166666666667,0.03810129523822529,551,Neptune's having a Trump hair day.
2900,2,9,85,96,1.1354166666666667,0.04087795181322621,551,"This is ""Making America Great Again""?"
2900,2,9,85,96,1.1354166666666667,0.04087795181322621,551,This wave sure trumps the last one!
2900,1,11,84,96,1.1354166666666667,0.03810129523822529,551,"Tempest tossed, party of seven."
2900,1,11,84,96,1.1354166666666667,0.03810129523822529,551,Drain the swamp AND swamp the boat?
2900,3,7,86,96,1.1354166666666667,0.043477640116023765,551,Welcome to Ellis Island in 2017 folks.
2900,2,9,85,96,1.1354166666666667,0.04087795181322621,551,"Merrily, merrily ... Holy *#$! Wave! It's Donald!"
2900,2,9,85,96,1.1354166666666667,0.04087795181322621,551,Keep rowing and ignore the loud tweets; we are almost Americans.
2900,2,9,85,96,1.1354166666666667,0.04087795181322621,551,This new administration is emphasizing the tempest-tost requirement.
2900,3,7,86,96,1.1354166666666667,0.043477640116023765,551,"Look, we're running into the arms of America!"
2900,1,11,84,96,1.1354166666666667,0.03810129523822529,551,"So, who did you vote for?"
2900,1,11,84,96,1.1354166666666667,0.03810129523822529,551,"He's changing it to give me your tired, your poor, your huddled masses yearning to eat steak and sell real estate."
2900,2,9,85,96,1.1354166666666667,0.04087795181322621,551,The new weave of immigration
2900,3,7,86,96,1.1354166666666667,0.043477640116023765,551,Whoa! He did build a wall after all.
2900,1,11,84,96,1.1354166666666667,0.03810129523822529,551,He's taking this wall thing a bit far!
2900,4,5,87,96,1.1354166666666667,0.045930419502466055,551,Just build a wall!
2900,2,9,85,96,1.1354166666666667,0.04087795181322621,551,I am beginning to think it's NOT my imagination!
2900,1,11,84,96,1.1354166666666667,0.03810129523822529,551,"The little hands are less menacing, don't you think?"
2900,1,11,84,96,1.1354166666666667,0.03810129523822529,551,Come on -- we really weren't going to row to Canada!
2900,3,7,86,96,1.1354166666666667,0.043477640116023765,551,I told you we should have gone first class!
2900,2,9,85,96,1.1354166666666667,0.04087795181322621,551,Like America needed a rogue wave election...with a comb-over.
2900,3,7,86,96,1.1354166666666667,0.043477640116023765,551,Do you think that's his real hair?
2900,2,9,85,96,1.1354166666666667,0.04087795181322621,551,Need I state the obvious?
2900,2,9,85,96,1.1354166666666667,0.04087795181322621,551,I hear the sound of Trumpets. What do they mean?
2900,1,11,84,96,1.1354166666666667,0.03810129523822529,551,You're right. The hair is kind of orange.
2900,3,7,86,96,1.1354166666666667,0.043477640116023765,551,"Called a trump wave, stay calm."
2900,4,5,87,96,1.1354166666666667,0.045930419502466055,551,"You are all too tired, hungry, and poor to do be of any use to me... GO AWAY!"
2900,3,7,86,96,1.1354166666666667,0.043477640116023765,551,This is the last vacation we are taking with Economy Cruise Lines
3018,2,9,86,97,1.134020618556701,0.04047841577109879,551,I see why they named it Superstorm Trump.
3018,3,7,87,97,1.134020618556701,0.043049724454871305,551,Don't worry; he's not grabbing any of us with hands that size...
3018,3,7,87,97,1.134020618556701,0.043049724454871305,551,"This is ""huge""! He vowed to keep us out!"
3018,2,9,86,97,1.134020618556701,0.04047841577109879,551,Notice the small hands. We should be safe enough.
3018,1,11,85,97,1.134020618556701,0.03773228738143943,551,Now that's chutzpah.
3018,0,13,84,97,1.134020618556701,0.03476994217327846,551,"I thought this was a hop-on, hop-off deal."
3018,3,7,87,97,1.134020618556701,0.043049724454871305,551,"Give us your tired"", my ass!"
3018,2,9,86,97,1.134020618556701,0.04047841577109879,551,Hang on; almost to the land of the Muddled Masses
3018,4,5,88,97,1.134020618556701,0.04547587720916167,551,"You are entering the Trump trough. No, the tiny hands do not massage."
3018,2,9,86,97,1.134020618556701,0.04047841577109879,551,"Oh no, a 'Rogue Trump Wave'!"
3018,1,11,85,97,1.134020618556701,0.03773228738143943,551,Our creation of a genetically modified ocean has led to some unexpected developments.
3018,3,7,87,97,1.134020618556701,0.043049724454871305,551,Is this real? Why is the water orange? Why did we not build a bigger boat? Who brought the rum?
3018,2,9,86,97,1.134020618556701,0.04047841577109879,551,"And still, they did not understand."
3018,3,7,87,97,1.134020618556701,0.043049724454871305,551,"Send me your tired, your poor and your good swimmers."
3018,3,7,87,97,1.134020618556701,0.043049724454871305,551,I guess it's time we start spreading the news.
3018,1,11,85,97,1.134020618556701,0.03773228738143943,551,"I'm biglier than her, I know more than her.... just let me get my little hands on you immigrant rapists!"
3018,3,7,87,97,1.134020618556701,0.043049724454871305,551,I'm starting to doubt that he loves Hispanics.
3018,3,7,87,97,1.134020618556701,0.043049724454871305,551,"Watch out for those tiny, grabby hands!"
3018,2,9,86,97,1.134020618556701,0.04047841577109879,551,"It's a trumpal wave,,,cover your pussies"
3018,2,9,86,97,1.134020618556701,0.04047841577109879,551,"They told me tired, poor, huddle masses, and wretched refuse was enough to get in. Now we gotta be tempest-tossed too?"
3018,2,9,86,97,1.134020618556701,0.04047841577109879,551,"It's fine, it will lose steam soon."
3018,2,9,86,97,1.134020618556701,0.04047841577109879,551,We should have tried before the election.
3018,2,9,86,97,1.134020618556701,0.04047841577109879,551,I guess they don't like out-of-towners.
3041,2,9,87,98,1.1326530612244898,0.04008657552277356,551,"Don't worry, we'll make it. The waves are little and they only pretend to be 6'3"
3041,2,9,87,98,1.1326530612244898,0.04008657552277356,551,"I'm not so sure about this ""They're coming to America"" thing anymore!"
3041,2,9,87,98,1.1326530612244898,0.04008657552277356,551,"Trump really is redefining, ""Give me your tired, your poor, your huddled masses yearning to breathe free..."""
3041,3,7,88,98,1.1326530612244898,0.04263011814278531,551,And those of you that took dramamine prior to emigrating may notice some unpleasant side effects...
3045,1,10,83,94,1.127659574468085,0.037765433825609464,551,"What a cute wave. Wave back, everybody."
3045,1,10,83,94,1.127659574468085,0.037765433825609464,551,At least it doesn't resemble a pantsuit.
3045,1,10,83,94,1.127659574468085,0.037765433825609464,551,Too soon.
3045,2,8,84,94,1.127659574468085,0.0406817968069462,551,Must be Trump and his populist wave heading straight for Hell Gate.
3045,1,10,83,94,1.127659574468085,0.037765433825609464,551,"Yep, never leaving Manhattan again."
3045,1,10,83,94,1.127659574468085,0.037765433825609464,551,Tycoon. Ty-coon. I could have sworn they said TyCOON!
3045,1,10,83,94,1.127659574468085,0.037765433825609464,551,We better row bigly to escape this wave!
3045,2,8,84,94,1.127659574468085,0.0406817968069462,551,"Give me your tired and your poor, they've suffered long enough."
3045,1,10,83,94,1.127659574468085,0.037765433825609464,551,"As towering as it is, we still call it low tide."
3045,3,6,85,94,1.127659574468085,0.04340264036722683,551,We are huddled masses yearning to be free.
3045,3,6,85,94,1.127659574468085,0.04340264036722683,551,"Thanks, let me see if I've got that....left on Lexington, then right on 84th......"
3045,2,8,84,94,1.127659574468085,0.0406817968069462,551,We're being Trumpest-tost.
3045,3,6,85,94,1.127659574468085,0.04340264036722683,551,All bluster and wavy hair.
3045,2,8,84,94,1.127659574468085,0.0406817968069462,551,"January 20th, it’s his new wave of harassment."
3045,1,10,83,94,1.127659574468085,0.037765433825609464,551,Shouldn't have voted for Jill Stein lol
3045,0,12,82,94,1.127659574468085,0.03460415282348806,551,"2017: The year of Tsunami ""El Trumpo""."
3045,1,10,83,94,1.127659574468085,0.037765433825609464,551,Who isn't looking for a handout these days.
3045,2,8,84,94,1.127659574468085,0.0406817968069462,551,I'm not sure I really like this 'dream sharing' virtual-reality ap.
3045,3,6,85,94,1.127659574468085,0.04340264036722683,551,"Give us your undesired, your poor, Your smuggled runaways trying to flee."
3045,3,6,85,94,1.127659574468085,0.04340264036722683,551,Hurry! Someone get Delilah and tell her to bring her shears!
3045,2,8,84,94,1.127659574468085,0.0406817968069462,551,A comb-over is a comb-over—we're sunk.
3045,0,12,82,94,1.127659574468085,0.03460415282348806,551,It's coming to take you away ha-ha !
3045,2,8,84,94,1.127659574468085,0.0406817968069462,551,I might be a bigly wave but trust me....things will be great.
3045,1,10,83,94,1.127659574468085,0.037765433825609464,551,When did New Yorkers become illegal aliens?
3045,1,10,83,94,1.127659574468085,0.037765433825609464,551,This is even better than whale-watching.
3045,1,10,83,94,1.127659574468085,0.037765433825609464,551,I knew there'd be waves but I didn't expect an impenetrable comb over!
3045,2,8,84,94,1.127659574468085,0.0406817968069462,551,"For the last time, we must unite on this or be overwhelmed by divisiveness. The correct term is Tsunami."
3045,4,4,86,94,1.127659574468085,0.04596269998870822,551,"twitter, instagram and trump....turn around"
3045,4,4,86,94,1.127659574468085,0.04596269998870822,551,"One if by sea, two if by fence!"
3045,1,10,83,94,1.127659574468085,0.037765433825609464,551,This wasn't in the brochure...
3045,3,6,85,94,1.127659574468085,0.04340264036722683,551,"Give me your tired, your poor, your row boat."
3045,3,6,85,94,1.127659574468085,0.04340264036722683,551,Wait! We're here to barter hair products.
3045,3,6,85,94,1.127659574468085,0.04340264036722683,551,And straight ahead is the original Trump wave.
3045,2,8,84,94,1.127659574468085,0.0406817968069462,551,"Great, again."
3045,1,10,83,94,1.127659574468085,0.037765433825609464,551,This will be refreshing!
3045,0,12,82,94,1.127659574468085,0.03460415282348806,551,"Let's just chant: ""Love Trumps Hate!"""
3045,1,10,83,94,1.127659574468085,0.037765433825609464,551,The Lifeboat of Egalitarianism
3045,2,8,84,94,1.127659574468085,0.0406817968069462,551,Freedom's hairnet.
3045,3,6,85,94,1.127659574468085,0.04340264036722683,551,This must be the new Trump Deluxe International immigration policy.
3045,2,8,84,94,1.127659574468085,0.0406817968069462,551,This year's regatta is definitely more challenging.
3045,2,8,84,94,1.127659574468085,0.0406817968069462,551,"Uh, Oh. The spirit of Elections past."
3045,2,8,84,94,1.127659574468085,0.0406817968069462,551,nothing worse than finding yourself in a symbolic cartoon
3045,0,12,82,94,1.127659574468085,0.03460415282348806,551,Have you been vetted yet?
3045,2,8,84,94,1.127659574468085,0.0406817968069462,551,That swell looks intimidating but I can't see it rocking the boat.
3045,2,8,84,94,1.127659574468085,0.0406817968069462,551,Hoping we will make it by a hair.
3045,3,6,85,94,1.127659574468085,0.04340264036722683,551,It hasn't even reached shore yet. Let's give it a chance.
3045,3,6,85,94,1.127659574468085,0.04340264036722683,551,"Isn't it odd that it's only January 20th, and this is our 4th hurricane?!"
3045,1,10,83,94,1.127659574468085,0.037765433825609464,551,I wonder if New Jersey paid for the wave/
3045,4,4,86,94,1.127659574468085,0.04596269998870822,551,"The Circle Line is fancier, but they don't give out free peyote."
3045,1,10,83,94,1.127659574468085,0.037765433825609464,551,"Hey, we're yearning to breath free."
3045,1,10,83,94,1.127659574468085,0.037765433825609464,551,"""Give me your tired, your poor, your huddled masses yearning to breathe free.” Trump Tweet response - we will extremely vet any nationalities who are tired losers"
3045,2,8,84,94,1.127659574468085,0.0406817968069462,551,Disney outdid itself with the climate change tsunami simulator.
3045,1,10,83,94,1.127659574468085,0.037765433825609464,551,Catch this wave.... What have we got to lose.
3045,0,12,82,94,1.127659574468085,0.03460415282348806,551,This is much worse than the Wall.
3045,3,6,85,94,1.127659574468085,0.04340264036722683,551,Look! Orange tidal waves!
3045,1,10,83,94,1.127659574468085,0.037765433825609464,551,Hold tight! It's going to be a bumpy ride!
3045,0,12,82,94,1.127659574468085,0.03460415282348806,551,We're looking for the DNC.
3045,3,6,85,94,1.127659574468085,0.04340264036722683,551,Women and children first!
3045,3,6,85,94,1.127659574468085,0.04340264036722683,551,Do all American waves have weaves?
3045,1,10,83,94,1.127659574468085,0.037765433825609464,551,"None of us expected this wave, now did we?"
3045,2,8,84,94,1.127659574468085,0.0406817968069462,551,"""Kawa Bunga or Let us Pray ""!"
3045,1,10,83,94,1.127659574468085,0.037765433825609464,551,The best Coney Island ride ever!
3045,3,6,85,94,1.127659574468085,0.04340264036722683,551,The tidal wave that's about to destroy our life and land looks like Donald Trump.
3045,0,12,82,94,1.127659574468085,0.03460415282348806,551,No life preservers and the post election tsunami is already here.
3045,2,8,84,94,1.127659574468085,0.0406817968069462,551,I remember when it had just two arms.
3045,2,8,84,94,1.127659574468085,0.0406817968069462,551,"Did he say 'build a wall, or a wail?"
3045,2,8,84,94,1.127659574468085,0.0406817968069462,551,"Trumping the Statue of Liberty. . . ""Go Away!"""
3045,3,6,85,94,1.127659574468085,0.04340264036722683,551,"You are the master of your own destiny. Now choose your death by : Rock, Paper, or Scissors."
3045,1,10,83,94,1.127659574468085,0.037765433825609464,551,That does not look like our welcome party.
3045,0,12,82,94,1.127659574468085,0.03460415282348806,551,"What do you think, left side or centre part for this sea?"
3045,2,8,84,94,1.127659574468085,0.0406817968069462,551,Looks like Trump was serious about immigrants.
3045,1,10,83,94,1.127659574468085,0.037765433825609464,551,"Sir, nobody said your hair looked funny."
3045,1,10,83,94,1.127659574468085,0.037765433825609464,551,We're in deep water now.
3045,2,8,84,94,1.127659574468085,0.0406817968069462,551,That is the Loch Ness Trump
3045,2,8,84,94,1.127659574468085,0.0406817968069462,551,And then there were none.
3045,2,8,84,94,1.127659574468085,0.0406817968069462,551,It's only a self-indulgent rain.
3045,2,8,84,94,1.127659574468085,0.0406817968069462,551,"Look out ladies, he's going to destroy more than this boat."
3045,1,10,83,94,1.127659574468085,0.037765433825609464,551,"don't worry, it isn't the law, just a tweet!"
3045,1,10,83,94,1.127659574468085,0.037765433825609464,551,"And like a tsunami, the Donald and his cabinet rained down upon the American refugees heading for Cuba."
3045,1,10,83,94,1.127659574468085,0.037765433825609464,551,"Tired, poor, huddled masses no longer admitted."
3045,2,8,84,94,1.127659574468085,0.0406817968069462,551,Quit whining. Did we complain when the water was calm?
3045,2,8,84,94,1.127659574468085,0.0406817968069462,551,OH NO! IT'S THE TRUMP WAVE.
3045,1,10,83,94,1.127659574468085,0.037765433825609464,551,"Mama, that's a really big weave..."
3045,3,6,85,94,1.127659574468085,0.04340264036722683,551,"Give me your tired, your poor, your huddled masses yearning to breathe free...actually we are full on all those categories."
3045,1,10,83,94,1.127659574468085,0.037765433825609464,551,"Gee, this redefines wavy hair completely."
3045,2,8,84,94,1.127659574468085,0.0406817968069462,551,"As of noon January 20th, all you huddled masses yearning to breathe free are no longer welcome here."
3045,2,8,84,94,1.127659574468085,0.0406817968069462,551,Somehow I just don't think this is what the Beach Boys meant.
3045,2,8,84,94,1.127659574468085,0.0406817968069462,551,"Unlike the Mexican wall, the U.S. paid for this, which we believe explains the likeness."
3045,3,6,85,94,1.127659574468085,0.04340264036722683,551,Looks like our American Dream is about to be swallowed by that HUGE yellow tidal wave.
3045,2,8,84,94,1.127659574468085,0.0406817968069462,551,Trump wave incoming!
3045,4,4,86,94,1.127659574468085,0.04596269998870822,551,Oh no! Trump!
3045,2,8,84,94,1.127659574468085,0.0406817968069462,551,I smell oil spill!
3045,3,6,85,94,1.127659574468085,0.04340264036722683,551,"On the plus side, no more tormenting rectal itch."
3045,3,6,85,94,1.127659574468085,0.04340264036722683,551,I forgot about the tempest tossed part
3045,2,8,84,94,1.127659574468085,0.0406817968069462,551,"The anonymous children's author tried several edited versions but curiously contemplated the rhyme ""row, row row your boat or I'll scare the hell out of you"" a bit too long."
3045,3,6,85,94,1.127659574468085,0.04340264036722683,551,He came without elected office. He came without warning or foreign caucus.
3045,0,12,82,94,1.127659574468085,0.03460415282348806,551,"Don't worry, it'll blow itself out in soon enough!"
3045,2,8,84,94,1.127659574468085,0.0406817968069462,551,Looks like the New World has become the Old World.
3045,2,8,84,94,1.127659574468085,0.0406817968069462,551,Prepare to be alt-dry.
3045,3,6,85,94,1.127659574468085,0.04340264036722683,551,An orange plague cometh!
3045,2,8,84,94,1.127659574468085,0.0406817968069462,551,Hold on..........this isn't usually part of the Statue of Liberty grand tour
3045,1,10,83,94,1.127659574468085,0.037765433825609464,551,"It's the golden hair, not the golden door!"
3045,1,10,83,94,1.127659574468085,0.037765433825609464,551,"He hates the welcome, loves the 'tempest-tost' part."
3045,2,8,84,94,1.127659574468085,0.0406817968069462,551,Well...I recognize the hair.
3045,0,12,82,94,1.127659574468085,0.03460415282348806,551,I told you we should have checked the forecast.
3045,3,6,85,94,1.127659574468085,0.04340264036722683,551,"Aye, aye! It was the accursed white male that razeed me."
3045,3,6,85,94,1.127659574468085,0.04340264036722683,551,A storm is on the way -- liberty for the little people could be in danger.
3045,1,10,83,94,1.127659574468085,0.037765433825609464,551,Trump said things were going to get worse.
3045,0,12,82,94,1.127659574468085,0.03460415282348806,551,We're making the Upper Bay great again!
3045,3,6,85,94,1.127659574468085,0.04340264036722683,551,"Yearning to breathe free? I'd love to breathe free, but jeez, give the wave a Tic-Tac already."
3045,1,10,83,94,1.127659574468085,0.037765433825609464,551,They made the American WAVE great again!
3045,0,12,82,94,1.127659574468085,0.03460415282348806,551,We could really use your wall here Mr. Trump
3045,1,10,83,94,1.127659574468085,0.037765433825609464,551,No worries. We offer 50% off your next boat excursion.
3045,0,12,82,94,1.127659574468085,0.03460415282348806,551,"Is this a part of the ""Made by New Yorkers"" package?"
3045,4,4,86,94,1.127659574468085,0.04596269998870822,551,There goes the neighborhood.
3045,3,6,85,94,1.127659574468085,0.04340264036722683,551,Check your passports and visas folks. That's INS' newest anti-illegals measure.
3045,4,4,86,94,1.127659574468085,0.04596269998870822,551,"Wadda mean, man the lifeboats? This IS a lifeboat!"
3045,1,10,83,94,1.127659574468085,0.037765433825609464,551,I think we made a wrong turn at Greenland.
3045,3,6,85,94,1.127659574468085,0.04340264036722683,551,"Relax, it's just the Donald wave."
3045,1,10,83,94,1.127659574468085,0.037765433825609464,551,Is this a preview of things to come?
3045,1,10,83,94,1.127659574468085,0.037765433825609464,551,In the new America even the East River had to adopt his haircut.
3045,1,10,83,94,1.127659574468085,0.037765433825609464,551,This takes tempest-tossed to a whole new level!
3045,3,6,85,94,1.127659574468085,0.04340264036722683,551,"Happy New Fear to you, too, Donald."
3045,1,10,83,94,1.127659574468085,0.037765433825609464,551,This will really mess with those art history students.
3045,1,10,83,94,1.127659574468085,0.037765433825609464,551,"The Trump of Liberty: ""Send (back)...your tired, your poor, your huddled masses yearning to breathe free..."""
3045,0,12,82,94,1.127659574468085,0.03460415282348806,551,We're ok -- the Trumpnami always moves backwards.
3045,2,8,84,94,1.127659574468085,0.0406817968069462,551,I heard there was a Trump wave- but this is ridiculous!
3045,0,12,82,94,1.127659574468085,0.03460415282348806,551,Maybe if we paddle strong enough we can turn the tide ?...
3045,1,10,83,94,1.127659574468085,0.037765433825609464,551,What was Frank Gehry thinking?
3045,4,4,86,94,1.127659574468085,0.04596269998870822,551,"Unless my new wife's on board, go back!"
3045,2,8,84,94,1.127659574468085,0.0406817968069462,551,Swamped!
3045,1,10,83,94,1.127659574468085,0.037765433825609464,551,Making Nordeasters great again.
3045,1,10,83,94,1.127659574468085,0.037765433825609464,551,Can you give us a push north?
3045,3,6,85,94,1.127659574468085,0.04340264036722683,551,Great.
3045,2,8,84,94,1.127659574468085,0.0406817968069462,551,"Hey, a French wave!"
3045,2,8,84,94,1.127659574468085,0.0406817968069462,551,"Give him the bird, he hates the tweets."
3045,4,4,86,94,1.127659574468085,0.04596269998870822,551,Trump's Ellis Island: Refuse Wretched Huddled Masses and Toss to Tempest
3045,3,6,85,94,1.127659574468085,0.04340264036722683,551,"And lo, there came unto the people, the promised waves of greatness! Bigly."
3045,1,10,83,94,1.127659574468085,0.037765433825609464,551,"Back off, buddy... we voted for you!"
3045,2,8,84,94,1.127659574468085,0.0406817968069462,551,"Hey, I didn't know his hair was THAT wavy!"
3045,2,8,84,94,1.127659574468085,0.0406817968069462,551,This must be the Trumptapussy.
3045,1,10,83,94,1.127659574468085,0.037765433825609464,551,We're 'huddled masses yearning' to stay dry.
3045,0,12,82,94,1.127659574468085,0.03460415282348806,551,Go back; I said we forgot to rig the BOAT.
3045,1,10,83,94,1.127659574468085,0.037765433825609464,551,"Row, what have we got to lose?"
3045,2,8,84,94,1.127659574468085,0.0406817968069462,551,Hurricane Trump kills seven immigrants illegally trying to enter the country.
3190,0,12,83,95,1.1263157894736842,0.03426432155975449,551,Sigh . . . guess we should go back to Greece
3190,4,4,87,95,1.1263157894736842,0.04549615802333409,551,C'MON MAN!
3190,4,4,87,95,1.1263157894736842,0.04549615802333409,551,This is way better than the ferry!
3190,1,10,84,95,1.1263157894736842,0.0373899438042335,551,Everybody wave to Hoboken!
3190,3,6,86,95,1.1263157894736842,0.04296435998767705,551,Do you mind? We've received asylum from Mexico.
3190,1,10,84,95,1.1263157894736842,0.0373899438042335,551,Not to worry. It's the Orange One that's dangerous.
3190,1,10,84,95,1.1263157894736842,0.0373899438042335,551,"Don't panic, it'll die down soon enough."
3190,2,8,85,95,1.1263157894736842,0.040273714298748535,551,Everyone...do the wave!
3190,1,10,84,95,1.1263157894736842,0.0373899438042335,551,"""The Combover That Ate Manhattan""...coming soon."
3190,1,10,84,95,1.1263157894736842,0.0373899438042335,551,Let him know we're the ship of state.
3190,2,8,85,95,1.1263157894736842,0.040273714298748535,551,Hokusai-onara!
3190,4,4,87,95,1.1263157894736842,0.04549615802333409,551,America is being ravaged by Hurricane Trump
3190,2,8,85,95,1.1263157894736842,0.040273714298748535,551,Mr. Trump has been working with Homeland Security on securing the East Coast.
3190,3,6,86,95,1.1263157894736842,0.04296435998767705,551,"Well, it looks like America is extending it's ""unwelcome mat"" well in advance of January 20th."
3190,2,8,85,95,1.1263157894736842,0.040273714298748535,551,Let's rethink this.
3190,2,8,85,95,1.1263157894736842,0.040273714298748535,551,Never mind her! We're making America great again.
3190,3,6,86,95,1.1263157894736842,0.04296435998767705,551,A new comber to over-comb
3190,2,8,85,95,1.1263157894736842,0.040273714298748535,551,They said 2016 couldn't get any worse.
3190,1,10,84,95,1.1263157894736842,0.0373899438042335,551,One more Trump joke and I'm losing it.
3190,3,6,86,95,1.1263157894736842,0.04296435998767705,551,And this is a New York storm we call Jumpy Trumpy.
3190,3,6,86,95,1.1263157894736842,0.04296435998767705,551,"Look! He's, like, a really smart wave!"
3190,3,6,86,95,1.1263157894736842,0.04296435998767705,551,Don't worry - just another tweet from Trump.
3190,0,12,83,95,1.1263157894736842,0.03426432155975449,551,"Okay, let's skip 'gently down the stream'"
3190,2,8,85,95,1.1263157894736842,0.040273714298748535,551,"Houston, we have a problem."
3190,2,8,85,95,1.1263157894736842,0.040273714298748535,551,"Lately, I’ve felt that maybe there’s something in the water."
3190,1,10,84,95,1.1263157894736842,0.0373899438042335,551,"That's not just a wave, it's a wall."
3190,1,10,84,95,1.1263157894736842,0.0373899438042335,551,Travel Advisory: The Orange Monster of New York has raised its ugly head.
3190,3,6,86,95,1.1263157894736842,0.04296435998767705,551,Welcome to New York and don't come back
3190,2,8,85,95,1.1263157894736842,0.040273714298748535,551,We're hoping to join your new administration.
3190,3,6,86,95,1.1263157894736842,0.04296435998767705,551,"Small hands, huh? OK, but there's lots of 'em, and their destructive impact is HUGE!"
3220,1,10,85,96,1.125,0.037021804859943275,551,The Statue is temporarily out-of-order.
3220,2,8,86,96,1.125,0.03987370412567353,551,"What a funny-looking white hood–I mean, ""white cap."""
3220,2,8,86,96,1.125,0.03987370412567353,551,I bet it's the second worst comb over Ms. Liberty has ever seen!
3220,3,6,87,96,1.125,0.042534815461170036,551,"Unfortunately, I think it's saying, ""All hands on deck."""
3220,1,10,85,96,1.125,0.037021804859943275,551,"Toto, I don't think we're in Trump Tower anymore"
3225,2,7,83,92,1.1195652173913044,0.04043005587608424,551,"No problem, folks. Just ignore the insults and mind the small hands. They're grabby."
3225,3,5,84,92,1.1195652173913044,0.04328372628809427,551,"Cool! A man-eating, soul-sucking wave. Please refer to your safety cards for further info, and thanks for sailing with us today."
3225,3,5,84,92,1.1195652173913044,0.04328372628809427,551,"Relax, we're homeless and tempest tossed, they gotta take us in."
3225,1,9,82,92,1.1195652173913044,0.037359040069358376,551,Just another tourist trap
3225,0,11,81,92,1.1195652173913044,0.03401185575155456,551,It's only an illusion - Liberty is way bigger than this sorry-looking wave.
3225,1,9,82,92,1.1195652173913044,0.037359040069358376,551,"You can""t trump that wave."
3225,1,9,82,92,1.1195652173913044,0.037359040069358376,551,"Nasty, let's rank this ""Wave"" minus 10."
3225,2,7,83,92,1.1195652173913044,0.04043005587608424,551,You forgot to read the small print...
3225,3,5,84,92,1.1195652173913044,0.04328372628809427,551,Maybe we should have waited it out at the bridge.
3225,0,11,81,92,1.1195652173913044,0.03401185575155456,551,All hands off deck!
3225,0,11,81,92,1.1195652173913044,0.03401185575155456,551,Aargh -- he's everywhere!
3225,2,7,83,92,1.1195652173913044,0.04043005587608424,551,Trump's hair has really gotten out of control.
3225,3,5,84,92,1.1195652173913044,0.04328372628809427,551,"Give me your tired, your poor, Your huddled masses yearning to breathe free, The wretched refuse of your teeming shore. Send these, the homeless, tempest-tost to me, I lift my lamp beside the golden door."
3225,2,7,83,92,1.1195652173913044,0.04043005587608424,551,Watch that weave!
3225,2,7,83,92,1.1195652173913044,0.04043005587608424,551,He's not beholden to the corporate waves.
3225,1,9,82,92,1.1195652173913044,0.037359040069358376,551,"Send me only your billionaires,t tempest-tost to me."
3225,1,9,82,92,1.1195652173913044,0.037359040069358376,551,It's a TRUMPical storm. They say it's trying to reach out and should have us covered in no time..
3225,2,7,83,92,1.1195652173913044,0.04043005587608424,551,...and here we have the Not My Trump Wave....
3225,1,9,82,92,1.1195652173913044,0.037359040069358376,551,Did everyone remember to initial the Indemnity Clause?
3225,3,5,84,92,1.1195652173913044,0.04328372628809427,551,WELCOME.
3225,0,11,81,92,1.1195652173913044,0.03401185575155456,551,It's a red tide!
3225,0,11,81,92,1.1195652173913044,0.03401185575155456,551,Here be dragons!
3225,2,7,83,92,1.1195652173913044,0.04043005587608424,551,Quick! Let's get to the Lady before the 20th.
3225,1,9,82,92,1.1195652173913044,0.037359040069358376,551,Trumpian tidal wave. Starboard. 2 o'clock.
3225,2,7,83,92,1.1195652173913044,0.04043005587608424,551,Tweet: And you thought the wall would be concrete.
3225,0,11,81,92,1.1195652173913044,0.03401185575155456,551,Aaugh! Hard alee! It's an amber wave of populism.
3225,1,9,82,92,1.1195652173913044,0.037359040069358376,551,Typhoon is more like it.
3225,0,11,81,92,1.1195652173913044,0.03401185575155456,551,I guess we misheard that 'home of the brave' lyric.
3225,1,9,82,92,1.1195652173913044,0.037359040069358376,551,It's a Trump tsunami. hold onto your papers.
3225,1,9,82,92,1.1195652173913044,0.037359040069358376,551,"Quick, call NOAA. It's a hair plug Tsunami!"
3225,2,7,83,92,1.1195652173913044,0.04043005587608424,551,And this is the Japanese winner of our Scariest Wave Contest.
3225,3,5,84,92,1.1195652173913044,0.04328372628809427,551,"Welcome to Staten Island, the friendly borough."
3225,2,7,83,92,1.1195652173913044,0.04043005587608424,551,The 'low cost harbor cruise' apparently was a mistake.
3225,2,7,83,92,1.1195652173913044,0.04043005587608424,551,We're almost there. We just have to deal with his hair.
3225,1,9,82,92,1.1195652173913044,0.037359040069358376,551,Give ME! You're FIRED! You're poor! You're huddled masses yearning to breathe... for FREE!
3225,0,11,81,92,1.1195652173913044,0.03401185575155456,551,"As a result of Governor Christie's policies, our tours tend to slow down somewhat once we enter New Jersey waters."
3225,1,9,82,92,1.1195652173913044,0.037359040069358376,551,"would you look at that windswept, wavy hair..."
3225,2,7,83,92,1.1195652173913044,0.04043005587608424,551,life and liberty trumphooned
3225,3,5,84,92,1.1195652173913044,0.04328372628809427,551,Uh-oh. Neptune is in Aquarius.
3225,0,11,81,92,1.1195652173913044,0.03401185575155456,551,"Hang on! This tsunami, too, shall pass!"
3225,0,11,81,92,1.1195652173913044,0.03401185575155456,551,Watch out. It's heading for the coasts.
3225,1,9,82,92,1.1195652173913044,0.037359040069358376,551,President # 45 is here to greet us !!!
3225,2,7,83,92,1.1195652173913044,0.04043005587608424,551,"I'm going back, we've just been Trumped."
3225,3,5,84,92,1.1195652173913044,0.04328372628809427,551,You can huff and puff all you want. We still hear Lady Liberty beckoning us.
3225,1,9,82,92,1.1195652173913044,0.037359040069358376,551,"Stop thinking about Trump, it is just an illusion"
3225,1,9,82,92,1.1195652173913044,0.037359040069358376,551,¿Es esta la pared que pagamos?
3225,2,7,83,92,1.1195652173913044,0.04043005587608424,551,"Et tu,Triton?"
3225,2,7,83,92,1.1195652173913044,0.04043005587608424,551,I knew these Picasso tours would be cool!
3225,3,5,84,92,1.1195652173913044,0.04328372628809427,551,The Great Wave off Trumpanagawa
3225,3,5,84,92,1.1195652173913044,0.04328372628809427,551,Good Lord. As refugees I expected a hostile environment but nothing like this!
3225,3,5,84,92,1.1195652173913044,0.04328372628809427,551,Turn the boat around - that's Donald Trump!
3225,0,11,81,92,1.1195652173913044,0.03401185575155456,551,"Is it me, or does that wave look like Trump?"
3225,2,7,83,92,1.1195652173913044,0.04043005587608424,551,"1.	We’re the fired, sore, muddled masses."
3225,4,3,85,92,1.1195652173913044,0.04596055378933148,551,"Once more unto the bleach, dear friends..."
3225,2,7,83,92,1.1195652173913044,0.04043005587608424,551,It's a giant Trumpwave ... we're going to be swamped!
3225,3,5,84,92,1.1195652173913044,0.04328372628809427,551,"Oh wait, I get it! The wave looks like Trump!"
3225,2,7,83,92,1.1195652173913044,0.04043005587608424,551,Time for extreme vetting. Will you make America great again?
3225,1,9,82,92,1.1195652173913044,0.037359040069358376,551,No one is allowed on shore without a green card.
3225,1,9,82,92,1.1195652173913044,0.037359040069358376,551,This begins the much anticipated Home of the Brave part of our tour!
3225,2,7,83,92,1.1195652173913044,0.04043005587608424,551,Mr. President?
3225,2,7,83,92,1.1195652173913044,0.04043005587608424,551,Huddled masses? I'll tell you where to put your huddled massses!
3225,3,5,84,92,1.1195652173913044,0.04328372628809427,551,They always say a rising tide lifts all boats.
3225,1,9,82,92,1.1195652173913044,0.037359040069358376,551,"Democrats, hold onto your change, we're about to cross the River Styx..."
3225,2,7,83,92,1.1195652173913044,0.04043005587608424,551,"The mayor's got us covered, right?"
3225,0,11,81,92,1.1195652173913044,0.03401185575155456,551,His wave is worse than his flooding.
3225,3,5,84,92,1.1195652173913044,0.04328372628809427,551,"No fear, Trump is here!"
3225,1,9,82,92,1.1195652173913044,0.037359040069358376,551,When is God going to send us the rainbow sign?
3225,3,5,84,92,1.1195652173913044,0.04328372628809427,551,"""...so..you're saying we're on the new Tempest Toast list?"
3225,2,7,83,92,1.1195652173913044,0.04043005587608424,551,Yay! We all get to be on the evening news!
3225,1,9,82,92,1.1195652173913044,0.037359040069358376,551,"In the old country we had huge waves, in America they have Y U G E waves."
3225,1,9,82,92,1.1195652173913044,0.037359040069358376,551,Here comes 'UGE!!!
3225,1,9,82,92,1.1195652173913044,0.037359040069358376,551,And on your right is . . . just about everything.
3225,2,7,83,92,1.1195652173913044,0.04043005587608424,551,"Yup, that's the blue-green wall."
3225,2,7,83,92,1.1195652173913044,0.04043005587608424,551,"Oh, come on -- stop anthropomorphizing."
3225,1,9,82,92,1.1195652173913044,0.037359040069358376,551,I didn't expect the wall to have such small digits!
3225,1,9,82,92,1.1195652173913044,0.037359040069358376,551,Getting away from Trump is harder than I thought!
3225,2,7,83,92,1.1195652173913044,0.04043005587608424,551,That doesn't look like the Liberty Wave to me.
3225,1,9,82,92,1.1195652173913044,0.037359040069358376,551,"Hark, a Chinese hoax!"
3225,1,9,82,92,1.1195652173913044,0.037359040069358376,551,I would like to be your next apprentice!
3225,1,9,82,92,1.1195652173913044,0.037359040069358376,551,Our discount visit to Ellis Island was fraught with peril.
3225,3,5,84,92,1.1195652173913044,0.04328372628809427,551,I've seen this before--in a dream.
3225,1,9,82,92,1.1195652173913044,0.037359040069358376,551,I sense some deeper meaning here.
3225,1,9,82,92,1.1195652173913044,0.037359040069358376,551,Prepare to submerge!
3225,2,7,83,92,1.1195652173913044,0.04043005587608424,551,"Quite honestly, not the storm troopers I was worried about."
3225,2,7,83,92,1.1195652173913044,0.04043005587608424,551,"I guess it was a wave election, after all!"
3225,2,7,83,92,1.1195652173913044,0.04043005587608424,551,This happens every time we take out the H.P.Love craft!
3225,2,7,83,92,1.1195652173913044,0.04043005587608424,551,This is not exactly the welcome we had hoped for.
3225,0,11,81,92,1.1195652173913044,0.03401185575155456,551,Look! They are doing the wave.
3225,3,5,84,92,1.1195652173913044,0.04328372628809427,551,"This must be Trump's ""Wall of Water"" blocking us from Ellis Island."
3225,2,7,83,92,1.1195652173913044,0.04043005587608424,551,Who the hell is Lina Wertmuller?
3225,2,7,83,92,1.1195652173913044,0.04043005587608424,551,"As you can see, 'The Donald' even rules the waves."
3225,1,9,82,92,1.1195652173913044,0.037359040069358376,551,So true! A rising tide lifts all boats.
3225,1,9,82,92,1.1195652173913044,0.037359040069358376,551,There was an old trump who swallowed a country
3225,2,7,83,92,1.1195652173913044,0.04043005587608424,551,"It's scary, but there's an 85% probability that we'll be okay."
3225,0,11,81,92,1.1195652173913044,0.03401185575155456,551,We're gonna need a more inclusive boat.
3225,1,9,82,92,1.1195652173913044,0.037359040069358376,551,"Do you suppose Americans are aware that 'here at their sea-washed, sunset gates still stands a mighty woman with a torch that glows world-wide welcome' who will far outlast Trump?"
3225,3,5,84,92,1.1195652173913044,0.04328372628809427,551,It's going to take more than a rogue wave to keep us out.
3225,1,9,82,92,1.1195652173913044,0.037359040069358376,551,This way the Mexicans will have to take us!
3225,1,9,82,92,1.1195652173913044,0.037359040069358376,551,And this is Trump's new Ellis Island concept project
3225,2,7,83,92,1.1195652173913044,0.04043005587608424,551,Stroke! Stroke! Stroke!
3225,1,9,82,92,1.1195652173913044,0.037359040069358376,551,"Quick ladies, remove your tops. It's the only way we can get through. He can't resist reaching out and touching someone."
3225,1,9,82,92,1.1195652173913044,0.037359040069358376,551,He's the harbor master-elect.
3225,1,9,82,92,1.1195652173913044,0.037359040069358376,551,"Hmm, not the friendliest of waves."
3225,2,7,83,92,1.1195652173913044,0.04043005587608424,551,It looks like the only thing between us and Lady Liberty is a wall of water.
3225,2,7,83,92,1.1195652173913044,0.04043005587608424,551,Oh say can you sea...
3225,3,5,84,92,1.1195652173913044,0.04328372628809427,551,"There's no escaping ""The Donald""."
3225,1,9,82,92,1.1195652173913044,0.037359040069358376,551,"You may have won here, Mister President! But you'll never get Berlin!"
3225,1,9,82,92,1.1195652173913044,0.037359040069358376,551,"Ok nature, your waves of intimidation are going alittle overboard."
3225,2,7,83,92,1.1195652173913044,0.04043005587608424,551,That's the scariest thing I've ever seen. A wave with a combover!
3225,4,3,85,92,1.1195652173913044,0.04596055378933148,551,"""Yo Pres. . . . we are your tired and your poor!"" Joyce Grimm Pittsburgh, PA 15228"
3225,0,11,81,92,1.1195652173913044,0.03401185575155456,551,Anyone have a pair of scissors? I was a barber in my home country.
3225,2,7,83,92,1.1195652173913044,0.04043005587608424,551,Could be worse...could be Hillary.
3225,1,9,82,92,1.1195652173913044,0.037359040069358376,551,Give ME your tired poor...
3225,1,9,82,92,1.1195652173913044,0.037359040069358376,551,"One if by land, two if by sea, and I on the uninformed side will be..."
3225,1,9,82,92,1.1195652173913044,0.037359040069358376,551,Who knows the words to Kumbaya?
3225,2,7,83,92,1.1195652173913044,0.04043005587608424,551,It's because we didn't vote for him.
3225,0,11,81,92,1.1195652173913044,0.03401185575155456,551,"George, I don't think we're in the Potomac anymore."
3225,1,9,82,92,1.1195652173913044,0.037359040069358376,551,"Sorta gives a whole new meaning to ""Wave of Consciousness"", don'tcha think?"
3225,0,11,81,92,1.1195652173913044,0.03401185575155456,551,And I thought Charybdis was scary.
3225,2,7,83,92,1.1195652173913044,0.04043005587608424,551,"Well, this is Sad."
3225,2,7,83,92,1.1195652173913044,0.04043005587608424,551,"That's the Big Kahuna greeting your tired, poor, huddled masses."
3225,2,7,83,92,1.1195652173913044,0.04043005587608424,551,We must be getting close to Williamsburg! The waves are appearing more artisanal!
3225,2,7,83,92,1.1195652173913044,0.04043005587608424,551,"Starboard, far, far to starboard and we'll be O.K."
3225,1,9,82,92,1.1195652173913044,0.037359040069358376,551,"If you must know, it's because we missed the last ferry."
3349,1,9,83,93,1.118279569892473,0.036977503381552486,551,Watch your...kitties!!
3349,1,9,83,93,1.118279569892473,0.036977503381552486,551,There's no turning back now!
3349,2,7,84,93,1.118279569892473,0.04001362076879963,551,"That's just Donald practicing his ""I'm really scary"" routine."
3349,1,9,83,93,1.118279569892473,0.036977503381552486,551,"Man o' Trump, That's one hairy wave."
3349,2,7,84,93,1.118279569892473,0.04001362076879963,551,Ellis Island or Bust
3349,1,9,83,93,1.118279569892473,0.036977503381552486,551,Hokusai would be appalled!
3349,0,11,82,93,1.118279569892473,0.03366870454347981,551,... and some folks see waves as a metaphor.
3349,2,7,84,93,1.118279569892473,0.04001362076879963,551,I told you not to go to New Jersey
3349,3,5,85,93,1.118279569892473,0.04283507835554757,551,OMG. It's a Trump tsunami.
3349,1,9,83,93,1.118279569892473,0.036977503381552486,551,Scary but it's still better than where we came from
3349,2,7,84,93,1.118279569892473,0.04001362076879963,551,I didn't think a wave could have a comb over!
3349,0,11,82,93,1.118279569892473,0.03366870454347981,551,First we have to get past the Big Kahuna...
3349,1,9,83,93,1.118279569892473,0.036977503381552486,551,"You know, I'll bet that tidal wave doesn't have a birth certificate."
3349,0,11,82,93,1.118279569892473,0.03366870454347981,551,But we made our hotel reservations in Russian.
3349,4,3,86,93,1.118279569892473,0.04548184284329833,551,Mobby Dick.
3349,1,9,83,93,1.118279569892473,0.036977503381552486,551,Home of the brazen.
3349,2,7,84,93,1.118279569892473,0.04001362076879963,551,"I said, give me back my comb!"
3349,0,11,82,93,1.118279569892473,0.03366870454347981,551,Blind Trust
3349,2,7,84,93,1.118279569892473,0.04001362076879963,551,Oh no! It's a Trump-nami. We're doomed.
3349,2,7,84,93,1.118279569892473,0.04001362076879963,551,We're looking for Ithaca!
3349,2,7,84,93,1.118279569892473,0.04001362076879963,551,I told you we should have taken a different route.
3349,1,9,83,93,1.118279569892473,0.036977503381552486,551,"Just keep in mind, we are in a Las Vegas replica."
3349,0,11,82,93,1.118279569892473,0.03366870454347981,551,"OK! OK! I'm sorry I called Manhattan Brooklyn."""
3349,1,9,83,93,1.118279569892473,0.036977503381552486,551,I'm thinking Hokusai.
3349,1,9,83,93,1.118279569892473,0.036977503381552486,551,"Ahead, our newest addition to NEW YORK WORLD! He doesn't play well with others and we are having glitches in his narrative loop. Try saying, 'You're fired!' and see what happens..."
3349,2,7,84,93,1.118279569892473,0.04001362076879963,551,Trump finally unveild his economic strategy!
3349,1,9,83,93,1.118279569892473,0.036977503381552486,551,At least it's still blue and not orange.
3349,0,11,82,93,1.118279569892473,0.03366870454347981,551,There is no way that we will be able to escape the entire Trump Presidency
3349,3,5,85,93,1.118279569892473,0.04283507835554757,551,Don't worry - she'll keep us safe
3349,2,7,84,93,1.118279569892473,0.04001362076879963,551,"So this is the New Colossus? Well, It does bring a whole new meaning to huddled masses yearning to breathe free."
3349,3,5,85,93,1.118279569892473,0.04283507835554757,551,Let me help you over the wall
3349,3,5,85,93,1.118279569892473,0.04283507835554757,551,"Whatever you do, don't be a pussy."
3349,1,9,83,93,1.118279569892473,0.036977503381552486,551,Enough already!
3349,1,9,83,93,1.118279569892473,0.036977503381552486,551,"But Kennedy said a rising tide floats all boats, so what could go wrong?"
3349,1,9,83,93,1.118279569892473,0.036977503381552486,551,"Hey look, it's the iron curtain, never known to extend this far west before now!"
3349,1,9,83,93,1.118279569892473,0.036977503381552486,551,Either Poseidon's now sporting a combover or this Trump thing is getting ridiculous!
3349,1,9,83,93,1.118279569892473,0.036977503381552486,551,That one looks like President Trump!
3349,2,7,84,93,1.118279569892473,0.04001362076879963,551,"Trump is saying DON'T bring me your tired, your poor, your huddled masses. That's unpresidented."
3349,3,5,85,93,1.118279569892473,0.04283507835554757,551,Merde!!
3349,3,5,85,93,1.118279569892473,0.04283507835554757,551,"Make the Wretched Refuse from the Teeming Shore, Great Again!"
3349,2,7,84,93,1.118279569892473,0.04001362076879963,551,A tsunami with a bad hairpiece doesn't scare me.
3349,1,9,83,93,1.118279569892473,0.036977503381552486,551,Let's wait this one out and see what happens.
3349,2,7,84,93,1.118279569892473,0.04001362076879963,551,But her emails!
3349,2,7,84,93,1.118279569892473,0.04001362076879963,551,Relax. It's only Donald Trump.
3349,2,7,84,93,1.118279569892473,0.04001362076879963,551,"Joke's on you, Trump. We left our wallets at the boathouse."
3349,1,9,83,93,1.118279569892473,0.036977503381552486,551,"Guard your kittys, there’s a huge populist wave with a comb over to overcome."
3349,1,9,83,93,1.118279569892473,0.036977503381552486,551,"Lo! The poor Indian, whose untutored mind sees God in clouds, or hears him in the wind."
3396,1,9,84,94,1.1170212765957446,0.03660364473954168,551,There must be another response to January 20th
3396,2,7,85,94,1.1170212765957446,0.03960564868328441,551,"Don't worry. The mini hands are the least of our worries, if they don't get too close."
3396,1,9,84,94,1.1170212765957446,0.03660364473954168,551,This is not a welcoming wave!
3396,2,7,85,94,1.1170212765957446,0.03960564868328441,551,"Ok, who used American Express?"
3396,3,5,86,94,1.1170212765957446,0.0423956130634871,551,It's mirroring us. Stay calm and act benevolent.
3396,1,9,84,94,1.1170212765957446,0.03660364473954168,551,"So we beat on, boats against the current borne back ceaselessly into the past. F. Scott Fitzgerald"
3396,1,9,84,94,1.1170212765957446,0.03660364473954168,551,Global warming is Japanese fantasy.
3396,1,9,84,94,1.1170212765957446,0.03660364473954168,551,Did you remember to close the windows?
3404,1,8,81,90,1.1111111111111112,0.036870202688664894,551,Wait - are we rowing on 3 or 4?
3404,0,10,80,90,1.1111111111111112,0.03331251951092717,551,"I know you wanted to visit all the museums, but this is extreme art appreciation."
3404,2,6,82,90,1.1111111111111112,0.04011358543486932,551,Is this really the only way to Williamsburg?
3404,3,4,83,90,1.1111111111111112,0.04311365939673746,551,I think he wants us to ride him to shore!
3404,2,6,82,90,1.1111111111111112,0.04011358543486932,551,He still has bad hair.
3404,1,8,81,90,1.1111111111111112,0.036870202688664894,551,This guy Krackens me up.
3404,2,6,82,90,1.1111111111111112,0.04011358543486932,551,HOOOAAX
3404,1,8,81,90,1.1111111111111112,0.036870202688664894,551,"""It's called 'The Knave'""."
3404,2,6,82,90,1.1111111111111112,0.04011358543486932,551,We should be good... Since he wife lied about graduating college when she was a drop out... And her doing a naked photo session with another naked female... They'll let anyone in...
3404,1,8,81,90,1.1111111111111112,0.036870202688664894,551,I've never faced a wave like this before!
3404,1,8,81,90,1.1111111111111112,0.036870202688664894,551,Oh no! A Bully Wave.
3404,0,10,80,90,1.1111111111111112,0.03331251951092717,551,Maybe this harbor is New Yuck!
3404,1,8,81,90,1.1111111111111112,0.036870202688664894,551,Misery acquaints a man with strange bedfellows.
3404,2,6,82,90,1.1111111111111112,0.04011358543486932,551,"How many do you need to be considered a ""huddled masses""?"
3404,1,8,81,90,1.1111111111111112,0.036870202688664894,551,"Hey dude, we're from Hollywood...we're looking for Canada?"
3404,1,8,81,90,1.1111111111111112,0.036870202688664894,551,This is a yuuuuge Hokusai rip-off!
3404,1,8,81,90,1.1111111111111112,0.036870202688664894,551,"Relax, US is great enough to get through this political tsunami."
3404,1,8,81,90,1.1111111111111112,0.036870202688664894,551,Don't worry everyone. It's only a licensed image.
3404,1,8,81,90,1.1111111111111112,0.036870202688664894,551,The wretched refuse of your teeming shore.. I lift my lamp only if you can scale The beautiful wall And come through the tiny golden door
3404,1,8,81,90,1.1111111111111112,0.036870202688664894,551,"Row harder, it's opening its mouth again!"
3404,2,6,82,90,1.1111111111111112,0.04011358543486932,551,"Actually, we're leaving. Is that okay, Mr. Trump?"
3404,1,8,81,90,1.1111111111111112,0.036870202688664894,551,"It's the tsunami, stupid."
3404,2,6,82,90,1.1111111111111112,0.04011358543486932,551,"With a foreign shore their goal, Noah and his neighbors forgo the Ferry to discover the Man in the Sea is now Majority controlled."
3404,2,6,82,90,1.1111111111111112,0.04011358543486932,551,"Yes, we're not tired, poor, or huddled masses."
3404,2,6,82,90,1.1111111111111112,0.04011358543486932,551,"...hey, isn't that Donald waving?"
3404,3,4,83,90,1.1111111111111112,0.04311365939673746,551,Does anyone know what'fuhgeddaboudit'means?
3404,2,6,82,90,1.1111111111111112,0.04011358543486932,551,"Like the old adage says, 'many little hands make light of the Presidency.'"
3404,2,6,82,90,1.1111111111111112,0.04011358543486932,551,The Hillary supporters who promised to leave and are.
3404,1,8,81,90,1.1111111111111112,0.036870202688664894,551,These days nobody remembers why we call it Donald.
3404,2,6,82,90,1.1111111111111112,0.04011358543486932,551,Don't be alarmed. This is a fake wave.
3404,1,8,81,90,1.1111111111111112,0.036870202688664894,551,I guess this is his idea of sealing our borders.
3404,3,4,83,90,1.1111111111111112,0.04311365939673746,551,We have here a reproduction of a famous Japanese print.
3404,3,4,83,90,1.1111111111111112,0.04311365939673746,551,Thank God they weren't calling for snow.
3404,2,6,82,90,1.1111111111111112,0.04011358543486932,551,"Well, at least he branded it."
3404,2,6,82,90,1.1111111111111112,0.04011358543486932,551,"There are Internet meme Cheetos that look like Trump, but this is ridiculous."
3404,0,10,80,90,1.1111111111111112,0.03331251951092717,551,Did it sound like 'Welcome' to you?
3404,2,6,82,90,1.1111111111111112,0.04011358543486932,551,"This Trumpstro, I've heard of him! By a wave of his hair, he swallows whole ships alive!"
3404,1,8,81,90,1.1111111111111112,0.036870202688664894,551,I say we stay put til there's a full recount.
3404,1,8,81,90,1.1111111111111112,0.036870202688664894,551,Don't tread on me!
3404,3,4,83,90,1.1111111111111112,0.04311365939673746,551,Maybe it's delousing!
3404,1,8,81,90,1.1111111111111112,0.036870202688664894,551,May Day! May Day! Trumpism!
3404,1,8,81,90,1.1111111111111112,0.036870202688664894,551,Wait a minute! He said global warming was a hoax by the Chinese. . .
3404,3,4,83,90,1.1111111111111112,0.04311365939673746,551,"So this is "" The Great Wall of Trump."""
3404,1,8,81,90,1.1111111111111112,0.036870202688664894,551,"So that's how we got the expressions ""Rouge Wave"" and ""Angry Seas""!"
3404,2,6,82,90,1.1111111111111112,0.04011358543486932,551,"When it rains, it roars!"
3404,2,6,82,90,1.1111111111111112,0.04011358543486932,551,Would you like a hug?
3404,2,6,82,90,1.1111111111111112,0.04011358543486932,551,But in the print the wave wasn't orange.
3404,1,8,81,90,1.1111111111111112,0.036870202688664894,551,comb over to the other side if you want to Triumpp
3404,2,6,82,90,1.1111111111111112,0.04011358543486932,551,"To the last, I grapple with thee..."
3404,3,4,83,90,1.1111111111111112,0.04311365939673746,551,"''I knew we should have chosen the 'Thirty-six Views of Trump Tower' tour instead."""
3404,0,10,80,90,1.1111111111111112,0.03331251951092717,551,My ears hath heard you tweet. Who is this that darkeneth words without knowledge?
3404,2,6,82,90,1.1111111111111112,0.04011358543486932,551,"Ursula, make my martini extra dry."
3404,1,8,81,90,1.1111111111111112,0.036870202688664894,551,"Hang on, everyone! I didn't know Trump's portfolio had holdings in rogue waves."
3404,3,4,83,90,1.1111111111111112,0.04311365939673746,551,You can only enter if you are staying at a Trump property.
3404,1,8,81,90,1.1111111111111112,0.036870202688664894,551,"Behold, the Loser Wave off New York."
3404,0,10,80,90,1.1111111111111112,0.03331251951092717,551,"And these, folks, are the famous orange caps, found only in New York Harbor. Let's row the boat back toward Brooklyn, shall we?"
3404,2,6,82,90,1.1111111111111112,0.04011358543486932,551,You're all wet!
3404,3,4,83,90,1.1111111111111112,0.04311365939673746,551,"Her ""waiting list""is YUUUGE. I'm sending all you ""wretcheds"" back!!"
3404,0,10,80,90,1.1111111111111112,0.03331251951092717,551,This is more than hands across the sea!
3404,2,6,82,90,1.1111111111111112,0.04011358543486932,551,No one here named Ahab or Ishmael.
3404,0,10,80,90,1.1111111111111112,0.03331251951092717,551,"Hey Lady, do your liberty thing!"
3404,1,8,81,90,1.1111111111111112,0.036870202688664894,551,"Is it my imagination, or does this look like Trump?"
3404,2,6,82,90,1.1111111111111112,0.04011358543486932,551,"Ladies, Beware! It's the Trump-o-pus!"
3404,2,6,82,90,1.1111111111111112,0.04011358543486932,551,"boy, I'm glad we bought the 4K version of this tour."
3404,0,10,80,90,1.1111111111111112,0.03331251951092717,551,Wow I really understand what rising sea levels means
3404,2,6,82,90,1.1111111111111112,0.04011358543486932,551,"Resist, resist, resist."
3404,2,6,82,90,1.1111111111111112,0.04011358543486932,551,And this compensates for small hands ?
3404,1,8,81,90,1.1111111111111112,0.036870202688664894,551,"Give me your tired, your poor, your huddled masses, yearning to clarify their climate change equivocality."
3404,1,8,81,90,1.1111111111111112,0.036870202688664894,551,We are totally going to pay for this wall.
3404,2,6,82,90,1.1111111111111112,0.04011358543486932,551,Who needs martinis when you have LSD.
3404,1,8,81,90,1.1111111111111112,0.036870202688664894,551,Trump Ahoy!
3404,3,4,83,90,1.1111111111111112,0.04311365939673746,551,Just shake hands and everybody will be ok!
3404,4,2,84,90,1.1111111111111112,0.04591813929935769,551,Oh No!!!It's a Trump Tide-
3404,2,6,82,90,1.1111111111111112,0.04011358543486932,551,I wonder if that's his real hair?
3404,1,8,81,90,1.1111111111111112,0.036870202688664894,551,"Well, I guess we have to give him a chance"
3404,1,8,81,90,1.1111111111111112,0.036870202688664894,551,"Gimmee gimmee gimmee your tired, your poor, your huddled masses!"
3404,2,6,82,90,1.1111111111111112,0.04011358543486932,551,Trumptsunami (Thirty-six Views of Mount Liberty)
3404,2,6,82,90,1.1111111111111112,0.04011358543486932,551,She looks a lot like the old Colossus to me.
3404,2,6,82,90,1.1111111111111112,0.04011358543486932,551,That's no rising tide!!
3404,2,6,82,90,1.1111111111111112,0.04011358543486932,551,Every things going to be alright!
3404,4,2,84,90,1.1111111111111112,0.04591813929935769,551,Heads Up!
3404,1,8,81,90,1.1111111111111112,0.036870202688664894,551,This is going to be so sad!
3404,3,4,83,90,1.1111111111111112,0.04311365939673746,551,His reach exceeds his grasp with current events.
3404,3,4,83,90,1.1111111111111112,0.04311365939673746,551,Grab you ass and you wallet!
3404,0,10,80,90,1.1111111111111112,0.03331251951092717,551,"As you are about to see, this has nothing to do with Donald Trump."
3404,0,10,80,90,1.1111111111111112,0.03331251951092717,551,Hang on. We're about to be tempest-tost by the Trump tsunami.
3404,1,8,81,90,1.1111111111111112,0.036870202688664894,551,His escalator wave was a lot more appealing.
3404,1,8,81,90,1.1111111111111112,0.036870202688664894,551,"Don't worry, the Weather Channel predicted blue skies and sunshine!"
3404,1,8,81,90,1.1111111111111112,0.036870202688664894,551,"""Remember the breath - holding exercises? Start now!"
3404,1,8,81,90,1.1111111111111112,0.036870202688664894,551,It's Yuge! And it's got us by the balls.
3404,2,6,82,90,1.1111111111111112,0.04011358543486932,551,It's a Trump-nami!
3404,2,6,82,90,1.1111111111111112,0.04011358543486932,551,I understand we're here to test President Trump's replacement for waterboarding.
3404,3,4,83,90,1.1111111111111112,0.04311365939673746,551,And to think that we paid $100 each for the supposedly 36 greatest views of NYC.
3404,2,6,82,90,1.1111111111111112,0.04011358543486932,551,"Oh no, it's the Trump combover coming after us poor immigrants!"
3404,3,4,83,90,1.1111111111111112,0.04311365939673746,551,Oh no it is the mango mussolini tsunami! Paddle faster!
3404,1,8,81,90,1.1111111111111112,0.036870202688664894,551,"Dang, that rising tide again!"
3404,2,6,82,90,1.1111111111111112,0.04011358543486932,551,Told you Trump would catch us.
3404,0,11,88,99,1.1111111111111112,0.03174603174603174,551,"For a closer look at Hokusai's lesser known Great Wave off Staten Island, we just bring you out here."
3404,0,10,80,90,1.1111111111111112,0.03331251951092717,551,I told you the surf report was wrong. Sad.
3404,2,6,82,90,1.1111111111111112,0.04011358543486932,551,"Meet Donald J. Poseidon, another mythical creature."
3404,1,8,81,90,1.1111111111111112,0.036870202688664894,551,"Don't worry everyone, it knows we voted for it."
3404,1,8,81,90,1.1111111111111112,0.036870202688664894,551,I'm feeling a lot of economic anxiety right now.
3404,2,6,82,90,1.1111111111111112,0.04011358543486932,551,I told you we should have taken the bridge!
3404,2,6,82,90,1.1111111111111112,0.04011358543486932,551,We forgot to pack an orange Smartie!
3404,1,8,81,90,1.1111111111111112,0.036870202688664894,551,"And on your right, we see the spirit of the tired, poor and hungry who failed to properly complete a Form I-589 ""Application for Asylum."
3404,1,8,81,90,1.1111111111111112,0.036870202688664894,551,That one's called the tempest tosser.
3404,1,8,81,90,1.1111111111111112,0.036870202688664894,551,Turn around! The New Yorker has become a left-wing rag!
3404,0,10,80,90,1.1111111111111112,0.03331251951092717,551,"Calm down Donald, we're from Staten Island."
3404,1,8,81,90,1.1111111111111112,0.036870202688664894,551,"Give me your tired, your poor, your huddled masses yearning to be free because I really want to hone in on my waterboarding skills."
3404,1,8,81,90,1.1111111111111112,0.036870202688664894,551,"You are no longer welcome you tired, you poor, you huddled masses yearning to breathe free."
3404,1,8,81,90,1.1111111111111112,0.036870202688664894,551,"Relax, we'll sail through easily...as long as we avoid any leaks."
3404,3,4,83,90,1.1111111111111112,0.04311365939673746,551,"Ladies don't worry the Not So Great Wave off NYC is not a tsunami but a freak, rogue groper with tiny hands."
3516,1,8,82,91,1.10989010989011,0.03648322226516845,551,"Don't care how tired you are keep huddling, huge huddling, yearning--but Poor, get out here."
3516,1,8,82,91,1.10989010989011,0.03648322226516845,551,"Woe be-tweet us, the orange-dark sea is not nice today, my friends, believe me."
3516,1,8,82,91,1.10989010989011,0.03648322226516845,551,"Look out Lady Liberty , those small hands are churning up whats called the comb over tsunami."
3516,2,6,83,91,1.10989010989011,0.0396891137599459,551,And our next attraction on the Immigrant Cruise is 'wave of change'.
3516,1,8,82,91,1.10989010989011,0.03648322226516845,551,Rowing tours are the best way to truly experience the Hudson River mouth.
3516,2,6,83,91,1.10989010989011,0.0396891137599459,551,A wave away from freedom.
3516,2,6,83,91,1.10989010989011,0.0396891137599459,551,"Man, now that's one mean NY wave"
3516,2,6,83,91,1.10989010989011,0.0396891137599459,551,Dump your cash!
3516,3,4,84,91,1.10989010989011,0.04265473004544949,551,"Cast out the tired, the poor / The drug-addicted seeking all things free / The thieves and hustlers from some distant shore / Send these, the useless shirkers, back to sea / I turn away and bravely slam the door."
3516,3,4,84,91,1.10989010989011,0.04265473004544949,551,"We've entered hostile waters, but we're not turning back."""
3516,2,6,83,91,1.10989010989011,0.0396891137599459,551,I can't believe he is building a wall here.
3516,1,8,82,91,1.10989010989011,0.03648322226516845,551,This shore is wretched!
3516,0,10,81,91,1.10989010989011,0.032967032967032975,551,"We're already as wet as can be, so what have we got to lose?"
3516,1,8,82,91,1.10989010989011,0.03648322226516845,551,"Hi, we are the Mass family. Can you tell us where we might huddle?"
3516,2,6,83,91,1.10989010989011,0.0396891137599459,551,"Seems we're seeing ""the Donald"" everywhere lately."
3516,1,8,82,91,1.10989010989011,0.03648322226516845,551,"Give me your tired, your poor, your huddled masses yearning to breathe toupee."
3516,1,8,82,91,1.10989010989011,0.03648322226516845,551,You were right. The swamp would have been faster.
3516,0,10,81,91,1.10989010989011,0.032967032967032975,551,He just won't let anything get past him.
3516,2,6,83,91,1.10989010989011,0.0396891137599459,551,"Kookie,Kookie,lend me your comb"
3516,2,6,83,91,1.10989010989011,0.0396891137599459,551,The Bermuda Triangle already?
3516,0,10,81,91,1.10989010989011,0.032967032967032975,551,"Don't worry--the city cut a deal. It's 58 stories high, but the public has access to the bottom levels."
3516,3,4,84,91,1.10989010989011,0.04265473004544949,551,"On your left is the New York, rogue wave that sunk our tour ship."
3516,3,4,84,91,1.10989010989011,0.04265473004544949,551,We're homeless and tempest-tossed and want to help you make America great again.
3516,1,8,82,91,1.10989010989011,0.03648322226516845,551,Tiny hands make fright work!
3516,1,8,82,91,1.10989010989011,0.03648322226516845,551,Making Waves.
3516,2,6,83,91,1.10989010989011,0.0396891137599459,551,"Uh, now would be a good time for him to build that wall."
3516,1,8,82,91,1.10989010989011,0.03648322226516845,551,"He says if we're tired, we must be fired."
3516,0,10,81,91,1.10989010989011,0.032967032967032975,551,"Please, we promise you we didn't vote for the Lady!"
3516,1,8,82,91,1.10989010989011,0.03648322226516845,551,And we all thought things were a problem with just one set of hands
3516,2,6,83,91,1.10989010989011,0.0396891137599459,551,Everyone jump! It's the ghost of Christmas never.
3516,1,8,82,91,1.10989010989011,0.03648322226516845,551,"It appears the sea is a little restless today, folks!"
3516,2,6,83,91,1.10989010989011,0.0396891137599459,551,"We've seen that silly hairdo before. Not scared. Aside, you poseur! We're coming on in."
3516,1,8,82,91,1.10989010989011,0.03648322226516845,551,"At last, a low-cost, no-frills, low-calorie way to sail to Europe."
3516,2,6,83,91,1.10989010989011,0.0396891137599459,551,And if you'll look to the bow you'll see 10 million pounds of sludge from New York and New Jersey.
3516,1,8,82,91,1.10989010989011,0.03648322226516845,551,"Ok, now I understand the one-star Yelp review."
3516,3,4,84,91,1.10989010989011,0.04265473004544949,551,grab your dinghy I think he's going to swamp us
3516,2,6,83,91,1.10989010989011,0.0396891137599459,551,"Donald, I am so relieved, you are not half as scary as when campaigning"
3553,2,6,84,92,1.108695652173913,0.039273508147597495,551,Mein Gott! It's a sue-nami.
3553,2,6,84,92,1.108695652173913,0.039273508147597495,551,"I think It's saying ""money trumps need""."
3553,2,6,84,92,1.108695652173913,0.039273508147597495,551,"OMG, It’s Octo-Trump!"
3553,1,8,83,92,1.108695652173913,0.03610425042817033,551,Hokusai would not approve!
3553,1,8,83,92,1.108695652173913,0.03610425042817033,551,"Now the second verse: 'Wave, wave, go away . . .'"
3553,2,6,84,92,1.108695652173913,0.039273508147597495,551,"On this Trump Tour, we learn that Mother Nature doesn't cut deals, she dictates."
3553,1,8,83,92,1.108695652173913,0.03610425042817033,551,It's called 'psychotic ideation'. We may need more than a pail to right the good ship 'Liberal'.
3553,2,6,84,92,1.108695652173913,0.039273508147597495,551,We're out of luck. Trump put up his liquid fence.
3553,0,10,82,92,1.108695652173913,0.03262859720767456,551,"Not on MY WATCH, Missy"
3553,1,8,83,92,1.108695652173913,0.03610425042817033,551,At first I thought it was the parting of the Red Sea.
3553,2,6,84,92,1.108695652173913,0.039273508147597495,551,I think the ocean's finally sick of getting the wretched refuse of our teeming shore.
3553,1,8,83,92,1.108695652173913,0.03610425042817033,551,Just take a deep breath--and hold it.
3553,1,8,83,92,1.108695652173913,0.03610425042817033,551,say hello to our resident tsunami wave....
3553,2,6,84,92,1.108695652173913,0.039273508147597495,551,I wonder who will pay for this wall.
3553,1,8,83,92,1.108695652173913,0.03610425042817033,551,We're from the EPA. The fair-minded would start with Trump Tower.
3553,1,8,83,92,1.108695652173913,0.03610425042817033,551,"But, it's not our boat!"
3553,2,6,84,92,1.108695652173913,0.039273508147597495,551,"....and on the starboard side, Trump's Great Wave of Fear...it's scary, but it's not real."
3553,3,4,85,92,1.108695652173913,0.04220544971278918,551,Who knew Trump could metamorphosis?
3553,2,6,84,92,1.108695652173913,0.039273508147597495,551,And I thought all were welcome! And I was led to believe all were welcome!
3553,1,8,83,92,1.108695652173913,0.03610425042817033,551,"No problem, our seat cushions can be used as life preservers."
3553,0,10,82,92,1.108695652173913,0.03262859720767456,551,"I like to be in America, Okay by me in America, Everything free in America.."
3553,2,6,84,92,1.108695652173913,0.039273508147597495,551,"Oh no, it's a rogue Trump"
3553,1,8,83,92,1.108695652173913,0.03610425042817033,551,Holy Moses!!
3553,2,6,84,92,1.108695652173913,0.039273508147597495,551,It looks like Donald learned to control the climate to get rid of immigrants
3553,1,8,83,92,1.108695652173913,0.03610425042817033,551,I guess this is how Americans wave hello now.
3553,2,6,84,92,1.108695652173913,0.039273508147597495,551,Did I just hear somebody back there say life is but a dream?
3553,0,10,82,92,1.108695652173913,0.03262859720767456,551,"uh oh, the Trump wave has arrived"
3553,2,6,84,92,1.108695652173913,0.039273508147597495,551,I knew it was a mistake to go to Trump International Boat Rentals
3553,0,10,82,92,1.108695652173913,0.03262859720767456,551,Oh no! I thought he was going to build a wall not a wave!
3553,1,8,83,92,1.108695652173913,0.03610425042817033,551,"It's a bird, it's a plane, it's Duperman!"
3553,0,10,82,92,1.108695652173913,0.03262859720767456,551,Am I the only one who thinks this wave looks a lot like our next President?
3553,3,4,85,92,1.108695652173913,0.04220544971278918,551,"Don't worry, everyone. The small hands of the Trump-nami can't reach us as long as we remember how great we are."
3553,2,6,84,92,1.108695652173913,0.039273508147597495,551,Is this part of Trump's new immigration policy?
3553,2,6,84,92,1.108695652173913,0.039273508147597495,551,"Oh dear Lord, please make the wild trumpus stop!"
3553,1,8,83,92,1.108695652173913,0.03610425042817033,551,..heard Hillary had joined the Waves.
3553,1,8,83,92,1.108695652173913,0.03610425042817033,551,"Told ya that ""Give me your tired..."" was a bunch of crock!"
3553,1,8,83,92,1.108695652173913,0.03610425042817033,551,"Hey pal. If you're the homeless, tempest tossed, jump in."
3590,2,6,85,93,1.10752688172043,0.03886649447231017,551,"It's a creepy, bigly wave, all right, but we'll ride it out!"
3590,1,8,84,93,1.10752688172043,0.03573304215805771,551,"Come on honey, let's give it a chance"
3590,0,10,83,93,1.10752688172043,0.03229700003364001,551,Wow...and orange curl.
3590,3,4,86,93,1.10752688172043,0.04176551787375207,551,Tell Mr. Hokusai I'll deport him.
3590,1,8,84,93,1.10752688172043,0.03573304215805771,551,"Don't worry. This is a fun, easy-to-manage wave that's perfect for the beach or a day on the bay."
3590,0,10,83,93,1.10752688172043,0.03229700003364001,551,"Whoa, I thought this only happened on Lake Eerie."
3590,2,6,85,93,1.10752688172043,0.03886649447231017,551,Is this a new type of tweeting?
3590,1,8,84,93,1.10752688172043,0.03573304215805771,551,"Lois, I know the waters a little rough but I really think you are projecting here..."
3590,1,8,84,93,1.10752688172043,0.03573304215805771,551,It's El Blanco.
3590,1,8,84,93,1.10752688172043,0.03573304215805771,551,'I've seen some scary waves in my time but this is ridiculous.'
3600,3,4,87,94,1.1063829787234043,0.04133464632783404,551,"Quick everyone, mannequin challenge!"
3600,2,6,86,94,1.1063829787234043,0.03846780975883542,551,This New Wave Trump will drown us!
3602,3,3,83,89,1.101123595505618,0.04241480019815027,551,The sea has never been the same since it played Off-Broadway.
3602,1,7,81,89,1.101123595505618,0.03589275757061102,551,Even the elements have their own Trump impressions these days.
3602,1,7,81,89,1.101123595505618,0.03589275757061102,551,I think its a Mexican Wave ...
3602,2,5,82,89,1.101123595505618,0.039289345386959953,551,"That's right--wave, now smile."
3602,1,7,81,89,1.101123595505618,0.03589275757061102,551,"God help us all. Not only is that hair real, but he actually has six pairs of tiny hands."
3602,1,7,81,89,1.101123595505618,0.03589275757061102,551,The president-elect is trapped in a twitter storm and is asking us to tweet him out of it.
3602,1,7,81,89,1.101123595505618,0.03589275757061102,551,I know Donald doesn't want us here but commissioning waves to look like him seems a bit overboard.
3602,2,5,82,89,1.101123595505618,0.039289345386959953,551,Special prize goes to the person who first spots the three Ninas
3602,1,7,81,89,1.101123595505618,0.03589275757061102,551,This wave blowing over is exactly what I'm worried about
3602,2,5,82,89,1.101123595505618,0.039289345386959953,551,Looks lie we won't have to take a shower tonight!
3602,1,7,81,89,1.101123595505618,0.03589275757061102,551,"OMG! Instead of Czechoslovakia, he's taking over the East River!"
3602,2,5,82,89,1.101123595505618,0.039289345386959953,551,Is the Bill of Rights inflatable?
3602,2,5,82,89,1.101123595505618,0.039289345386959953,551,"So I need to build a sea wall as well, do I?"
3602,1,7,81,89,1.101123595505618,0.03589275757061102,551,Too much gel in that comb-over
3602,1,7,81,89,1.101123595505618,0.03589275757061102,551,"Remember, 'if we can make it here...'"
3602,1,7,81,89,1.101123595505618,0.03589275757061102,551,We paid for our sea wall before we got the populist wave
3602,3,3,83,89,1.101123595505618,0.04241480019815027,551,Welcome to Staten Island
3602,1,7,81,89,1.101123595505618,0.03589275757061102,551,I think we should give it a chance.
3602,0,9,80,89,1.101123595505618,0.03213918840153681,551,But the lady said she was cool with 'the wretched refuse'.
3602,1,7,81,89,1.101123595505618,0.03589275757061102,551,Is that the Trump tsunami or Trump tsuris coming?
3602,1,7,81,89,1.101123595505618,0.03589275757061102,551,Saint Elmo you're fired!
3602,1,7,81,89,1.101123595505618,0.03589275757061102,551,Looks like a turn down for us.
3602,1,7,81,89,1.101123595505618,0.03589275757061102,551,"Lady Liberty is on the right, the thing here only looks like Trump."
3602,0,9,80,89,1.101123595505618,0.03213918840153681,551,"Oh, I have great news! That wave is not going to land on us!"
3602,1,7,81,89,1.101123595505618,0.03589275757061102,551,Is the pot melting or boiling?
3602,2,5,82,89,1.101123595505618,0.039289345386959953,551,I've never been face to face with such a handy wave.
3602,1,7,81,89,1.101123595505618,0.03589275757061102,551,Our tsunami is bigger than your backlash.
3602,2,5,82,89,1.101123595505618,0.039289345386959953,551,"Okay, who's first?"
3602,1,7,81,89,1.101123595505618,0.03589275757061102,551,Better hold off on that breathing free business for now.
3602,1,7,81,89,1.101123595505618,0.03589275757061102,551,Who here is an immigrant?
3602,0,9,80,89,1.101123595505618,0.03213918840153681,551,Don't wave back--you'll only encourage her.
3602,0,9,80,89,1.101123595505618,0.03213918840153681,551,I feel so welcome here.
3602,1,7,81,89,1.101123595505618,0.03589275757061102,551,I guess he's starting with the wretched refuse.
3602,0,9,80,89,1.101123595505618,0.03213918840153681,551,We're gonna get swamped!
3602,0,9,80,89,1.101123595505618,0.03213918840153681,551,Good morning Mr. Trump.
3602,1,7,81,89,1.101123595505618,0.03589275757061102,551,I told you not to rely on that stupid GPS.
3602,1,7,81,89,1.101123595505618,0.03589275757061102,551,Looks like Donald Trump really lost his wig!
3602,2,5,82,89,1.101123595505618,0.039289345386959953,551,The Narrows is very angry today.
3602,0,9,80,89,1.101123595505618,0.03213918840153681,551,"Oh, don't worry. Giuliani and he are good friends."
3602,2,5,82,89,1.101123595505618,0.039289345386959953,551,"Well that's kind of on the nose, isn't it?"
3602,2,5,82,89,1.101123595505618,0.039289345386959953,551,look out! . That wave has orange hair
3602,0,9,80,89,1.101123595505618,0.03213918840153681,551,Ah. Look! The elusive subway tile waves - found only in New York.
3602,3,3,83,89,1.101123595505618,0.04241480019815027,551,Going to be tough to 'catch the wave!'
3602,0,9,80,89,1.101123595505618,0.03213918840153681,551,This is HUGE! An real-life test of the theory that a rising tide lifts all boats!
3602,3,3,83,89,1.101123595505618,0.04241480019815027,551,Don't listen to what she says.
3602,2,5,82,89,1.101123595505618,0.039289345386959953,551,We're heading into a perfect sturm und drang.
3602,1,7,81,89,1.101123595505618,0.03589275757061102,551,Looks like the angry sea of voter discontent favors Donald Trump.
3602,2,5,82,89,1.101123595505618,0.039289345386959953,551,That's more than gnarly.
3602,2,5,82,89,1.101123595505618,0.039289345386959953,551,Just keep rowing—I can't imagine we'll get wet.
3602,1,7,81,89,1.101123595505618,0.03589275757061102,551,Immigrants Deported by the Don-tsunami
3602,2,5,82,89,1.101123595505618,0.039289345386959953,551,"I thought it was supposed to say ‘Give me your tired, your poor’ or something like that."
3602,1,7,81,89,1.101123595505618,0.03589275757061102,551,The Donald waves you away from our shores.
3602,1,7,81,89,1.101123595505618,0.03589275757061102,551,Take cover!! It's his tidal wave!!
3602,2,5,82,89,1.101123595505618,0.039289345386959953,551,This Trump wave only looks huge. We can defeat it with a popular vote to do so.
3602,2,5,82,89,1.101123595505618,0.039289345386959953,551,What do you mean we're fired?
3602,2,5,82,89,1.101123595505618,0.039289345386959953,551,Of course as everyone knows global Trumping is a hoax.
3602,3,3,83,89,1.101123595505618,0.04241480019815027,551,I'm a big tidal wave. Yuuuuge. But look at these hands. Are they small hands? People say the rest of me must be small. I guarantee you there is no problem. I guarantee you.
3602,1,7,81,89,1.101123595505618,0.03589275757061102,551,Trump's Tidal Weave: Once again swamping another boat of Family Tourists mistakenly thinking they were a boat of Family Terrorists.
3602,1,7,81,89,1.101123595505618,0.03589275757061102,551,Oh my god it's a Trumpami
3602,2,5,82,89,1.101123595505618,0.039289345386959953,551,It's been done Don.
3602,1,7,81,89,1.101123595505618,0.03589275757061102,551,"Oh, say his star-spangled Bannon does wave."
3602,2,5,82,89,1.101123595505618,0.039289345386959953,551,Life is but a bad dream.
3602,2,5,82,89,1.101123595505618,0.039289345386959953,551,We are about to be Trumped by a WALL of water.
3602,2,5,82,89,1.101123595505618,0.039289345386959953,551,"Good Lord, that's a really nasty looking swell!"
3602,1,7,81,89,1.101123595505618,0.03589275757061102,551,I forgot to close the windows.
3602,1,7,81,89,1.101123595505618,0.03589275757061102,551,"I thought he said wall, not swell!"
3602,1,7,81,89,1.101123595505618,0.03589275757061102,551,I think the President-Elect wants us to go back home...
3602,0,9,80,89,1.101123595505618,0.03213918840153681,551,Don't worry—the mouth of this Hokusai wave is actually a portal to Brooklyn.
3602,3,3,83,89,1.101123595505618,0.04241480019815027,551,Looks like we chose the wrong Tweet
3602,1,7,81,89,1.101123595505618,0.03589275757061102,551,I told you we should have built an Arc!
3602,0,9,80,89,1.101123595505618,0.03213918840153681,551,We want out of Staten Island!
3602,0,9,80,89,1.101123595505618,0.03213918840153681,551,It isn't easy being a huddled mass!
3602,0,9,80,89,1.101123595505618,0.03213918840153681,551,"Get back in the game, Charybdis. We've outlived competition before."
3602,1,7,81,89,1.101123595505618,0.03589275757061102,551,It was either this or the bus to Staten Island.
3602,1,7,81,89,1.101123595505618,0.03589275757061102,551,So help us God
3602,1,7,81,89,1.101123595505618,0.03589275757061102,551,"I'm no matchmaker, but...do you think we could fix the two of them up?"
3602,3,3,83,89,1.101123595505618,0.04241480019815027,551,"Send these, the homeless, tempest-tost from me."
3602,1,7,81,89,1.101123595505618,0.03589275757061102,551,"Don't blame me, I voted to see one of the other thirty-five views of New York."
3602,0,9,80,89,1.101123595505618,0.03213918840153681,551,The guy who rented us this boat at the pier was right - it isn't the circle tour of the harbor.
3602,1,7,81,89,1.101123595505618,0.03589275757061102,551,"'America, America,' we cried. Yonder's the Lady on whom we relied And here the spirits of those denied."
3602,1,7,81,89,1.101123595505618,0.03589275757061102,551,"From right to left it's Freedom Tower, the Statue of Liberty, and the insidious TrumpMeister MeisterTrumpster"
3602,1,7,81,89,1.101123595505618,0.03589275757061102,551,So that's why they call them waves!
3602,1,7,81,89,1.101123595505618,0.03589275757061102,551,It's an early Hokusai - 'The Uuge Comber off Ellis Island.'
3602,1,7,81,89,1.101123595505618,0.03589275757061102,551,Never fear! It's just the current.
3602,3,3,83,89,1.101123595505618,0.04241480019815027,551,Little boats? My little hands love little boats!
3602,0,9,80,89,1.101123595505618,0.03213918840153681,551,"Did someone say ""Let's make America great again."" ?"
3602,1,7,81,89,1.101123595505618,0.03589275757061102,551,"The jeannie got this all wrong. I asked for a trip on the sea because Trump is a monster, not a Trump Sea Monster."
3602,3,3,83,89,1.101123595505618,0.04241480019815027,551,For sure a storms a comin
3602,2,5,82,89,1.101123595505618,0.039289345386959953,551,"We'll rise with this wave, keep rowing."
3602,2,5,82,89,1.101123595505618,0.039289345386959953,551,Beware the little hands!
3602,1,7,81,89,1.101123595505618,0.03589275757061102,551,The lame duck told us we'd be welcomed.
3602,2,5,82,89,1.101123595505618,0.039289345386959953,551,Hurricane Donald. Just like they said on the news last night.
3602,0,9,80,89,1.101123595505618,0.03213918840153681,551,"Now, I really miss Purple Rain."
3602,0,9,80,89,1.101123595505618,0.03213918840153681,551,Don't worry; it will pass over.
3602,1,7,81,89,1.101123595505618,0.03589275757061102,551,"Liberals will make mountains out of mole hills, look what they created, it only took 8 years !"
3602,1,7,81,89,1.101123595505618,0.03589275757061102,551,"See that huge woman with the torch? Head that way, Smolenski!"
3602,1,7,81,89,1.101123595505618,0.03589275757061102,551,Anybody want to go bodysurfing?
3602,1,7,81,89,1.101123595505618,0.03589275757061102,551,"Global Warming Effects of 2016: Hurricane Donald, you know it, she knows it, everybody knows it."
3602,1,7,81,89,1.101123595505618,0.03589275757061102,551,This one's called The Donald.
3602,1,7,81,89,1.101123595505618,0.03589275757061102,551,Bad hair days are normal in transitions.
3602,0,9,80,89,1.101123595505618,0.03213918840153681,551,It says it's the new Golden Door but then mumbles something about us being wretched refuse...
3602,1,7,81,89,1.101123595505618,0.03589275757061102,551,Immigrants collide with the menacing Trump Tower.
3602,2,5,82,89,1.101123595505618,0.039289345386959953,551,OK.. this we take literally AND seriously...
3602,1,7,81,89,1.101123595505618,0.03589275757061102,551,Quick! Take a selfie before it's too late!
3602,1,7,81,89,1.101123595505618,0.03589275757061102,551,The latest tide of immigrants were treated to a warm welcome in New York harbor by Amnesty International.
3602,1,7,81,89,1.101123595505618,0.03589275757061102,551,Welcome to Staten Island
3602,1,7,81,89,1.101123595505618,0.03589275757061102,551,I told you would should have been here before the 20th.
3602,2,5,82,89,1.101123595505618,0.039289345386959953,551,"If we survive, we'll commemorate this date annually with a turkey dinner."
3602,0,9,80,89,1.101123595505618,0.03213918840153681,551,The great weave off Manhattan
3602,3,3,83,89,1.101123595505618,0.04241480019815027,551,I guess the UN has collapsed
3602,1,7,81,89,1.101123595505618,0.03589275757061102,551,And I thought hurricane Katrina was bad.
3602,0,9,80,89,1.101123595505618,0.03213918840153681,551,You're creating a disaster!
3602,1,7,81,89,1.101123595505618,0.03589275757061102,551,"You don't scare us, we have insurance."
3602,2,5,82,89,1.101123595505618,0.039289345386959953,551,We are doomed. It's another Trump Wave.
3602,1,7,81,89,1.101123595505618,0.03589275757061102,551,"I thought ""Hands Across the Sea"" was Parade Music"
3602,3,3,83,89,1.101123595505618,0.04241480019815027,551,"Hold on, this one's from New Jersey!"
3602,3,3,83,89,1.101123595505618,0.04241480019815027,551,Don't move and the Trump wave won't be able to see us.
3602,0,9,80,89,1.101123595505618,0.03213918840153681,551,"Tweet or be tweeted, Alice"
3602,2,5,82,89,1.101123595505618,0.039289345386959953,551,Ferry's not running.
3602,1,7,81,89,1.101123595505618,0.03589275757061102,551,And here's where we send the tempest-tossed.
3602,1,7,81,89,1.101123595505618,0.03589275757061102,551,Don't worry--it won't rock the boat.
3602,2,5,82,89,1.101123595505618,0.039289345386959953,551,"""Finally understand 'in a ship without a paddle' might not mean a ship without a paddle""."
3602,1,7,81,89,1.101123595505618,0.03589275757061102,551,That wave's headed straight for Trump Tower!
3602,2,5,82,89,1.101123595505618,0.039289345386959953,551,"Call this one ""Thirty six views of Trump's New York."""
3602,1,7,81,89,1.101123595505618,0.03589275757061102,551,No wonder Molly Brown stayed on board.
3602,0,9,80,89,1.101123595505618,0.03213918840153681,551,Let's try doing the wave
3602,3,3,83,89,1.101123595505618,0.04241480019815027,551,Help us all. It's a Trump-nami!
3602,1,7,81,89,1.101123595505618,0.03589275757061102,551,Whoa - he did tweet that he'd make waves great again!
3602,1,7,81,89,1.101123595505618,0.03589275757061102,551,"January Twentieth, Two Thousand Sixteen."
3602,1,7,81,89,1.101123595505618,0.03589275757061102,551,Is this New York's version of Wet and Wild?
3602,1,7,81,89,1.101123595505618,0.03589275757061102,551,This Homeland Security thing has goe too far!
3602,1,7,81,89,1.101123595505618,0.03589275757061102,551,How some people see the recent election results.
3602,2,5,82,89,1.101123595505618,0.039289345386959953,551,"""Nice fringe""."
3602,1,7,81,89,1.101123595505618,0.03589275757061102,551,Candygram
3602,2,5,82,89,1.101123595505618,0.039289345386959953,551,...a wall of water in the harbor?
3602,1,7,81,89,1.101123595505618,0.03589275757061102,551,Jonah's got nothing on this!
3602,4,1,84,89,1.101123595505618,0.045325245622745224,551,Who does your rediculous hair?
3602,0,9,80,89,1.101123595505618,0.03213918840153681,551,It's definitely Trump--I'd recognize that comb-over anywhere.
3602,2,5,82,89,1.101123595505618,0.039289345386959953,551,I hate when this happens. It means one of you has to be sacrificed.
3602,2,5,82,89,1.101123595505618,0.039289345386959953,551,"Sir, our Lady advises that she’s never taken part in a beauty contest. You must be thinking of someone else."
3602,1,7,81,89,1.101123595505618,0.03589275757061102,551,I was happy when the world was flat!
3602,1,7,81,89,1.101123595505618,0.03589275757061102,551,Show-goers to Donald Trump's new off-off Broadway production called it a hair-raising experience.
3602,1,7,81,89,1.101123595505618,0.03589275757061102,551,I guess Jersey really is that bad...
3602,1,7,81,89,1.101123595505618,0.03589275757061102,551,"Hang on, we just have to get through the Trump Tunnel."
3602,1,7,81,89,1.101123595505618,0.03589275757061102,551,"Now if we had Liberty Mutual insurance..."""
3602,2,5,82,89,1.101123595505618,0.039289345386959953,551,He warned us that he has the best waves.
3602,1,7,81,89,1.101123595505618,0.03589275757061102,551,"Mayday, Mayday! USS America, keep an even keel and we'll ride out this orange tsunami's bluster and destruction."
3602,0,9,80,89,1.101123595505618,0.03213918840153681,551,This is the high point—or low point—of our Uncharted Waters ride.
3602,1,7,81,89,1.101123595505618,0.03589275757061102,551,It's a promo for a new Broadway show.
3602,0,9,80,89,1.101123595505618,0.03213918840153681,551,There's a new president and a new wave.
3602,1,7,81,89,1.101123595505618,0.03589275757061102,551,Did anyone notice that guy Jonah who stayed behind at the Circle Line terminal?
3602,1,7,81,89,1.101123595505618,0.03589275757061102,551,Trumpador not pompadour wave greets immigrants at Ellis Island.
3602,1,7,81,89,1.101123595505618,0.03589275757061102,551,"Even the NYC harbour is ""trumping"" us."
3602,3,3,83,89,1.101123595505618,0.04241480019815027,551,"Oh no, they've built that wave!"
3602,1,7,81,89,1.101123595505618,0.03589275757061102,551,HAPPY NEW YEAR
3757,2,5,83,90,1.1,0.03886658893356652,551,This rouge wave is trying to Trump us.
3757,1,7,82,90,1.1,0.03550948950905247,551,Rogue Wall!
3757,1,7,82,90,1.1,0.03550948950905247,551,Emma Lazarus invited us.
3757,2,5,83,90,1.1,0.03886658893356652,551,"Where there's a will, there's a wave..."
3757,2,5,83,90,1.1,0.03886658893356652,551,I think it said it wants a cat.
3757,1,7,82,90,1.1,0.03550948950905247,551,Hold on ! It's a trumpeter swan song.
3757,2,5,83,90,1.1,0.03886658893356652,551,It's Hurricane Trump!
3757,2,5,83,90,1.1,0.03886658893356652,551,"Looks like he got Atlantis to build a wall for him, too."
3757,1,7,82,90,1.1,0.03550948950905247,551,Tourist-de-traction weather here!
3757,2,5,83,90,1.1,0.03886658893356652,551,"Well, he warned us we'd be grabbed by Nyuyoku ichi."
3757,1,7,82,90,1.1,0.03550948950905247,551,Name all of the Supreme Court Justices or face the consequences!
3757,0,9,81,90,1.1,0.031799936400190784,551,"Hey, do you have any Grey Poupon?"
3757,2,5,83,90,1.1,0.03886658893356652,551,"Now all together: Row,row,row your boat....."
3770,1,6,79,86,1.0930232558139534,0.03558349644646313,551,"Immigrants face ""hairrowing"" wave of antagonism"
3771,1,6,80,87,1.0919540229885059,0.03518836131447995,551,"Ha! Joke's on you, bub. I already got mugged today."
3771,1,6,80,87,1.0919540229885059,0.03518836131447995,551,"It's a rogue ""Trump-nami"" wave."
3771,0,8,79,87,1.0919540229885059,0.031159469919054366,551,I believe it's one of those huddled masses.
3771,1,6,80,87,1.0919540229885059,0.03518836131447995,551,a 3 hour tour?
3771,0,8,79,87,1.0919540229885059,0.031159469919054366,551,"Ooh, let's get a selfie!"
3771,2,4,81,87,1.0919540229885059,0.03880114661141246,551,"This is the Hillary tsunami, and it just won't stop."
3771,0,8,79,87,1.0919540229885059,0.031159469919054366,551,Your ancestors were immigrants too!
3771,1,6,80,87,1.0919540229885059,0.03518836131447995,551,"""Give me your tired, your poor, your huddled.""..Booo!"
3771,0,8,79,87,1.0919540229885059,0.031159469919054366,551,Poseidon lost too.
3771,1,6,80,87,1.0919540229885059,0.03518836131447995,551,No rooms in my hotel!
3771,1,6,80,87,1.0919540229885059,0.03518836131447995,551,"Everybody sing! ... Row, row, row your boat ...."
3771,2,4,81,87,1.0919540229885059,0.03880114661141246,551,Waves break after hitting bottom.
3771,1,6,80,87,1.0919540229885059,0.03518836131447995,551,"Hold on, here comes another gust."
3771,2,4,81,87,1.0919540229885059,0.03880114661141246,551,Have no fear; it just reminds you of something phony that was on TV.
3771,2,4,81,87,1.0919540229885059,0.03880114661141246,551,"""Quick! The shrimp popcorn!"
3771,2,4,81,87,1.0919540229885059,0.03880114661141246,551,"And straight ahead, you see Donald Trump, our ""President Elect"" - a scary Kraken who sometimes spends his weekends in the Hudson River."
3771,0,8,79,87,1.0919540229885059,0.031159469919054366,551,I told you to sail away from the wall.
3771,0,8,79,87,1.0919540229885059,0.031159469919054366,551,Yeah... she asked me to take care of the huddled masses from now on
3771,0,8,79,87,1.0919540229885059,0.031159469919054366,551,"""Hey, hey, Colossus, we're the huddled masses""."
3771,1,6,80,87,1.0919540229885059,0.03518836131447995,551,I'll give you tempest-tost.
3771,0,8,79,87,1.0919540229885059,0.031159469919054366,551,"Tired, poor, and huddled, but no match for the Great Wave."
3771,0,8,79,87,1.0919540229885059,0.031159469919054366,551,I think we're going out to sea.
3771,1,6,80,87,1.0919540229885059,0.03518836131447995,551,"Pardon me, we're with the ""Melville Experience"" charters company and we were supposed to get a white whale."
3771,2,4,81,87,1.0919540229885059,0.03880114661141246,551,Orange hair! we're in danger!
3771,3,2,82,87,1.0919540229885059,0.04210507314709547,551,"And this is Sue Nammy, if everybody waves to Sue, then Sue will wave back"
3771,0,8,79,87,1.0919540229885059,0.031159469919054366,551,I had to let her go; she was too inclusive...
3771,1,6,80,87,1.0919540229885059,0.03518836131447995,551,It'll be ok. He just met with Don King!!
3771,0,8,79,87,1.0919540229885059,0.031159469919054366,551,Didn't I tell you that sightseeing in New York City would be exciting?
3771,0,8,79,87,1.0919540229885059,0.031159469919054366,551,They were right about the view from out here!
3771,1,6,80,87,1.0919540229885059,0.03518836131447995,551,To your front - a picturesque giant wave.
3771,1,6,80,87,1.0919540229885059,0.03518836131447995,551,"Look, at least it's well-intentioned."
3771,1,6,80,87,1.0919540229885059,0.03518836131447995,551,"Don't worry, we're documented to wash up anywhere on shore between here and Caracas."
3771,0,8,79,87,1.0919540229885059,0.031159469919054366,551,We'll be alright if we can just weather the rogue wave.
3771,0,8,79,87,1.0919540229885059,0.031159469919054366,551,Oh! Here's a promising one!
3771,0,8,79,87,1.0919540229885059,0.031159469919054366,551,"If we row hard together, we can survive this."
3771,1,6,80,87,1.0919540229885059,0.03518836131447995,551,Sandy?...Donald?
3771,1,6,80,87,1.0919540229885059,0.03518836131447995,551,These huddled masses no longer feel welcome.
3771,1,6,80,87,1.0919540229885059,0.03518836131447995,551,Comb-over here!
3771,2,4,81,87,1.0919540229885059,0.03880114661141246,551,Trump's Wall
3771,1,6,80,87,1.0919540229885059,0.03518836131447995,551,I think we qualify as 'Your huddled masses yearning to breathe free' at the very least.
3771,1,6,80,87,1.0919540229885059,0.03518836131447995,551,I remember hair like that
3771,0,8,79,87,1.0919540229885059,0.031159469919054366,551,Who are you calling a watery tart?
3771,1,6,80,87,1.0919540229885059,0.03518836131447995,551,The Great Wave off Ellis Island
3771,0,8,79,87,1.0919540229885059,0.031159469919054366,551,That wave is trying to tell us something about ourselves.
3771,1,6,80,87,1.0919540229885059,0.03518836131447995,551,"It's OK, compadres! It's a Mexican wave over!"
3771,0,8,79,87,1.0919540229885059,0.031159469919054366,551,Noseless in a sea of no.
3771,1,6,80,87,1.0919540229885059,0.03518836131447995,551,"Hey Mr. Trump, there really aren't any Muslims in this boat."
3771,1,6,80,87,1.0919540229885059,0.03518836131447995,551,I thought he was moving to Washington? Row on...
3771,1,6,80,87,1.0919540229885059,0.03518836131447995,551,Have current events created the new colossass?
3771,0,8,79,87,1.0919540229885059,0.031159469919054366,551,Green isn't easy but imagine being orange.
3771,3,2,82,87,1.0919540229885059,0.04210507314709547,551,It's the Trump wave sending us back!
3771,0,8,79,87,1.0919540229885059,0.031159469919054366,551,"We all agreed with you, lots of small hands are better than only two big ones!"
3771,1,6,80,87,1.0919540229885059,0.03518836131447995,551,"Maybe it's the hands, but I think this one will fade quickly"
3771,1,6,80,87,1.0919540229885059,0.03518836131447995,551,"Damn the sea change, full speed ahead!"
3771,1,6,80,87,1.0919540229885059,0.03518836131447995,551,STEER LEFT! That wave trumps all the rest.
3771,2,4,81,87,1.0919540229885059,0.03880114661141246,551,It's A Trump Thing!
3771,0,8,79,87,1.0919540229885059,0.031159469919054366,551,"Sorry guys... I heard ""the golden door"" not ""the golden hair"" !"
3771,1,6,80,87,1.0919540229885059,0.03518836131447995,551,Trump Wall's bankrupt.
3771,3,2,82,87,1.0919540229885059,0.04210507314709547,551,"Hey, that wave looks like Donald Trump."
3771,1,6,80,87,1.0919540229885059,0.03518836131447995,551,"I thought he said wall, not swell!"
3771,2,4,81,87,1.0919540229885059,0.03880114661141246,551,This is sooo surreal!
3771,1,6,80,87,1.0919540229885059,0.03518836131447995,551,Noooooo! Wake me from this nightmare!
3771,1,6,80,87,1.0919540229885059,0.03518836131447995,551,"Welcome to New York City- here, you are in the eye of all storms-wherever!"
3771,0,8,79,87,1.0919540229885059,0.031159469919054366,551,"Faugh! It's that rat-crested, little-handed, mouthy wave! So sad - for US!"
3771,0,8,79,87,1.0919540229885059,0.031159469919054366,551,Twenty percent chance of rain my eye.
3771,1,6,80,87,1.0919540229885059,0.03518836131447995,551,Why did I just think of Washington crossing the Delaware ?
3771,2,4,81,87,1.0919540229885059,0.03880114661141246,551,You're Fired!
3771,0,8,79,87,1.0919540229885059,0.031159469919054366,551,Man his hands have gone every were
3771,2,4,81,87,1.0919540229885059,0.03880114661141246,551,"Either the sushi was past its sell-by date, or we're in for a world of hurt."
3771,0,8,79,87,1.0919540229885059,0.031159469919054366,551,Extremism in the defense of liberty can be a vice.
3771,0,8,79,87,1.0919540229885059,0.031159469919054366,551,"Guys, it's time for some game theory."
3771,0,8,79,87,1.0919540229885059,0.031159469919054366,551,"Donald,""the monster wave,"" consumes freedom seeking immigrants."
3771,1,6,80,87,1.0919540229885059,0.03518836131447995,551,I guess he didn't build the wall after all.
3771,2,4,81,87,1.0919540229885059,0.03880114661141246,551,"Faster, faster, the wall is coming!"
3771,0,8,79,87,1.0919540229885059,0.031159469919054366,551,Please Donald! We're tired and poor. Honest!
3771,1,6,80,87,1.0919540229885059,0.03518836131447995,551,Guess who!
3771,3,2,82,87,1.0919540229885059,0.04210507314709547,551,...and this is 'The Statute of Libertine Enfrightening the World.'
3771,0,8,79,87,1.0919540229885059,0.031159469919054366,551,Oh so THAT'S where Trump's wig went
3771,1,6,80,87,1.0919540229885059,0.03518836131447995,551,Don't give me tired or your poor!
3771,0,8,79,87,1.0919540229885059,0.031159469919054366,551,Is this what they meant by a surprise greeting?
3771,1,6,80,87,1.0919540229885059,0.03518836131447995,551,"Hey you, out there in the boat! Come back to Liberty Island and take me with you!!"
3771,0,8,79,87,1.0919540229885059,0.031159469919054366,551,You're right. He actually looks less presidential without the combover.
3771,3,2,82,87,1.0919540229885059,0.04210507314709547,551,"Hurray, it's the Wave of Protectionism!"
3771,0,8,79,87,1.0919540229885059,0.031159469919054366,551,"Yeah, it's me. Trump. Bad hair day. GO AWAY!"
3771,1,6,80,87,1.0919540229885059,0.03518836131447995,551,So this is freedom everyone !!
3771,1,6,80,87,1.0919540229885059,0.03518836131447995,551,"Send these, the homeless tempest-tossed to me. I lift my lamp beside the golden hair."
3771,1,6,80,87,1.0919540229885059,0.03518836131447995,551,"one more time , row row row your boat"
3771,1,6,80,87,1.0919540229885059,0.03518836131447995,551,Do not blame Queens.
3771,1,6,80,87,1.0919540229885059,0.03518836131447995,551,Uh-oh. She lifts her lamp beside the orange door.
3771,1,6,80,87,1.0919540229885059,0.03518836131447995,551,Trump is really taking this improving infrastructure thing seriously!
3771,2,4,81,87,1.0919540229885059,0.03880114661141246,551,Timid men prefer the calm of despotism to the Trumpestuous Sea of Liberty.
3771,1,6,80,87,1.0919540229885059,0.03518836131447995,551,We accidentally angered The Wave God.
3771,1,6,80,87,1.0919540229885059,0.03518836131447995,551,I thought we were guaranteed that Hillary would win.
3771,2,4,81,87,1.0919540229885059,0.03880114661141246,551,It's Trump's nod to Japanese art trading.
3771,1,6,80,87,1.0919540229885059,0.03518836131447995,551,I don't think we're at wild water park anymore.
3771,1,6,80,87,1.0919540229885059,0.03518836131447995,551,We got bigger in Brooklyn fuggetaboutit
3771,1,6,80,87,1.0919540229885059,0.03518836131447995,551,"My god, a wall of water!"
3771,1,6,80,87,1.0919540229885059,0.03518836131447995,551,The horror! The horror!
3771,2,4,81,87,1.0919540229885059,0.03880114661141246,551,This 'Divine Kamikaze Wind' is supposed to protect Chris Christe and New Jersey.
3771,1,6,80,87,1.0919540229885059,0.03518836131447995,551,I told you this was a wave election.
3771,1,6,80,87,1.0919540229885059,0.03518836131447995,551,"Johnson, thanks for taking a back seat on this one."
3771,2,4,81,87,1.0919540229885059,0.03880114661141246,551,Welcome to my house!
3771,0,8,79,87,1.0919540229885059,0.031159469919054366,551,Too late to steer towards rigid and unlikable...
3771,0,8,79,87,1.0919540229885059,0.031159469919054366,551,"This is crazy, all the meteorologists predicted calm seas."
3771,1,6,80,87,1.0919540229885059,0.03518836131447995,551,"Okay, ladies--stay vigilant. This is a land of opportunity."
3771,1,6,80,87,1.0919540229885059,0.03518836131447995,551,I hope you all brought your surf boards.
3771,0,8,79,87,1.0919540229885059,0.031159469919054366,551,The tide has changed!...but this hateful wave will blow over soon.
3771,1,6,80,87,1.0919540229885059,0.03518836131447995,551,"Do you know what, I think I left the oven on."
3771,2,4,81,87,1.0919540229885059,0.03880114661141246,551,This storm is so authentic.
3771,1,6,80,87,1.0919540229885059,0.03518836131447995,551,"It said ""Send these, the homeless, tempest-tost to me..."" apparently that's so we can be devoured!"
3771,1,6,80,87,1.0919540229885059,0.03518836131447995,551,"You know, tidal waves don't usually discriminate, but this one may be just shallow enough to keep 1% of us alive."
3771,0,8,79,87,1.0919540229885059,0.031159469919054366,551,"HURRY, OAR'S IN THE WATER, IT'S THE TRUMP WAVE !"
3771,2,4,81,87,1.0919540229885059,0.03880114661141246,551,Goin' down
3771,1,6,80,87,1.0919540229885059,0.03518836131447995,551,It says that's 60 guilders each! Including Trump Tower.
3771,1,6,80,87,1.0919540229885059,0.03518836131447995,551,Look out! It's Donald Trump as a wave! It's even got small hands with which to grope attractive women! Our whiney solipsistic pseudo-informed New York opinions will be swept away! We'll become even more irrelevant!
3771,1,6,80,87,1.0919540229885059,0.03518836131447995,551,Please remove your headsets. NOW.
3771,2,4,81,87,1.0919540229885059,0.03880114661141246,551,"As we passed by lady liberty, we now head into what we used to call catastrophically rising sea levels, but now glibly call, ""The Trump Bump. """
3771,2,4,81,87,1.0919540229885059,0.03880114661141246,551,The Drumpf wave is an attack on everything that is diverse and wonderful about New York City.
3771,1,6,80,87,1.0919540229885059,0.03518836131447995,551,"and here we have an american alligator, a result of global warming."
3771,1,6,80,87,1.0919540229885059,0.03518836131447995,551,"This is the part of the trip when it asks ""Give me your tired, your poor, Your huddled masses..."""
3771,1,6,80,87,1.0919540229885059,0.03518836131447995,551,I'm going to have to start listening to Blondie. The tide is high.
3771,1,6,80,87,1.0919540229885059,0.03518836131447995,551,"Look, because of the Clean Air Act we don't allow huddled masses to breathe free anymore...you'll have to pay if you want to breathe."
3771,1,6,80,87,1.0919540229885059,0.03518836131447995,551,His hair looks a little different up close.
3771,2,4,81,87,1.0919540229885059,0.03880114661141246,551,But we're from the Heartland! Remember? The Heartland?
3771,1,6,80,87,1.0919540229885059,0.03518836131447995,551,This is the entrance to the Liberty Nail and Hair Salon
3771,0,8,79,87,1.0919540229885059,0.031159469919054366,551,"You know, I'm getting the strangest sense of deja-vu..."
3771,2,4,81,87,1.0919540229885059,0.03880114661141246,551,This was a wave election.
3771,1,6,80,87,1.0919540229885059,0.03518836131447995,551,"We've been tired, poor, huddled, wretched, tempest-tost, and now--these slimy tentacles. Sit tight, Ladies, and take a whack!"
3771,2,4,81,87,1.0919540229885059,0.03880114661141246,551,"This way to Brooklyn, a small empty village where most of the inhabitants have recently migrated to Berlin."
3771,0,8,79,87,1.0919540229885059,0.031159469919054366,551,Looks like it's headed below deck.
3771,0,8,79,87,1.0919540229885059,0.031159469919054366,551,This re-enactment has some new dangers that Henry Hudson's crew never had to face.
3771,0,8,79,87,1.0919540229885059,0.031159469919054366,551,The roar is the collective conscience of the antiTrump voters.
3771,0,8,79,87,1.0919540229885059,0.031159469919054366,551,The DREAM act under Trump
3771,1,6,80,87,1.0919540229885059,0.03518836131447995,551,You just cannot deny that.
3771,1,6,80,87,1.0919540229885059,0.03518836131447995,551,Get in my BELLY!
3771,0,8,79,87,1.0919540229885059,0.031159469919054366,551,It's just branding taken to new heights.
3771,0,8,79,87,1.0919540229885059,0.031159469919054366,551,"Gimme, gimme, gimme your tired, your poor, your huddled masses ..."
3771,1,6,80,87,1.0919540229885059,0.03518836131447995,551,The packaged macaroni and cheese isn't as bad as Europe makes it out to be.
3771,1,6,80,87,1.0919540229885059,0.03518836131447995,551,"""Wretched refuse"" is really the pot calling the kettle black."
3771,2,4,81,87,1.0919540229885059,0.03880114661141246,551,We just need one big helping hand.
3771,0,8,79,87,1.0919540229885059,0.031159469919054366,551,"Is this what she really meant when she said, ""send these, the homeless, tempest-tossed to me""?"
3771,1,6,80,87,1.0919540229885059,0.03518836131447995,551,"Since last November, we also notice more orange in the sunsets and more scowls in the storm clouds."
3771,1,6,80,87,1.0919540229885059,0.03518836131447995,551,It's the last time we listen to Pat Henry.
3771,0,8,79,87,1.0919540229885059,0.031159469919054366,551,I never thought that David Bowie would come back as a wave!
3771,0,8,79,87,1.0919540229885059,0.031159469919054366,551,"Check it out: 'Give me your tired, your poor...."
3771,2,4,81,87,1.0919540229885059,0.03880114661141246,551,Perfect!
3771,1,6,80,87,1.0919540229885059,0.03518836131447995,551,"Our tour is almost over, ladies and gentlemen. Straight ahead is the Donald Trump Sea Wall of Exclusion. So that we can all return to our homeland safely and without delay, please repeat after me today's secret password, ""THANKS, DONALD."
3771,2,4,81,87,1.0919540229885059,0.03880114661141246,551,"Great, it looks like a ""Trumpest"" is going to prevent us making it to American"
3771,0,8,79,87,1.0919540229885059,0.031159469919054366,551,OK people. It's just Regret.
3771,0,8,79,87,1.0919540229885059,0.031159469919054366,551,We need a wall to keep us apart.
3771,0,8,79,87,1.0919540229885059,0.031159469919054366,551,Watch out! That wave with the calamity hairdo is gonna grab our dinghy!
3771,2,4,81,87,1.0919540229885059,0.03880114661141246,551,The Trump Water Wave Park is wild!
3771,1,6,80,87,1.0919540229885059,0.03518836131447995,551,You ain't seen nothin yet
3771,0,8,79,87,1.0919540229885059,0.031159469919054366,551,Go home and take the statue with you...
3771,0,8,79,87,1.0919540229885059,0.031159469919054366,551,"This is carrying ""tempest tossed"" too far."
3771,0,8,79,87,1.0919540229885059,0.031159469919054366,551,"Unlike the King of Persia, Donald Trump is able to command the ocean with results -- here, to deal with unwanted immigrants."
3771,1,6,80,87,1.0919540229885059,0.03518836131447995,551,...welcome to the huddled masses
3771,0,8,79,87,1.0919540229885059,0.031159469919054366,551,"All aboard granted shore leave, starting NOW."
3771,0,8,79,87,1.0919540229885059,0.031159469919054366,551,I've heard New Yorkers are good at making waves.
3771,0,8,79,87,1.0919540229885059,0.031159469919054366,551,Quick ... 90 degrees starboard!
3771,0,8,79,87,1.0919540229885059,0.031159469919054366,551,Trump Proposes An Extension to His Wall
3771,2,4,81,87,1.0919540229885059,0.03880114661141246,551,Only in America can you see that!
3771,1,6,80,87,1.0919540229885059,0.03518836131447995,551,I wasn't expecting this... get ready to bail!
3771,1,6,80,87,1.0919540229885059,0.03518836131447995,551,Oh No! I'm getting a bad feeling. Too late to abandon ship?
3771,1,6,80,87,1.0919540229885059,0.03518836131447995,551,We're the huddled masses just yearning to breathe.
3771,1,6,80,87,1.0919540229885059,0.03518836131447995,551,"When he said give me your huddled masses yearning to breathe free, I didn't think he meant THIS!!!"
3771,1,6,80,87,1.0919540229885059,0.03518836131447995,551,This is the best theme park!
3771,0,8,79,87,1.0919540229885059,0.031159469919054366,551,"Mexico has its wall, we have 'The Wave'!"
3771,2,4,81,87,1.0919540229885059,0.03880114661141246,551,America. Grabbing immigrant pussy since (strikethrough)2005(/strikethrough) 2016.
3771,2,4,81,87,1.0919540229885059,0.03880114661141246,551,Trump'eau.
3771,2,4,81,87,1.0919540229885059,0.03880114661141246,551,I like your hair.
3771,2,4,81,87,1.0919540229885059,0.03880114661141246,551,This will be our last stop on the sea monster tour!
3771,1,6,80,87,1.0919540229885059,0.03518836131447995,551,The struggle continues!
3771,2,4,81,87,1.0919540229885059,0.03880114661141246,551,Well - the Circle Line guaranteed us 'a thrill a minute!'
3771,1,6,80,87,1.0919540229885059,0.03518836131447995,551,Climate change should worry presidents.
3771,2,4,81,87,1.0919540229885059,0.03880114661141246,551,...the golden door.
3771,0,8,79,87,1.0919540229885059,0.031159469919054366,551,Global setback: bad permanent wave to take hold in 2017.
3771,1,6,80,87,1.0919540229885059,0.03518836131447995,551,"Look, Trump is waving at us!"
3771,1,6,80,87,1.0919540229885059,0.03518836131447995,551,I told you the media were wrong. There really was a Trump tidal wave.
3771,0,8,79,87,1.0919540229885059,0.031159469919054366,551,"Apparently, sometimes he grabs 'em by the inscription."
3771,0,8,79,87,1.0919540229885059,0.031159469919054366,551,I love these iconic art festival outings.
3771,1,6,80,87,1.0919540229885059,0.03518836131447995,551,You want to leave then leave. Nobody is stopping you. Mylie? Bryan?
3953,0,8,80,88,1.0909090909090908,0.030821068346400457,551,Oh No! The Trump wave!
3953,0,8,80,88,1.0909090909090908,0.030821068346400457,551,I KNOW I should've voted for him!!
3953,1,6,81,88,1.0909090909090908,0.03480188606767164,551,"Manuel, being wet doesn't improve his hair."
3953,0,8,80,88,1.0909090909090908,0.030821068346400457,551,"As immigrants, whose hair does that remind you of?"
3953,1,6,81,88,1.0909090909090908,0.03480188606767164,551,Jeepers! That whack-job comb over bears a remarkable resemblance to....
3953,2,4,82,88,1.0909090909090908,0.03837192064154343,551,I feel like we've done this before.
3953,1,6,81,88,1.0909090909090908,0.03480188606767164,551,Never saw Nature look so scared before. Something up?
3953,2,4,82,88,1.0909090909090908,0.03837192064154343,551,"El Segunda Titanic, another one too big to fail."
3953,1,6,81,88,1.0909090909090908,0.03480188606767164,551,Apparently I misheard the national anthem everyone. This is clearly the land of the free and the home of the wave!
3953,0,8,80,88,1.0909090909090908,0.030821068346400457,551,"We're coming about, so that ugly wave will only get our backs wet!"
3953,2,4,82,88,1.0909090909090908,0.03837192064154343,551,Just a New York scare of mind.
3953,0,8,80,88,1.0909090909090908,0.030821068346400457,551,"Not to worry, it's just a category 3 tempest."
3953,1,6,81,88,1.0909090909090908,0.03480188606767164,551,Who is John Galt?
3953,0,8,80,88,1.0909090909090908,0.030821068346400457,551,The small handed wave with big wave hair plugs thinks it can scare us? Sad!
3953,1,6,81,88,1.0909090909090908,0.03480188606767164,551,I'm m not sure we qualify for these new waivers.
3953,0,8,80,88,1.0909090909090908,0.030821068346400457,551,Watch out for those tentacles because they will form you into a mindless follower of populism!
3953,0,8,80,88,1.0909090909090908,0.030821068346400457,551,"Give me your tired, your...never mind. Bad hair day!"
3953,0,8,80,88,1.0909090909090908,0.030821068346400457,551,"Give me your tired, your poor, your huddled masses..."
3953,2,4,82,88,1.0909090909090908,0.03837192064154343,551,"This is New York, it's not Nessie, it must be Trumpie"
3953,2,4,82,88,1.0909090909090908,0.03837192064154343,551,"Give me a break! Your tired? Your poor? Your huddled masses yearning to breathe free? The wretched refuse of your teeming shore? Send these back - the homeless, tempest-tost to sea! I snuff the lamp beside the golden door!"
3953,0,8,80,88,1.0909090909090908,0.030821068346400457,551,"I'm no longer ""feeling the yearn."""
3953,1,6,81,88,1.0909090909090908,0.03480188606767164,551,"LADY LIBERTY beckoned for us to come, but lo and behold, out of the depth, appeared this HUGE TRUMP that blew us back to sea!"
3953,1,6,81,88,1.0909090909090908,0.03480188606767164,551,He values quantity over quality.
3976,0,8,81,89,1.0898876404494382,0.030489911249436768,551,Now that's one heck of a welcome mat!!
3976,1,6,82,89,1.0898876404494382,0.034423789781366426,551,And keep that old Jonah story to yourself.
3976,1,6,82,89,1.0898876404494382,0.034423789781366426,551,"She said, ""Give me your tired, your poor, your huddled masses yearning to be free, . . .,"" but wait a minute. Hang on, it's going to be a bumpy ride!"
3976,2,4,83,89,1.0898876404494382,0.03795207395946741,551,"Don't worry, the forecast said it would be a great day for boating!"
3976,1,6,82,89,1.0898876404494382,0.034423789781366426,551,We'll take our stylist over yours any day of the week.
3981,1,6,83,90,1.0888888888888888,0.03405380352021444,551,Wake up. It was all just a bad dream.
3982,2,3,79,84,1.0833333333333333,0.03865322139475579,551,I dreamt that a huge wave in the shape of Trumps' face overwhelmed us as we were about to hit shore.
3983,0,7,78,85,1.0823529411764705,0.02999423243289873,551,Tour refunds will be available on our website.
3983,1,5,79,85,1.0823529411764705,0.03434772225427301,551,A wall to the south. Crowds to the north. We ARE doomed.
3983,0,7,78,85,1.0823529411764705,0.02999423243289873,551,Trump warned us about Mexican waves!
3983,0,7,78,85,1.0823529411764705,0.02999423243289873,551,Too late. We're overwhelmed!
3983,1,5,79,85,1.0823529411764705,0.03434772225427301,551,"Trump's Japanese ""style"" Official Presidential Portrait"
3983,1,5,79,85,1.0823529411764705,0.03434772225427301,551,He said we would no longer be welcome.
3983,0,7,78,85,1.0823529411764705,0.02999423243289873,551,I thought we were headed to the promise land?
3983,2,3,80,85,1.0823529411764705,0.03820835077407305,551,"To your left, you can see into the eyes of Ultimate Global Ruin, or UGR as we like to call him."
3983,1,5,79,85,1.0823529411764705,0.03434772225427301,551,That sure can't be the face of new HOPE!
3983,1,5,79,85,1.0823529411764705,0.03434772225427301,551,'Take a really deep breath.'
3983,1,5,79,85,1.0823529411764705,0.03434772225427301,551,See. I told you Trump is a bore.
3983,1,5,79,85,1.0823529411764705,0.03434772225427301,551,Look! It's Donald Trump again!
3983,2,3,80,85,1.0823529411764705,0.03820835077407305,551,This must be TsuJersey!
3983,0,7,78,85,1.0823529411764705,0.02999423243289873,551,I don't think the wave really means it.
3983,0,7,78,85,1.0823529411764705,0.02999423243289873,551,Troubled waters ahead! Prepare for a starboard sift.
3983,0,7,78,85,1.0823529411764705,0.02999423243289873,551,"I like Hiroshige's wave better but then, he never had a trump."
3983,1,5,79,85,1.0823529411764705,0.03434772225427301,551,Russian fluent hackers only
3983,1,5,79,85,1.0823529411764705,0.03434772225427301,551,"Paddle quicker, Trump almost has us."
3983,2,3,80,85,1.0823529411764705,0.03820835077407305,551,Winner waves trump the wall.
3983,1,5,79,85,1.0823529411764705,0.03434772225427301,551,It's called The Wall 2.0.
3983,0,7,78,85,1.0823529411764705,0.02999423243289873,551,We should've taken the Second Avenue Subway.
3983,0,7,78,85,1.0823529411764705,0.02999423243289873,551,Worst. Equinox. Class. Ever.
3983,2,3,80,85,1.0823529411764705,0.03820835077407305,551,"Come on in, Jonah just left!"
3983,1,5,79,85,1.0823529411764705,0.03434772225427301,551,"It seems we've run into the Tempest younger sister, Tempestuous."
3983,1,5,79,85,1.0823529411764705,0.03434772225427301,551,"That's right, folks. The People Have Spoken: NO MORE REFUGEES!"
3983,0,7,78,85,1.0823529411764705,0.02999423243289873,551,I am experiencing economic anxiety.
3983,1,5,79,85,1.0823529411764705,0.03434772225427301,551,"Give us your tired, your poor-----your frightening."
3983,2,3,80,85,1.0823529411764705,0.03820835077407305,551,Why didn't we just ask for liberty period!
3983,1,5,79,85,1.0823529411764705,0.03434772225427301,551,It is only a Trump wave. We are in a safe place.
3983,1,5,79,85,1.0823529411764705,0.03434772225427301,551,"1)America, just a boat ride away from totalitarianism. 2) I am not sure which is scarier, being on this boat or being ruled by the elite. 3)The mainstream media called and said that it's perfectly safe out here!"
3983,2,3,80,85,1.0823529411764705,0.03820835077407305,551,"Calm down, Donald. Sure, we huddled masses are invited to enter America’s golden door, but the statue doesn’t mean your Trump Towers entrance."
3983,0,7,78,85,1.0823529411764705,0.02999423243289873,551,Monster Wave! We are doomed. I wish She didn't have to see this.
3983,1,5,79,85,1.0823529411764705,0.03434772225427301,551,"Immigrants to Ellis Island biggest fear, a Trump wave."
3983,3,1,81,85,1.0823529411764705,0.04171318872601969,551,"I object. Don't love Trump, but was there a strongly negative cartoon about a President (-elect) in the caption contest before? Your bias is showing. Obama fiddling while Syria burns next? Please stick to humor, not political commentary."
3983,2,3,80,85,1.0823529411764705,0.03820835077407305,551,"Don’t be fooled by the tackiness, this combover wave has quick hands!"
3983,0,7,78,85,1.0823529411764705,0.02999423243289873,551,"It's Gothamworld, Dorothy. You're not in Orlando anymore."
3983,3,1,81,85,1.0823529411764705,0.04171318872601969,551,Boy! You couldn't trump this cartoon!
3983,2,3,80,85,1.0823529411764705,0.03820835077407305,551,"But what happened to 'Give me your tired, your poor, your huddled masses'?"
3983,0,7,78,85,1.0823529411764705,0.02999423243289873,551,I feared that the new Administration would also look to secure the Eastern seaboard.
3983,2,3,80,85,1.0823529411764705,0.03820835077407305,551,Swim for your lives! The Hairy Grabber strikes again!
3983,1,5,79,85,1.0823529411764705,0.03434772225427301,551,New York doesn't have tidal waves so we've decided it's an optical illusion.
3983,2,3,80,85,1.0823529411764705,0.03820835077407305,551,"""Global warming?! Not on my watch!"" - Precedent-Elect Donald Trump"
3983,0,7,78,85,1.0823529411764705,0.02999423243289873,551,Ms. Clinton save us! Ms. Clinton? Hilary? Are you there?
3983,1,5,79,85,1.0823529411764705,0.03434772225427301,551,Boat salesman said we were headed for better times.
3983,0,7,78,85,1.0823529411764705,0.02999423243289873,551,It's enorme!
3983,1,5,79,85,1.0823529411764705,0.03434772225427301,551,It's saying to donald lifejackets!
3983,0,7,78,85,1.0823529411764705,0.02999423243289873,551,"At least, this wave has some personality."
3983,0,7,78,85,1.0823529411764705,0.02999423243289873,551,Mayday! Mayday! Prepare for extreme vetting.
3983,0,7,78,85,1.0823529411764705,0.02999423243289873,551,I sure hope we come out the other side unscathed.
3983,0,7,78,85,1.0823529411764705,0.02999423243289873,551,Everything will be fine as long as we keep yearning to breathe free!
3983,2,3,80,85,1.0823529411764705,0.03820835077407305,551,"One would like to breathe free, but doesn't look like he's got a mint in his mouth."
3983,1,5,79,85,1.0823529411764705,0.03434772225427301,551,To our right...The scenic route to the underworld
3983,0,7,78,85,1.0823529411764705,0.02999423243289873,551,"Where's the Circle Line, when you need it ?"
3983,2,3,80,85,1.0823529411764705,0.03820835077407305,551,"Row, row, row your boat, gently down the stream..."
3983,0,7,78,85,1.0823529411764705,0.02999423243289873,551,I knew we should have taken the plane.
3983,1,5,79,85,1.0823529411764705,0.03434772225427301,551,Tidal Trump!!
3983,1,5,79,85,1.0823529411764705,0.03434772225427301,551,I thought we left that wave back in Mosul.
3983,0,7,78,85,1.0823529411764705,0.02999423243289873,551,"As you can see, there have been many changes to immigration policy under the President Elect's Make the Colossus New Again Campaign."
3983,1,5,79,85,1.0823529411764705,0.03434772225427301,551,"All passengers aboard the ""Oracle"" Please buckle your life vests for 2017."
3983,0,7,78,85,1.0823529411764705,0.02999423243289873,551,"Hey, calm down, pal--we're just tourists looking for some big, green lady who walks on water."
3983,1,5,79,85,1.0823529411764705,0.03434772225427301,551,Just wave it goodbye...
3983,1,5,79,85,1.0823529411764705,0.03434772225427301,551,We either sink or we swim.
3983,1,5,79,85,1.0823529411764705,0.03434772225427301,551,AP Alert A Trumpian wave imperils the huddled masses.
3983,3,1,81,85,1.0823529411764705,0.04171318872601969,551,"And here in front this ""Trump-ish"" image juxtaposed with the Statue suggests the artist views an open-door policy, used early in our history to provide cheap labor, should be continued regardless of need, sustainability, or good social planning"
3983,1,5,79,85,1.0823529411764705,0.03434772225427301,551,New big wig immigration policy. Grab boat people wherever and toss them overboard.
3983,1,5,79,85,1.0823529411764705,0.03434772225427301,551,So... Can you tell us how to get to Century 21?
3983,1,5,79,85,1.0823529411764705,0.03434772225427301,551,Mom!?
3983,1,5,79,85,1.0823529411764705,0.03434772225427301,551,I'm more of a tower than a wave
3983,1,5,79,85,1.0823529411764705,0.03434772225427301,551,This is fine.
3983,1,5,79,85,1.0823529411764705,0.03434772225427301,551,It's a hoax..full speed ahead!
3983,1,5,79,85,1.0823529411764705,0.03434772225427301,551,On your right you'll see the Statue of Liberty. A monument to a time before the Tsunami Monster Uprising.
3983,0,7,78,85,1.0823529411764705,0.02999423243289873,551,"If some god shall wreck me in the wine-dark deep, even so I will endure."
3983,1,5,79,85,1.0823529411764705,0.03434772225427301,551,"Naah, just a wall. Keeps out the merely huddled masses. Any resemblance is pure coincidence."
3983,2,3,80,85,1.0823529411764705,0.03820835077407305,551,And coming up on your right is Trump Island.
3983,1,5,79,85,1.0823529411764705,0.03434772225427301,551,"Honey, even this ""tsunami"" is an immigrant !"
3983,0,7,78,85,1.0823529411764705,0.02999423243289873,551,It looks different than I had imagined.
3983,1,5,79,85,1.0823529411764705,0.03434772225427301,551,"Be brave everyone! If we don't face this wave of hate today, it will be too late for all of us tomorrow!"
3983,2,3,80,85,1.0823529411764705,0.03820835077407305,551,It looks like a Trump wave but that's not possible.
3983,1,5,79,85,1.0823529411764705,0.03434772225427301,551,Let America make you great again!
3983,1,5,79,85,1.0823529411764705,0.03434772225427301,551,Oh you mean his policy is literally hand wavey??
3983,1,5,79,85,1.0823529411764705,0.03434772225427301,551,All of a sudden Aleppo doesn't look so bad!
3983,1,5,79,85,1.0823529411764705,0.03434772225427301,551,Hey! It's just like in the guidebook!
3983,1,5,79,85,1.0823529411764705,0.03434772225427301,551,It's an anti-Mexican wave.
3983,1,5,79,85,1.0823529411764705,0.03434772225427301,551,It's a surfers nightmare.
3983,0,7,78,85,1.0823529411764705,0.02999423243289873,551,"""Keep ancient lands, your storied pompadour!"" cries she ..."
3983,0,7,78,85,1.0823529411764705,0.02999423243289873,551,"Hey, if you don't like my comb-over or my tiny hands and think you can create a better monster from my Id, you can do it back in YOUR country because Ellis Island is CLOSED and so you immigrants are FIRED!!"
3983,1,5,79,85,1.0823529411764705,0.03434772225427301,551,Can I have your autograph please?
3983,2,3,80,85,1.0823529411764705,0.03820835077407305,551,"''Hey JoAnne, still an atheist?"
3983,0,7,78,85,1.0823529411764705,0.02999423243289873,551,We're yearning to be free?
3983,2,3,80,85,1.0823529411764705,0.03820835077407305,551,This is worse than when the Bradys went to Hawaii!
3983,2,3,80,85,1.0823529411764705,0.03820835077407305,551,Apparently this is where Trump got his leadership skills from
3983,0,7,78,85,1.0823529411764705,0.02999423243289873,551,At least we won't have to be on his registry.
3983,1,5,79,85,1.0823529411764705,0.03434772225427301,551,Here or on shore- either way we face a soulless force of destruction.
3983,1,5,79,85,1.0823529411764705,0.03434772225427301,551,Meet America's handoff
3983,1,5,79,85,1.0823529411764705,0.03434772225427301,551,Gesticulations gestate geometrically between Scylla and Charybdis.
3983,2,3,80,85,1.0823529411764705,0.03820835077407305,551,Talkin' 'bout wavy hair!...Here she comes...thinkin' she all that!
3983,0,7,78,85,1.0823529411764705,0.02999423243289873,551,Not to worry. We have your signed disclaimer forms back at the office.
3983,0,7,78,85,1.0823529411764705,0.02999423243289873,551,"Ominous? Foreboding? Welcome to America, anyway."
3983,2,3,80,85,1.0823529411764705,0.03820835077407305,551,First reality ride made with all US parts.
3983,1,5,79,85,1.0823529411764705,0.03434772225427301,551,really? you're the new lady liberty? orange hair? grabby fingers? that's all you got? SAD!
3983,1,5,79,85,1.0823529411764705,0.03434772225427301,551,Hey! That looks like my Aunt Bessie.
3983,1,5,79,85,1.0823529411764705,0.03434772225427301,551,Your final citizenship test: the great pusami.
3983,1,5,79,85,1.0823529411764705,0.03434772225427301,551,"Forget your tired, poor, and hungry. I'll deport you and your rapist relatives while that ugly liberal, French woman in green watches."
3983,2,3,80,85,1.0823529411764705,0.03820835077407305,551,He'll make breathing great again.
3983,1,5,79,85,1.0823529411764705,0.03434772225427301,551,Rogue Wall!
3983,2,3,80,85,1.0823529411764705,0.03820835077407305,551,Go ahead! You try cleaning toilets for a week.
3983,2,3,80,85,1.0823529411764705,0.03820835077407305,551,Don't blame me; I voted for Underwood.
3983,1,5,79,85,1.0823529411764705,0.03434772225427301,551,"We come as your tired, your poor. your huddled masses...."
3983,0,7,78,85,1.0823529411764705,0.02999423243289873,551,"Look out, it's an anti-Mexican wave!"
3983,0,7,78,85,1.0823529411764705,0.02999423243289873,551,And we're pre-qualified for the purchase of a bridge!
3983,3,1,81,85,1.0823529411764705,0.04171318872601969,551,"Send these, the homeless, tempest-tossed to me, I lift my lamp beside my golden door!”"
3983,0,7,78,85,1.0823529411764705,0.02999423243289873,551,And on your right is the new Donald Trump many little hands anti immigration wave .
3983,3,1,81,85,1.0823529411764705,0.04171318872601969,551,Pass me a lighter. We may be able to make popcorn out of this thing!
3983,1,5,79,85,1.0823529411764705,0.03434772225427301,551,welcome to the new tsunami attraction at city island amusement park.
3983,3,1,81,85,1.0823529411764705,0.04171318872601969,551,"The New Yorker Magazine is the consummate sore loser, and cannot accept the result of the election, as they demanded Trump do if he lost. How long do you cling to your failed mission? Will we ever see actual news again? Can you ever LET IT GO?"
3983,1,5,79,85,1.0823529411764705,0.03434772225427301,551,Hmmm. This could leave a mark.
3983,2,3,80,85,1.0823529411764705,0.03820835077407305,551,"The sea was angry that day my friends ""The sea was angry that day my friends"""
3983,2,3,80,85,1.0823529411764705,0.03820835077407305,551,How did you get over the wall?
3983,2,3,80,85,1.0823529411764705,0.03820835077407305,551,Extinguish this Lady and on to Greatness.
3983,1,5,79,85,1.0823529411764705,0.03434772225427301,551,This doesn't look like the stream we were to row gently down on.
3983,1,5,79,85,1.0823529411764705,0.03434772225427301,551,Special effects by Tim Burton!
3983,1,5,79,85,1.0823529411764705,0.03434772225427301,551,Even the waves in America look like Donald Trump.
3983,1,5,79,85,1.0823529411764705,0.03434772225427301,551,Tell Donald how great his hair is so he'll be distracted and we can make it to Liberty before Jan. 20th.
3983,1,5,79,85,1.0823529411764705,0.03434772225427301,551,Only one of you shall survive become THE APPRENTICE CITIZEN.
3983,2,3,80,85,1.0823529411764705,0.03820835077407305,551,Nope. Not a Registered Sex Offender.
3983,1,5,79,85,1.0823529411764705,0.03434772225427301,551,Hey! Haven't you heard? Can't come here any longer!
3983,1,5,79,85,1.0823529411764705,0.03434772225427301,551,I think I'l do a painting of this- I'll call it 'The Great Wall'.
3983,1,5,79,85,1.0823529411764705,0.03434772225427301,551,That's a serious case of jazz hands.
3983,1,5,79,85,1.0823529411764705,0.03434772225427301,551,We're disaffected citizens leaving for Canada before Inauguration Day!
3983,0,7,78,85,1.0823529411764705,0.02999423243289873,551,No need for a wall. Just grab 'em.
3983,1,5,79,85,1.0823529411764705,0.03434772225427301,551,I think it has something to do with baseball.
3983,1,5,79,85,1.0823529411764705,0.03434772225427301,551,Everybody wave to Mr. Trump.
3983,0,7,78,85,1.0823529411764705,0.02999423243289873,551,It looks like New Jersey is going rogue.
3983,1,5,79,85,1.0823529411764705,0.03434772225427301,551,Definitely tougher than his wall.
3983,2,3,80,85,1.0823529411764705,0.03820835077407305,551,I tawt I tawt an orange tsunami
3983,0,7,78,85,1.0823529411764705,0.02999423243289873,551,What did you say about the Mosul Dam?
3983,2,3,80,85,1.0823529411764705,0.03820835077407305,551,At least punk music will be good
3983,1,5,79,85,1.0823529411764705,0.03434772225427301,551,"""And the trumpets spouted 'YOU SHALL NOT PASS'"" (With apologies to Gandalf)"
3983,1,5,79,85,1.0823529411764705,0.03434772225427301,551,Hey not to worry! It's just a beach wave do!
3983,1,5,79,85,1.0823529411764705,0.03434772225427301,551,"OK, 'atfal, who remembers the definition of ""visual metaphor?"""
3983,1,5,79,85,1.0823529411764705,0.03434772225427301,551,They said there was no chance of rain.
3983,0,7,78,85,1.0823529411764705,0.02999423243289873,551,Please tell me someone brought a self stick.
3983,1,5,79,85,1.0823529411764705,0.03434772225427301,551,"Holy cow, it's Donald Trump -- small hands and everything! Maybe all ships don't rise after all!"
3983,2,3,80,85,1.0823529411764705,0.03820835077407305,551,"Send these, the homeless, tempest-tossed to hell!"
3983,0,7,78,85,1.0823529411764705,0.02999423243289873,551,It's a Presidential Wave. Hold onto your pu..er...privates!
3983,0,7,78,85,1.0823529411764705,0.02999423243289873,551,"Don't worry, they're just little waves."
4129,1,5,80,86,1.0813953488372092,0.033959484506994285,551,"—Poseidon with a wig?! Only in America... —Yea, making America drowned again!"
4129,1,5,80,86,1.0813953488372092,0.033959484506994285,551,This is all part of Mr. Trump's new border control policy. Notice the fine Mexican tile work...
4129,1,5,80,86,1.0813953488372092,0.033959484506994285,551,Evidently Canada does not want us refugees from Trump.
4129,1,5,80,86,1.0813953488372092,0.033959484506994285,551,Give ME your poor!
4129,0,7,79,86,1.0813953488372092,0.02965887349113709,551,"Boat, hell! We're gonna need a bigger empathy!"
4129,2,3,81,86,1.0813953488372092,0.03777359394071863,551,"HELLO,I AM THE HUGE DONALD WAVE AND I AM HERE TO BUILD A WALL."
4129,2,3,81,86,1.0813953488372092,0.03777359394071863,551,We shouldn't have come -- his hands really are small!
4129,0,7,79,86,1.0813953488372092,0.02965887349113709,551,Perhaps dismissing the rogue wave advisory was a bad idea.
4129,0,7,79,86,1.0813953488372092,0.02965887349113709,551,When 2016 is finally behind you.
4129,1,5,80,86,1.0813953488372092,0.033959484506994285,551,Maybe we should have diversified.
4129,0,7,79,86,1.0813953488372092,0.02965887349113709,551,I think we can squeeze one more in.
4129,1,5,80,86,1.0813953488372092,0.033959484506994285,551,"Did you say shining, or shunning?"
4129,0,7,79,86,1.0813953488372092,0.02965887349113709,551,Apparently we're not on the same wavelength.
4129,0,7,79,86,1.0813953488372092,0.02965887349113709,551,"But we saw you on ""Hawaii 5-0"" and you were harmless!"
4129,0,7,79,86,1.0813953488372092,0.02965887349113709,551,"Row, row, the Trump wave is upon us!!"
4129,3,1,82,86,1.0813953488372092,0.04123641849646748,551,"We should have gone surfing, instead."
4129,1,5,80,86,1.0813953488372092,0.033959484506994285,551,It's a Donald Trump wave -- Believe Me.
4129,1,5,80,86,1.0813953488372092,0.033959484506994285,551,My dreams are getting too normal.
4129,1,5,80,86,1.0813953488372092,0.033959484506994285,551,"The mousse-dimmed tide is loosed, and everywhere The ceremony of innocence is drowned"
4129,1,5,80,86,1.0813953488372092,0.033959484506994285,551,UGE wave scares NYC tourists
4129,1,5,80,86,1.0813953488372092,0.033959484506994285,551,More LSD here--now--please....
4129,1,5,80,86,1.0813953488372092,0.033959484506994285,551,That's big league.
4129,1,5,80,86,1.0813953488372092,0.033959484506994285,551,i can't wait 'til Vox explains this to me
4129,1,5,80,86,1.0813953488372092,0.033959484506994285,551,"Once again, that you for riding the 'Trump Climate Change Adventure'"
4129,0,7,79,86,1.0813953488372092,0.02965887349113709,551,Surf's up?
4129,1,5,80,86,1.0813953488372092,0.033959484506994285,551,Sorry we displeased you Mr. Trump.
4129,1,5,80,86,1.0813953488372092,0.033959484506994285,551,Wow from Trump tower to Trump tidal New York sure has it all!
4129,2,3,81,86,1.0813953488372092,0.03777359394071863,551,Remember: These hands are UGE!
4129,0,7,79,86,1.0813953488372092,0.02965887349113709,551,Where's Mount Fuji?
4129,1,5,80,86,1.0813953488372092,0.033959484506994285,551,No! No! Not tired and oppressed anymore! Million dollar deposit now.
4159,0,7,80,87,1.0804597701149425,0.029330909862272565,551,Is that a rogue wave or just a rouge?
4159,1,5,81,87,1.0804597701149425,0.033579911847869605,551,"'Golden Door, you said, not Golden Monster!'"
4159,2,3,82,87,1.0804597701149425,0.037348610229466755,551,Wonder if that hair will fit in the White House?
4159,1,5,81,87,1.0804597701149425,0.033579911847869605,551,"Finally, the middle class has got a break."
4163,0,7,81,88,1.0795454545454546,0.02901010034307146,551,He's going to devour the little people. Where's Leona Helmsley when you need her.
4164,0,6,77,83,1.072289156626506,0.02859802024120332,551,"And finally, should you provide the right perfunctory answers to all seven of my inane interview questions, you'll advance to next round."
4164,0,6,77,83,1.072289156626506,0.02859802024120332,551,When did the New Yorker cartoons become SO political? Roger Ebert must be turning in his grave.
4164,2,2,79,83,1.072289156626506,0.03749084531264898,551,"Lady Liberty tries to hail the Republic's Ship of Fools as it rows the boat into Trump's tsunami, Hellalujah!"
4164,1,4,78,83,1.072289156626506,0.033342242305919145,551,That is one handsome wave!
4164,0,6,77,83,1.072289156626506,0.02859802024120332,551,Please observe all hands in search of a deck to be on.
4164,0,6,77,83,1.072289156626506,0.02859802024120332,551,"Now, I understand the hairstyle."
4164,1,4,78,83,1.072289156626506,0.033342242305919145,551,Cuba goes the other way.
4164,0,6,77,83,1.072289156626506,0.02859802024120332,551,Anyone who's ready to make America great again is welcome!
4164,1,4,78,83,1.072289156626506,0.033342242305919145,551,"Relax. By the end of January, this rogue wave and all things from our heir presumptive's comb over empire are relocating to 1500 Pennsylvania Ave."
4164,1,4,78,83,1.072289156626506,0.033342242305919145,551,HA!
4164,1,4,78,83,1.072289156626506,0.033342242305919145,551,Orange is the new wizard.
4164,1,4,78,83,1.072289156626506,0.033342242305919145,551,Apres moi? NO WAY! Deluge NOW!
4164,1,4,78,83,1.072289156626506,0.033342242305919145,551,It's the Great Orange Combover Wave of Riker's Island
4164,0,6,77,83,1.072289156626506,0.02859802024120332,551,She is not thrilled how your welcoming a few huddled masses.
4164,2,2,79,83,1.072289156626506,0.03749084531264898,551,Let's all do wave.
4164,1,4,78,83,1.072289156626506,0.033342242305919145,551,"Hey huddled masses, no worries. This rising Trump wave will most assuredly lift all boats!"
4164,1,4,78,83,1.072289156626506,0.033342242305919145,551,The scariest thing is his hair.
4164,1,4,78,83,1.072289156626506,0.033342242305919145,551,I thought I said no tweets about the waves!
4164,1,4,78,83,1.072289156626506,0.033342242305919145,551,"Where's the ""safe harbor"" for us tired, poor, and huddled masses?"
4164,1,4,78,83,1.072289156626506,0.033342242305919145,551,"Uh!Oh!,It looks like the Lady Of The Sea ride got loose from Coney Island again"
4164,2,2,79,83,1.072289156626506,0.03749084531264898,551,Looks like this was a Chitty idea.
4164,0,6,77,83,1.072289156626506,0.02859802024120332,551,Keep rowing. This Trumpnami couldn't possibly hurt us.
4164,2,2,79,83,1.072289156626506,0.03749084531264898,551,why couldn't it be woman-made climate change?
4164,1,4,78,83,1.072289156626506,0.033342242305919145,551,Talk about treading on a slippery slope.
4164,0,6,77,83,1.072289156626506,0.02859802024120332,551,"Ok, everybody - time to project that 'homeless, tempest-tossed' look."
4164,0,6,77,83,1.072289156626506,0.02859802024120332,551,Must be a 'New York' wave of mind......
4164,1,4,78,83,1.072289156626506,0.033342242305919145,551,And now boys and girls - Epcots your worst nightmare part of the Americas virtual reality tour
4164,0,6,77,83,1.072289156626506,0.02859802024120332,551,From the mountains to the prairies!
4164,1,4,78,83,1.072289156626506,0.033342242305919145,551,Fear washes over the Johnson family during the site seeing cruise
4164,1,4,78,83,1.072289156626506,0.033342242305919145,551,See how Lady Liberty stands up to Trumpian waves
4164,1,4,78,83,1.072289156626506,0.033342242305919145,551,The ONE day I forget to bring my umbrella.
4164,0,6,77,83,1.072289156626506,0.02859802024120332,551,"With all due respect, Mr. Trump, this is a bit over the top. Ellis Island has not served as a gateway for immigrants since last century."
4164,1,4,78,83,1.072289156626506,0.033342242305919145,551,I guess it's the Old Man OF The Sea.
4164,2,2,79,83,1.072289156626506,0.03749084531264898,551,"Don't worry. Fake news about ""making America Great Again"" weather was already in the ""fake"" forecast. It'll dissipate in 4 years."
4164,2,2,79,83,1.072289156626506,0.03749084531264898,551,"What was your name again, Andromeda?"
4164,0,6,77,83,1.072289156626506,0.02859802024120332,551,"What the...?? Boating on the Hudson isn't great again, at all!!"
4164,1,4,78,83,1.072289156626506,0.033342242305919145,551,"Kids, it's just a mannequin challenge. Hold still for four years."
4164,1,4,78,83,1.072289156626506,0.033342242305919145,551,I SURE HOPE HE GETS A NEW HAIRSTYLIST BEFORE JANUARY 20TH!
4164,1,4,78,83,1.072289156626506,0.033342242305919145,551,"Ok everyone, get ready to wave."
4164,1,4,78,83,1.072289156626506,0.033342242305919145,551,So he has also taken the liberty of using a wall of water on the East coast?
4164,1,4,78,83,1.072289156626506,0.033342242305919145,551,"Run for your life---here comes the biggest ""sneaker"" wave yet!"
4164,1,4,78,83,1.072289156626506,0.033342242305919145,551,Who controls the button to turn off this wave machine?
4164,0,6,77,83,1.072289156626506,0.02859802024120332,551,It's the Trump-san Tsunami!
4164,2,2,79,83,1.072289156626506,0.03749084531264898,551,I told you guys the trough wouldn't be that deep.
4164,1,4,78,83,1.072289156626506,0.033342242305919145,551,The director wants to shoot another take — he says we didn't sound scared enough.
4164,1,4,78,83,1.072289156626506,0.033342242305919145,551,As the immigrants arrive in America the waves of greetings come fourth.
4164,0,6,77,83,1.072289156626506,0.02859802024120332,551,He rises!
4164,0,6,77,83,1.072289156626506,0.02859802024120332,551,Are we supposed to see this as a wave election?
4164,0,6,77,83,1.072289156626506,0.02859802024120332,551,"Remember folks, no flash photography."
4164,0,6,77,83,1.072289156626506,0.02859802024120332,551,There was no room for us on the Ark
4164,1,4,78,83,1.072289156626506,0.033342242305919145,551,"Which of you, tiny, tiny people said Donald J. Trump couldn't bigly control his temper and paper thin ego and would signal the end times -whatever?"
4164,0,6,77,83,1.072289156626506,0.02859802024120332,551,This is Donald J. Trump; I created the world and I can end it.
4164,0,6,77,83,1.072289156626506,0.02859802024120332,551,It's a wall of water!
4164,0,6,77,83,1.072289156626506,0.02859802024120332,551,"""Im just saying, We need to give hime chance""."
4164,1,4,78,83,1.072289156626506,0.033342242305919145,551,HEY! we WERE just TRYING to SEE New York!!
4164,1,4,78,83,1.072289156626506,0.033342242305919145,551,Don't you just love New York?
4164,0,6,77,83,1.072289156626506,0.02859802024120332,551,This isn’t what Madison had in mind.
4164,0,6,77,83,1.072289156626506,0.02859802024120332,551,"Can we all appreciate the irony of the ""lifeboat ethics"" metaphor before we drown in xenophobia?"
4164,1,4,78,83,1.072289156626506,0.033342242305919145,551,"See!Its the entrance to the""GREATEST"" comb-over tunnel ever!"
4164,0,6,77,83,1.072289156626506,0.02859802024120332,551,this is just a test
4164,1,4,78,83,1.072289156626506,0.033342242305919145,551,"It's our signature ""Welcome to America""."
4164,0,6,77,83,1.072289156626506,0.02859802024120332,551,"Don't worry, the weather changes immediatley now."
4164,1,4,78,83,1.072289156626506,0.033342242305919145,551,That will be $25 for bringing the bag.
4164,1,4,78,83,1.072289156626506,0.033342242305919145,551,And up ahead we see Lady Liberty's estranged Unkie Neocon.
4164,2,2,79,83,1.072289156626506,0.03749084531264898,551,"give me your tired, your pos, you Tump... WAIT I TAKE THE TRUMP PART BACK!!!"
4164,3,0,80,83,1.072289156626506,0.04122404447076152,551,God Bless America
4164,0,6,77,83,1.072289156626506,0.02859802024120332,551,"Quick!, turn around!, I'm not at liberty to wave today!!"
4164,1,4,78,83,1.072289156626506,0.033342242305919145,551,Where do we go from here?
4164,1,4,78,83,1.072289156626506,0.033342242305919145,551,Prepare to teem the shore...
4164,0,6,77,83,1.072289156626506,0.02859802024120332,551,I think I forgot to lock the front door.
4164,0,6,77,83,1.072289156626506,0.02859802024120332,551,I told you the sea wall works two ways.
4164,1,4,78,83,1.072289156626506,0.033342242305919145,551,Damn bike lanes.
4164,1,4,78,83,1.072289156626506,0.033342242305919145,551,"The Loud Storm! Trump waves: take back your poor, your tired, huddled masses."
4164,1,4,78,83,1.072289156626506,0.033342242305919145,551,Stand your ground.
4164,2,2,79,83,1.072289156626506,0.03749084531264898,551,Protect your scuppers!
4164,2,2,79,83,1.072289156626506,0.03749084531264898,551,"Given the amber waves of the Donald, we're better off repatriating."
4164,0,6,77,83,1.072289156626506,0.02859802024120332,551,Surf's up?
4164,1,4,78,83,1.072289156626506,0.033342242305919145,551,That golden wave could swamp us!!!!
4164,2,2,79,83,1.072289156626506,0.03749084531264898,551,"My God, at least they could have a BEWARE OF THE DOG sign..."
4164,1,4,78,83,1.072289156626506,0.033342242305919145,551,Just keep DREAMing; just keep DREAMing.
4164,2,2,79,83,1.072289156626506,0.03749084531264898,551,"It's Neptune. No, it's Trump."
4164,0,6,77,83,1.072289156626506,0.02859802024120332,551,"Hang on folks! The theme for todays mystery tour is ""The Poseidon Adventure!"""
4246,2,2,80,84,1.0714285714285714,0.037051832504523756,551,"We've been tempest tossed by better hobgoblins than that, guys, and you know that welcoming committee can't rock us either!"
4246,0,6,78,84,1.0714285714285714,0.028268619114727778,551,This swell adventure isn't included with Ferry transportation.
4246,1,4,79,84,1.0714285714285714,0.032954158452286685,551,"Mr. and Mrs. Pirate and kids took their home state's motto the wrong way, ""Give Me Liberty or Give Me Death"""
4246,1,4,79,84,1.0714285714285714,0.032954158452286685,551,Never mind what I just said. I think the wave is going to catch us!
4246,1,4,79,84,1.0714285714285714,0.032954158452286685,551,I'm yuge! Make America sweat again!
4246,0,6,78,84,1.0714285714285714,0.028268619114727778,551,Don't send your homeless tempest tossed to me.
4246,0,6,78,84,1.0714285714285714,0.028268619114727778,551,"Oh swell, another reminder that I don't have enough hair to make it wavy."
4246,0,6,78,84,1.0714285714285714,0.028268619114727778,551,We're convinced you're not that hard to swallow!
4246,0,6,78,84,1.0714285714285714,0.028268619114727778,551,Welcome to 2017 - Today's forecast is going to be YUGE!
4246,1,4,79,84,1.0714285714285714,0.032954158452286685,551,"Wretched refuse, I bet you expected an Emma Lazarus. Surprise!"
4246,2,2,80,84,1.0714285714285714,0.037051832504523756,551,So sad!
4246,0,6,78,84,1.0714285714285714,0.028268619114727778,551,"Hold On! This is a ""Titled"" wave #2017."
4246,0,6,78,84,1.0714285714285714,0.028268619114727778,551,Don't worry ! We can get past that Trump threat !
4246,2,2,80,84,1.0714285714285714,0.037051832504523756,551,"I absolutely, honestly, without doubt, and guarantee a promise of the true papers if you donate to my charity and comb your hair like me, trust me."
4246,3,0,81,84,1.0714285714285714,0.040739416105145004,551,Whalecome Beaches!
4246,1,4,79,84,1.0714285714285714,0.032954158452286685,551,Hold tight people we are going straight through his bigie mouth !
4246,1,4,79,84,1.0714285714285714,0.032954158452286685,551,My God...the president elect's water gods are selecting who can come into the US!
4246,1,4,79,84,1.0714285714285714,0.032954158452286685,551,I wonder if the Pacific is this much fun.
4246,0,6,78,84,1.0714285714285714,0.028268619114727778,551,What? You want us to comb over hair?
4246,0,6,78,84,1.0714285714285714,0.028268619114727778,551,Who's running the mobile wall app?
4246,1,4,79,84,1.0714285714285714,0.032954158452286685,551,"Amazing, there is truly no escaping Donald Trump. He even has control over the ocean now, looks just like him. And watch those hands ladies, looks like he wants to grab you, you know where!"
4246,0,6,78,84,1.0714285714285714,0.028268619114727778,551,"Ok everyone, present your immigration papers to swamp monster..."
4246,0,6,78,84,1.0714285714285714,0.028268619114727778,551,"Before you dock, I need your zip code."
4246,1,4,79,84,1.0714285714285714,0.032954158452286685,551,Oh my god not Trump's hair again!!!
4246,0,6,78,84,1.0714285714285714,0.028268619114727778,551,A lot of people are getting swept up in the Trump wave.
4246,3,0,81,84,1.0714285714285714,0.040739416105145004,551,"Said I'd like to know where, you got the notion, to rock the boat, don't rock the boat baby, don't tip the boat over, rock the boat."
4246,0,6,78,84,1.0714285714285714,0.028268619114727778,551,I've a feeling we're not in Put In Bay anymore.
4246,2,2,80,84,1.0714285714285714,0.037051832504523756,551,"Who invited that guy, Jonah-something?"
4246,1,4,79,84,1.0714285714285714,0.032954158452286685,551,"Of the neighborhoods he promised to fix, he considers this the most dangerous one."
4246,1,4,79,84,1.0714285714285714,0.032954158452286685,551,I'm afraid this wave won't just be frozen in time.
4246,0,6,78,84,1.0714285714285714,0.028268619114727778,551,And this here is the Trump wave!
4246,1,4,79,84,1.0714285714285714,0.032954158452286685,551,"We rode the great Trump Wave to America. Now, kind spirit, help us in our hour of need."
4246,2,2,80,84,1.0714285714285714,0.037051832504523756,551,Now here's an example of a Trump Loyal Wave.
4246,0,6,78,84,1.0714285714285714,0.028268619114727778,551,It's not the drowning you should worry about...it's the PCBs.
4246,0,6,78,84,1.0714285714285714,0.028268619114727778,551,Wait! We're your 9/11 dancers. Did we miss the press conference?
4246,1,4,79,84,1.0714285714285714,0.032954158452286685,551,"Well, quelle surprise, what fresh hell is this?!"
4246,0,6,78,84,1.0714285714285714,0.028268619114727778,551,Hang on! It's looks like a dangerous wave.
4246,1,4,79,84,1.0714285714285714,0.032954158452286685,551,The Great Wave of Trumpanawa is upon us!
4246,0,6,78,84,1.0714285714285714,0.028268619114727778,551,"Trump's riding quite a wave with his ""Make America Great Again"" slogan."
4246,0,6,78,84,1.0714285714285714,0.028268619114727778,551,It's saying 'Welcome to the Land of Orange Tiny Hands. Now scram!'
4246,0,6,78,84,1.0714285714285714,0.028268619114727778,551,"'Mom, is this a Mexican Wave?' 'No honey, it's quite the opposite'"
4246,2,2,80,84,1.0714285714285714,0.037051832504523756,551,Looks a lot like a tsunami.
4246,1,4,79,84,1.0714285714285714,0.032954158452286685,551,Trumpmania rules the waves
4246,0,6,78,84,1.0714285714285714,0.028268619114727778,551,I told you. Don't touch the voodoo idol didn't I?
4246,0,6,78,84,1.0714285714285714,0.028268619114727778,551,You are not an invited guests of the U.S.!
4246,1,4,79,84,1.0714285714285714,0.032954158452286685,551,Go for that lady to your left! She's HUUUGE!
4246,1,4,79,84,1.0714285714285714,0.032954158452286685,551,Hair-oshige's water wall too?
4246,0,6,78,84,1.0714285714285714,0.028268619114727778,551,Behold the Trump-tastic wave machine.
4246,1,4,79,84,1.0714285714285714,0.032954158452286685,551,Into each life a little rain must fall.
4295,1,4,80,85,1.0705882352941176,0.032574995540855196,551,I see a marvelous bookplate.
4295,2,2,81,85,1.0705882352941176,0.03662297611206199,551,I told you the ferry would be costly.
4295,1,4,80,85,1.0705882352941176,0.032574995540855196,551,"...And the last line is 'I lift my lamp beside the golden door!' Door? All I see is this big, fat yap."
4295,1,4,80,85,1.0705882352941176,0.032574995540855196,551,"For those of you who have just eaten lunch, too bad."
4295,0,6,79,85,1.0705882352941176,0.027946704450951078,551,"Not a kraken, it's President Trump!"
4295,0,6,79,85,1.0705882352941176,0.027946704450951078,551,"Relax, that's Donald the friendly wave."
4295,1,4,80,85,1.0705882352941176,0.032574995540855196,551,and this is New York's famous Donald Trump tsunami.
4302,0,6,80,86,1.069767441860465,0.027632024455162996,551,Sorry mates. The wind and waves were not expected to last.
4303,1,3,77,81,1.0617283950617284,0.03213435823412436,551,"""We are now entering New York's famous Beast River""."
4303,2,1,78,81,1.0617283950617284,0.03662320240541067,551,"Oh my gosh Steve, tell Carrie you're sorry!"
4303,0,5,76,81,1.0617283950617284,0.026906783602102913,551,"Don't worry, this great wave will be your last one!"
4303,0,5,76,81,1.0617283950617284,0.026906783602102913,551,Defrosting the GPS in the microwave may not have been one of my better ideas.
4303,0,5,76,81,1.0617283950617284,0.026906783602102913,551,Is this what they mean about gentrification?
4303,0,5,76,81,1.0617283950617284,0.026906783602102913,551,I just love Trump's new Statue of Fear
4303,0,5,76,81,1.0617283950617284,0.026906783602102913,551,We need to clear this new Trump barrier before Jan 20th!!
4303,1,3,77,81,1.0617283950617284,0.03213435823412436,551,Wow that's a big wave!
4303,0,5,76,81,1.0617283950617284,0.026906783602102913,551,Om nom nom..
4303,0,5,76,81,1.0617283950617284,0.026906783602102913,551,"A little hand back there, Marco!"
4303,0,5,76,81,1.0617283950617284,0.026906783602102913,551,"Weird, we've left the States, but it still doesn't feel less republican."
4303,1,3,77,81,1.0617283950617284,0.03213435823412436,551,Don't Be Trumped! That's a Huge Wave!
4303,0,5,76,81,1.0617283950617284,0.026906783602102913,551,"Tweet: ""What the hell is an anthropomorphic wave?"""
4303,1,3,77,81,1.0617283950617284,0.03213435823412436,551,I think it looks more like a flying elephant with a birthday hat.
4303,1,3,77,81,1.0617283950617284,0.03213435823412436,551,I guess we're going be dinner tonight!
4303,1,3,77,81,1.0617283950617284,0.03213435823412436,551,"I know this is too late, but my caption for Dec 19/26 is: The bathroom is down the hall, but there's a line for that too."
4303,0,5,76,81,1.0617283950617284,0.026906783602102913,551,This is Trumpland. Go home.
4303,0,5,76,81,1.0617283950617284,0.026906783602102913,551,Hold up until it breaks. This wave is all his Congress would fund to keep us out.
4303,0,5,76,81,1.0617283950617284,0.026906783602102913,551,"Trump's advice to the first wave of deports: ""Make like my rug and beat it!"""
4303,1,3,77,81,1.0617283950617284,0.03213435823412436,551,"Welcome, the elite educated tossed to me, I lift my lamp beside my golden hair."
4303,0,5,76,81,1.0617283950617284,0.026906783602102913,551,"Lookout, here comes the big one!"
4303,0,5,76,81,1.0617283950617284,0.026906783602102913,551,"During the last eight years the current regime has lost more than one thousand combined legislative seats, perhaps this is not an ill wind?"
4303,0,5,76,81,1.0617283950617284,0.026906783602102913,551,We're about to be Trump tossed
4303,1,3,77,81,1.0617283950617284,0.03213435823412436,551,"Don't be afraid. Its just the ugly wave that swept through the country with the last election. When the tide goes out, next month, we'll count the bodies left behind!"
4303,1,3,77,81,1.0617283950617284,0.03213435823412436,551,All hands on the poop deck!
4303,1,3,77,81,1.0617283950617284,0.03213435823412436,551,"Oh, no! It's the King Elect's new Wall of Waves policy."
4303,0,5,76,81,1.0617283950617284,0.026906783602102913,551,Even the seas have gone Trumpian!
4303,1,3,77,81,1.0617283950617284,0.03213435823412436,551,"O.M.G. This Trump Wave is dooming us, the people; the Statue of Liberty and all it stands for; and New York City and the rest of the country."
4303,0,5,76,81,1.0617283950617284,0.026906783602102913,551,"You're right, this Prisma filter does improve things!"
4303,0,5,76,81,1.0617283950617284,0.026906783602102913,551,Immigrant-hater. Russia-lover. How patriotic.
4303,1,3,77,81,1.0617283950617284,0.03213435823412436,551,"Don't panic, it's just big-headed rain."
4303,2,1,78,81,1.0617283950617284,0.03662320240541067,551,LADIES LOOKS LIKE WERE UP AGAINST THE WAVE AGAIN
4303,1,3,77,81,1.0617283950617284,0.03213435823412436,551,The voices want to know how that makes you feel.
4303,1,3,77,81,1.0617283950617284,0.03213435823412436,551,Everyone stay calm and grab a cat.
4303,1,3,77,81,1.0617283950617284,0.03213435823412436,551,"So,what d'ya want fer $1.98? The Circle Line?!"
4303,0,5,76,81,1.0617283950617284,0.026906783602102913,551,Trump Homeland plan uses waves to nab illegals!
4303,1,3,77,81,1.0617283950617284,0.03213435823412436,551,That tsunami was made in America but I can't be sure.
4303,2,1,78,81,1.0617283950617284,0.03662320240541067,551,What da fuck !
4303,0,5,76,81,1.0617283950617284,0.026906783602102913,551,Another copycat feeling liberated by the election.
4303,0,5,76,81,1.0617283950617284,0.026906783602102913,551,"There's no escaping ""The Donald""."
4303,1,3,77,81,1.0617283950617284,0.03213435823412436,551,"The Trump Wave is so anti-immigration, he will probably even tax our boat"
4303,0,5,76,81,1.0617283950617284,0.026906783602102913,551,...and this is our latest attraction the Kellyanne Tsunami!
4303,2,1,78,81,1.0617283950617284,0.03662320240541067,551,Crikey Moses!!
4303,0,5,76,81,1.0617283950617284,0.026906783602102913,551,"Don't worry, he's a vegan!"
4303,0,5,76,81,1.0617283950617284,0.026906783602102913,551,"Hey we're all aboard the ""Trumptanic"" and we're unsinkable! So full speed ahead!!"
4303,1,3,77,81,1.0617283950617284,0.03213435823412436,551,Any questions?
4303,0,5,76,81,1.0617283950617284,0.026906783602102913,551,Take a sharp right at Trump Wave. Continue past Liberty Island to the Promised City. No vacancies.
4303,1,3,77,81,1.0617283950617284,0.03213435823412436,551,A lot of MAGA-wave activity today! Looks like Ellis Island is out of the question...
4303,0,5,76,81,1.0617283950617284,0.026906783602102913,551,"The only original line we can keep is ‘I lift my lamp beside the golden door,’ the rest will have to be re-written since Trump is President-elect."
4303,0,5,76,81,1.0617283950617284,0.026906783602102913,551,Octapuses are our friends.
4303,0,5,76,81,1.0617283950617284,0.026906783602102913,551,"It'll be okay, we're the bigger wave."
4303,0,5,76,81,1.0617283950617284,0.026906783602102913,551,There's no room in the Tower.
4303,0,5,76,81,1.0617283950617284,0.026906783602102913,551,Just upgraded to category 5
4303,0,5,76,81,1.0617283950617284,0.026906783602102913,551,Yo...The Potomac is 300 miles Southwest of here.
4303,1,3,77,81,1.0617283950617284,0.03213435823412436,551,I don't do the email thing.
4303,0,5,76,81,1.0617283950617284,0.026906783602102913,551,When are you hipsters gonna learn: this city is a dangerous place!
4303,0,5,76,81,1.0617283950617284,0.026906783602102913,551,It's been a very disturbing fall and now he's appearing to me in nightmares as a killer wave!
4303,1,3,77,81,1.0617283950617284,0.03213435823412436,551,Hey! How about you lend a hand here!
4303,0,5,76,81,1.0617283950617284,0.026906783602102913,551,"Raging storm rising, But waves have little fingers, Calm will soon prevail."
4303,1,3,77,81,1.0617283950617284,0.03213435823412436,551,The Trump Wave: So you think you're going to stay here?
4303,1,3,77,81,1.0617283950617284,0.03213435823412436,551,"The fingerling waves are no problem, but be wary of the black hole inviting escape."
4303,0,5,76,81,1.0617283950617284,0.026906783602102913,551,It is all about a wave.
4303,0,5,76,81,1.0617283950617284,0.026906783602102913,551,"Just when the airwaves seem to settle down, we get this."
4303,1,3,77,81,1.0617283950617284,0.03213435823412436,551,New York Angst
4303,0,5,76,81,1.0617283950617284,0.026906783602102913,551,Don't worry - it's just some kind of a strange American welcoming committee.
4303,1,3,77,81,1.0617283950617284,0.03213435823412436,551,"we hoped for the sound of the trumpet, but here is a roll of thunder"
4303,1,3,77,81,1.0617283950617284,0.03213435823412436,551,One day you'll sit where I'm sitting.
4303,0,5,76,81,1.0617283950617284,0.026906783602102913,551,Could you just calm down until we get to shore
4303,1,3,77,81,1.0617283950617284,0.03213435823412436,551,This the new President Donald Trump ride the mayor had set up. It officially opens in mid-January. We're all supposed to be scared.
4303,0,5,76,81,1.0617283950617284,0.026906783602102913,551,Bad Bad People Row Row your boat Away
4303,1,3,77,81,1.0617283950617284,0.03213435823412436,551,It's alright--it just looks like him!
4303,1,3,77,81,1.0617283950617284,0.03213435823412436,551,How can you tell me with a straight face that it's not a comb-over?
4303,0,5,76,81,1.0617283950617284,0.026906783602102913,551,Abandon ship ... it's Trump!
4303,0,5,76,81,1.0617283950617284,0.026906783602102913,551,"By Donald's standards we do qualify---tired, poor and huddled masses!"
4303,1,3,77,81,1.0617283950617284,0.03213435823412436,551,Row faster before we get swamped!
4303,1,3,77,81,1.0617283950617284,0.03213435823412436,551,Help! Help! Wavy hair trend for 2017.
4303,1,3,77,81,1.0617283950617284,0.03213435823412436,551,I knew this would happen sooner or later.
4303,0,5,76,81,1.0617283950617284,0.026906783602102913,551,Incoming!
4381,1,3,78,82,1.0609756097560976,0.03174898242238476,551,"To your right is Poseidon-elect Benny Trump, the son of Medusa and Neptune. His planned wall between the sun and the moon is guaranteed to repel global warming and will be paid for by the Martians!"
4381,0,5,77,82,1.0609756097560976,0.02658728573217963,551,This Pharoah is really scary!
4381,0,5,77,82,1.0609756097560976,0.02658728573217963,551,Trump was serious when he said he was preventing immigrants from coming over
4381,0,5,77,82,1.0609756097560976,0.02658728573217963,551,We just tell 'em that we tried to leave the country but this Celebrity Barrier is stopping us!
4381,1,3,78,82,1.0609756097560976,0.03174898242238476,551,"Trumpaphobia is ridiculous girls, don't allow yourself to see him behind everything you encounter......."
4381,2,1,79,82,1.0609756097560976,0.0361816529073677,551,"That bottled blond leviathan's sigh is hokey; in a word, it's a genuine Hokusai."
4381,1,3,78,82,1.0609756097560976,0.03174898242238476,551,"I've owned my boat for four years, and I've named it Brad...."
4381,0,5,77,82,1.0609756097560976,0.02658728573217963,551,We're backwards people! Wave liberty goodbye.
4381,1,3,78,82,1.0609756097560976,0.03174898242238476,551,"Naturally we call it a Trupal Wave. From the hair to the small hands, a mouthful of thank-you and handful of much obliged."
4381,0,5,77,82,1.0609756097560976,0.02658728573217963,551,WILSOOOOOOOOOO.................N!
4381,1,3,78,82,1.0609756097560976,0.03174898242238476,551,The political climate is changing too. It's up to the best navigators to make it through.
4381,0,5,77,82,1.0609756097560976,0.02658728573217963,551,"Nah, it's not a yuuuuge wave, not even in the top half I've seen."
4381,1,3,78,82,1.0609756097560976,0.03174898242238476,551,Maybe leaving our homeland was not such a good idea after all
4381,0,5,77,82,1.0609756097560976,0.02658728573217963,551,So THIS is Trump?
4381,1,3,78,82,1.0609756097560976,0.03174898242238476,551,Maybe ethnic cleansing wasn't so bad.
4381,0,5,77,82,1.0609756097560976,0.02658728573217963,551,To your right is the Statue of Liberty and...
4381,1,3,78,82,1.0609756097560976,0.03174898242238476,551,"Portrait of New York Harbor by the artist Tom Chitty, circa January 2017"
4381,1,3,78,82,1.0609756097560976,0.03174898242238476,551,Wow! They never told us about in the tour book.
4381,1,3,78,82,1.0609756097560976,0.03174898242238476,551,Look out! It's Trump's wave of hate!
4381,0,5,77,82,1.0609756097560976,0.02658728573217963,551,"Hold on, Trumpnami!"
4381,0,5,77,82,1.0609756097560976,0.02658728573217963,551,He has the last gaff now
4381,0,5,77,82,1.0609756097560976,0.02658728573217963,551,America does not have the culture I expected.
4381,0,5,77,82,1.0609756097560976,0.02658728573217963,551,"Give me the taxes of your tired, your poor, your huddled masses yearning to breathe free, the wretched refuse of your teeming shore."
4381,0,5,77,82,1.0609756097560976,0.02658728573217963,551,It's our right as a sovereign nation to choose immigrants that we think are the likeliest to thrive and flourish and love us. The rest can drown.
4381,0,5,77,82,1.0609756097560976,0.02658728573217963,551,It's a lot better than a woman
4381,0,5,77,82,1.0609756097560976,0.02658728573217963,551,"Salty?...yes, very salty"
4381,0,5,77,82,1.0609756097560976,0.02658728573217963,551,"We are the tired and poor, and have no money for the toll."
4381,0,5,77,82,1.0609756097560976,0.02658728573217963,551,"THAT HAIRDO, WHO DOES IT REMIND YOU OF?"
4381,0,5,77,82,1.0609756097560976,0.02658728573217963,551,"Send these, the homeless, back from whence they came I lift my lamp beside the tidal boor."
4381,1,3,78,82,1.0609756097560976,0.03174898242238476,551,hair style gone viral
4381,1,3,78,82,1.0609756097560976,0.03174898242238476,551,Global warming is hitting the U.S. quite hard.
4381,1,3,78,82,1.0609756097560976,0.03174898242238476,551,"Grab your beads girls, we'll say The Rosie together."
4381,1,3,78,82,1.0609756097560976,0.03174898242238476,551,"Sorry, she didn't get a mandate."
4381,0,5,77,82,1.0609756097560976,0.02658728573217963,551,All out! This is the surprise ending of our New York City tour.
4381,1,3,78,82,1.0609756097560976,0.03174898242238476,551,"Hey, we don't want your tired, your poor, your huddled masses yearning to breath free."
4381,0,5,77,82,1.0609756097560976,0.02658728573217963,551,"This is perfect! It ticks off the very important ""Tempest-tost"" box."
4381,0,5,77,82,1.0609756097560976,0.02658728573217963,551,Global warming!
4381,0,5,77,82,1.0609756097560976,0.02658728573217963,551,The comb over in the water is tempting us to fight or ride the wave of electoral acceptance.
4381,1,3,78,82,1.0609756097560976,0.03174898242238476,551,Number 38?
4381,1,3,78,82,1.0609756097560976,0.03174898242238476,551,"So, miserable huddled masses, you think you're free to tweet MY hotel ""a 2-star dive""!!? WRONG!!!!!"
4381,0,5,77,82,1.0609756097560976,0.02658728573217963,551,Wow! A flaxen wave of fear.
4381,1,3,78,82,1.0609756097560976,0.03174898242238476,551,"Don't worry, folks. It's just a DTAW—a Donald Trump Allegorical Wave."
4381,0,5,77,82,1.0609756097560976,0.02658728573217963,551,We are about to embrace and enjoy our new tidal wave.
4381,0,5,77,82,1.0609756097560976,0.02658728573217963,551,"ladies! start batting your waterproof mascara, happy hour drinks on me"
4381,0,5,77,82,1.0609756097560976,0.02658728573217963,551,"Remember, Sandy was only Category 2!"
4381,1,3,78,82,1.0609756097560976,0.03174898242238476,551,And here we have the seascape of Canby Overdun.
4381,0,5,77,82,1.0609756097560976,0.02658728573217963,551,"Maybe, but I'm not a waveoligist."
4381,0,5,77,82,1.0609756097560976,0.02658728573217963,551,"Well, that explains one thing."
4381,2,1,79,82,1.0609756097560976,0.0361816529073677,551,Did'nt I tell you waves have feelings too
4381,0,5,77,82,1.0609756097560976,0.02658728573217963,551,Walk on water!
4381,0,5,77,82,1.0609756097560976,0.02658728573217963,551,"I see why this has been renamed ""The Sea Of Trump!"
4381,1,3,78,82,1.0609756097560976,0.03174898242238476,551,"""Our product's called 'Tempest-Tossed'. It's hair care for your poor, huddled, teaming masses who want salon quality beach waves at home""."
4381,1,3,78,82,1.0609756097560976,0.03174898242238476,551,Keep the bow into the wave.
4381,0,5,77,82,1.0609756097560976,0.02658728573217963,551,Looks like the golden door of freedom being is trumped by the orange wave.
4381,1,3,78,82,1.0609756097560976,0.03174898242238476,551,Truexit
4381,0,5,77,82,1.0609756097560976,0.02658728573217963,551,Even the best of people get attacked by the worst.
4381,0,5,77,82,1.0609756097560976,0.02658728573217963,551,Get ready for a hug from the sea.
4381,0,5,77,82,1.0609756097560976,0.02658728573217963,551,"Oh, go back! I said we forgot to rig the BOAT."
4381,0,5,77,82,1.0609756097560976,0.02658728573217963,551,"Honey, I told you not to drump in the ocean!"
4381,1,3,78,82,1.0609756097560976,0.03174898242238476,551,"Row, row, row your boat, gently down the stream..."
4381,1,3,78,82,1.0609756097560976,0.03174898242238476,551,It's Ramen Trump
4381,1,3,78,82,1.0609756097560976,0.03174898242238476,551,Welcome to the Trump Tidal Wave Seapark!
4381,1,3,78,82,1.0609756097560976,0.03174898242238476,551,This weather TRUMPED our journey.
4381,0,5,77,82,1.0609756097560976,0.02658728573217963,551,"Row strong you huddled masses, the torch flickers. We the retched refuse must return to our ancient teeming shore to escape this combed-over wave of an orange boor."
4381,1,3,78,82,1.0609756097560976,0.03174898242238476,551,Our president likes to wave on immigrants
4381,0,5,77,82,1.0609756097560976,0.02658728573217963,551,"row row row scapegoat, gently drown a scream"
4381,1,3,78,82,1.0609756097560976,0.03174898242238476,551,I ??New york
4381,1,3,78,82,1.0609756097560976,0.03174898242238476,551,Ok. On three - 'Happy New Year!'
4381,0,5,77,82,1.0609756097560976,0.02658728573217963,551,Look. It's trying to do the wave.
4450,0,5,78,83,1.0602409638554218,0.02627527589820373,551,Just you be glad it's not an e-mail!
4450,0,5,78,83,1.0602409638554218,0.02627527589820373,551,"Wow..Spare us Trump,we are legal immigrants,and our vote counted!!!!"
4450,1,3,79,83,1.0602409638554218,0.031372734719770215,551,"Kids, get your cameras, it looks just like grandpa's comb over."
4450,0,5,78,83,1.0602409638554218,0.02627527589820373,551,"To paraphrase, this looks like 'send your homeless, tempest-tossed to me: I lift my lamp beside my golden hair.'"
4450,1,3,79,83,1.0602409638554218,0.031372734719770215,551,"Since the election I just repeat to myself, over and over, ""calm blue ocean, calm blue ocean..."""
4450,0,5,78,83,1.0602409638554218,0.02627527589820373,551,OMG it looks just like Donald Trump and his hair.
4450,0,5,78,83,1.0602409638554218,0.02627527589820373,551,This was not what I meant when I called him a Fisher King!
4450,0,5,78,83,1.0602409638554218,0.02627527589820373,551,"Stroke...Stroke... Hey, we voted for this guy! Stroke me...Stroke me..."
4450,1,3,79,83,1.0602409638554218,0.031372734719770215,551,Oops; the golden door is closed!
4450,0,5,78,83,1.0602409638554218,0.02627527589820373,551,We are out of here!
4450,1,3,79,83,1.0602409638554218,0.031372734719770215,551,"Hey Doc, what is this wet hairy dream about?"
4450,1,3,79,83,1.0602409638554218,0.031372734719770215,551,"Sea, it's waving."
4450,0,5,78,83,1.0602409638554218,0.02627527589820373,551,Tell me: does this cartoonist have genre identity problems?
4463,0,5,79,84,1.0595238095238095,0.025970494292140555,551,"Moving to Mexico for our jobs? That's a good one! Too funny! ""You're fired!"" Ha! Ha! OK, now get out of the way."
4463,0,5,79,84,1.0595238095238095,0.025970494292140555,551,Sorry we didn't get to see the Empire State Building.
4463,0,5,79,84,1.0595238095238095,0.025970494292140555,551,Nyaa nya nya nyaa nya...nobody gets away with making fun of my beautiful hair!
4463,1,3,80,84,1.0595238095238095,0.031005294812708528,551,See Serpent
4463,1,3,80,84,1.0595238095238095,0.031005294812708528,551,I think New York is the other way!
4463,0,5,79,84,1.0595238095238095,0.025970494292140555,551,All ashore that's going ashore!
4463,0,5,79,84,1.0595238095238095,0.025970494292140555,551,"""Observe""......""RogueWavus Donaldus""."
4463,1,3,80,84,1.0595238095238095,0.031005294812708528,551,"Hokey, sigh."
4463,0,5,79,84,1.0595238095238095,0.025970494292140555,551,Welp... I THOUGHT we had a biggest boat.
4463,2,1,81,84,1.0595238095238095,0.03532973307382658,551,Did anyone think to bring an umbrella?
4463,0,5,79,84,1.0595238095238095,0.025970494292140555,551,We should have brought a bottle of wine
4463,0,5,79,84,1.0595238095238095,0.025970494292140555,551,"""Now if we all just think *really* positive ..."
4463,0,5,79,84,1.0595238095238095,0.025970494292140555,551,"This does not bode well for our attempt to secure political asylum, and I think we've all just been fired."
4476,0,5,80,85,1.0588235294117647,0.025672692968940272,551,Welcome to Teeming Shore Links. Tempest-tossed huddled masses half-price with proof of citizenship
4476,1,3,81,85,1.0588235294117647,0.030646357191278093,551,I knew this sea wasn't red. God does't substitute colors.
4476,0,5,80,85,1.0588235294117647,0.025672692968940272,551,It must be a Trump wave. Doesn't like immigrants.
4479,0,5,81,86,1.058139534883721,0.02538163517822088,551,"Don't worry, Donald Trump is all but a receding wave,"
4480,0,4,76,80,1.05,0.024520722313684188,551,Who knew searching for big apples could be this dangerous?
4480,0,4,76,80,1.05,0.024520722313684188,551,"Boo!! Oh, wait, you're not Noah."
4480,0,4,76,80,1.05,0.024520722313684188,551,The US after the immigrants were sent back.
4480,1,2,77,80,1.05,0.03029391884499827,551,Transphobia.
4480,0,4,76,80,1.05,0.024520722313684188,551,Steady everyone; once that wave settles down we'll have a clear path to the land of opportunity.
4480,0,4,76,80,1.05,0.024520722313684188,551,"Give me your tired, your poor, your huddled masses yearning to breathe free...tempest tossed to me. I lift my lamp beside the golden door"
4480,0,4,76,80,1.05,0.024520722313684188,551,Last obstacle-Wall of Water monster.
4480,0,4,76,80,1.05,0.024520722313684188,551,"Is this the Howlin"" Tunnel?"
4480,0,4,76,80,1.05,0.024520722313684188,551,"You know, rowing sure is a nice way to relieve economic anxiety."
4480,0,4,76,80,1.05,0.024520722313684188,551,It does look scary and sounds scary too.
4480,0,4,76,80,1.05,0.024520722313684188,551,"Warning from Old Man In The Sea with Trump pompadour: ""Lady Liberty will furlough social services with new tax cuts"""
4480,1,2,77,80,1.05,0.03029391884499827,551,Are we home yet?
4480,0,4,76,80,1.05,0.024520722313684188,551,So much for a golden door!
4480,0,4,76,80,1.05,0.024520722313684188,551,Get ready to huddle ya mass o'bastards.
4480,0,4,76,80,1.05,0.024520722313684188,551,The Trump shore is not just lore.
4480,1,2,77,80,1.05,0.03029391884499827,551,Hairy Trump Tsunami Many Small Hands Democracy in Lifeboat
4480,1,2,77,80,1.05,0.03029391884499827,551,"I’m sending you tired, you poor, you homeless terrorists back to your tempest-tost future. No Golden Door for you!"
4480,0,4,76,80,1.05,0.024520722313684188,551,Close your eyes; it's too early to see dead bodies.
4480,1,2,77,80,1.05,0.03029391884499827,551,I never thought it would come to this... a little dingy and going overboard with wavy hair!
4480,0,4,76,80,1.05,0.024520722313684188,551,"Too late to return to Guatemala, the Donald wave got them."
4480,0,4,76,80,1.05,0.024520722313684188,551,This is the new DT wave. Watch your wallets he is very grabby.
4480,0,4,76,80,1.05,0.024520722313684188,551,Ramone's Orange Pompadour Pate' sponsors this section of Wherethehellarewe World.
4480,0,4,76,80,1.05,0.024520722313684188,551,"Go home, all ye faithful.."
4480,0,4,76,80,1.05,0.024520722313684188,551,"No, he is not Groot."
4480,1,2,77,80,1.05,0.03029391884499827,551,You believed the old broad ? How sad.
4480,0,4,76,80,1.05,0.024520722313684188,551,"Beware!...It is already January 20, 2017"
4480,1,2,77,80,1.05,0.03029391884499827,551,I want this tsunami off of 5th Avenue before he rips more tides!
4480,0,4,76,80,1.05,0.024520722313684188,551,"But Mr. President, the citizens, they have no land left to live on."" ""Let them row oars."
4480,0,4,76,80,1.05,0.024520722313684188,551,I like those rowboats in Central Park
4480,0,4,76,80,1.05,0.024520722313684188,551,"You're waving, but it's not to say hi."
4480,0,4,76,80,1.05,0.024520722313684188,551,Go back illegals! Lady Liberty is going to build a huge white wall....
4480,1,2,77,80,1.05,0.03029391884499827,551,"Hey Neptune, over here!"
4480,1,2,77,80,1.05,0.03029391884499827,551,"Turn back, there's no escape from me!"
4480,2,0,78,80,1.05,0.035130858446526365,551,"New York New York, it's a wonderful town. Let's also make it all our own!"
4480,1,2,77,80,1.05,0.03029391884499827,551,"No worries, these presidential comb overs won't last"
4480,0,4,76,80,1.05,0.024520722313684188,551,Is his name Neptune or Poseidon?
4480,0,4,76,80,1.05,0.024520722313684188,551,"Don' t touch the tentacles, I think he has a cold."
4480,0,4,76,80,1.05,0.024520722313684188,551,Hands across the water - hope is on the way!
4480,1,2,77,80,1.05,0.03029391884499827,551,Hokusai! The great wave is upon us!
4480,1,2,77,80,1.05,0.03029391884499827,551,"We need to outyearn this big, yellow wave."
4480,0,4,76,80,1.05,0.024520722313684188,551,my dye job went awash
4480,0,4,76,80,1.05,0.024520722313684188,551,"THE GREAT AGAIN WAVE: Angry, white, capped - a famous block."
4480,0,4,76,80,1.05,0.024520722313684188,551,Ok.....I'm done!
4480,1,2,77,80,1.05,0.03029391884499827,551,Don't worry. He is not as scary as his hairs.
4480,0,4,76,80,1.05,0.024520722313684188,551,That's one human who can't deny his effect on climate.
4480,1,2,77,80,1.05,0.03029391884499827,551,"But the only bridge, that's a real gone bridge...."
4480,0,4,76,80,1.05,0.024520722313684188,551,"And neither snow, nor rain, nor hair, nor gloom of night, nor the winds of change, nor a nation challenged, will stay us from the swift completion of our appointed rounds."
4480,0,4,76,80,1.05,0.024520722313684188,551,I'm not sure this life boat can save us from the tsumani hair!
4480,1,2,77,80,1.05,0.03029391884499827,551,CHITTY!!! You're Fired!
4480,1,2,77,80,1.05,0.03029391884499827,551,Dorothy got away with it once...
4480,1,2,77,80,1.05,0.03029391884499827,551,"We could have just taken the PATH... Not on Christmas, never reliable."
4480,1,2,77,80,1.05,0.03029391884499827,551,"Heads, I get the life jacket!"
4480,0,4,76,80,1.05,0.024520722313684188,551,Last time I saw a rogue wave this huge was Put-In Bay.
4480,0,4,76,80,1.05,0.024520722313684188,551,Is Disney into National Monuments now?
4480,0,4,76,80,1.05,0.024520722313684188,551,In the wake of what is happening please drown out all screaming.
4480,0,4,76,80,1.05,0.024520722313684188,551,Towering Trump Titanic
4480,0,4,76,80,1.05,0.024520722313684188,551,Mutation! Ho!
4480,1,2,77,80,1.05,0.03029391884499827,551,"Call me Bush, Billy Bush"
4480,1,2,77,80,1.05,0.03029391884499827,551,Keep your puny wavelets to yourself!
4480,1,2,77,80,1.05,0.03029391884499827,551,"OMG, it's a Trumpall wave!"
4480,0,4,76,80,1.05,0.024520722313684188,551,"""I said I wanted to see Rogue One"" [""one"" underlined]"
4541,0,4,77,81,1.0493827160493827,0.024223971444874794,551,The sequel: Snow whitecap and the seven dwarfs on the Hudson
4541,0,4,77,81,1.0493827160493827,0.024223971444874794,551,We don't want nobody nobody sent.
4541,0,4,77,81,1.0493827160493827,0.024223971444874794,551,Don't worry--it's only a harbor wave.
4541,0,4,77,81,1.0493827160493827,0.024223971444874794,551,Having assuaged their economic anxiety...
4541,0,4,77,81,1.0493827160493827,0.024223971444874794,551,No! I didn't say Muslim...I said we're masochists!
4541,0,4,77,81,1.0493827160493827,0.024223971444874794,551,"A cheap shot by Chitty. Liberals don't get it, and they probably never will."
4541,0,4,77,81,1.0493827160493827,0.024223971444874794,551,Ms. Liberty welcomes you - the flow does not.
4541,0,4,77,81,1.0493827160493827,0.024223971444874794,551,"Don't worry, luckily we have two paddles."""
4541,0,4,77,81,1.0493827160493827,0.024223971444874794,551,Trump really scares me!
4541,0,4,77,81,1.0493827160493827,0.024223971444874794,551,"He's tough on the outside, but, once you get to know him, he's a real pussycat. Just don't make fun of hs hairdo."
4541,0,4,77,81,1.0493827160493827,0.024223971444874794,551,Time for the Fun Zone!
4541,0,4,77,81,1.0493827160493827,0.024223971444874794,551,Don't worry...It's just Moana.
4541,1,2,78,81,1.0493827160493827,0.02992394973713783,551,"Paddle to port, dammit!"
4541,0,4,77,81,1.0493827160493827,0.024223971444874794,551,This one is definitely the comfiest.
4541,1,2,78,81,1.0493827160493827,0.02992394973713783,551,Thirty-six Ways to Flood Mount Liberty
4541,0,4,77,81,1.0493827160493827,0.024223971444874794,551,Oh no. Not another remake of the Swiss Family Robinson!
4541,1,2,78,81,1.0493827160493827,0.02992394973713783,551,"I King Donald command you, ""Row, row, row my boat."""
4541,0,4,77,81,1.0493827160493827,0.024223971444874794,551,"You know, Trump's not really so bad up close!"
4541,0,4,77,81,1.0493827160493827,0.024223971444874794,551,Lady Liberty's new crown requires more than s'more oars to pass port.
4541,0,4,77,81,1.0493827160493827,0.024223971444874794,551,America! and the welcome wagon
4541,1,2,78,81,1.0493827160493827,0.02992394973713783,551,This must be the golden mouth!
4541,1,2,78,81,1.0493827160493827,0.02992394973713783,551,It's a one in a million tears storm!
4541,0,4,77,81,1.0493827160493827,0.024223971444874794,551,"And to your immediate left folks, we have a welcoming display sponsored by our New York Political Committee."
4541,0,4,77,81,1.0493827160493827,0.024223971444874794,551,UH-OH! LOOK OUT! IT'S THE BIG ONE WITH THE CRAZY BLONDE FORWARD-COMBED HAIR AND THE GRASPING HANDS! ROW FASTER!
4541,0,4,77,81,1.0493827160493827,0.024223971444874794,551,Who would've thought it was going to be such a HAIR RAISING experience immigrating into the United States..The President Elect is ROCKING our BOAT & hoping to WAVE goodbye!!
4541,0,4,77,81,1.0493827160493827,0.024223971444874794,551,Wow! I ?? NY!
4541,1,2,78,81,1.0493827160493827,0.02992394973713783,551,Who is the climate change that's changing now ... income gap?
4541,0,4,77,81,1.0493827160493827,0.024223971444874794,551,"maybe we should have accepted his victory, instead of making excuses for an out-of -touch, incompetent, arrogant DNC candidate"
4541,0,4,77,81,1.0493827160493827,0.024223971444874794,551,The name is Gilligan. Why do you ask?
4541,0,4,77,81,1.0493827160493827,0.024223971444874794,551,"Believe me, people. There's no escaping that I'm going to Make America Great Again!!"
4541,0,4,77,81,1.0493827160493827,0.024223971444874794,551,Why should we hire you to be the Aide to the Assistant Deputy Junior Regional Auxiliary Interim Manager ?
4541,0,4,77,81,1.0493827160493827,0.024223971444874794,551,"Real people, not actors."
4541,1,2,78,81,1.0493827160493827,0.02992394973713783,551,Many hydrologists and oceanographers believe the Spuyten Duyvil is now gradually migrating southwest of New York waters.
4541,0,4,77,81,1.0493827160493827,0.024223971444874794,551,See You Later
4541,0,4,77,81,1.0493827160493827,0.024223971444874794,551,You got the DT's. Drink..........
4541,0,4,77,81,1.0493827160493827,0.024223971444874794,551,We may experience some turbulence on landing.
4541,0,4,77,81,1.0493827160493827,0.024223971444874794,551,"We're not drowning, they're waving!"
4541,0,4,77,81,1.0493827160493827,0.024223971444874794,551,The water is extra salty today.
4541,0,4,77,81,1.0493827160493827,0.024223971444874794,551,"Oh, hello, how's the weather? It's so beautiful outside. How are the Yankees doing?"
4541,0,4,77,81,1.0493827160493827,0.024223971444874794,551,It's the Trump Election Wave protecting US shores!
4541,0,4,77,81,1.0493827160493827,0.024223971444874794,551,Typical! They forgot to tell us to bring surfboards!
4541,0,4,77,81,1.0493827160493827,0.024223971444874794,551,"The great wave, Blown dry, People at sea."
4541,0,4,77,81,1.0493827160493827,0.024223971444874794,551,Don't worry. His hands are too tiny to close even a red door.
4541,0,4,77,81,1.0493827160493827,0.024223971444874794,551,"I'm with, ah, him!"
4541,0,4,77,81,1.0493827160493827,0.024223971444874794,551,"Yes, but look at the Trump Hair."
4541,0,4,77,81,1.0493827160493827,0.024223971444874794,551,"Donald ""And that is the sea monster elect"""
4541,0,4,77,81,1.0493827160493827,0.024223971444874794,551,"As you can see, here in America we're famous for our waves."
4541,0,4,77,81,1.0493827160493827,0.024223971444874794,551,There's no escaping Trump.
4589,1,2,79,82,1.048780487804878,0.0295629054597174,551,"""We'll head for Fort Lee! 'Bridgegate' was child's play compared to this!"
4590,1,1,76,78,1.0384615384615385,0.028518227063191303,551,And now we just have to pass through the Wave Wall of Extreme Vetting!
4590,0,3,75,78,1.0384615384615385,0.021915495473007307,551,"All hands on deck! He is draining the swamp!"" ""But we are the NY Times!"
4590,0,3,75,78,1.0384615384615385,0.021915495473007307,551,A Hack and Sigh Wave
4590,0,3,75,78,1.0384615384615385,0.021915495473007307,551,"There are so many things I want to say to you but first, congratulations on your Powerball win."
4590,0,3,75,78,1.0384615384615385,0.021915495473007307,551,"Honey, maybe we should've taken the speed boat tour..."
4590,0,3,75,78,1.0384615384615385,0.021915495473007307,551,I mean I was okay with 'Trumped up trickle down economics.' But why can't this wave trickle down?
4590,0,3,75,78,1.0384615384615385,0.021915495473007307,551,"And just off Ellis Island is the latest invention from U.S. Border Control - the ""Hair Wave"" wall. Note the incredible attention to detail and the realistic hairstyle."
4590,0,3,75,78,1.0384615384615385,0.021915495473007307,551,From sea to shining sea; let freedom ring!
4590,0,3,75,78,1.0384615384615385,0.021915495473007307,551,. . . I looked upon the rotting sea . . .
4590,0,3,75,78,1.0384615384615385,0.021915495473007307,551,There's no more room for bodies in the East river !
4590,0,3,75,78,1.0384615384615385,0.021915495473007307,551,Hey breaker! This isn't funny!
4590,0,3,75,78,1.0384615384615385,0.021915495473007307,551,This is really something! ('Really' to be underlined.)
4590,0,3,75,78,1.0384615384615385,0.021915495473007307,551,"This one was also done by Calatrava, but in collaboration with Lady Gaga."
4590,1,1,76,78,1.0384615384615385,0.028518227063191303,551,"But Donald, there's not even a 17 to 28 year-old male among our boat people!"
4590,0,3,75,78,1.0384615384615385,0.021915495473007307,551,"Wow, this America is like the Sorcerer's Apprentice in ""Fantasia."" Is that Mickey Mouse?"
4590,0,3,75,78,1.0384615384615385,0.021915495473007307,551,It's gonna grab us!!!
4590,0,3,75,78,1.0384615384615385,0.021915495473007307,551,Make sure you have on your life vests.
4590,0,3,75,78,1.0384615384615385,0.021915495473007307,551,"Look! It's Sue Nami's Atlantic cousin, Trump Nami!"
4590,0,3,75,78,1.0384615384615385,0.021915495473007307,551,We call it the funhouse. Prepare to die.
4590,0,3,75,78,1.0384615384615385,0.021915495473007307,551,The political climate is changing too. It's up to the best navigators to help us all make it through.
4590,0,3,75,78,1.0384615384615385,0.021915495473007307,551,"OH, NO! Now we gonna' be WAYVE'LAID ~ ~ ~"
4590,0,3,75,78,1.0384615384615385,0.021915495473007307,551,Trump Ahoy!
4590,0,3,75,78,1.0384615384615385,0.021915495473007307,551,The river is becoming great again but you can't see it from the bridge from New Jersey
4590,0,3,75,78,1.0384615384615385,0.021915495473007307,551,Trump is really putting his mark on downtown Manhattan and climate change.
4590,0,3,75,78,1.0384615384615385,0.021915495473007307,551,My wavelength senses some political fear.
4590,0,3,75,78,1.0384615384615385,0.021915495473007307,551,I guess Trump's gonna swim to D.C.
4590,0,3,75,78,1.0384615384615385,0.021915495473007307,551,It's the president-elect
4590,0,3,75,78,1.0384615384615385,0.021915495473007307,551,Build that wall...of water.
4590,0,3,75,78,1.0384615384615385,0.021915495473007307,551,"Honey, I'm shore that's Donald waving at us."
4590,1,1,76,78,1.0384615384615385,0.028518227063191303,551,This is much more fun than the ferry.
4590,0,3,75,78,1.0384615384615385,0.021915495473007307,551,Didn't you say tsunami is a Japanese dish?
4590,0,3,75,78,1.0384615384615385,0.021915495473007307,551,"Maybe Secretary of Defense, should it be open."
4590,1,1,76,78,1.0384615384615385,0.028518227063191303,551,Let's go back to Mexico Trump's wall is finished
4590,0,3,75,78,1.0384615384615385,0.021915495473007307,551,Technology's faithful servants test a prototype Smart Wave.
4590,1,1,76,78,1.0384615384615385,0.028518227063191303,551,HA!
4590,0,3,75,78,1.0384615384615385,0.021915495473007307,551,I have crossed the horizon to find you / I know your name / I may have stolen the heart from inside you / But this does not define you / This is not who you are / You know who you are
4590,0,3,75,78,1.0384615384615385,0.021915495473007307,551,Moana has faced down this type of fool - and so can we.
4590,1,1,76,78,1.0384615384615385,0.028518227063191303,551,New York has the best driftwood!
4590,1,1,76,78,1.0384615384615385,0.028518227063191303,551,Wow! Who brought the 3d projector?
4590,1,1,76,78,1.0384615384615385,0.028518227063191303,551,"Cop: ""Do you know why I pulled you over?"" Astronaut: ""Hell, officer, I wanna know HOW you pulled me over."""
4590,0,3,75,78,1.0384615384615385,0.021915495473007307,551,"No- this isn't ""A Small World"" - You're in Trump country now!"
4590,0,3,75,78,1.0384615384615385,0.021915495473007307,551,"...And for you logical behaviorists on the cruise with us today, discovering a face in the oncoming wave is akin to finding a 'ghost in the machine'."
4590,0,3,75,78,1.0384615384615385,0.021915495473007307,551,"Chin up men, positive attitude!"
4590,0,3,75,78,1.0384615384615385,0.021915495473007307,551,Look everyone! It's climate change! Hey ya Donald! You're hired! Ha ha. Is that your REAL hair?!
4590,0,3,75,78,1.0384615384615385,0.021915495473007307,551,Charity Case.
4590,0,3,75,78,1.0384615384615385,0.021915495473007307,551,"'O hear us when we cry to thee, for those in peril on the sea.'"
4590,0,3,75,78,1.0384615384615385,0.021915495473007307,551,"Look out! Business and property values are safe, but people values will be lost in the big mouth of this wave."
4590,0,3,75,78,1.0384615384615385,0.021915495473007307,551,"""Send these, the homeless tempest-tossed to me..."" (Identity theft)"
4590,0,3,75,78,1.0384615384615385,0.021915495473007307,551,"Say, I'm willing to look past this. How about you guys?"
4590,0,3,75,78,1.0384615384615385,0.021915495473007307,551,Don't worry. That's just Tsu. Everyone's getting into these Trump impersonations.
4590,1,1,76,78,1.0384615384615385,0.028518227063191303,551,"Sir, the minimum speed limit is 40 miles per hour."
4590,0,3,75,78,1.0384615384615385,0.021915495473007307,551,Look out! It's a huge wave!
4590,1,1,76,78,1.0384615384615385,0.028518227063191303,551,Trumped Icons Tour
4590,0,3,75,78,1.0384615384615385,0.021915495473007307,551,"We're really not 'at sea'. This is the Hudson -- see, Lady Liberty hasn't moved."
4590,0,3,75,78,1.0384615384615385,0.021915495473007307,551,Trust Me! ... I do..
4590,0,3,75,78,1.0384615384615385,0.021915495473007307,551,I thought white-water rafting was supposed to be fun!
4590,1,1,76,78,1.0384615384615385,0.028518227063191303,551,"Look, it's Sandy's little sister, Margaret."
4590,0,3,75,78,1.0384615384615385,0.021915495473007307,551,"It's my company, Hamrock, and I can play musical chairs any way I damn well please."
4590,1,1,76,78,1.0384615384615385,0.028518227063191303,551,When I said you released the Krakon I wanted you to pull up your pants.
4590,0,3,75,78,1.0384615384615385,0.021915495473007307,551,Le Donald eclairant le monde.
4590,0,3,75,78,1.0384615384615385,0.021915495473007307,551,The Statue of Liberty Eludes Trump: His Hair is in His Way
4590,0,3,75,78,1.0384615384615385,0.021915495473007307,551,I don't think I only will be escaped alone to tell thee.
4590,1,1,76,78,1.0384615384615385,0.028518227063191303,551,"Look, I know you want us to see the Statue of Liberty too, but this is an awfully long tour."""
4590,0,3,75,78,1.0384615384615385,0.021915495473007307,551,This marks the only time he's used low-pressure gale tactics.
4590,1,1,76,78,1.0384615384615385,0.028518227063191303,551,"""When they said that we'd be ""tempest tossed,"" I was expecting something else."
4590,0,3,75,78,1.0384615384615385,0.021915495473007307,551,But itild But I told you America is the wave of the future!
4590,0,3,75,78,1.0384615384615385,0.021915495473007307,551,"Excellence cannot be defined,it can only be proved !"
4590,0,3,75,78,1.0384615384615385,0.021915495473007307,551,"well, we could've chosen the Merry-go-round."
4590,0,3,75,78,1.0384615384615385,0.021915495473007307,551,Way enough already!
4590,0,3,75,78,1.0384615384615385,0.021915495473007307,551,His name is Chestnut and he's Aquarius.
4590,0,3,75,78,1.0384615384615385,0.021915495473007307,551,"What the world needs now is love, sweet love."
4590,0,3,75,78,1.0384615384615385,0.021915495473007307,551,"ok, let's all sing now, ""row, row, row your boat, gently down the stream. Merrily..."""
4590,0,3,75,78,1.0384615384615385,0.021915495473007307,551,That wave has a wave like Donald's wave!
4590,0,3,75,78,1.0384615384615385,0.021915495473007307,551,Nahn taebuna wafuqara'.
4590,0,3,75,78,1.0384615384615385,0.021915495473007307,551,Is that Trump or Poseidon?
4590,0,3,75,78,1.0384615384615385,0.021915495473007307,551,"Believe me, I am your worst nightmare of horror."
4590,0,3,75,78,1.0384615384615385,0.021915495473007307,551,"I think it was a right on First, honey."
4590,0,3,75,78,1.0384615384615385,0.021915495473007307,551,"I think Mr. Trump just misspelled ""Hola""..."
4590,1,1,76,78,1.0384615384615385,0.028518227063191303,551,We're gone- they elected a crappy HOA.
4590,1,1,76,78,1.0384615384615385,0.028518227063191303,551,Thank you based god.
4590,0,3,75,78,1.0384615384615385,0.021915495473007307,551,Muva Nature is the new Mother Nature.
4590,1,1,76,78,1.0384615384615385,0.028518227063191303,551,Shouldn't he be in Noh?
4590,0,3,75,78,1.0384615384615385,0.021915495473007307,551,"I can see that you care about the environment, that's why I swiped right..."
4590,0,3,75,78,1.0384615384615385,0.021915495473007307,551,"Love me, or else..."
4590,0,3,75,78,1.0384615384615385,0.021915495473007307,551,I'll huff and I'll puff and I'll blow your boat away!
4590,0,3,75,78,1.0384615384615385,0.021915495473007307,551,"Can we go back to the Ramada? I thought 'Huddled Masses"" meant tickets to a Giants' game."
4590,0,3,75,78,1.0384615384615385,0.021915495473007307,551,This new Coney Island ride based on Hollywood apocalypse films is making me absolutely delirious.
4590,0,3,75,78,1.0384615384615385,0.021915495473007307,551,You're Showered!
4590,0,3,75,78,1.0384615384615385,0.021915495473007307,551,"We call it the ""Donald Trump wave."""
4590,1,1,76,78,1.0384615384615385,0.028518227063191303,551,"""In wet weather, there's nothing"
4590,0,3,75,78,1.0384615384615385,0.021915495473007307,551,So that's how you managed to put all those moves on those other ladies who have been airbrushed out of history. We we're out looking for them!
4590,0,3,75,78,1.0384615384615385,0.021915495473007307,551,"Hey, scary Trump waveman with your scary little wavehands. Can you tell me what this cartoon is about?"
4590,0,3,75,78,1.0384615384615385,0.021915495473007307,551,"You say it's just a heated wave, huh?"
4590,0,3,75,78,1.0384615384615385,0.021915495473007307,551,"It gets worse as we go, but we WILL come out the other end!"
4590,0,3,75,78,1.0384615384615385,0.021915495473007307,551,I think the fear of Trump is being carried to far.
4590,0,3,75,78,1.0384615384615385,0.021915495473007307,551,"""Even the waters obey him!""cforstee"
4590,0,3,75,78,1.0384615384615385,0.021915495473007307,551,Sink em' by the fishy.
4590,1,1,76,78,1.0384615384615385,0.028518227063191303,551,They think they need a bigger moat.
4590,0,3,75,78,1.0384615384615385,0.021915495473007307,551,This must be the new entrance to the Trump tunnel
4590,0,3,75,78,1.0384615384615385,0.021915495473007307,551,Scary but eco-friendly.
4590,0,3,75,78,1.0384615384615385,0.021915495473007307,551,Are we in an Art Gallery?!
4590,1,1,76,78,1.0384615384615385,0.028518227063191303,551,"Monkey business!, Funky business!"
4692,0,3,76,79,1.0379746835443038,0.021641782639623026,551,I'll take your refugees
4692,0,3,76,79,1.0379746835443038,0.021641782639623026,551,"Give me your tired, your poor, your huddled masses..."
4692,0,3,76,79,1.0379746835443038,0.021641782639623026,551,The Great Wave of Can-I-Grab-Ya
4692,0,3,76,79,1.0379746835443038,0.021641782639623026,551,Left my umbrella in the hall.
4692,0,3,76,79,1.0379746835443038,0.021641782639623026,551,"It's supposed to be the latest in sustainable seafood restaurants in NYC! And if we can make it in, it's free!"
4692,1,1,77,79,1.0379746835443038,0.02815913174520475,551,Our first example of New York's modern art collection.
4692,0,3,76,79,1.0379746835443038,0.021641782639623026,551,Welcome to the Non-United Stated of Trump!
4692,0,3,76,79,1.0379746835443038,0.021641782639623026,551,"Paul yells, who the heck wrote “Give me your tired, your poor, Your huddled masses...to breathe free?"" The Times next day reported seven drown in a freak squall ironically within sight of Lazarus’ famous inscription at the Statue of Liberty."
4692,0,3,76,79,1.0379746835443038,0.021641782639623026,551,"Wow, a shower welcoming us to the land of Arby's, Macs and Fries!"
4692,1,1,77,79,1.0379746835443038,0.02815913174520475,551,She didn't make the final cut of Jersey Shore.
4692,0,3,76,79,1.0379746835443038,0.021641782639623026,551,Just split already!
4703,0,3,77,80,1.0375,0.021374819563973062,551,Free Slurs
4703,1,1,78,80,1.0375,0.027808966316548646,551,We need a Trump's Ark for these turbulent times.
4703,1,1,78,80,1.0375,0.027808966316548646,551,"That reminds me, did I leave the bathtub running?"
4706,0,3,81,84,1.0357142857142858,0.020369708052572492,551,It's NY - the tsunami won't hurt you!
4707,1,0,75,76,1.0263157894736843,0.026315789473684206,551,"He says ""Bring me your hungry...I'm hungry too!"""
4707,1,0,75,76,1.0263157894736843,0.026315789473684206,551,From sea to shining sea.
4707,0,2,74,76,1.0263157894736843,0.018483603075180238,551,See honey! We should have paid the extra $5 and boarded the real ferry!
4707,0,2,74,76,1.0263157894736843,0.018483603075180238,551,Head for the hills--the dam at Booby Bin has burst!
4707,0,2,74,76,1.0263157894736843,0.018483603075180238,551,Don't let my hair-do scare you away yet.
4707,1,0,75,76,1.0263157894736843,0.026315789473684206,551,"New Ark City"" or ""What Happened to the Dove"
4707,0,2,74,76,1.0263157894736843,0.018483603075180238,551,The Devil in the Trump-do!
4707,0,2,74,76,1.0263157894736843,0.018483603075180238,551,"I thought we were headed to ""the land of the free and home of the brave"", not ""the land where migrants must flee or be crushed by a Trump wave""!"
4707,0,2,74,76,1.0263157894736843,0.018483603075180238,551,The New Colossus of America
4707,1,0,75,76,1.0263157894736843,0.026315789473684206,551,Affirmativeaction.
4707,0,2,74,76,1.0263157894736843,0.018483603075180238,551,Hands across the seamanship.
4707,0,2,74,76,1.0263157894736843,0.018483603075180238,551,For all men tragically great are made so through a certain morbidness.... all mortal greatness is but disease.
4707,0,2,74,76,1.0263157894736843,0.018483603075180238,551,Hang on everybody! It’s the sea’s trump wave!
4707,1,0,75,76,1.0263157894736843,0.026315789473684206,551,I just want to grab your man in the boat.
4707,0,2,74,76,1.0263157894736843,0.018483603075180238,551,Go ahead. Die. Just not here.
4707,0,2,74,76,1.0263157894736843,0.018483603075180238,551,"Yes, that's right, it's per person double occupancy"
4707,0,2,74,76,1.0263157894736843,0.018483603075180238,551,Yikes. Its the ghost wave of Tumpastavus!!!!
4707,0,2,74,76,1.0263157894736843,0.018483603075180238,551,"Yes, Shirley, I know it looks like a monster about to eat us! But it is merely a giant wave, and because it is about to kill us all, your imagination has added the illusion of a monster!"
4707,0,2,74,76,1.0263157894736843,0.018483603075180238,551,Whose idea was this again?
4707,0,2,74,76,1.0263157894736843,0.018483603075180238,551,"That tidal wave looks like it'll be soon on me."" ""Daaad!"
4707,0,2,74,76,1.0263157894736843,0.018483603075180238,551,"Is this Trump's notion of doing the wave?"" ""Maybe but I think it's more like a wave's version of Trump's comb-over."
4707,0,2,74,76,1.0263157894736843,0.018483603075180238,551,"A fine rendering of ""The Great Wave off New York Harbor"""
4707,0,2,74,76,1.0263157894736843,0.018483603075180238,551,Sometimes I don't ??New York.
4707,0,2,74,76,1.0263157894736843,0.018483603075180238,551,"Send these, the homeless, tempest tossed to me. I lift my lamp beside the golden door."
4707,0,2,74,76,1.0263157894736843,0.018483603075180238,551,What is a huddle??
4707,0,2,74,76,1.0263157894736843,0.018483603075180238,551,"Don't be afraid, absolutely. We are all well-positioned to grab this wave and ride it—for all it's worth."
4707,0,2,74,76,1.0263157894736843,0.018483603075180238,551,"Ladies and gents, Ms. Zsa Zsa Gabor's ghost; she'll insult your old mugs, your tired conversations and lastly, your poor wardrobes."
4707,0,2,74,76,1.0263157894736843,0.018483603075180238,551,"We are now in the ""land of bitters and trumpets!"
4707,1,0,75,76,1.0263157894736843,0.026315789473684206,551,"Immigrants will always be welcome to the US. Better screening and border controll is required. That's not radical. Pick another topic. ""Dark Energy"" (no, you'll make that a Trump metaphor), ""Big Pastrami"" ruining America (I like that one)?"
4707,0,2,74,76,1.0263157894736843,0.018483603075180238,551,Behold the great Leviathan!
4707,0,2,74,76,1.0263157894736843,0.018483603075180238,551,DEVOURING TRUMP WAVE
4707,0,2,74,76,1.0263157894736843,0.018483603075180238,551,What do you mean merrily? And this is a nightmare!
4707,0,2,74,76,1.0263157894736843,0.018483603075180238,551,This wave should be refreshing!
4707,0,2,74,76,1.0263157894736843,0.018483603075180238,551,Aaaargh ! The upcoming wave is known as the spirit of sight seekers past !
4707,0,2,74,76,1.0263157894736843,0.018483603075180238,551,"Behold! I, Macrowave, will be your harbor tour guide today."
4707,0,2,74,76,1.0263157894736843,0.018483603075180238,551,"If you're not committed, you don't belong here."
4707,0,2,74,76,1.0263157894736843,0.018483603075180238,551,A Trump type tsunami is unable to use hairspray.
4707,0,2,74,76,1.0263157894736843,0.018483603075180238,551,It's not 'big league'! You're scaring us 'big time'!
4745,0,2,75,77,1.025974025974026,0.018245178147695367,551,Greetings from the Arctic Circle!
4745,0,2,75,77,1.025974025974026,0.018245178147695367,551,"Forget your tired, poor, huddled masses and wretched refuse. Don't send these, the homeless, the tempest-tossed to me, even though I lift my lamp beside a special Golden Door."
4745,0,2,75,77,1.025974025974026,0.018245178147695367,551,I didn't think we'd be hit with the actual Wave of Emotion.
4745,0,2,75,77,1.025974025974026,0.018245178147695367,551,It's known as the waving wave
4745,0,2,75,77,1.025974025974026,0.018245178147695367,551,If this is the new colossus...
4745,0,2,75,77,1.025974025974026,0.018245178147695367,551,A wave more powerful than an actual tsunami.
4745,0,2,75,77,1.025974025974026,0.018245178147695367,551,"Don't worry, I know the inker."
4745,0,2,75,77,1.025974025974026,0.018245178147695367,551,This may be those rough Trump Seas we heard about but Liberty is in view. Just keep Rowing! We'll be home free once we're past the Comb-Over wave.
4745,0,2,75,77,1.025974025974026,0.018245178147695367,551,Matilda! How did you find me?
4745,0,2,75,77,1.025974025974026,0.018245178147695367,551,He's decided to keep immigrants out by really extending the wall
4745,0,2,75,77,1.025974025974026,0.018245178147695367,551,"First he builds a wall, then he curses Ellis Island."
4756,0,2,76,78,1.0256410256410255,0.018012824956774556,551,I don't know gals... I think we could really get pitted in that barrel.
4756,0,2,76,78,1.0256410256410255,0.018012824956774556,551,This will hurt me more than it hurts you.
4758,0,2,77,79,1.0253164556962024,0.017786314519727727,551,"Yes, seeing a comer with an orange comb over and grasping wavelet hands this close to Lady Liberty is an unprecedented experience."
4758,0,2,77,79,1.0253164556962024,0.017786314519727727,551,If only Hillary would have put on a Korn t-shirt and a trucker hat and tapdanced on a table for the vote of those five toothless dudes in Ohio!
4760,0,1,73,74,1.0135135135135136,0.013605756997417963,551,It's been smashing.
4760,0,1,73,74,1.0135135135135136,0.013605756997417963,551,"Why don't *you* take an oar, Mister ""It's Only a Sprinkle."""
4760,0,1,73,74,1.0135135135135136,0.013605756997417963,551,"""Nest stop- ""The Tickle Shop""!"
4760,0,1,73,74,1.0135135135135136,0.013605756997417963,551,That's zero votes for Land of the Free and eight for taking our chances with ISIS!
4760,0,1,73,74,1.0135135135135136,0.013605756997417963,551,"Nice hair, dude."" ""Thanks. I like to go with the flow."
4760,0,1,73,74,1.0135135135135136,0.013605756997417963,551,Creature who's whack buffoon
4760,0,1,73,74,1.0135135135135136,0.013605756997417963,551,"Ha, you don't scare us! Your tiny, wavy, inept hands reveal your tiny, wavy, enept brain, not to mention other tiny, wavy and enept parts of your anatomy."""
4760,0,1,73,74,1.0135135135135136,0.013605756997417963,551,This wave serves as the inspiration for our president -elect's hairdo while seconding as a corrective for the beckoning Statue of Liberty.
4760,0,1,73,74,1.0135135135135136,0.013605756997417963,551,We have no fear!
4760,0,1,73,74,1.0135135135135136,0.013605756997417963,551,We apologize for laughing when you said you thought that water was looking blond.
4760,0,1,73,74,1.0135135135135136,0.013605756997417963,551,"Future 2020 Statue of Liberty Attraction: ""Oh! This is the part where we are tossed by the tempest! The golden door awaits!"""
4760,0,1,73,74,1.0135135135135136,0.013605756997417963,551,And to your right is a Donald wave.
4760,0,1,73,74,1.0135135135135136,0.013605756997417963,551,This All-Inclusive package is wild!
4760,0,1,73,74,1.0135135135135136,0.013605756997417963,551,The name isTrump. Donald Trump.
4760,0,1,73,74,1.0135135135135136,0.013605756997417963,551,"The comb over wants us to believe. Believe he is Wavy Gravy. On the way to Woodstock, Hillary counted half a million strong..."
4760,0,1,73,74,1.0135135135135136,0.013605756997417963,551,"So, you're saying that this one is to keep the Hillary supporters out of New York?"
4760,0,1,73,74,1.0135135135135136,0.013605756997417963,551,He's makes a lot of waves about letting in refugees. But his wives have his ear.
4760,0,1,73,74,1.0135135135135136,0.013605756997417963,551,I'm afraid this is the soup's revenge.
4760,0,1,73,74,1.0135135135135136,0.013605756997417963,551,Wait! Let me show you my mixtape.
4760,0,1,73,74,1.0135135135135136,0.013605756997417963,551,Immigration. Extradition. Trump. Obama. Scylla. Charybdis. Pick your poison.
4760,0,1,73,74,1.0135135135135136,0.013605756997417963,551,Impermanent Resident Act
4760,0,1,73,74,1.0135135135135136,0.013605756997417963,551,"Wow, it's ""Adventure Time""!"
4760,0,1,73,74,1.0135135135135136,0.013605756997417963,551,DRUMPFINATOR
4760,0,1,73,74,1.0135135135135136,0.013605756997417963,551,"Excuse me, but how do we get to Kanagawa?"
4760,0,1,73,74,1.0135135135135136,0.013605756997417963,551,"The Great Wave of Trumpgawa Pokémon, HP: 3.7B Ability: Frothy Hair Slap - 300 Weakness: Freedom of Speech"
4760,0,1,73,74,1.0135135135135136,0.013605756997417963,551,"With his 19th century approach, Trump woodblock women's 21st century progression."
4760,0,1,73,74,1.0135135135135136,0.013605756997417963,551,"The Giant Wave: ""Ship of fools beware!"" Oarsman: ""We're rowing a boat, fool! Are you a Rogue, or, a Virtual Wave?"""
4760,0,1,73,74,1.0135135135135136,0.013605756997417963,551,looks like this will the wave to finally Trump us!
4760,0,1,73,74,1.0135135135135136,0.013605756997417963,551,We like it spicy.
4760,0,1,73,74,1.0135135135135136,0.013605756997417963,551,He who has not bathed recently shall be bathed instantly.
4760,0,1,73,74,1.0135135135135136,0.013605756997417963,551,"Trump wave password, pleeeeeze ......."
4760,0,1,73,74,1.0135135135135136,0.013605756997417963,551,Oh say can you see by the dawns early light
4792,0,1,74,75,1.0133333333333334,0.013423121104280487,551,We are headed home to come back legally. We don't believe your press either!
4792,0,1,74,75,1.0133333333333334,0.013423121104280487,551,Puzzling
4792,0,1,74,75,1.0133333333333334,0.013423121104280487,551,You say you can save me half a million dollars? Move up three chairs.
4792,0,1,74,75,1.0133333333333334,0.013423121104280487,551,All I want is the statute of liberty!
4792,0,1,74,75,1.0133333333333334,0.013423121104280487,551,Celebrities are finally making good on their promises ... and so does Trump.
4792,0,1,74,75,1.0133333333333334,0.013423121104280487,551,I don't do the email thing.
4792,0,1,74,75,1.0133333333333334,0.013423121104280487,551,Donald Trump makes an appearance.
4792,0,1,74,75,1.0133333333333334,0.013423121104280487,551,"I don't know, guys. I just have a good feeling about this year."
4792,0,1,74,75,1.0133333333333334,0.013423121104280487,551,Don't kill us! We subscribe to Tidal.
4792,0,1,74,75,1.0133333333333334,0.013423121104280487,551,"This rougue wave approaches from the right, reels up and grabs you by the crotch. Everybody strt singing along with the Status of Liberty ""Yoor Love is Lifting Me - Higher and Higher!"""
4792,0,1,74,75,1.0133333333333334,0.013423121104280487,551,This is how the wave started
4803,0,1,75,76,1.013157894736842,0.013245323570650438,551,""" It's NOT A TSUNAMEI that's gonna hit America January 20th; it's a TRUMP-TSUNAMEI ! ! !"
4803,0,1,75,76,1.013157894736842,0.013245323570650438,551,"Yeah, NOW I'd rather be Charlton Heston."
4803,0,1,75,76,1.013157894736842,0.013245323570650438,551,That reminds me there's a 50% off sale at Macy's next Friday!
4803,0,1,75,76,1.013157894736842,0.013245323570650438,551,Is it me or does that tidal wave look an awful like Pre-President Elect Donald Trump?
4803,0,1,75,76,1.013157894736842,0.013245323570650438,551,"Well, that uvula is no hoax!"
4803,0,1,75,76,1.013157894736842,0.013245323570650438,551,"""Get out of your neighborhood-"" they said, ""there's more than the Lower East side"", they said."
4803,0,1,75,76,1.013157894736842,0.013245323570650438,551,"yeah but i mean as upper middle class people living in an extremely blue city we're going to have it a lot easier than you know people who are like, muslim or LGBTQ or otherwise vulnerable"
4803,0,1,75,76,1.013157894736842,0.013245323570650438,551,"Folks, look ahead to see the Donald Trump waves"
4803,0,1,75,76,1.013157894736842,0.013245323570650438,551,Even the ocean in New York is a Trump fan
4803,0,1,75,76,1.013157894736842,0.013245323570650438,551,Looks like the tempest is tossing us away from the golden doors of Trump Tower!
4813,0,1,77,78,1.0128205128205128,0.012903494352312729,551,The Phillies have waves this big.
4814,0,0,72,72,1.0,0.013986355971611485,551,Of course our jobs haven't been relocated to Mexico! You put an end to all that!
4814,0,0,72,72,1.0,0.013986355971611485,551,Get the hell out of here!
4814,0,0,72,72,1.0,0.013986355971611485,551,And this is the Wave Of Multiculturalism: Halloween via Hokusai.
4814,0,0,72,72,1.0,0.013986355971611485,551,"Sure, Robert Moses was quite the innovator but I'm afraid this job is over his head!"
4814,0,0,72,72,1.0,0.013986355971611485,551,Immigrants get Trump-ant welcome?
4814,0,0,73,73,1.0,0.013793431476706131,551,I guess this is how he wants us vetted - with his own Great Wave off his Tower!
4814,0,0,72,72,1.0,0.013986355971611485,551,Show me the way to Santa Fey.
4814,0,0,73,73,1.0,0.013793431476706131,551,Trump: you cannot enter the United States Boater: do not take him seriously! Another passenger: I bet i have seen this wave before!
4814,0,0,72,72,1.0,0.013986355971611485,551,I want to see indigo now—now!
4814,0,0,72,72,1.0,0.013986355971611485,551,The law of averages says we should have traveled to Thailand.
4814,0,0,73,73,1.0,0.013793431476706131,551,Where are the billy goat gruff when you need them
4814,0,0,72,72,1.0,0.013986355971611485,551,"The hairdo and tiny hands look familiar. This could be the dreaded ""Manhattan Monster""."
4814,0,0,72,72,1.0,0.013986355971611485,551,Anyone else up for sushi?
4814,0,0,72,72,1.0,0.013986355971611485,551,I thought you cancelled our reservation at Angry Wade's!
4814,0,0,72,72,1.0,0.013986355971611485,551,The Great Wave at Bunga-Bunga
4814,0,0,73,73,1.0,0.013793431476706131,551,Wait! I am going to Make America Great Again!
4814,0,0,72,72,1.0,0.013986355971611485,551,"But Maaaaw, we said we'd be out late!"
4814,0,0,72,72,1.0,0.013986355971611485,551,Of course it looks like Donald Trump.
4814,0,0,72,72,1.0,0.013986355971611485,551,Oh no! Trump!
4814,0,0,72,72,1.0,0.013986355971611485,551,A serious tsunami is on its way.
4814,0,0,74,74,1.0,0.013605756997417963,551,Your afterburner was out
4814,0,0,72,72,1.0,0.013986355971611485,551,"Please, toss them through to Pittsburgh, would ya?"
4814,0,0,72,72,1.0,0.013986355971611485,551,I told you we were in trouble in America if we put our oar in!
4814,0,0,72,72,1.0,0.013986355971611485,551,He's helping us get to shore. It's terrifico!
4814,0,0,72,72,1.0,0.013986355971611485,551,Hold on this looks like a brazen giant to me...
4814,0,0,72,72,1.0,0.013986355971611485,551,I know most of us didn't get vote to go on this ride but together we will get through this
4814,0,0,72,72,1.0,0.013986355971611485,551,"My goodness, even the river is overcrowded and unfriendly here."
4814,0,0,72,72,1.0,0.013986355971611485,551,But really? That Fukushima wave had to make to us with that due?
4814,0,0,72,72,1.0,0.013986355971611485,551,"Yep, you're dying."
4814,0,0,73,73,1.0,0.013793431476706131,551,"He's turning us away for ""lice"""
